Poker Hand #RC3334603734: Hold'em No Limit ($0.02/$0.05) - 2025/02/17 21:51:36
Table 'RushAndCash638994' 6-max Seat #1 is the button
Seat 1: Hero ($9.04 in chips)
Seat 2: 6ad786fd ($5.37 in chips)
Seat 3: b6083d7e ($5.58 in chips)
Seat 4: d60e3ce5 ($5.69 in chips)
Seat 5: f6efd55a ($7.49 in chips)
Seat 6: 3f6d99d0 ($4.43 in chips)
6ad786fd: posts small blind $0.02
b6083d7e: posts big blind $0.05
*** HOLE CARDS ***
Dealt to Hero [6s 6d]
Dealt to 6ad786fd 
Dealt to b6083d7e 
Dealt to d60e3ce5 
Dealt to f6efd55a 
Dealt to 3f6d99d0 
d60e3ce5: folds
f6efd55a: folds
3f6d99d0: folds
Hero: raises $0.05 to $0.1
6ad786fd: folds
b6083d7e: raises $0.27 to $0.37
Hero: folds
Uncalled bet ($0.27) returned to b6083d7e
*** SHOWDOWN ***
b6083d7e collected $0.21 from pot
*** SUMMARY ***
Total pot $0.22 | Rake $0.01 | Jackpot $0 | Bingo $0 | Fortune $0 | Tax $0
Seat 1: Hero (button) folded before Flop
Seat 2: 6ad786fd (small blind) folded before Flop
Seat 3: b6083d7e (big blind) collected ($0.21)
Seat 4: d60e3ce5 folded before Flop (didn't bet)
Seat 5: f6efd55a folded before Flop (didn't bet)
Seat 6: 3f6d99d0 folded before Flop (didn't bet)


Poker Hand #RC3334603703: Hold'em No Limit ($0.02/$0.05) - 2025/02/17 21:51:32
Table 'RushAndCash638963' 6-max Seat #1 is the button
Seat 1: 24aff26b ($5 in chips)
Seat 2: dfdc1c0b ($5 in chips)
Seat 3: Hero ($9.09 in chips)
Seat 4: 95d29c49 ($5.12 in chips)
Seat 5: 769f9172 ($11.55 in chips)
Seat 6: 6608ec00 ($7.96 in chips)
dfdc1c0b: posts small blind $0.02
Hero: posts big blind $0.05
*** HOLE CARDS ***
Dealt to 24aff26b 
Dealt to dfdc1c0b 
Dealt to Hero [8c 7h]
Dealt to 95d29c49 
Dealt to 769f9172 
Dealt to 6608ec00 
95d29c49: folds
769f9172: folds
6608ec00: folds
24aff26b: folds
dfdc1c0b: raises $0.1 to $0.15
Hero: folds
Uncalled bet ($0.1) returned to dfdc1c0b
*** SHOWDOWN ***
dfdc1c0b collected $0.1 from pot
*** SUMMARY ***
Total pot $0.1 | Rake $0 | Jackpot $0 | Bingo $0 | Fortune $0 | Tax $0
Seat 1: 24aff26b (button) folded before Flop (didn't bet)
Seat 2: dfdc1c0b (small blind) collected ($0.1)
Seat 3: Hero (big blind) folded before Flop
Seat 4: 95d29c49 folded before Flop (didn't bet)
Seat 5: 769f9172 folded before Flop (didn't bet)
Seat 6: 6608ec00 folded before Flop (didn't bet)


Poker Hand #RC3334603677: Hold'em No Limit ($0.02/$0.05) - 2025/02/17 21:51:29
Table 'RushAndCash638937' 6-max Seat #1 is the button
Seat 1: c806dd25 ($11.38 in chips)
Seat 2: 3d2b2789 ($5.29 in chips)
Seat 3: 1941fa92 ($4.73 in chips)
Seat 4: 8023de0f ($8.22 in chips)
Seat 5: Hero ($9.09 in chips)
Seat 6: 860b5247 ($11.29 in chips)
3d2b2789: posts small blind $0.02
1941fa92: posts big blind $0.05
*** HOLE CARDS ***
Dealt to c806dd25 
Dealt to 3d2b2789 
Dealt to 1941fa92 
Dealt to 8023de0f 
Dealt to Hero [Ah 2c]
Dealt to 860b5247 
8023de0f: folds
Hero: folds
860b5247: folds
c806dd25: raises $0.1 to $0.15
3d2b2789: folds
1941fa92: calls $0.1
*** FLOP *** [3s 8d 9s]
1941fa92: checks
c806dd25: bets $0.17
1941fa92: calls $0.17
*** TURN *** [3s 8d 9s] [As]
1941fa92: checks
c806dd25: checks
*** RIVER *** [3s 8d 9s As] [8c]
1941fa92: bets $0.5
c806dd25: calls $0.5
1941fa92: shows [Td Js] (Pair of Eights)
c806dd25: shows [Qh Ac] (Pair of Aces and Pair of Eights)
*** SHOWDOWN ***
c806dd25 collected $1.51 from pot
*** SUMMARY ***
Total pot $1.66 | Rake $0.08 | Jackpot $0.07 | Bingo $0 | Fortune $0 | Tax $0
Board [3s 8d 9s As 8c]
Seat 1: c806dd25 (button) showed [Qh Ac] and won ($1.51) with Pair of Aces and Pair of Eights
Seat 2: 3d2b2789 (small blind) folded before Flop
Seat 3: 1941fa92 (big blind) showed [Td Js] and lost with Pair of Eights
Seat 4: 8023de0f folded before Flop (didn't bet)
Seat 5: Hero folded before Flop (didn't bet)
Seat 6: 860b5247 folded before Flop (didn't bet)


Poker Hand #RC3334603393: Hold'em No Limit ($0.02/$0.05) - 2025/02/17 21:50:56
Table 'RushAndCash638653' 6-max Seat #1 is the button
Seat 1: 860b5247 ($11.41 in chips)
Seat 2: Hero ($8.93 in chips)
Seat 3: 697412e ($11.74 in chips)
Seat 4: 82341569 ($5.07 in chips)
Seat 5: 6ab3ea38 ($5.79 in chips)
Seat 6: d58b99ca ($49.24 in chips)
Hero: posts small blind $0.02
697412e: posts big blind $0.05
*** HOLE CARDS ***
Dealt to 860b5247 
Dealt to Hero [Qs Ac]
Dealt to 697412e 
Dealt to 82341569 
Dealt to 6ab3ea38 
Dealt to d58b99ca 
82341569: folds
6ab3ea38: folds
d58b99ca: folds
860b5247: raises $0.07 to $0.12
Hero: raises $0.38 to $0.5
697412e: folds
860b5247: folds
Uncalled bet ($0.38) returned to Hero
*** SHOWDOWN ***
Hero collected $0.28 from pot
*** SUMMARY ***
Total pot $0.29 | Rake $0.01 | Jackpot $0 | Bingo $0 | Fortune $0 | Tax $0
Seat 1: 860b5247 (button) folded before Flop
Seat 2: Hero (small blind) collected ($0.28)
Seat 3: 697412e (big blind) folded before Flop
Seat 4: 82341569 folded before Flop (didn't bet)
Seat 5: 6ab3ea38 folded before Flop (didn't bet)
Seat 6: d58b99ca folded before Flop (didn't bet)


Poker Hand #RC3334603362: Hold'em No Limit ($0.02/$0.05) - 2025/02/17 21:50:53
Table 'RushAndCash638622' 6-max Seat #1 is the button
Seat 1: db90e8c7 ($5 in chips)
Seat 2: 93056ee9 ($10.36 in chips)
Seat 3: ca7c2b72 ($5 in chips)
Seat 4: Hero ($8.93 in chips)
Seat 5: b58ce910 ($5.22 in chips)
Seat 6: 52f43d28 ($8.85 in chips)
93056ee9: posts small blind $0.02
ca7c2b72: posts big blind $0.05
*** HOLE CARDS ***
Dealt to db90e8c7 
Dealt to 93056ee9 
Dealt to ca7c2b72 
Dealt to Hero [Kc Th]
Dealt to b58ce910 
Dealt to 52f43d28 
Hero: folds
b58ce910: folds
52f43d28: folds
db90e8c7: raises $0.08 to $0.13
93056ee9: calls $0.11
ca7c2b72: folds
*** FLOP *** [9d Kd Ts]
93056ee9: checks
db90e8c7: checks
*** TURN *** [9d Kd Ts] [Jd]
93056ee9: checks
db90e8c7: checks
*** RIVER *** [9d Kd Ts Jd] [Qs]
93056ee9: checks
db90e8c7: checks
93056ee9: shows [2c 2s] (Kings-High Straight)
db90e8c7: shows [3s As] (Aces-High Straight)
*** SHOWDOWN ***
db90e8c7 collected $0.3 from pot
*** SUMMARY ***
Total pot $0.31 | Rake $0.01 | Jackpot $0 | Bingo $0 | Fortune $0 | Tax $0
Board [9d Kd Ts Jd Qs]
Seat 1: db90e8c7 (button) showed [3s As] and won ($0.3) with Aces-High Straight
Seat 2: 93056ee9 (small blind) showed [2c 2s] and lost with Kings-High Straight
Seat 3: ca7c2b72 (big blind) folded before Flop
Seat 4: Hero folded before Flop (didn't bet)
Seat 5: b58ce910 folded before Flop (didn't bet)
Seat 6: 52f43d28 folded before Flop (didn't bet)


Poker Hand #RC3334603326: Hold'em No Limit ($0.02/$0.05) - 2025/02/17 21:50:49
Table 'RushAndCash638586' 6-max Seat #1 is the button
Seat 1: 692e3a83 ($8.79 in chips)
Seat 2: 697412e ($11.76 in chips)
Seat 3: d737deb4 ($11.21 in chips)
Seat 4: Hero ($8.93 in chips)
Seat 5: 76e7cdfc ($5.84 in chips)
Seat 6: 7d310fdd ($5.16 in chips)
697412e: posts small blind $0.02
d737deb4: posts big blind $0.05
*** HOLE CARDS ***
Dealt to 692e3a83 
Dealt to 697412e 
Dealt to d737deb4 
Dealt to Hero [5d Ts]
Dealt to 76e7cdfc 
Dealt to 7d310fdd 
Hero: folds
76e7cdfc: folds
7d310fdd: folds
692e3a83: raises $0.07 to $0.12
697412e: folds
d737deb4: raises $0.38 to $0.5
692e3a83: folds
Uncalled bet ($0.38) returned to d737deb4
*** SHOWDOWN ***
d737deb4 collected $0.25 from pot
*** SUMMARY ***
Total pot $0.26 | Rake $0.01 | Jackpot $0 | Bingo $0 | Fortune $0 | Tax $0
Seat 1: 692e3a83 (button) folded before Flop
Seat 2: 697412e (small blind) folded before Flop
Seat 3: d737deb4 (big blind) collected ($0.25)
Seat 4: Hero folded before Flop (didn't bet)
Seat 5: 76e7cdfc folded before Flop (didn't bet)
Seat 6: 7d310fdd folded before Flop (didn't bet)


Poker Hand #RC3334603122: Hold'em No Limit ($0.02/$0.05) - 2025/02/17 21:50:29
Table 'RushAndCash638382' 6-max Seat #1 is the button
Seat 1: 6ac4af54 ($10.21 in chips)
Seat 2: d737deb4 ($11.07 in chips)
Seat 3: 2e6fb3bc ($5 in chips)
Seat 4: d86379c5 ($4.79 in chips)
Seat 5: ee3fdfd8 ($11.99 in chips)
Seat 6: Hero ($9.03 in chips)
d737deb4: posts small blind $0.02
2e6fb3bc: posts big blind $0.05
*** HOLE CARDS ***
Dealt to 6ac4af54 
Dealt to d737deb4 
Dealt to 2e6fb3bc 
Dealt to d86379c5 
Dealt to ee3fdfd8 
Dealt to Hero [Qs Jc]
d86379c5: folds
ee3fdfd8: folds
Hero: raises $0.05 to $0.1
6ac4af54: folds
d737deb4: raises $0.4 to $0.5
2e6fb3bc: folds
Hero: folds
Uncalled bet ($0.4) returned to d737deb4
*** SHOWDOWN ***
d737deb4 collected $0.24 from pot
*** SUMMARY ***
Total pot $0.25 | Rake $0.01 | Jackpot $0 | Bingo $0 | Fortune $0 | Tax $0
Seat 1: 6ac4af54 (button) folded before Flop (didn't bet)
Seat 2: d737deb4 (small blind) collected ($0.24)
Seat 3: 2e6fb3bc (big blind) folded before Flop
Seat 4: d86379c5 folded before Flop (didn't bet)
Seat 5: ee3fdfd8 folded before Flop (didn't bet)
Seat 6: Hero folded before Flop


Poker Hand #RC3334603088: Hold'em No Limit ($0.02/$0.05) - 2025/02/17 21:50:25
Table 'RushAndCash638348' 6-max Seat #1 is the button
Seat 1: 820e1571 ($5.2 in chips)
Seat 2: Hero ($8.98 in chips)
Seat 3: dd3f46e9 ($5 in chips)
Seat 4: 9b09147b ($15.13 in chips)
Seat 5: 7fe74cc5 ($15.79 in chips)
Seat 6: d7ea6681 ($5.64 in chips)
Hero: posts small blind $0.02
dd3f46e9: posts big blind $0.05
*** HOLE CARDS ***
Dealt to 820e1571 
Dealt to Hero [Qc 5d]
Dealt to dd3f46e9 
Dealt to 9b09147b 
Dealt to 7fe74cc5 
Dealt to d7ea6681 
9b09147b: folds
7fe74cc5: folds
d7ea6681: folds
820e1571: folds
Hero: folds
Uncalled bet ($0.03) returned to dd3f46e9
*** SHOWDOWN ***
dd3f46e9 collected $0.04 from pot
*** SUMMARY ***
Total pot $0.04 | Rake $0 | Jackpot $0 | Bingo $0 | Fortune $0 | Tax $0
Seat 1: 820e1571 (button) folded before Flop (didn't bet)
Seat 2: Hero (small blind) folded before Flop
Seat 3: dd3f46e9 (big blind) collected ($0.04)
Seat 4: 9b09147b folded before Flop (didn't bet)
Seat 5: 7fe74cc5 folded before Flop (didn't bet)
Seat 6: d7ea6681 folded before Flop (didn't bet)


Poker Hand #RC3334603051: Hold'em No Limit ($0.02/$0.05) - 2025/02/17 21:50:21
Table 'RushAndCash638311' 6-max Seat #1 is the button
Seat 1: 4305bf97 ($5.87 in chips)
Seat 2: 493e7626 ($10.18 in chips)
Seat 3: Hero ($9.03 in chips)
Seat 4: 9bc1cdf1 ($5.48 in chips)
Seat 5: 510f8c9f ($10.65 in chips)
Seat 6: 273e47ba ($5.12 in chips)
493e7626: posts small blind $0.02
Hero: posts big blind $0.05
*** HOLE CARDS ***
Dealt to 4305bf97 
Dealt to 493e7626 
Dealt to Hero [4d Qs]
Dealt to 9bc1cdf1 
Dealt to 510f8c9f 
Dealt to 273e47ba 
9bc1cdf1: folds
510f8c9f: folds
273e47ba: folds
4305bf97: folds
493e7626: folds
Uncalled bet ($0.03) returned to Hero
*** SHOWDOWN ***
Hero collected $0.04 from pot
*** SUMMARY ***
Total pot $0.04 | Rake $0 | Jackpot $0 | Bingo $0 | Fortune $0 | Tax $0
Seat 1: 4305bf97 (button) folded before Flop (didn't bet)
Seat 2: 493e7626 (small blind) folded before Flop
Seat 3: Hero (big blind) collected ($0.04)
Seat 4: 9bc1cdf1 folded before Flop (didn't bet)
Seat 5: 510f8c9f folded before Flop (didn't bet)
Seat 6: 273e47ba folded before Flop (didn't bet)


Poker Hand #RC3334603018: Hold'em No Limit ($0.02/$0.05) - 2025/02/17 21:50:18
Table 'RushAndCash638278' 6-max Seat #1 is the button
Seat 1: 530477b2 ($5.33 in chips)
Seat 2: 8d7c8253 ($5.18 in chips)
Seat 3: c582715a ($8.13 in chips)
Seat 4: Hero ($9.03 in chips)
Seat 5: a678f821 ($8.77 in chips)
Seat 6: b59fc0b9 ($5.27 in chips)
8d7c8253: posts small blind $0.02
c582715a: posts big blind $0.05
*** HOLE CARDS ***
Dealt to 530477b2 
Dealt to 8d7c8253 
Dealt to c582715a 
Dealt to Hero [5h 2h]
Dealt to a678f821 
Dealt to b59fc0b9 
Hero: folds
a678f821: raises $0.1 to $0.15
b59fc0b9: folds
530477b2: folds
8d7c8253: folds
c582715a: folds
Uncalled bet ($0.1) returned to a678f821
*** SHOWDOWN ***
a678f821 collected $0.12 from pot
*** SUMMARY ***
Total pot $0.12 | Rake $0 | Jackpot $0 | Bingo $0 | Fortune $0 | Tax $0
Seat 1: 530477b2 (button) folded before Flop (didn't bet)
Seat 2: 8d7c8253 (small blind) folded before Flop
Seat 3: c582715a (big blind) folded before Flop
Seat 4: Hero folded before Flop (didn't bet)
Seat 5: a678f821 collected ($0.12)
Seat 6: b59fc0b9 folded before Flop (didn't bet)


Poker Hand #RC3334602988: Hold'em No Limit ($0.02/$0.05) - 2025/02/17 21:50:15
Table 'RushAndCash638248' 6-max Seat #1 is the button
Seat 1: 6be17d4e ($7.64 in chips)
Seat 2: de38466f ($5.41 in chips)
Seat 3: b4cd57cf ($8.26 in chips)
Seat 4: 663d0aa ($1.41 in chips)
Seat 5: Hero ($9.03 in chips)
Seat 6: c29eb839 ($5.33 in chips)
de38466f: posts small blind $0.02
b4cd57cf: posts big blind $0.05
*** HOLE CARDS ***
Dealt to 6be17d4e 
Dealt to de38466f 
Dealt to b4cd57cf 
Dealt to 663d0aa 
Dealt to Hero [Kc 8d]
Dealt to c29eb839 
663d0aa: raises $0.05 to $0.1
Hero: folds
c29eb839: folds
6be17d4e: folds
de38466f: folds
b4cd57cf: calls $0.05
*** FLOP *** [3c 2d 6c]
b4cd57cf: bets $0.1
663d0aa: raises $0.42 to $0.52
b4cd57cf: folds
Uncalled bet ($0.42) returned to 663d0aa
*** SHOWDOWN ***
663d0aa collected $0.4 from pot
*** SUMMARY ***
Total pot $0.42 | Rake $0.02 | Jackpot $0 | Bingo $0 | Fortune $0 | Tax $0
Board [3c 2d 6c]
Seat 1: 6be17d4e (button) folded before Flop (didn't bet)
Seat 2: de38466f (small blind) folded before Flop
Seat 3: b4cd57cf (big blind) folded on the Flop
Seat 4: 663d0aa won ($0.4)
Seat 5: Hero folded before Flop (didn't bet)
Seat 6: c29eb839 folded before Flop (didn't bet)


Poker Hand #RC3334602948: Hold'em No Limit ($0.02/$0.05) - 2025/02/17 21:50:11
Table 'RushAndCash638208' 6-max Seat #1 is the button
Seat 1: 656af102 ($6.51 in chips)
Seat 2: c24b20b9 ($17.31 in chips)
Seat 3: 5c08f408 ($4.75 in chips)
Seat 4: 3d2b2789 ($5.48 in chips)
Seat 5: Hero ($9.03 in chips)
Seat 6: 598d859f ($14.74 in chips)
c24b20b9: posts small blind $0.02
5c08f408: posts big blind $0.05
*** HOLE CARDS ***
Dealt to 656af102 
Dealt to c24b20b9 
Dealt to 5c08f408 
Dealt to 3d2b2789 
Dealt to Hero [Qd 6d]
Dealt to 598d859f 
3d2b2789: folds
Hero: folds
598d859f: folds
656af102: folds
c24b20b9: folds
Uncalled bet ($0.03) returned to 5c08f408
*** SHOWDOWN ***
5c08f408 collected $0.04 from pot
*** SUMMARY ***
Total pot $0.04 | Rake $0 | Jackpot $0 | Bingo $0 | Fortune $0 | Tax $0
Seat 1: 656af102 (button) folded before Flop (didn't bet)
Seat 2: c24b20b9 (small blind) folded before Flop
Seat 3: 5c08f408 (big blind) collected ($0.04)
Seat 4: 3d2b2789 folded before Flop (didn't bet)
Seat 5: Hero folded before Flop (didn't bet)
Seat 6: 598d859f folded before Flop (didn't bet)


Poker Hand #RC3334602916: Hold'em No Limit ($0.02/$0.05) - 2025/02/17 21:50:08
Table 'RushAndCash638176' 6-max Seat #1 is the button
Seat 1: 35016d48 ($5.7 in chips)
Seat 2: 87205baf ($11.34 in chips)
Seat 3: ccabd9d2 ($3.13 in chips)
Seat 4: 4299b97d ($5.48 in chips)
Seat 5: Hero ($9.03 in chips)
Seat 6: 4922466d ($4.93 in chips)
87205baf: posts small blind $0.02
ccabd9d2: posts big blind $0.05
*** HOLE CARDS ***
Dealt to 35016d48 
Dealt to 87205baf 
Dealt to ccabd9d2 
Dealt to 4299b97d 
Dealt to Hero [3s Qh]
Dealt to 4922466d 
4299b97d: folds
Hero: folds
4922466d: folds
35016d48: raises $0.08 to $0.13
87205baf: folds
ccabd9d2: folds
Uncalled bet ($0.08) returned to 35016d48
*** SHOWDOWN ***
35016d48 collected $0.12 from pot
*** SUMMARY ***
Total pot $0.12 | Rake $0 | Jackpot $0 | Bingo $0 | Fortune $0 | Tax $0
Seat 1: 35016d48 (button) collected ($0.12)
Seat 2: 87205baf (small blind) folded before Flop
Seat 3: ccabd9d2 (big blind) folded before Flop
Seat 4: 4299b97d folded before Flop (didn't bet)
Seat 5: Hero folded before Flop (didn't bet)
Seat 6: 4922466d folded before Flop (didn't bet)


Poker Hand #RC3334602885: Hold'em No Limit ($0.02/$0.05) - 2025/02/17 21:50:05
Table 'RushAndCash638145' 6-max Seat #1 is the button
Seat 1: ab43c8b8 ($9.08 in chips)
Seat 2: cef157c0 ($4.86 in chips)
Seat 3: Hero ($9.08 in chips)
Seat 4: 55e0d4fe ($8.92 in chips)
Seat 5: c59158f3 ($5.84 in chips)
Seat 6: 9013f95e ($10.25 in chips)
cef157c0: posts small blind $0.02
Hero: posts big blind $0.05
*** HOLE CARDS ***
Dealt to ab43c8b8 
Dealt to cef157c0 
Dealt to Hero [4s 5c]
Dealt to 55e0d4fe 
Dealt to c59158f3 
Dealt to 9013f95e 
55e0d4fe: folds
c59158f3: folds
9013f95e: folds
ab43c8b8: folds
cef157c0: raises $0.1 to $0.15
Hero: folds
Uncalled bet ($0.1) returned to cef157c0
*** SHOWDOWN ***
cef157c0 collected $0.1 from pot
*** SUMMARY ***
Total pot $0.1 | Rake $0 | Jackpot $0 | Bingo $0 | Fortune $0 | Tax $0
Seat 1: ab43c8b8 (button) folded before Flop (didn't bet)
Seat 2: cef157c0 (small blind) collected ($0.1)
Seat 3: Hero (big blind) folded before Flop
Seat 4: 55e0d4fe folded before Flop (didn't bet)
Seat 5: c59158f3 folded before Flop (didn't bet)
Seat 6: 9013f95e folded before Flop (didn't bet)


Poker Hand #RC3334602855: Hold'em No Limit ($0.02/$0.05) - 2025/02/17 21:50:02
Table 'RushAndCash638115' 6-max Seat #1 is the button
Seat 1: Hero ($9.08 in chips)
Seat 2: d60e3ce5 ($5.78 in chips)
Seat 3: a4461af6 ($12.95 in chips)
Seat 4: 110fdc96 ($6.53 in chips)
Seat 5: 18fbcc2b ($1.32 in chips)
Seat 6: cef157c0 ($4.86 in chips)
d60e3ce5: posts small blind $0.02
a4461af6: posts big blind $0.05
*** HOLE CARDS ***
Dealt to Hero [Tc Qd]
Dealt to d60e3ce5 
Dealt to a4461af6 
Dealt to 110fdc96 
Dealt to 18fbcc2b 
Dealt to cef157c0 
110fdc96: folds
18fbcc2b: folds
cef157c0: folds
Hero: folds
d60e3ce5: raises $0.08 to $0.13
a4461af6: calls $0.08
*** FLOP *** [Kh 2s Qc]
d60e3ce5: checks
a4461af6: checks
*** TURN *** [Kh 2s Qc] [Ks]
d60e3ce5: checks
a4461af6: checks
*** RIVER *** [Kh 2s Qc Ks] [Ts]
d60e3ce5: checks
a4461af6: checks
d60e3ce5: shows [6s 5c] (Pair of Kings)
a4461af6: shows [Ad 4d] (Pair of Kings)
*** SHOWDOWN ***
a4461af6 collected $0.25 from pot
*** SUMMARY ***
Total pot $0.26 | Rake $0.01 | Jackpot $0 | Bingo $0 | Fortune $0 | Tax $0
Board [Kh 2s Qc Ks Ts]
Seat 1: Hero (button) folded before Flop (didn't bet)
Seat 2: d60e3ce5 (small blind) showed [6s 5c] and lost with Pair of Kings
Seat 3: a4461af6 (big blind) showed [Ad 4d] and won ($0.25) with Pair of Kings
Seat 4: 110fdc96 folded before Flop (didn't bet)
Seat 5: 18fbcc2b folded before Flop (didn't bet)
Seat 6: cef157c0 folded before Flop (didn't bet)


Poker Hand #RC3334602822: Hold'em No Limit ($0.02/$0.05) - 2025/02/17 21:49:58
Table 'RushAndCash638082' 6-max Seat #1 is the button
Seat 1: 8d7c8253 ($5.11 in chips)
Seat 2: 3a228f55 ($5 in chips)
Seat 3: a5be70d9 ($15.19 in chips)
Seat 4: c29eb839 ($5.35 in chips)
Seat 5: a4461af6 ($12.95 in chips)
Seat 6: Hero ($9.08 in chips)
3a228f55: posts small blind $0.02
a5be70d9: posts big blind $0.05
*** HOLE CARDS ***
Dealt to 8d7c8253 
Dealt to 3a228f55 
Dealt to a5be70d9 
Dealt to c29eb839 
Dealt to a4461af6 
Dealt to Hero [8s 9d]
c29eb839: folds
a4461af6: folds
Hero: folds
8d7c8253: folds
3a228f55: folds
Uncalled bet ($0.03) returned to a5be70d9
*** SHOWDOWN ***
a5be70d9 collected $0.04 from pot
*** SUMMARY ***
Total pot $0.04 | Rake $0 | Jackpot $0 | Bingo $0 | Fortune $0 | Tax $0
Seat 1: 8d7c8253 (button) folded before Flop (didn't bet)
Seat 2: 3a228f55 (small blind) folded before Flop
Seat 3: a5be70d9 (big blind) collected ($0.04)
Seat 4: c29eb839 folded before Flop (didn't bet)
Seat 5: a4461af6 folded before Flop (didn't bet)
Seat 6: Hero folded before Flop (didn't bet)


Poker Hand #RC3334602789: Hold'em No Limit ($0.02/$0.05) - 2025/02/17 21:49:55
Table 'RushAndCash638049' 6-max Seat #1 is the button
Seat 1: 79d81faa ($6.66 in chips)
Seat 2: dcd4e05 ($1.79 in chips)
Seat 3: 2d52b322 ($5 in chips)
Seat 4: 719071b8 ($6.94 in chips)
Seat 5: Hero ($9.08 in chips)
Seat 6: f691c1c2 ($5.25 in chips)
dcd4e05: posts small blind $0.02
2d52b322: posts big blind $0.05
*** HOLE CARDS ***
Dealt to 79d81faa 
Dealt to dcd4e05 
Dealt to 2d52b322 
Dealt to 719071b8 
Dealt to Hero [Ah 5c]
Dealt to f691c1c2 
719071b8: folds
Hero: folds
f691c1c2: folds
79d81faa: folds
dcd4e05: raises $0.1 to $0.15
2d52b322: raises $0.3 to $0.45
dcd4e05: folds
Uncalled bet ($0.3) returned to 2d52b322
*** SHOWDOWN ***
2d52b322 collected $0.29 from pot
*** SUMMARY ***
Total pot $0.3 | Rake $0.01 | Jackpot $0 | Bingo $0 | Fortune $0 | Tax $0
Seat 1: 79d81faa (button) folded before Flop (didn't bet)
Seat 2: dcd4e05 (small blind) folded before Flop
Seat 3: 2d52b322 (big blind) collected ($0.29)
Seat 4: 719071b8 folded before Flop (didn't bet)
Seat 5: Hero folded before Flop (didn't bet)
Seat 6: f691c1c2 folded before Flop (didn't bet)


Poker Hand #RC3334602758: Hold'em No Limit ($0.02/$0.05) - 2025/02/17 21:49:51
Table 'RushAndCash638018' 6-max Seat #1 is the button
Seat 1: Hero ($9.08 in chips)
Seat 2: c4311617 ($5.75 in chips)
Seat 3: 8e93231a ($5 in chips)
Seat 4: e6b639b4 ($5.36 in chips)
Seat 5: da5bd304 ($5.03 in chips)
Seat 6: df1d9475 ($5 in chips)
c4311617: posts small blind $0.02
8e93231a: posts big blind $0.05
*** HOLE CARDS ***
Dealt to Hero [Ks 6d]
Dealt to c4311617 
Dealt to 8e93231a 
Dealt to e6b639b4 
Dealt to da5bd304 
Dealt to df1d9475 
e6b639b4: raises $0.08 to $0.13
da5bd304: folds
df1d9475: folds
Hero: folds
c4311617: folds
8e93231a: calls $0.08
*** FLOP *** [Jd Qs 6c]
8e93231a: checks
e6b639b4: checks
*** TURN *** [Jd Qs 6c] [Jh]
8e93231a: checks
e6b639b4: checks
*** RIVER *** [Jd Qs 6c Jh] [9c]
8e93231a: bets $0.16
e6b639b4: folds
Uncalled bet ($0.16) returned to 8e93231a
*** SHOWDOWN ***
8e93231a collected $0.27 from pot
*** SUMMARY ***
Total pot $0.28 | Rake $0.01 | Jackpot $0 | Bingo $0 | Fortune $0 | Tax $0
Board [Jd Qs 6c Jh 9c]
Seat 1: Hero (button) folded before Flop (didn't bet)
Seat 2: c4311617 (small blind) folded before Flop
Seat 3: 8e93231a (big blind) won ($0.27)
Seat 4: e6b639b4 folded on the River
Seat 5: da5bd304 folded before Flop (didn't bet)
Seat 6: df1d9475 folded before Flop (didn't bet)


Poker Hand #RC3334602666: Hold'em No Limit ($0.02/$0.05) - 2025/02/17 21:49:41
Table 'RushAndCash637926' 6-max Seat #1 is the button
Seat 1: 656af102 ($6.53 in chips)
Seat 2: b58ce910 ($5.38 in chips)
Seat 3: a25931dc ($5.97 in chips)
Seat 4: 6b09dc81 ($4.97 in chips)
Seat 5: 697412e ($11.83 in chips)
Seat 6: Hero ($9.08 in chips)
b58ce910: posts small blind $0.02
a25931dc: posts big blind $0.05
*** HOLE CARDS ***
Dealt to 656af102 
Dealt to b58ce910 
Dealt to a25931dc 
Dealt to 6b09dc81 
Dealt to 697412e 
Dealt to Hero [Kh Js]
6b09dc81: folds
697412e: raises $0.06 to $0.11
Hero: folds
656af102: folds
b58ce910: folds
a25931dc: calls $0.06
*** FLOP *** [Th 8d Ts]
a25931dc: checks
697412e: bets $0.08
a25931dc: calls $0.08
*** TURN *** [Th 8d Ts] [6h]
a25931dc: checks
697412e: checks
*** RIVER *** [Th 8d Ts 6h] [3h]
a25931dc: bets $0.2
697412e: folds
Uncalled bet ($0.2) returned to a25931dc
*** SHOWDOWN ***
a25931dc collected $0.38 from pot
*** SUMMARY ***
Total pot $0.4 | Rake $0.02 | Jackpot $0 | Bingo $0 | Fortune $0 | Tax $0
Board [Th 8d Ts 6h 3h]
Seat 1: 656af102 (button) folded before Flop (didn't bet)
Seat 2: b58ce910 (small blind) folded before Flop
Seat 3: a25931dc (big blind) won ($0.38)
Seat 4: 6b09dc81 folded before Flop (didn't bet)
Seat 5: 697412e folded on the River
Seat 6: Hero folded before Flop (didn't bet)


Poker Hand #RC3334602638: Hold'em No Limit ($0.02/$0.05) - 2025/02/17 21:49:38
Table 'RushAndCash637898' 6-max Seat #1 is the button
Seat 1: 4262311b ($9.39 in chips)
Seat 2: Hero ($9.1 in chips)
Seat 3: e0d14e10 ($5 in chips)
Seat 4: a7365f1c ($6.65 in chips)
Seat 5: c9baa38a ($5.43 in chips)
Seat 6: 7b1424ef ($5.31 in chips)
Hero: posts small blind $0.02
e0d14e10: posts big blind $0.05
*** HOLE CARDS ***
Dealt to 4262311b 
Dealt to Hero [5h Kd]
Dealt to e0d14e10 
Dealt to a7365f1c 
Dealt to c9baa38a 
Dealt to 7b1424ef 
a7365f1c: raises $0.06 to $0.11
c9baa38a: folds
7b1424ef: folds
4262311b: folds
Hero: folds
e0d14e10: folds
Uncalled bet ($0.06) returned to a7365f1c
*** SHOWDOWN ***
a7365f1c collected $0.12 from pot
*** SUMMARY ***
Total pot $0.12 | Rake $0 | Jackpot $0 | Bingo $0 | Fortune $0 | Tax $0
Seat 1: 4262311b (button) folded before Flop (didn't bet)
Seat 2: Hero (small blind) folded before Flop
Seat 3: e0d14e10 (big blind) folded before Flop
Seat 4: a7365f1c collected ($0.12)
Seat 5: c9baa38a folded before Flop (didn't bet)
Seat 6: 7b1424ef folded before Flop (didn't bet)


Poker Hand #RC3334602608: Hold'em No Limit ($0.02/$0.05) - 2025/02/17 21:49:34
Table 'RushAndCash637868' 6-max Seat #1 is the button
Seat 1: Hero ($9.1 in chips)
Seat 2: 692e3a83 ($8.9 in chips)
Seat 3: 2d4e8369 ($5 in chips)
Seat 4: 657ee1fc ($14.99 in chips)
Seat 5: 23c23672 ($5 in chips)
Seat 6: 92fa3d91 ($5.43 in chips)
692e3a83: posts small blind $0.02
2d4e8369: posts big blind $0.05
*** HOLE CARDS ***
Dealt to Hero [8s Tc]
Dealt to 692e3a83 
Dealt to 2d4e8369 
Dealt to 657ee1fc 
Dealt to 23c23672 
Dealt to 92fa3d91 
657ee1fc: folds
23c23672: folds
92fa3d91: folds
Hero: folds
692e3a83: folds
Uncalled bet ($0.03) returned to 2d4e8369
*** SHOWDOWN ***
2d4e8369 collected $0.04 from pot
*** SUMMARY ***
Total pot $0.04 | Rake $0 | Jackpot $0 | Bingo $0 | Fortune $0 | Tax $0
Seat 1: Hero (button) folded before Flop (didn't bet)
Seat 2: 692e3a83 (small blind) folded before Flop
Seat 3: 2d4e8369 (big blind) collected ($0.04)
Seat 4: 657ee1fc folded before Flop (didn't bet)
Seat 5: 23c23672 folded before Flop (didn't bet)
Seat 6: 92fa3d91 folded before Flop (didn't bet)


Poker Hand #RC3334602580: Hold'em No Limit ($0.02/$0.05) - 2025/02/17 21:49:31
Table 'RushAndCash637840' 6-max Seat #1 is the button
Seat 1: 3b2a8270 ($10.67 in chips)
Seat 2: 2642904 ($6.73 in chips)
Seat 3: 59c43665 ($2.73 in chips)
Seat 4: Hero ($9.1 in chips)
Seat 5: 21be8833 ($5 in chips)
Seat 6: 1f960832 ($5.99 in chips)
2642904: posts small blind $0.02
59c43665: posts big blind $0.05
*** HOLE CARDS ***
Dealt to 3b2a8270 
Dealt to 2642904 
Dealt to 59c43665 
Dealt to Hero [9s Kc]
Dealt to 21be8833 
Dealt to 1f960832 
Hero: folds
21be8833: folds
1f960832: folds
3b2a8270: folds
2642904: folds
Uncalled bet ($0.03) returned to 59c43665
*** SHOWDOWN ***
59c43665 collected $0.04 from pot
*** SUMMARY ***
Total pot $0.04 | Rake $0 | Jackpot $0 | Bingo $0 | Fortune $0 | Tax $0
Seat 1: 3b2a8270 (button) folded before Flop (didn't bet)
Seat 2: 2642904 (small blind) folded before Flop
Seat 3: 59c43665 (big blind) collected ($0.04)
Seat 4: Hero folded before Flop (didn't bet)
Seat 5: 21be8833 folded before Flop (didn't bet)
Seat 6: 1f960832 folded before Flop (didn't bet)


Poker Hand #RC3334602499: Hold'em No Limit ($0.02/$0.05) - 2025/02/17 21:49:22
Table 'RushAndCash637759' 6-max Seat #1 is the button
Seat 1: 8671b051 ($4.85 in chips)
Seat 2: e7d8e6cc ($1.36 in chips)
Seat 3: Hero ($9.08 in chips)
Seat 4: cc91d9ca ($10.3 in chips)
Seat 5: ef00759f ($1.9 in chips)
Seat 6: 10cdb6a1 ($5 in chips)
e7d8e6cc: posts small blind $0.02
Hero: posts big blind $0.05
*** HOLE CARDS ***
Dealt to 8671b051 
Dealt to e7d8e6cc 
Dealt to Hero [8h Qh]
Dealt to cc91d9ca 
Dealt to ef00759f 
Dealt to 10cdb6a1 
cc91d9ca: folds
ef00759f: folds
10cdb6a1: folds
8671b051: folds
e7d8e6cc: folds
Uncalled bet ($0.03) returned to Hero
*** SHOWDOWN ***
Hero collected $0.04 from pot
*** SUMMARY ***
Total pot $0.04 | Rake $0 | Jackpot $0 | Bingo $0 | Fortune $0 | Tax $0
Seat 1: 8671b051 (button) folded before Flop (didn't bet)
Seat 2: e7d8e6cc (small blind) folded before Flop
Seat 3: Hero (big blind) collected ($0.04)
Seat 4: cc91d9ca folded before Flop (didn't bet)
Seat 5: ef00759f folded before Flop (didn't bet)
Seat 6: 10cdb6a1 folded before Flop (didn't bet)


Poker Hand #RC3334602456: Hold'em No Limit ($0.02/$0.05) - 2025/02/17 21:49:17
Table 'RushAndCash637716' 6-max Seat #1 is the button
Seat 1: 62e1fc77 ($6.43 in chips)
Seat 2: 5abb6a6d ($5.07 in chips)
Seat 3: bbb0d90f ($3.9 in chips)
Seat 4: 31f44d74 ($6.89 in chips)
Seat 5: Hero ($9.08 in chips)
Seat 6: add6668e ($5.94 in chips)
5abb6a6d: posts small blind $0.02
bbb0d90f: posts big blind $0.05
*** HOLE CARDS ***
Dealt to 62e1fc77 
Dealt to 5abb6a6d 
Dealt to bbb0d90f 
Dealt to 31f44d74 
Dealt to Hero [3c Qh]
Dealt to add6668e 
31f44d74: folds
Hero: folds
add6668e: folds
62e1fc77: folds
5abb6a6d: folds
Uncalled bet ($0.03) returned to bbb0d90f
*** SHOWDOWN ***
bbb0d90f collected $0.04 from pot
*** SUMMARY ***
Total pot $0.04 | Rake $0 | Jackpot $0 | Bingo $0 | Fortune $0 | Tax $0
Seat 1: 62e1fc77 (button) folded before Flop (didn't bet)
Seat 2: 5abb6a6d (small blind) folded before Flop
Seat 3: bbb0d90f (big blind) collected ($0.04)
Seat 4: 31f44d74 folded before Flop (didn't bet)
Seat 5: Hero folded before Flop (didn't bet)
Seat 6: add6668e folded before Flop (didn't bet)


Poker Hand #RC3334602371: Hold'em No Limit ($0.02/$0.05) - 2025/02/17 21:49:08
Table 'RushAndCash637631' 6-max Seat #1 is the button
Seat 1: Hero ($9.08 in chips)
Seat 2: b59fc0b9 ($5.34 in chips)
Seat 3: c81ca578 ($5.14 in chips)
Seat 4: 826a79b4 ($4.83 in chips)
Seat 5: fdbac393 ($14.92 in chips)
Seat 6: bc8371cb ($6.09 in chips)
b59fc0b9: posts small blind $0.02
c81ca578: posts big blind $0.05
*** HOLE CARDS ***
Dealt to Hero [Qd Jd]
Dealt to b59fc0b9 
Dealt to c81ca578 
Dealt to 826a79b4 
Dealt to fdbac393 
Dealt to bc8371cb 
826a79b4: raises $0.05 to $0.1
fdbac393: raises $0.32 to $0.42
bc8371cb: folds
Hero: folds
b59fc0b9: folds
c81ca578: folds
826a79b4: calls $0.32
*** FLOP *** [Qh Qc 4s]
826a79b4: checks
fdbac393: bets $0.32
826a79b4: calls $0.32
*** TURN *** [Qh Qc 4s] [Ks]
826a79b4: checks
fdbac393: checks
*** RIVER *** [Qh Qc 4s Ks] [Jc]
826a79b4: checks
fdbac393: checks
826a79b4: shows [6s 6c] (Pair of Queens and Pair of Sixes)
fdbac393: shows [Kc Ah] (Pair of Kings and Pair of Queens)
*** SHOWDOWN ***
fdbac393 collected $1.41 from pot
*** SUMMARY ***
Total pot $1.55 | Rake $0.07 | Jackpot $0.07 | Bingo $0 | Fortune $0 | Tax $0
Board [Qh Qc 4s Ks Jc]
Seat 1: Hero (button) folded before Flop (didn't bet)
Seat 2: b59fc0b9 (small blind) folded before Flop
Seat 3: c81ca578 (big blind) folded before Flop
Seat 4: 826a79b4 showed [6s 6c] and lost with Pair of Queens and Pair of Sixes
Seat 5: fdbac393 showed [Kc Ah] and won ($1.41) with Pair of Kings and Pair of Queens
Seat 6: bc8371cb folded before Flop (didn't bet)


Poker Hand #RC3334602339: Hold'em No Limit ($0.02/$0.05) - 2025/02/17 21:49:04
Table 'RushAndCash637599' 6-max Seat #1 is the button
Seat 1: b2069524 ($5.87 in chips)
Seat 2: b4c33f6c ($8 in chips)
Seat 3: ed18a71b ($6.24 in chips)
Seat 4: Hero ($9.08 in chips)
Seat 5: 96707874 ($5.08 in chips)
Seat 6: 34028f01 ($6.27 in chips)
b4c33f6c: posts small blind $0.02
ed18a71b: posts big blind $0.05
*** HOLE CARDS ***
Dealt to b2069524 
Dealt to b4c33f6c 
Dealt to ed18a71b 
Dealt to Hero [8c Qd]
Dealt to 96707874 
Dealt to 34028f01 
Hero: folds
96707874: folds
34028f01: folds
b2069524: folds
b4c33f6c: raises $0.08 to $0.13
ed18a71b: calls $0.08
*** FLOP *** [Ks 3h 5h]
b4c33f6c: checks
ed18a71b: checks
*** TURN *** [Ks 3h 5h] [Ah]
b4c33f6c: checks
ed18a71b: bets $0.2
b4c33f6c: folds
Uncalled bet ($0.2) returned to ed18a71b
*** SHOWDOWN ***
ed18a71b collected $0.25 from pot
*** SUMMARY ***
Total pot $0.26 | Rake $0.01 | Jackpot $0 | Bingo $0 | Fortune $0 | Tax $0
Board [Ks 3h 5h Ah]
Seat 1: b2069524 (button) folded before Flop (didn't bet)
Seat 2: b4c33f6c (small blind) folded on the Turn
Seat 3: ed18a71b (big blind) won ($0.25)
Seat 4: Hero folded before Flop (didn't bet)
Seat 5: 96707874 folded before Flop (didn't bet)
Seat 6: 34028f01 folded before Flop (didn't bet)


Poker Hand #RC3334602311: Hold'em No Limit ($0.02/$0.05) - 2025/02/17 21:49:01
Table 'RushAndCash637571' 6-max Seat #1 is the button
Seat 1: 915fe0fb ($5.63 in chips)
Seat 2: 5cef4c25 ($6.04 in chips)
Seat 3: f6efd55a ($7.8 in chips)
Seat 4: edbb0bb6 ($5.07 in chips)
Seat 5: 49ccafb4 ($5.04 in chips)
Seat 6: Hero ($9.08 in chips)
5cef4c25: posts small blind $0.02
f6efd55a: posts big blind $0.05
*** HOLE CARDS ***
Dealt to 915fe0fb 
Dealt to 5cef4c25 
Dealt to f6efd55a 
Dealt to edbb0bb6 
Dealt to 49ccafb4 
Dealt to Hero [9d 5d]
edbb0bb6: folds
49ccafb4: folds
Hero: folds
915fe0fb: raises $0.06 to $0.11
5cef4c25: calls $0.09
f6efd55a: folds
*** FLOP *** [Jd 2c Qh]
5cef4c25: checks
915fe0fb: bets $0.14
5cef4c25: folds
Uncalled bet ($0.14) returned to 915fe0fb
*** SHOWDOWN ***
915fe0fb collected $0.26 from pot
*** SUMMARY ***
Total pot $0.27 | Rake $0.01 | Jackpot $0 | Bingo $0 | Fortune $0 | Tax $0
Board [Jd 2c Qh]
Seat 1: 915fe0fb (button) won ($0.26)
Seat 2: 5cef4c25 (small blind) folded on the Flop
Seat 3: f6efd55a (big blind) folded before Flop
Seat 4: edbb0bb6 folded before Flop (didn't bet)
Seat 5: 49ccafb4 folded before Flop (didn't bet)
Seat 6: Hero folded before Flop (didn't bet)


Poker Hand #RC3334602257: Hold'em No Limit ($0.02/$0.05) - 2025/02/17 21:48:56
Table 'RushAndCash637517' 6-max Seat #1 is the button
Seat 1: d47282a4 ($6.43 in chips)
Seat 2: Hero ($9.1 in chips)
Seat 3: 9e4602fe ($6.26 in chips)
Seat 4: 3f6d99d0 ($5 in chips)
Seat 5: e331f6bb ($3.66 in chips)
Seat 6: ef00759f ($1.97 in chips)
Hero: posts small blind $0.02
9e4602fe: posts big blind $0.05
*** HOLE CARDS ***
Dealt to d47282a4 
Dealt to Hero [6d 2s]
Dealt to 9e4602fe 
Dealt to 3f6d99d0 
Dealt to e331f6bb 
Dealt to ef00759f 
3f6d99d0: folds
e331f6bb: folds
ef00759f: folds
d47282a4: raises $0.05 to $0.1
Hero: folds
9e4602fe: folds
Uncalled bet ($0.05) returned to d47282a4
*** SHOWDOWN ***
d47282a4 collected $0.12 from pot
*** SUMMARY ***
Total pot $0.12 | Rake $0 | Jackpot $0 | Bingo $0 | Fortune $0 | Tax $0
Seat 1: d47282a4 (button) collected ($0.12)
Seat 2: Hero (small blind) folded before Flop
Seat 3: 9e4602fe (big blind) folded before Flop
Seat 4: 3f6d99d0 folded before Flop (didn't bet)
Seat 5: e331f6bb folded before Flop (didn't bet)
Seat 6: ef00759f folded before Flop (didn't bet)


Poker Hand #RC3334602208: Hold'em No Limit ($0.02/$0.05) - 2025/02/17 21:48:51
Table 'RushAndCash637468' 6-max Seat #1 is the button
Seat 1: 33387631 ($5 in chips)
Seat 2: b7ed060 ($5 in chips)
Seat 3: 218dd9df ($9.18 in chips)
Seat 4: Hero ($9.1 in chips)
Seat 5: 988dc015 ($11 in chips)
Seat 6: 39109629 ($5.35 in chips)
b7ed060: posts small blind $0.02
218dd9df: posts big blind $0.05
*** HOLE CARDS ***
Dealt to 33387631 
Dealt to b7ed060 
Dealt to 218dd9df 
Dealt to Hero [6c Ah]
Dealt to 988dc015 
Dealt to 39109629 
Hero: folds
988dc015: folds
39109629: folds
33387631: raises $0.06 to $0.11
b7ed060: folds
218dd9df: folds
Uncalled bet ($0.06) returned to 33387631
*** SHOWDOWN ***
33387631 collected $0.12 from pot
*** SUMMARY ***
Total pot $0.12 | Rake $0 | Jackpot $0 | Bingo $0 | Fortune $0 | Tax $0
Seat 1: 33387631 (button) collected ($0.12)
Seat 2: b7ed060 (small blind) folded before Flop
Seat 3: 218dd9df (big blind) folded before Flop
Seat 4: Hero folded before Flop (didn't bet)
Seat 5: 988dc015 folded before Flop (didn't bet)
Seat 6: 39109629 folded before Flop (didn't bet)


Poker Hand #RC3334602178: Hold'em No Limit ($0.02/$0.05) - 2025/02/17 21:48:47
Table 'RushAndCash637438' 6-max Seat #1 is the button
Seat 1: 8f77797e ($5.51 in chips)
Seat 2: 6ffcfcbd ($5.46 in chips)
Seat 3: 42fca4f9 ($13.73 in chips)
Seat 4: a664c86a ($7.46 in chips)
Seat 5: Hero ($9.1 in chips)
Seat 6: dc1a94f3 ($2.5 in chips)
6ffcfcbd: posts small blind $0.02
42fca4f9: posts big blind $0.05
*** HOLE CARDS ***
Dealt to 8f77797e 
Dealt to 6ffcfcbd 
Dealt to 42fca4f9 
Dealt to a664c86a 
Dealt to Hero [9h 8s]
Dealt to dc1a94f3 
a664c86a: folds
Hero: folds
dc1a94f3: folds
8f77797e: folds
6ffcfcbd: folds
Uncalled bet ($0.03) returned to 42fca4f9
*** SHOWDOWN ***
42fca4f9 collected $0.04 from pot
*** SUMMARY ***
Total pot $0.04 | Rake $0 | Jackpot $0 | Bingo $0 | Fortune $0 | Tax $0
Seat 1: 8f77797e (button) folded before Flop (didn't bet)
Seat 2: 6ffcfcbd (small blind) folded before Flop
Seat 3: 42fca4f9 (big blind) collected ($0.04)
Seat 4: a664c86a folded before Flop (didn't bet)
Seat 5: Hero folded before Flop (didn't bet)
Seat 6: dc1a94f3 folded before Flop (didn't bet)


Poker Hand #RC3334602153: Hold'em No Limit ($0.02/$0.05) - 2025/02/17 21:48:44
Table 'RushAndCash637413' 6-max Seat #1 is the button
Seat 1: debb9287 ($5.79 in chips)
Seat 2: 56d81d8 ($5.48 in chips)
Seat 3: Hero ($9.15 in chips)
Seat 4: 9d687e0 ($3.77 in chips)
Seat 5: 189fa0ee ($5.56 in chips)
Seat 6: 443f46a7 ($5 in chips)
56d81d8: posts small blind $0.02
Hero: posts big blind $0.05
*** HOLE CARDS ***
Dealt to debb9287 
Dealt to 56d81d8 
Dealt to Hero [9h 6d]
Dealt to 9d687e0 
Dealt to 189fa0ee 
Dealt to 443f46a7 
9d687e0: raises $0.05 to $0.1
189fa0ee: folds
443f46a7: folds
debb9287: folds
56d81d8: folds
Hero: folds
Uncalled bet ($0.05) returned to 9d687e0
*** SHOWDOWN ***
9d687e0 collected $0.12 from pot
*** SUMMARY ***
Total pot $0.12 | Rake $0 | Jackpot $0 | Bingo $0 | Fortune $0 | Tax $0
Seat 1: debb9287 (button) folded before Flop (didn't bet)
Seat 2: 56d81d8 (small blind) folded before Flop
Seat 3: Hero (big blind) folded before Flop
Seat 4: 9d687e0 collected ($0.12)
Seat 5: 189fa0ee folded before Flop (didn't bet)
Seat 6: 443f46a7 folded before Flop (didn't bet)


Poker Hand #RC3334602017: Hold'em No Limit ($0.02/$0.05) - 2025/02/17 21:48:28
Table 'RushAndCash637277' 6-max Seat #1 is the button
Seat 1: Hero ($8.96 in chips)
Seat 2: d04ecf ($6.56 in chips)
Seat 3: d1079439 ($5.07 in chips)
Seat 4: d037279c ($5.05 in chips)
Seat 5: 14d966a6 ($8.31 in chips)
Seat 6: fcc3c3cc ($13.09 in chips)
d04ecf: posts small blind $0.02
d1079439: posts big blind $0.05
*** HOLE CARDS ***
Dealt to Hero [Kc As]
Dealt to d04ecf 
Dealt to d1079439 
Dealt to d037279c 
Dealt to 14d966a6 
Dealt to fcc3c3cc 
d037279c: folds
14d966a6: folds
fcc3c3cc: raises $0.08 to $0.13
Hero: raises $0.25 to $0.38
d04ecf: folds
d1079439: folds
fcc3c3cc: folds
Uncalled bet ($0.25) returned to Hero
*** SHOWDOWN ***
Hero collected $0.32 from pot
*** SUMMARY ***
Total pot $0.33 | Rake $0.01 | Jackpot $0 | Bingo $0 | Fortune $0 | Tax $0
Seat 1: Hero (button) collected ($0.32)
Seat 2: d04ecf (small blind) folded before Flop
Seat 3: d1079439 (big blind) folded before Flop
Seat 4: d037279c folded before Flop (didn't bet)
Seat 5: 14d966a6 folded before Flop (didn't bet)
Seat 6: fcc3c3cc folded before Flop


Poker Hand #RC3334601971: Hold'em No Limit ($0.02/$0.05) - 2025/02/17 21:48:22
Table 'RushAndCash637231' 6-max Seat #1 is the button
Seat 1: 1a2d8f33 ($8.13 in chips)
Seat 2: 46971127 ($9.1 in chips)
Seat 3: c565c977 ($5.24 in chips)
Seat 4: 692417ff ($13.28 in chips)
Seat 5: 4299b97d ($5.07 in chips)
Seat 6: Hero ($8.96 in chips)
46971127: posts small blind $0.02
c565c977: posts big blind $0.05
*** HOLE CARDS ***
Dealt to 1a2d8f33 
Dealt to 46971127 
Dealt to c565c977 
Dealt to 692417ff 
Dealt to 4299b97d 
Dealt to Hero [Kc 3s]
692417ff: folds
4299b97d: raises $0.08 to $0.13
Hero: folds
1a2d8f33: folds
46971127: folds
c565c977: folds
Uncalled bet ($0.08) returned to 4299b97d
*** SHOWDOWN ***
4299b97d collected $0.12 from pot
*** SUMMARY ***
Total pot $0.12 | Rake $0 | Jackpot $0 | Bingo $0 | Fortune $0 | Tax $0
Seat 1: 1a2d8f33 (button) folded before Flop (didn't bet)
Seat 2: 46971127 (small blind) folded before Flop
Seat 3: c565c977 (big blind) folded before Flop
Seat 4: 692417ff folded before Flop (didn't bet)
Seat 5: 4299b97d collected ($0.12)
Seat 6: Hero folded before Flop (didn't bet)


Poker Hand #RC3334601812: Hold'em No Limit ($0.02/$0.05) - 2025/02/17 21:48:05
Table 'RushAndCash637072' 6-max Seat #1 is the button
Seat 1: f56d4922 ($5.06 in chips)
Seat 2: Hero ($8.91 in chips)
Seat 3: 8f77797e ($5.63 in chips)
Seat 4: 5e2a2694 ($10.2 in chips)
Seat 5: dd5b2a2c ($5.08 in chips)
Seat 6: 2aa9c26c ($4.19 in chips)
Hero: posts small blind $0.02
8f77797e: posts big blind $0.05
*** HOLE CARDS ***
Dealt to f56d4922 
Dealt to Hero [Jh Qh]
Dealt to 8f77797e 
Dealt to 5e2a2694 
Dealt to dd5b2a2c 
Dealt to 2aa9c26c 
5e2a2694: folds
dd5b2a2c: folds
2aa9c26c: folds
f56d4922: folds
Hero: calls $0.03
8f77797e: checks
*** FLOP *** [Qs 6s 5c]
Hero: bets $0.05
8f77797e: folds
Uncalled bet ($0.05) returned to Hero
*** SHOWDOWN ***
Hero collected $0.1 from pot
*** SUMMARY ***
Total pot $0.1 | Rake $0 | Jackpot $0 | Bingo $0 | Fortune $0 | Tax $0
Board [Qs 6s 5c]
Seat 1: f56d4922 (button) folded before Flop (didn't bet)
Seat 2: Hero (small blind) won ($0.1)
Seat 3: 8f77797e (big blind) folded on the Flop
Seat 4: 5e2a2694 folded before Flop (didn't bet)
Seat 5: dd5b2a2c folded before Flop (didn't bet)
Seat 6: 2aa9c26c folded before Flop (didn't bet)


Poker Hand #RC3334601779: Hold'em No Limit ($0.02/$0.05) - 2025/02/17 21:48:01
Table 'RushAndCash637039' 6-max Seat #1 is the button
Seat 1: bf1b95ee ($4.72 in chips)
Seat 2: ccabd9d2 ($3.55 in chips)
Seat 3: c26c61ab ($5.19 in chips)
Seat 4: Hero ($8.91 in chips)
Seat 5: 198a1e4 ($7.86 in chips)
Seat 6: ac97d851 ($5 in chips)
ccabd9d2: posts small blind $0.02
c26c61ab: posts big blind $0.05
*** HOLE CARDS ***
Dealt to bf1b95ee 
Dealt to ccabd9d2 
Dealt to c26c61ab 
Dealt to Hero [2s 5s]
Dealt to 198a1e4 
Dealt to ac97d851 
Hero: folds
198a1e4: folds
ac97d851: folds
bf1b95ee: folds
ccabd9d2: raises $0.05 to $0.1
c26c61ab: folds
Uncalled bet ($0.05) returned to ccabd9d2
*** SHOWDOWN ***
ccabd9d2 collected $0.1 from pot
*** SUMMARY ***
Total pot $0.1 | Rake $0 | Jackpot $0 | Bingo $0 | Fortune $0 | Tax $0
Seat 1: bf1b95ee (button) folded before Flop (didn't bet)
Seat 2: ccabd9d2 (small blind) collected ($0.1)
Seat 3: c26c61ab (big blind) folded before Flop
Seat 4: Hero folded before Flop (didn't bet)
Seat 5: 198a1e4 folded before Flop (didn't bet)
Seat 6: ac97d851 folded before Flop (didn't bet)


Poker Hand #RC3334601741: Hold'em No Limit ($0.02/$0.05) - 2025/02/17 21:47:57
Table 'RushAndCash637001' 6-max Seat #1 is the button
Seat 1: d1079439 ($5 in chips)
Seat 2: 8f77797e ($5.65 in chips)
Seat 3: db0f0c64 ($8.51 in chips)
Seat 4: 6ab3ea38 ($5 in chips)
Seat 5: Hero ($8.91 in chips)
Seat 6: 4e53b23f ($5 in chips)
8f77797e: posts small blind $0.02
db0f0c64: posts big blind $0.05
*** HOLE CARDS ***
Dealt to d1079439 
Dealt to 8f77797e 
Dealt to db0f0c64 
Dealt to 6ab3ea38 
Dealt to Hero [Td 2c]
Dealt to 4e53b23f 
6ab3ea38: folds
Hero: folds
4e53b23f: folds
d1079439: folds
8f77797e: folds
Uncalled bet ($0.03) returned to db0f0c64
*** SHOWDOWN ***
db0f0c64 collected $0.04 from pot
*** SUMMARY ***
Total pot $0.04 | Rake $0 | Jackpot $0 | Bingo $0 | Fortune $0 | Tax $0
Seat 1: d1079439 (button) folded before Flop (didn't bet)
Seat 2: 8f77797e (small blind) folded before Flop
Seat 3: db0f0c64 (big blind) collected ($0.04)
Seat 4: 6ab3ea38 folded before Flop (didn't bet)
Seat 5: Hero folded before Flop (didn't bet)
Seat 6: 4e53b23f folded before Flop (didn't bet)


Poker Hand #RC3334601715: Hold'em No Limit ($0.02/$0.05) - 2025/02/17 21:47:54
Table 'RushAndCash636975' 6-max Seat #1 is the button
Seat 1: Hero ($8.91 in chips)
Seat 2: ef7b5599 ($37.08 in chips)
Seat 3: b87651f7 ($5.05 in chips)
Seat 4: 18fbcc2b ($2.02 in chips)
Seat 5: aa38767f ($5.23 in chips)
Seat 6: e89f6814 ($5.86 in chips)
ef7b5599: posts small blind $0.02
b87651f7: posts big blind $0.05
*** HOLE CARDS ***
Dealt to Hero [Kh 6d]
Dealt to ef7b5599 
Dealt to b87651f7 
Dealt to 18fbcc2b 
Dealt to aa38767f 
Dealt to e89f6814 
18fbcc2b: raises $0.05 to $0.1
aa38767f: folds
e89f6814: folds
Hero: folds
ef7b5599: folds
b87651f7: calls $0.05
*** FLOP *** [3h 8d 2d]
b87651f7: checks
18fbcc2b: checks
*** TURN *** [3h 8d 2d] [9c]
b87651f7: bets $0.18
18fbcc2b: calls $0.18
*** RIVER *** [3h 8d 2d 9c] [Jh]
b87651f7: checks
18fbcc2b: bets $0.29
b87651f7: calls $0.29
18fbcc2b: shows [Ad 3d] (Pair of Treys)
b87651f7: shows [9d Kc] (Pair of Nines)
*** SHOWDOWN ***
b87651f7 collected $1.11 from pot
*** SUMMARY ***
Total pot $1.16 | Rake $0.05 | Jackpot $0 | Bingo $0 | Fortune $0 | Tax $0
Board [3h 8d 2d 9c Jh]
Seat 1: Hero (button) folded before Flop (didn't bet)
Seat 2: ef7b5599 (small blind) folded before Flop
Seat 3: b87651f7 (big blind) showed [9d Kc] and won ($1.11) with Pair of Nines
Seat 4: 18fbcc2b showed [Ad 3d] and lost with Pair of Treys
Seat 5: aa38767f folded before Flop (didn't bet)
Seat 6: e89f6814 folded before Flop (didn't bet)


Poker Hand #RC3334601687: Hold'em No Limit ($0.02/$0.05) - 2025/02/17 21:47:51
Table 'RushAndCash636947' 6-max Seat #1 is the button
Seat 1: c3c40ffa ($6.47 in chips)
Seat 2: 8d7c8253 ($5.4 in chips)
Seat 3: 32972137 ($5.15 in chips)
Seat 4: Hero ($8.91 in chips)
Seat 5: 15141573 ($5.44 in chips)
Seat 6: 6c641898 ($5.79 in chips)
8d7c8253: posts small blind $0.02
32972137: posts big blind $0.05
*** HOLE CARDS ***
Dealt to c3c40ffa 
Dealt to 8d7c8253 
Dealt to 32972137 
Dealt to Hero [7h 2s]
Dealt to 15141573 
Dealt to 6c641898 
Hero: folds
15141573: folds
6c641898: folds
c3c40ffa: folds
8d7c8253: folds
Uncalled bet ($0.03) returned to 32972137
*** SHOWDOWN ***
32972137 collected $0.04 from pot
*** SUMMARY ***
Total pot $0.04 | Rake $0 | Jackpot $0 | Bingo $0 | Fortune $0 | Tax $0
Seat 1: c3c40ffa (button) folded before Flop (didn't bet)
Seat 2: 8d7c8253 (small blind) folded before Flop
Seat 3: 32972137 (big blind) collected ($0.04)
Seat 4: Hero folded before Flop (didn't bet)
Seat 5: 15141573 folded before Flop (didn't bet)
Seat 6: 6c641898 folded before Flop (didn't bet)


Poker Hand #RC3334601650: Hold'em No Limit ($0.02/$0.05) - 2025/02/17 21:47:47
Table 'RushAndCash636910' 6-max Seat #1 is the button
Seat 1: db7750ea ($3.79 in chips)
Seat 2: Hero ($8.93 in chips)
Seat 3: 58e1e47f ($5.52 in chips)
Seat 4: 717e9861 ($10.47 in chips)
Seat 5: 218dd9df ($9.44 in chips)
Seat 6: 5d2d2612 ($4.91 in chips)
Hero: posts small blind $0.02
58e1e47f: posts big blind $0.05
*** HOLE CARDS ***
Dealt to db7750ea 
Dealt to Hero [9c Kd]
Dealt to 58e1e47f 
Dealt to 717e9861 
Dealt to 218dd9df 
Dealt to 5d2d2612 
717e9861: folds
218dd9df: raises $0.05 to $0.1
5d2d2612: folds
db7750ea: calls $0.1
Hero: folds
58e1e47f: raises $0.42 to $0.52
218dd9df: folds
db7750ea: raises $3.27 to $3.79 and is all-in
58e1e47f: calls $3.27
db7750ea: shows [Jd Kc]
58e1e47f: shows [Ks Ad]
*** FLOP *** [Kh Qc 2s]
58e1e47f: Chooses to EV Cashout
*** TURN *** [Kh Qc 2s] [5h]
*** RIVER *** [Kh Qc 2s 5h] [Ac]
58e1e47f: Pays Cashout Risk ($1.08)
*** SHOWDOWN ***
58e1e47f collected $7.48 from pot
*** SUMMARY ***
Total pot $7.7 | Rake $0.15 | Jackpot $0.07 | Bingo $0 | Fortune $0 | Tax $0
Board [Kh Qc 2s 5h Ac]
Seat 1: db7750ea (button) showed [Jd Kc] and lost with Pair of Kings
Seat 2: Hero (small blind) folded before Flop
Seat 3: 58e1e47f (big blind) showed [Ks Ad] and won ($7.48) with Pair of Aces and Pair of Kings, Cashout Risk ($1.08)
Seat 4: 717e9861 folded before Flop (didn't bet)
Seat 5: 218dd9df folded before Flop
Seat 6: 5d2d2612 folded before Flop (didn't bet)


Poker Hand #RC3334601624: Hold'em No Limit ($0.02/$0.05) - 2025/02/17 21:47:43
Table 'RushAndCash636884' 6-max Seat #1 is the button
Seat 1: 345ce3dc ($5.71 in chips)
Seat 2: 3e6e7b99 ($6.98 in chips)
Seat 3: Hero ($8.98 in chips)
Seat 4: 610144dc ($4.71 in chips)
Seat 5: 8a026fe3 ($8.22 in chips)
Seat 6: 218dd9df ($9.44 in chips)
3e6e7b99: posts small blind $0.02
Hero: posts big blind $0.05
*** HOLE CARDS ***
Dealt to 345ce3dc 
Dealt to 3e6e7b99 
Dealt to Hero [5d Jc]
Dealt to 610144dc 
Dealt to 8a026fe3 
Dealt to 218dd9df 
610144dc: folds
8a026fe3: folds
218dd9df: folds
345ce3dc: folds
3e6e7b99: raises $0.1 to $0.15
Hero: folds
Uncalled bet ($0.1) returned to 3e6e7b99
*** SHOWDOWN ***
3e6e7b99 collected $0.1 from pot
*** SUMMARY ***
Total pot $0.1 | Rake $0 | Jackpot $0 | Bingo $0 | Fortune $0 | Tax $0
Seat 1: 345ce3dc (button) folded before Flop (didn't bet)
Seat 2: 3e6e7b99 (small blind) collected ($0.1)
Seat 3: Hero (big blind) folded before Flop
Seat 4: 610144dc folded before Flop (didn't bet)
Seat 5: 8a026fe3 folded before Flop (didn't bet)
Seat 6: 218dd9df folded before Flop (didn't bet)


Poker Hand #RC3334601183: Hold'em No Limit ($0.02/$0.05) - 2025/02/17 21:46:55
Table 'RushAndCash636443' 6-max Seat #1 is the button
Seat 1: 3f6d99d0 ($4.28 in chips)
Seat 2: Hero ($8.46 in chips)
Seat 3: b59fc0b9 ($5.02 in chips)
Seat 4: b02447b8 ($5 in chips)
Seat 5: f6efd55a ($9.54 in chips)
Seat 6: 610144dc ($5.23 in chips)
Hero: posts small blind $0.02
b59fc0b9: posts big blind $0.05
*** HOLE CARDS ***
Dealt to 3f6d99d0 
Dealt to Hero [Qd Qh]
Dealt to b59fc0b9 
Dealt to b02447b8 
Dealt to f6efd55a 
Dealt to 610144dc 
b02447b8: folds
f6efd55a: folds
610144dc: raises $0.08 to $0.13
3f6d99d0: folds
Hero: raises $0.39 to $0.52
b59fc0b9: folds
610144dc: calls $0.39
*** FLOP *** [7h Kc 9h]
Hero: checks
610144dc: checks
*** TURN *** [7h Kc 9h] [7s]
Hero: checks
610144dc: checks
*** RIVER *** [7h Kc 9h 7s] [6d]
Hero: checks
610144dc: checks
Hero: shows [Qd Qh] (Pair of Queens and Pair of Sevens)
610144dc: shows [3h Ah] (Pair of Sevens)
*** SHOWDOWN ***
Hero collected $1.04 from pot
*** SUMMARY ***
Total pot $1.09 | Rake $0.05 | Jackpot $0 | Bingo $0 | Fortune $0 | Tax $0
Board [7h Kc 9h 7s 6d]
Seat 1: 3f6d99d0 (button) folded before Flop (didn't bet)
Seat 2: Hero (small blind) showed [Qd Qh] and won ($1.04) with Pair of Queens and Pair of Sevens
Seat 3: b59fc0b9 (big blind) folded before Flop
Seat 4: b02447b8 folded before Flop (didn't bet)
Seat 5: f6efd55a folded before Flop (didn't bet)
Seat 6: 610144dc showed [3h Ah] and lost with Pair of Sevens


Poker Hand #RC3334601105: Hold'em No Limit ($0.02/$0.05) - 2025/02/17 21:46:46
Table 'RushAndCash636365' 6-max Seat #1 is the button
Seat 1: 82c6ccfb ($11.89 in chips)
Seat 2: 486aa946 ($4.28 in chips)
Seat 3: Hero ($8.44 in chips)
Seat 4: ceaf3b1d ($6.93 in chips)
Seat 5: 94cb065d ($10.35 in chips)
Seat 6: 5b653011 ($4.55 in chips)
486aa946: posts small blind $0.02
Hero: posts big blind $0.05
*** HOLE CARDS ***
Dealt to 82c6ccfb 
Dealt to 486aa946 
Dealt to Hero [Jc Kh]
Dealt to ceaf3b1d 
Dealt to 94cb065d 
Dealt to 5b653011 
ceaf3b1d: folds
94cb065d: folds
5b653011: folds
82c6ccfb: folds
486aa946: folds
Uncalled bet ($0.03) returned to Hero
*** SHOWDOWN ***
Hero collected $0.04 from pot
*** SUMMARY ***
Total pot $0.04 | Rake $0 | Jackpot $0 | Bingo $0 | Fortune $0 | Tax $0
Seat 1: 82c6ccfb (button) folded before Flop (didn't bet)
Seat 2: 486aa946 (small blind) folded before Flop
Seat 3: Hero (big blind) collected ($0.04)
Seat 4: ceaf3b1d folded before Flop (didn't bet)
Seat 5: 94cb065d folded before Flop (didn't bet)
Seat 6: 5b653011 folded before Flop (didn't bet)


Poker Hand #RC3334601068: Hold'em No Limit ($0.02/$0.05) - 2025/02/17 21:46:42
Table 'RushAndCash636328' 6-max Seat #1 is the button
Seat 1: Hero ($8.44 in chips)
Seat 2: b9f66756 ($5.19 in chips)
Seat 3: a9d8ced4 ($5.49 in chips)
Seat 4: cea9730b ($7.76 in chips)
Seat 5: e59e5895 ($5.35 in chips)
Seat 6: 14d03752 ($7.21 in chips)
b9f66756: posts small blind $0.02
a9d8ced4: posts big blind $0.05
*** HOLE CARDS ***
Dealt to Hero [Qc 9d]
Dealt to b9f66756 
Dealt to a9d8ced4 
Dealt to cea9730b 
Dealt to e59e5895 
Dealt to 14d03752 
cea9730b: folds
e59e5895: folds
14d03752: folds
Hero: folds
b9f66756: raises $0.08 to $0.13
a9d8ced4: folds
Uncalled bet ($0.08) returned to b9f66756
*** SHOWDOWN ***
b9f66756 collected $0.1 from pot
*** SUMMARY ***
Total pot $0.1 | Rake $0 | Jackpot $0 | Bingo $0 | Fortune $0 | Tax $0
Seat 1: Hero (button) folded before Flop (didn't bet)
Seat 2: b9f66756 (small blind) collected ($0.1)
Seat 3: a9d8ced4 (big blind) folded before Flop
Seat 4: cea9730b folded before Flop (didn't bet)
Seat 5: e59e5895 folded before Flop (didn't bet)
Seat 6: 14d03752 folded before Flop (didn't bet)


Poker Hand #RC3334601040: Hold'em No Limit ($0.02/$0.05) - 2025/02/17 21:46:39
Table 'RushAndCash636300' 6-max Seat #1 is the button
Seat 1: 486aa946 ($4.33 in chips)
Seat 2: 4cb872a ($7.69 in chips)
Seat 3: 8a026fe3 ($9.49 in chips)
Seat 4: dfc02c40 ($6.07 in chips)
Seat 5: 3db4c32a ($5.79 in chips)
Seat 6: Hero ($8.44 in chips)
4cb872a: posts small blind $0.02
8a026fe3: posts big blind $0.05
*** HOLE CARDS ***
Dealt to 486aa946 
Dealt to 4cb872a 
Dealt to 8a026fe3 
Dealt to dfc02c40 
Dealt to 3db4c32a 
Dealt to Hero [3c 2h]
dfc02c40: folds
3db4c32a: folds
Hero: folds
486aa946: folds
4cb872a: raises $0.1 to $0.15
8a026fe3: calls $0.1
*** FLOP *** [2c 3d 8s]
4cb872a: bets $0.1
8a026fe3: calls $0.1
*** TURN *** [2c 3d 8s] [8c]
4cb872a: bets $0.38
8a026fe3: raises $0.64 to $1.02
4cb872a: calls $0.64
*** RIVER *** [2c 3d 8s 8c] [Ah]
4cb872a: checks
8a026fe3: checks
4cb872a: shows [Jh 8h] (Three Eights)
8a026fe3: shows [Ts Ac] (Pair of Aces and Pair of Eights)
*** SHOWDOWN ***
4cb872a collected $2.35 from pot
*** SUMMARY ***
Total pot $2.54 | Rake $0.12 | Jackpot $0.07 | Bingo $0 | Fortune $0 | Tax $0
Board [2c 3d 8s 8c Ah]
Seat 1: 486aa946 (button) folded before Flop (didn't bet)
Seat 2: 4cb872a (small blind) showed [Jh 8h] and won ($2.35) with Three Eights
Seat 3: 8a026fe3 (big blind) showed [Ts Ac] and lost with Pair of Aces and Pair of Eights
Seat 4: dfc02c40 folded before Flop (didn't bet)
Seat 5: 3db4c32a folded before Flop (didn't bet)
Seat 6: Hero folded before Flop (didn't bet)


Poker Hand #RC3334601013: Hold'em No Limit ($0.02/$0.05) - 2025/02/17 21:46:36
Table 'RushAndCash636273' 6-max Seat #1 is the button
Seat 1: fc77b046 ($12.05 in chips)
Seat 2: 46fb98 ($6.6 in chips)
Seat 3: 2b8c1076 ($5.34 in chips)
Seat 4: ccabd9d2 ($3.64 in chips)
Seat 5: 92fa3d91 ($5.67 in chips)
Seat 6: Hero ($8.44 in chips)
46fb98: posts small blind $0.02
2b8c1076: posts big blind $0.05
*** HOLE CARDS ***
Dealt to fc77b046 
Dealt to 46fb98 
Dealt to 2b8c1076 
Dealt to ccabd9d2 
Dealt to 92fa3d91 
Dealt to Hero [4d Qh]
ccabd9d2: folds
92fa3d91: folds
Hero: folds
fc77b046: folds
46fb98: raises $0.08 to $0.13
2b8c1076: folds
Uncalled bet ($0.08) returned to 46fb98
*** SHOWDOWN ***
46fb98 collected $0.1 from pot
*** SUMMARY ***
Total pot $0.1 | Rake $0 | Jackpot $0 | Bingo $0 | Fortune $0 | Tax $0
Seat 1: fc77b046 (button) folded before Flop (didn't bet)
Seat 2: 46fb98 (small blind) collected ($0.1)
Seat 3: 2b8c1076 (big blind) folded before Flop
Seat 4: ccabd9d2 folded before Flop (didn't bet)
Seat 5: 92fa3d91 folded before Flop (didn't bet)
Seat 6: Hero folded before Flop (didn't bet)


Poker Hand #RC3334600980: Hold'em No Limit ($0.02/$0.05) - 2025/02/17 21:46:32
Table 'RushAndCash636240' 6-max Seat #1 is the button
Seat 1: Hero ($8.44 in chips)
Seat 2: 22975d ($5 in chips)
Seat 3: e7c4d687 ($2.87 in chips)
Seat 4: 717e9861 ($10.52 in chips)
Seat 5: 8a403375 ($4.31 in chips)
Seat 6: 51719807 ($4.1 in chips)
22975d: posts small blind $0.02
e7c4d687: posts big blind $0.05
*** HOLE CARDS ***
Dealt to Hero [Qc 5s]
Dealt to 22975d 
Dealt to e7c4d687 
Dealt to 717e9861 
Dealt to 8a403375 
Dealt to 51719807 
717e9861: folds
8a403375: folds
51719807: folds
Hero: folds
22975d: raises $0.1 to $0.15
e7c4d687: calls $0.1
*** FLOP *** [5d 5c 6h]
22975d: bets $0.15
e7c4d687: calls $0.15
*** TURN *** [5d 5c 6h] [3d]
22975d: checks
e7c4d687: checks
*** RIVER *** [5d 5c 6h 3d] [Ts]
22975d: checks
e7c4d687: bets $0.2
22975d: folds
Uncalled bet ($0.2) returned to e7c4d687
*** SHOWDOWN ***
e7c4d687 collected $0.57 from pot
*** SUMMARY ***
Total pot $0.6 | Rake $0.03 | Jackpot $0 | Bingo $0 | Fortune $0 | Tax $0
Board [5d 5c 6h 3d Ts]
Seat 1: Hero (button) folded before Flop (didn't bet)
Seat 2: 22975d (small blind) folded on the River
Seat 3: e7c4d687 (big blind) won ($0.57)
Seat 4: 717e9861 folded before Flop (didn't bet)
Seat 5: 8a403375 folded before Flop (didn't bet)
Seat 6: 51719807 folded before Flop (didn't bet)


Poker Hand #RC3334600948: Hold'em No Limit ($0.02/$0.05) - 2025/02/17 21:46:28
Table 'RushAndCash636208' 6-max Seat #1 is the button
Seat 1: 24aff26b ($6.31 in chips)
Seat 2: e7c4d687 ($2.89 in chips)
Seat 3: 644e5259 ($5.18 in chips)
Seat 4: Hero ($8.44 in chips)
Seat 5: 79d81faa ($8.53 in chips)
Seat 6: e7a0ba42 ($27.1 in chips)
e7c4d687: posts small blind $0.02
644e5259: posts big blind $0.05
*** HOLE CARDS ***
Dealt to 24aff26b 
Dealt to e7c4d687 
Dealt to 644e5259 
Dealt to Hero [7d Jh]
Dealt to 79d81faa 
Dealt to e7a0ba42 
Hero: folds
79d81faa: folds
e7a0ba42: folds
24aff26b: folds
e7c4d687: folds
Uncalled bet ($0.03) returned to 644e5259
*** SHOWDOWN ***
644e5259 collected $0.04 from pot
*** SUMMARY ***
Total pot $0.04 | Rake $0 | Jackpot $0 | Bingo $0 | Fortune $0 | Tax $0
Seat 1: 24aff26b (button) folded before Flop (didn't bet)
Seat 2: e7c4d687 (small blind) folded before Flop
Seat 3: 644e5259 (big blind) collected ($0.04)
Seat 4: Hero folded before Flop (didn't bet)
Seat 5: 79d81faa folded before Flop (didn't bet)
Seat 6: e7a0ba42 folded before Flop (didn't bet)


Poker Hand #RC3334600916: Hold'em No Limit ($0.02/$0.05) - 2025/02/17 21:46:25
Table 'RushAndCash636176' 6-max Seat #1 is the button
Seat 1: 82c6ccfb ($11.94 in chips)
Seat 2: 72b3f81 ($5.98 in chips)
Seat 3: 3ecb9f22 ($4.88 in chips)
Seat 4: 820e1571 ($5 in chips)
Seat 5: aadfce52 ($6.99 in chips)
Seat 6: Hero ($8.44 in chips)
72b3f81: posts small blind $0.02
3ecb9f22: posts big blind $0.05
*** HOLE CARDS ***
Dealt to 82c6ccfb 
Dealt to 72b3f81 
Dealt to 3ecb9f22 
Dealt to 820e1571 
Dealt to aadfce52 
Dealt to Hero [As 7c]
820e1571: folds
aadfce52: folds
Hero: folds
82c6ccfb: folds
72b3f81: raises $0.1 to $0.15
3ecb9f22: folds
Uncalled bet ($0.1) returned to 72b3f81
*** SHOWDOWN ***
72b3f81 collected $0.1 from pot
*** SUMMARY ***
Total pot $0.1 | Rake $0 | Jackpot $0 | Bingo $0 | Fortune $0 | Tax $0
Seat 1: 82c6ccfb (button) folded before Flop (didn't bet)
Seat 2: 72b3f81 (small blind) collected ($0.1)
Seat 3: 3ecb9f22 (big blind) folded before Flop
Seat 4: 820e1571 folded before Flop (didn't bet)
Seat 5: aadfce52 folded before Flop (didn't bet)
Seat 6: Hero folded before Flop (didn't bet)


Poker Hand #RC3334600885: Hold'em No Limit ($0.02/$0.05) - 2025/02/17 21:46:21
Table 'RushAndCash636145' 6-max Seat #1 is the button
Seat 1: ab43c8b8 ($9.15 in chips)
Seat 2: c723772e ($16.34 in chips)
Seat 3: 56cefdc9 ($10.68 in chips)
Seat 4: Hero ($8.44 in chips)
Seat 5: 717e9861 ($10.54 in chips)
Seat 6: 2b6ba85b ($4.93 in chips)
c723772e: posts small blind $0.02
56cefdc9: posts big blind $0.05
*** HOLE CARDS ***
Dealt to ab43c8b8 
Dealt to c723772e 
Dealt to 56cefdc9 
Dealt to Hero [Th Qd]
Dealt to 717e9861 
Dealt to 2b6ba85b 
Hero: folds
717e9861: folds
2b6ba85b: folds
ab43c8b8: folds
c723772e: raises $0.05 to $0.1
56cefdc9: raises $0.4 to $0.5
c723772e: folds
Uncalled bet ($0.4) returned to 56cefdc9
*** SHOWDOWN ***
56cefdc9 collected $0.19 from pot
*** SUMMARY ***
Total pot $0.2 | Rake $0.01 | Jackpot $0 | Bingo $0 | Fortune $0 | Tax $0
Seat 1: ab43c8b8 (button) folded before Flop (didn't bet)
Seat 2: c723772e (small blind) folded before Flop
Seat 3: 56cefdc9 (big blind) collected ($0.19)
Seat 4: Hero folded before Flop (didn't bet)
Seat 5: 717e9861 folded before Flop (didn't bet)
Seat 6: 2b6ba85b folded before Flop (didn't bet)


Poker Hand #RC3334600857: Hold'em No Limit ($0.02/$0.05) - 2025/02/17 21:46:18
Table 'RushAndCash636117' 6-max Seat #1 is the button
Seat 1: b323473e ($5.35 in chips)
Seat 2: Hero ($8.46 in chips)
Seat 3: a32bdeef ($5.55 in chips)
Seat 4: 3c8d217b ($10.66 in chips)
Seat 5: 4ce7d5f4 ($6.75 in chips)
Seat 6: 961414b1 ($6.81 in chips)
Hero: posts small blind $0.02
a32bdeef: posts big blind $0.05
*** HOLE CARDS ***
Dealt to b323473e 
Dealt to Hero [Js 6s]
Dealt to a32bdeef 
Dealt to 3c8d217b 
Dealt to 4ce7d5f4 
Dealt to 961414b1 
3c8d217b: raises $0.05 to $0.1
4ce7d5f4: folds
961414b1: folds
b323473e: calls $0.1
Hero: folds
a32bdeef: calls $0.05
*** FLOP *** [3h 6h Th]
a32bdeef: checks
3c8d217b: bets $0.11
b323473e: calls $0.11
a32bdeef: folds
*** TURN *** [3h 6h Th] [2h]
3c8d217b: checks
b323473e: bets $0.27
3c8d217b: calls $0.27
*** RIVER *** [3h 6h Th 2h] [8h]
3c8d217b: checks
b323473e: checks
3c8d217b: shows [Kh As] (King High Flush)
b323473e: shows [Qs Ts] (Ten High Flush)
*** SHOWDOWN ***
3c8d217b collected $1.03 from pot
*** SUMMARY ***
Total pot $1.08 | Rake $0.05 | Jackpot $0 | Bingo $0 | Fortune $0 | Tax $0
Board [3h 6h Th 2h 8h]
Seat 1: b323473e (button) showed [Qs Ts] and lost with Ten High Flush
Seat 2: Hero (small blind) folded before Flop
Seat 3: a32bdeef (big blind) folded on the Flop
Seat 4: 3c8d217b showed [Kh As] and won ($1.03) with King High Flush
Seat 5: 4ce7d5f4 folded before Flop (didn't bet)
Seat 6: 961414b1 folded before Flop (didn't bet)


Poker Hand #RC3334600740: Hold'em No Limit ($0.02/$0.05) - 2025/02/17 21:46:04
Table 'RushAndCash636000' 6-max Seat #1 is the button
Seat 1: 6c7828d3 ($5 in chips)
Seat 2: 87d5083b ($20.78 in chips)
Seat 3: Hero ($8.51 in chips)
Seat 4: 717e9861 ($10.64 in chips)
Seat 5: 718a09e5 ($5 in chips)
Seat 6: 39a65b3b ($4.93 in chips)
87d5083b: posts small blind $0.02
Hero: posts big blind $0.05
*** HOLE CARDS ***
Dealt to 6c7828d3 
Dealt to 87d5083b 
Dealt to Hero [Qs 9s]
Dealt to 717e9861 
Dealt to 718a09e5 
Dealt to 39a65b3b 
717e9861: raises $0.05 to $0.1
718a09e5: folds
39a65b3b: folds
6c7828d3: calls $0.1
87d5083b: raises $0.53 to $0.63
Hero: folds
717e9861: folds
6c7828d3: folds
Uncalled bet ($0.53) returned to 87d5083b
*** SHOWDOWN ***
87d5083b collected $0.34 from pot
*** SUMMARY ***
Total pot $0.35 | Rake $0.01 | Jackpot $0 | Bingo $0 | Fortune $0 | Tax $0
Seat 1: 6c7828d3 (button) folded before Flop
Seat 2: 87d5083b (small blind) collected ($0.34)
Seat 3: Hero (big blind) folded before Flop
Seat 4: 717e9861 folded before Flop
Seat 5: 718a09e5 folded before Flop (didn't bet)
Seat 6: 39a65b3b folded before Flop (didn't bet)


Poker Hand #RC3334600714: Hold'em No Limit ($0.02/$0.05) - 2025/02/17 21:46:01
Table 'RushAndCash635974' 6-max Seat #1 is the button
Seat 1: 9013f95e ($10.57 in chips)
Seat 2: 2676a891 ($5.46 in chips)
Seat 3: 1fa8537 ($7.49 in chips)
Seat 4: Hero ($8.51 in chips)
Seat 5: a63aa4b7 ($16.11 in chips)
Seat 6: 90bbba9f ($5.41 in chips)
2676a891: posts small blind $0.02
1fa8537: posts big blind $0.05
*** HOLE CARDS ***
Dealt to 9013f95e 
Dealt to 2676a891 
Dealt to 1fa8537 
Dealt to Hero [Ks 9h]
Dealt to a63aa4b7 
Dealt to 90bbba9f 
Hero: folds
a63aa4b7: folds
90bbba9f: folds
9013f95e: folds
2676a891: raises $0.05 to $0.1
1fa8537: folds
Uncalled bet ($0.05) returned to 2676a891
*** SHOWDOWN ***
2676a891 collected $0.1 from pot
*** SUMMARY ***
Total pot $0.1 | Rake $0 | Jackpot $0 | Bingo $0 | Fortune $0 | Tax $0
Seat 1: 9013f95e (button) folded before Flop (didn't bet)
Seat 2: 2676a891 (small blind) collected ($0.1)
Seat 3: 1fa8537 (big blind) folded before Flop
Seat 4: Hero folded before Flop (didn't bet)
Seat 5: a63aa4b7 folded before Flop (didn't bet)
Seat 6: 90bbba9f folded before Flop (didn't bet)


Poker Hand #RC3334600458: Hold'em No Limit ($0.02/$0.05) - 2025/02/17 21:45:31
Table 'RushAndCash635718' 6-max Seat #1 is the button
Seat 1: c68571dc ($5 in chips)
Seat 2: Hero ($8.42 in chips)
Seat 3: 9013f95e ($10.67 in chips)
Seat 4: 3fac11ae ($5.35 in chips)
Seat 5: 15fafcaa ($5.4 in chips)
Seat 6: b9ae439d ($5.66 in chips)
Hero: posts small blind $0.02
9013f95e: posts big blind $0.05
*** HOLE CARDS ***
Dealt to c68571dc 
Dealt to Hero [7c 7h]
Dealt to 9013f95e 
Dealt to 3fac11ae 
Dealt to 15fafcaa 
Dealt to b9ae439d 
3fac11ae: folds
15fafcaa: folds
b9ae439d: folds
c68571dc: folds
Hero: calls $0.03
9013f95e: checks
*** FLOP *** [Tc Ad 8h]
Hero: checks
9013f95e: checks
*** TURN *** [Tc Ad 8h] [5c]
Hero: bets $0.05
9013f95e: calls $0.05
*** RIVER *** [Tc Ad 8h 5c] [9h]
Hero: checks
9013f95e: checks
Hero: shows [7c 7h] (Pair of Sevens)
9013f95e: shows [4h 3h] (Ace-High)
*** SHOWDOWN ***
Hero collected $0.19 from pot
*** SUMMARY ***
Total pot $0.2 | Rake $0.01 | Jackpot $0 | Bingo $0 | Fortune $0 | Tax $0
Board [Tc Ad 8h 5c 9h]
Seat 1: c68571dc (button) folded before Flop (didn't bet)
Seat 2: Hero (small blind) showed [7c 7h] and won ($0.19) with Pair of Sevens
Seat 3: 9013f95e (big blind) showed [4h 3h] and lost with Ace-High
Seat 4: 3fac11ae folded before Flop (didn't bet)
Seat 5: 15fafcaa folded before Flop (didn't bet)
Seat 6: b9ae439d folded before Flop (didn't bet)


Poker Hand #RC3334600252: Hold'em No Limit ($0.02/$0.05) - 2025/02/17 21:45:08
Table 'RushAndCash635512' 6-max Seat #1 is the button
Seat 1: b74983a1 ($5.35 in chips)
Seat 2: df79f8b0 ($5.02 in chips)
Seat 3: Hero ($8.54 in chips)
Seat 4: 23c23672 ($5.31 in chips)
Seat 5: 3ffd6491 ($9.71 in chips)
Seat 6: 82c6ccfb ($11.92 in chips)
df79f8b0: posts small blind $0.02
Hero: posts big blind $0.05
*** HOLE CARDS ***
Dealt to b74983a1 
Dealt to df79f8b0 
Dealt to Hero [2d 4d]
Dealt to 23c23672 
Dealt to 3ffd6491 
Dealt to 82c6ccfb 
23c23672: folds
3ffd6491: raises $0.07 to $0.12
82c6ccfb: calls $0.12
b74983a1: folds
df79f8b0: folds
Hero: calls $0.07
*** FLOP *** [Qc 7h 3s]
Hero: checks
3ffd6491: bets $0.13
82c6ccfb: calls $0.13
Hero: folds
*** TURN *** [Qc 7h 3s] [7c]
3ffd6491: checks
82c6ccfb: bets $0.32
3ffd6491: calls $0.32
*** RIVER *** [Qc 7h 3s 7c] [7d]
3ffd6491: checks
82c6ccfb: checks
3ffd6491: shows [Ac Tc] (Three Sevens)
82c6ccfb: shows [As Js] (Three Sevens)
*** SHOWDOWN ***
3ffd6491 collected $0.61 from pot
82c6ccfb collected $0.61 from pot
*** SUMMARY ***
Total pot $1.28 | Rake $0.06 | Jackpot $0 | Bingo $0 | Fortune $0 | Tax $0
Board [Qc 7h 3s 7c 7d]
Seat 1: b74983a1 (button) folded before Flop (didn't bet)
Seat 2: df79f8b0 (small blind) folded before Flop
Seat 3: Hero (big blind) folded on the Flop
Seat 4: 23c23672 folded before Flop (didn't bet)
Seat 5: 3ffd6491 showed [Ac Tc] and won ($0.61) with Three Sevens
Seat 6: 82c6ccfb showed [As Js] and won ($0.61) with Three Sevens


Poker Hand #RC3334600224: Hold'em No Limit ($0.02/$0.05) - 2025/02/17 21:45:05
Table 'RushAndCash635484' 6-max Seat #1 is the button
Seat 1: 5115f4c2 ($5 in chips)
Seat 2: 3d537b07 ($16.08 in chips)
Seat 3: Hero ($8.59 in chips)
Seat 4: e331f6bb ($4.57 in chips)
Seat 5: ec2814be ($5 in chips)
Seat 6: 3e3946b0 ($8.96 in chips)
3d537b07: posts small blind $0.02
Hero: posts big blind $0.05
*** HOLE CARDS ***
Dealt to 5115f4c2 
Dealt to 3d537b07 
Dealt to Hero [3h 8s]
Dealt to e331f6bb 
Dealt to ec2814be 
Dealt to 3e3946b0 
e331f6bb: folds
ec2814be: folds
3e3946b0: folds
5115f4c2: raises $0.07 to $0.12
3d537b07: folds
Hero: folds
Uncalled bet ($0.07) returned to 5115f4c2
*** SHOWDOWN ***
5115f4c2 collected $0.12 from pot
*** SUMMARY ***
Total pot $0.12 | Rake $0 | Jackpot $0 | Bingo $0 | Fortune $0 | Tax $0
Seat 1: 5115f4c2 (button) collected ($0.12)
Seat 2: 3d537b07 (small blind) folded before Flop
Seat 3: Hero (big blind) folded before Flop
Seat 4: e331f6bb folded before Flop (didn't bet)
Seat 5: ec2814be folded before Flop (didn't bet)
Seat 6: 3e3946b0 folded before Flop (didn't bet)


Poker Hand #RC3334600200: Hold'em No Limit ($0.02/$0.05) - 2025/02/17 21:45:02
Table 'RushAndCash635460' 6-max Seat #1 is the button
Seat 1: 6ad786fd ($6.31 in chips)
Seat 2: 59238e48 ($5.38 in chips)
Seat 3: 34388f19 ($5.64 in chips)
Seat 4: Hero ($8.59 in chips)
Seat 5: 9f70f94d ($7.67 in chips)
Seat 6: 90bbba9f ($5.51 in chips)
59238e48: posts small blind $0.02
34388f19: posts big blind $0.05
*** HOLE CARDS ***
Dealt to 6ad786fd 
Dealt to 59238e48 
Dealt to 34388f19 
Dealt to Hero [Tc 8h]
Dealt to 9f70f94d 
Dealt to 90bbba9f 
Hero: folds
9f70f94d: folds
90bbba9f: folds
6ad786fd: raises $0.05 to $0.1
59238e48: folds
34388f19: folds
Uncalled bet ($0.05) returned to 6ad786fd
*** SHOWDOWN ***
6ad786fd collected $0.12 from pot
*** SUMMARY ***
Total pot $0.12 | Rake $0 | Jackpot $0 | Bingo $0 | Fortune $0 | Tax $0
Seat 1: 6ad786fd (button) collected ($0.12)
Seat 2: 59238e48 (small blind) folded before Flop
Seat 3: 34388f19 (big blind) folded before Flop
Seat 4: Hero folded before Flop (didn't bet)
Seat 5: 9f70f94d folded before Flop (didn't bet)
Seat 6: 90bbba9f folded before Flop (didn't bet)


Poker Hand #RC3334600055: Hold'em No Limit ($0.02/$0.05) - 2025/02/17 21:44:45
Table 'RushAndCash635315' 6-max Seat #1 is the button
Seat 1: 1e474bac ($5 in chips)
Seat 2: dcd4e05 ($2.26 in chips)
Seat 3: ac6c5037 ($7.25 in chips)
Seat 4: da5282f0 ($5.07 in chips)
Seat 5: f1fc05db ($3.58 in chips)
Seat 6: Hero ($8.52 in chips)
dcd4e05: posts small blind $0.02
ac6c5037: posts big blind $0.05
*** HOLE CARDS ***
Dealt to 1e474bac 
Dealt to dcd4e05 
Dealt to ac6c5037 
Dealt to da5282f0 
Dealt to f1fc05db 
Dealt to Hero [Qc Js]
da5282f0: folds
f1fc05db: folds
Hero: raises $0.05 to $0.1
1e474bac: folds
dcd4e05: folds
ac6c5037: folds
Uncalled bet ($0.05) returned to Hero
*** SHOWDOWN ***
Hero collected $0.12 from pot
*** SUMMARY ***
Total pot $0.12 | Rake $0 | Jackpot $0 | Bingo $0 | Fortune $0 | Tax $0
Seat 1: 1e474bac (button) folded before Flop (didn't bet)
Seat 2: dcd4e05 (small blind) folded before Flop
Seat 3: ac6c5037 (big blind) folded before Flop
Seat 4: da5282f0 folded before Flop (didn't bet)
Seat 5: f1fc05db folded before Flop (didn't bet)
Seat 6: Hero collected ($0.12)


Poker Hand #RC3334599988: Hold'em No Limit ($0.02/$0.05) - 2025/02/17 21:44:38
Table 'RushAndCash635248' 6-max Seat #1 is the button
Seat 1: Hero ($8.52 in chips)
Seat 2: 720edd8b ($2.06 in chips)
Seat 3: aff4b412 ($4.93 in chips)
Seat 4: 32d40ce0 ($5.89 in chips)
Seat 5: f0600331 ($7.4 in chips)
Seat 6: fcfd355a ($5.31 in chips)
720edd8b: posts small blind $0.02
aff4b412: posts big blind $0.05
*** HOLE CARDS ***
Dealt to Hero [3d Ad]
Dealt to 720edd8b 
Dealt to aff4b412 
Dealt to 32d40ce0 
Dealt to f0600331 
Dealt to fcfd355a 
32d40ce0: raises $0.07 to $0.12
f0600331: folds
fcfd355a: folds
Hero: folds
720edd8b: folds
aff4b412: folds
Uncalled bet ($0.07) returned to 32d40ce0
*** SHOWDOWN ***
32d40ce0 collected $0.12 from pot
*** SUMMARY ***
Total pot $0.12 | Rake $0 | Jackpot $0 | Bingo $0 | Fortune $0 | Tax $0
Seat 1: Hero (button) folded before Flop (didn't bet)
Seat 2: 720edd8b (small blind) folded before Flop
Seat 3: aff4b412 (big blind) folded before Flop
Seat 4: 32d40ce0 collected ($0.12)
Seat 5: f0600331 folded before Flop (didn't bet)
Seat 6: fcfd355a folded before Flop (didn't bet)


Poker Hand #RC3334599960: Hold'em No Limit ($0.02/$0.05) - 2025/02/17 21:44:35
Table 'RushAndCash635220' 6-max Seat #1 is the button
Seat 1: 598d859f ($15.22 in chips)
Seat 2: a7c2ce98 ($5 in chips)
Seat 3: 49ccafb4 ($5.07 in chips)
Seat 4: 79d81faa ($8.44 in chips)
Seat 5: Hero ($8.52 in chips)
Seat 6: 961414b1 ($6.58 in chips)
a7c2ce98: posts small blind $0.02
49ccafb4: posts big blind $0.05
*** HOLE CARDS ***
Dealt to 598d859f 
Dealt to a7c2ce98 
Dealt to 49ccafb4 
Dealt to 79d81faa 
Dealt to Hero [5d Tc]
Dealt to 961414b1 
79d81faa: folds
Hero: folds
961414b1: folds
598d859f: folds
a7c2ce98: folds
Uncalled bet ($0.03) returned to 49ccafb4
*** SHOWDOWN ***
49ccafb4 collected $0.04 from pot
*** SUMMARY ***
Total pot $0.04 | Rake $0 | Jackpot $0 | Bingo $0 | Fortune $0 | Tax $0
Seat 1: 598d859f (button) folded before Flop (didn't bet)
Seat 2: a7c2ce98 (small blind) folded before Flop
Seat 3: 49ccafb4 (big blind) collected ($0.04)
Seat 4: 79d81faa folded before Flop (didn't bet)
Seat 5: Hero folded before Flop (didn't bet)
Seat 6: 961414b1 folded before Flop (didn't bet)


Poker Hand #RC3334599904: Hold'em No Limit ($0.02/$0.05) - 2025/02/17 21:44:28
Table 'RushAndCash635164' 6-max Seat #1 is the button
Seat 1: 626359de ($17.06 in chips)
Seat 2: e89071f6 ($14.29 in chips)
Seat 3: 4c7728b5 ($5.63 in chips)
Seat 4: Hero ($8.52 in chips)
Seat 5: 34028f01 ($5.32 in chips)
Seat 6: b2f44cb6 ($10.92 in chips)
e89071f6: posts small blind $0.02
4c7728b5: posts big blind $0.05
*** HOLE CARDS ***
Dealt to 626359de 
Dealt to e89071f6 
Dealt to 4c7728b5 
Dealt to Hero [Kh 4h]
Dealt to 34028f01 
Dealt to b2f44cb6 
Hero: folds
34028f01: folds
b2f44cb6: folds
626359de: raises $0.08 to $0.13
e89071f6: calls $0.11
4c7728b5: raises $0.42 to $0.55
626359de: folds
e89071f6: calls $0.42
*** FLOP *** [8s 7d 8c]
e89071f6: checks
4c7728b5: bets $0.74
e89071f6: calls $0.74
*** TURN *** [8s 7d 8c] [Jh]
e89071f6: checks
4c7728b5: checks
*** RIVER *** [8s 7d 8c Jh] [9s]
e89071f6: bets $2.71
4c7728b5: folds
Uncalled bet ($2.71) returned to e89071f6
*** SHOWDOWN ***
e89071f6 collected $2.51 from pot
*** SUMMARY ***
Total pot $2.71 | Rake $0.13 | Jackpot $0.07 | Bingo $0 | Fortune $0 | Tax $0
Board [8s 7d 8c Jh 9s]
Seat 1: 626359de (button) folded before Flop
Seat 2: e89071f6 (small blind) won ($2.51)
Seat 3: 4c7728b5 (big blind) folded on the River
Seat 4: Hero folded before Flop (didn't bet)
Seat 5: 34028f01 folded before Flop (didn't bet)
Seat 6: b2f44cb6 folded before Flop (didn't bet)


Poker Hand #RC3334599874: Hold'em No Limit ($0.02/$0.05) - 2025/02/17 21:44:25
Table 'RushAndCash635134' 6-max Seat #1 is the button
Seat 1: 95d29c49 ($5.42 in chips)
Seat 2: Hero ($8.54 in chips)
Seat 3: 4038bf09 ($5 in chips)
Seat 4: a9d8ced4 ($5.68 in chips)
Seat 5: 87afea2d ($4.5 in chips)
Seat 6: 720edd8b ($2.11 in chips)
Hero: posts small blind $0.02
4038bf09: posts big blind $0.05
*** HOLE CARDS ***
Dealt to 95d29c49 
Dealt to Hero [6h Ah]
Dealt to 4038bf09 
Dealt to a9d8ced4 
Dealt to 87afea2d 
Dealt to 720edd8b 
a9d8ced4: folds
87afea2d: folds
720edd8b: folds
95d29c49: raises $0.05 to $0.1
Hero: folds
4038bf09: calls $0.05
*** FLOP *** [3s As Ks]
4038bf09: bets $0.05
95d29c49: folds
Uncalled bet ($0.05) returned to 4038bf09
*** SHOWDOWN ***
4038bf09 collected $0.21 from pot
*** SUMMARY ***
Total pot $0.22 | Rake $0.01 | Jackpot $0 | Bingo $0 | Fortune $0 | Tax $0
Board [3s As Ks]
Seat 1: 95d29c49 (button) folded on the Flop
Seat 2: Hero (small blind) folded before Flop
Seat 3: 4038bf09 (big blind) won ($0.21)
Seat 4: a9d8ced4 folded before Flop (didn't bet)
Seat 5: 87afea2d folded before Flop (didn't bet)
Seat 6: 720edd8b folded before Flop (didn't bet)


Poker Hand #RC3334599848: Hold'em No Limit ($0.02/$0.05) - 2025/02/17 21:44:22
Table 'RushAndCash635108' 6-max Seat #1 is the button
Seat 1: 726ab14e ($6.07 in chips)
Seat 2: Hero ($8.56 in chips)
Seat 3: f4f14fc8 ($5 in chips)
Seat 4: 720edd8b ($2.11 in chips)
Seat 5: 6d2abfa5 ($6.79 in chips)
Seat 6: fc77b046 ($12.07 in chips)
Hero: posts small blind $0.02
f4f14fc8: posts big blind $0.05
*** HOLE CARDS ***
Dealt to 726ab14e 
Dealt to Hero [Qs 4s]
Dealt to f4f14fc8 
Dealt to 720edd8b 
Dealt to 6d2abfa5 
Dealt to fc77b046 
720edd8b: folds
6d2abfa5: folds
fc77b046: folds
726ab14e: folds
Hero: folds
Uncalled bet ($0.03) returned to f4f14fc8
*** SHOWDOWN ***
f4f14fc8 collected $0.04 from pot
*** SUMMARY ***
Total pot $0.04 | Rake $0 | Jackpot $0 | Bingo $0 | Fortune $0 | Tax $0
Seat 1: 726ab14e (button) folded before Flop (didn't bet)
Seat 2: Hero (small blind) folded before Flop
Seat 3: f4f14fc8 (big blind) collected ($0.04)
Seat 4: 720edd8b folded before Flop (didn't bet)
Seat 5: 6d2abfa5 folded before Flop (didn't bet)
Seat 6: fc77b046 folded before Flop (didn't bet)


Poker Hand #RC3334599788: Hold'em No Limit ($0.02/$0.05) - 2025/02/17 21:44:16
Table 'RushAndCash635048' 6-max Seat #1 is the button
Seat 1: 4aed9f61 ($5.05 in chips)
Seat 2: 3f6d99d0 ($4.09 in chips)
Seat 3: f0a8dabb ($4.83 in chips)
Seat 4: df79f8b0 ($5 in chips)
Seat 5: 2e24bede ($6.44 in chips)
Seat 6: Hero ($8.56 in chips)
3f6d99d0: posts small blind $0.02
f0a8dabb: posts big blind $0.05
*** HOLE CARDS ***
Dealt to 4aed9f61 
Dealt to 3f6d99d0 
Dealt to f0a8dabb 
Dealt to df79f8b0 
Dealt to 2e24bede 
Dealt to Hero [Ah 4s]
df79f8b0: folds
2e24bede: folds
Hero: folds
4aed9f61: folds
3f6d99d0: folds
Uncalled bet ($0.03) returned to f0a8dabb
*** SHOWDOWN ***
f0a8dabb collected $0.04 from pot
*** SUMMARY ***
Total pot $0.04 | Rake $0 | Jackpot $0 | Bingo $0 | Fortune $0 | Tax $0
Seat 1: 4aed9f61 (button) folded before Flop (didn't bet)
Seat 2: 3f6d99d0 (small blind) folded before Flop
Seat 3: f0a8dabb (big blind) collected ($0.04)
Seat 4: df79f8b0 folded before Flop (didn't bet)
Seat 5: 2e24bede folded before Flop (didn't bet)
Seat 6: Hero folded before Flop (didn't bet)


Poker Hand #RC3334599754: Hold'em No Limit ($0.02/$0.05) - 2025/02/17 21:44:12
Table 'RushAndCash635014' 6-max Seat #1 is the button
Seat 1: Hero ($8.56 in chips)
Seat 2: df1d9475 ($5.95 in chips)
Seat 3: 75a97e80 ($5.36 in chips)
Seat 4: 395482a9 ($8.67 in chips)
Seat 5: a664c86a ($7.23 in chips)
Seat 6: a39b5beb ($5 in chips)
df1d9475: posts small blind $0.02
75a97e80: posts big blind $0.05
*** HOLE CARDS ***
Dealt to Hero [Qs 4c]
Dealt to df1d9475 
Dealt to 75a97e80 
Dealt to 395482a9 
Dealt to a664c86a 
Dealt to a39b5beb 
395482a9: raises $0.08 to $0.13
a664c86a: folds
a39b5beb: folds
Hero: folds
df1d9475: folds
75a97e80: folds
Uncalled bet ($0.08) returned to 395482a9
*** SHOWDOWN ***
395482a9 collected $0.12 from pot
*** SUMMARY ***
Total pot $0.12 | Rake $0 | Jackpot $0 | Bingo $0 | Fortune $0 | Tax $0
Seat 1: Hero (button) folded before Flop (didn't bet)
Seat 2: df1d9475 (small blind) folded before Flop
Seat 3: 75a97e80 (big blind) folded before Flop
Seat 4: 395482a9 collected ($0.12)
Seat 5: a664c86a folded before Flop (didn't bet)
Seat 6: a39b5beb folded before Flop (didn't bet)


Poker Hand #RC3334599707: Hold'em No Limit ($0.02/$0.05) - 2025/02/17 21:44:07
Table 'RushAndCash634967' 6-max Seat #1 is the button
Seat 1: b28541cc ($4.86 in chips)
Seat 2: 7fc44808 ($11.28 in chips)
Seat 3: Hero ($8.61 in chips)
Seat 4: 42065dde ($5.84 in chips)
Seat 5: 92fd04c6 ($7.54 in chips)
Seat 6: da5282f0 ($5 in chips)
7fc44808: posts small blind $0.02
Hero: posts big blind $0.05
*** HOLE CARDS ***
Dealt to b28541cc 
Dealt to 7fc44808 
Dealt to Hero [Qh 4d]
Dealt to 42065dde 
Dealt to 92fd04c6 
Dealt to da5282f0 
42065dde: folds
92fd04c6: raises $0.05 to $0.1
da5282f0: folds
b28541cc: folds
7fc44808: folds
Hero: folds
Uncalled bet ($0.05) returned to 92fd04c6
*** SHOWDOWN ***
92fd04c6 collected $0.12 from pot
*** SUMMARY ***
Total pot $0.12 | Rake $0 | Jackpot $0 | Bingo $0 | Fortune $0 | Tax $0
Seat 1: b28541cc (button) folded before Flop (didn't bet)
Seat 2: 7fc44808 (small blind) folded before Flop
Seat 3: Hero (big blind) folded before Flop
Seat 4: 42065dde folded before Flop (didn't bet)
Seat 5: 92fd04c6 collected ($0.12)
Seat 6: da5282f0 folded before Flop (didn't bet)


Poker Hand #RC3334599680: Hold'em No Limit ($0.02/$0.05) - 2025/02/17 21:44:04
Table 'RushAndCash634940' 6-max Seat #1 is the button
Seat 1: Hero ($8.61 in chips)
Seat 2: 94cb065d ($9.35 in chips)
Seat 3: df1d9475 ($5.93 in chips)
Seat 4: 23c23672 ($5.74 in chips)
Seat 5: c68571dc ($4.48 in chips)
Seat 6: 62fdcc3c ($10.68 in chips)
94cb065d: posts small blind $0.02
df1d9475: posts big blind $0.05
*** HOLE CARDS ***
Dealt to Hero [7d Jc]
Dealt to 94cb065d 
Dealt to df1d9475 
Dealt to 23c23672 
Dealt to c68571dc 
Dealt to 62fdcc3c 
23c23672: folds
c68571dc: folds
62fdcc3c: folds
Hero: folds
94cb065d: folds
Uncalled bet ($0.03) returned to df1d9475
*** SHOWDOWN ***
df1d9475 collected $0.04 from pot
*** SUMMARY ***
Total pot $0.04 | Rake $0 | Jackpot $0 | Bingo $0 | Fortune $0 | Tax $0
Seat 1: Hero (button) folded before Flop (didn't bet)
Seat 2: 94cb065d (small blind) folded before Flop
Seat 3: df1d9475 (big blind) collected ($0.04)
Seat 4: 23c23672 folded before Flop (didn't bet)
Seat 5: c68571dc folded before Flop (didn't bet)
Seat 6: 62fdcc3c folded before Flop (didn't bet)


Poker Hand #RC3334599649: Hold'em No Limit ($0.02/$0.05) - 2025/02/17 21:44:00
Table 'RushAndCash634909' 6-max Seat #1 is the button
Seat 1: ae52b2e0 ($5.94 in chips)
Seat 2: Hero ($8.63 in chips)
Seat 3: 2f016cc4 ($10.19 in chips)
Seat 4: 23c23672 ($5.74 in chips)
Seat 5: fbe8adcd ($2.02 in chips)
Seat 6: a4461af6 ($10.9 in chips)
Hero: posts small blind $0.02
2f016cc4: posts big blind $0.05
*** HOLE CARDS ***
Dealt to ae52b2e0 
Dealt to Hero [Ts 6h]
Dealt to 2f016cc4 
Dealt to 23c23672 
Dealt to fbe8adcd 
Dealt to a4461af6 
23c23672: folds
fbe8adcd: raises $0.1 to $0.15
a4461af6: raises $0.4 to $0.55
ae52b2e0: folds
Hero: folds
2f016cc4: folds
fbe8adcd: calls $0.4
*** FLOP *** [Ks 9h 8s]
fbe8adcd: checks
a4461af6: bets $0.59
fbe8adcd: folds
Uncalled bet ($0.59) returned to a4461af6
*** SHOWDOWN ***
a4461af6 collected $1.12 from pot
*** SUMMARY ***
Total pot $1.17 | Rake $0.05 | Jackpot $0 | Bingo $0 | Fortune $0 | Tax $0
Board [Ks 9h 8s]
Seat 1: ae52b2e0 (button) folded before Flop (didn't bet)
Seat 2: Hero (small blind) folded before Flop
Seat 3: 2f016cc4 (big blind) folded before Flop
Seat 4: 23c23672 folded before Flop (didn't bet)
Seat 5: fbe8adcd folded on the Flop
Seat 6: a4461af6 won ($1.12)


Poker Hand #RC3334599238: Hold'em No Limit ($0.02/$0.05) - 2025/02/17 21:43:11
Table 'RushAndCash634498' 6-max Seat #1 is the button
Seat 1: a4461af6 ($11.01 in chips)
Seat 2: 1941fa92 ($3.83 in chips)
Seat 3: Hero ($7.68 in chips)
Seat 4: 9f9e1094 ($6.09 in chips)
Seat 5: fbe8adcd ($2.89 in chips)
Seat 6: f3ded747 ($4.97 in chips)
1941fa92: posts small blind $0.02
Hero: posts big blind $0.05
*** HOLE CARDS ***
Dealt to a4461af6 
Dealt to 1941fa92 
Dealt to Hero [Ks 9s]
Dealt to 9f9e1094 
Dealt to fbe8adcd 
Dealt to f3ded747 
9f9e1094: raises $0.06 to $0.11
fbe8adcd: calls $0.11
f3ded747: folds
a4461af6: calls $0.11
1941fa92: folds
Hero: calls $0.06
*** FLOP *** [4d Qh 9c]
Hero: checks
9f9e1094: checks
fbe8adcd: bets $0.16
a4461af6: folds
Hero: calls $0.16
9f9e1094: folds
*** TURN *** [4d Qh 9c] [5h]
Hero: checks
fbe8adcd: checks
*** RIVER *** [4d Qh 9c 5h] [9d]
Hero: bets $0.6
fbe8adcd: calls $0.6
Hero: shows [Ks 9s] (Three Nines)
fbe8adcd: shows [Jc Qc] (Pair of Queens and Pair of Nines)
*** SHOWDOWN ***
Hero collected $1.82 from pot
*** SUMMARY ***
Total pot $1.98 | Rake $0.09 | Jackpot $0.07 | Bingo $0 | Fortune $0 | Tax $0
Board [4d Qh 9c 5h 9d]
Seat 1: a4461af6 (button) folded on the Flop
Seat 2: 1941fa92 (small blind) folded before Flop
Seat 3: Hero (big blind) showed [Ks 9s] and won ($1.82) with Three Nines
Seat 4: 9f9e1094 folded on the Flop
Seat 5: fbe8adcd showed [Jc Qc] and lost with Pair of Queens and Pair of Nines
Seat 6: f3ded747 folded before Flop (didn't bet)


Poker Hand #RC3334599211: Hold'em No Limit ($0.02/$0.05) - 2025/02/17 21:43:08
Table 'RushAndCash634471' 6-max Seat #1 is the button
Seat 1: 853dbdb5 ($4.61 in chips)
Seat 2: d46eb2ef ($5.05 in chips)
Seat 3: cf150da4 ($5.62 in chips)
Seat 4: ab43c8b8 ($8.83 in chips)
Seat 5: Hero ($7.68 in chips)
Seat 6: e6ee1d7f ($5.95 in chips)
d46eb2ef: posts small blind $0.02
cf150da4: posts big blind $0.05
*** HOLE CARDS ***
Dealt to 853dbdb5 
Dealt to d46eb2ef 
Dealt to cf150da4 
Dealt to ab43c8b8 
Dealt to Hero [4s Js]
Dealt to e6ee1d7f 
ab43c8b8: raises $0.05 to $0.1
Hero: folds
e6ee1d7f: folds
853dbdb5: calls $0.1
d46eb2ef: folds
cf150da4: folds
*** FLOP *** [8s 8d 3s]
ab43c8b8: checks
853dbdb5: checks
*** TURN *** [8s 8d 3s] [5c]
ab43c8b8: checks
853dbdb5: bets $0.08
ab43c8b8: calls $0.08
*** RIVER *** [8s 8d 3s 5c] [3h]
ab43c8b8: checks
853dbdb5: checks
ab43c8b8: shows [Ah Ks] (Pair of Eights and Pair of Treys)
853dbdb5: shows [6c Kc] (Pair of Eights and Pair of Treys)
*** SHOWDOWN ***
ab43c8b8 collected $0.41 from pot
*** SUMMARY ***
Total pot $0.43 | Rake $0.02 | Jackpot $0 | Bingo $0 | Fortune $0 | Tax $0
Board [8s 8d 3s 5c 3h]
Seat 1: 853dbdb5 (button) showed [6c Kc] and lost with Pair of Eights and Pair of Treys
Seat 2: d46eb2ef (small blind) folded before Flop
Seat 3: cf150da4 (big blind) folded before Flop
Seat 4: ab43c8b8 showed [Ah Ks] and won ($0.41) with Pair of Eights and Pair of Treys
Seat 5: Hero folded before Flop (didn't bet)
Seat 6: e6ee1d7f folded before Flop (didn't bet)


Poker Hand #RC3334599184: Hold'em No Limit ($0.02/$0.05) - 2025/02/17 21:43:05
Table 'RushAndCash634444' 6-max Seat #1 is the button
Seat 1: 218dd9df ($7.43 in chips)
Seat 2: d606d9 ($8.47 in chips)
Seat 3: 53a8c2fd ($9.68 in chips)
Seat 4: Hero ($7.68 in chips)
Seat 5: 1e76a4d8 ($7.06 in chips)
Seat 6: 4afebef ($5.26 in chips)
d606d9: posts small blind $0.02
53a8c2fd: posts big blind $0.05
*** HOLE CARDS ***
Dealt to 218dd9df 
Dealt to d606d9 
Dealt to 53a8c2fd 
Dealt to Hero [9c 3s]
Dealt to 1e76a4d8 
Dealt to 4afebef 
Hero: folds
1e76a4d8: folds
4afebef: raises $0.06 to $0.11
218dd9df: folds
d606d9: folds
53a8c2fd: folds
Uncalled bet ($0.06) returned to 4afebef
*** SHOWDOWN ***
4afebef collected $0.12 from pot
*** SUMMARY ***
Total pot $0.12 | Rake $0 | Jackpot $0 | Bingo $0 | Fortune $0 | Tax $0
Seat 1: 218dd9df (button) folded before Flop (didn't bet)
Seat 2: d606d9 (small blind) folded before Flop
Seat 3: 53a8c2fd (big blind) folded before Flop
Seat 4: Hero folded before Flop (didn't bet)
Seat 5: 1e76a4d8 folded before Flop (didn't bet)
Seat 6: 4afebef collected ($0.12)


Poker Hand #RC3334599159: Hold'em No Limit ($0.02/$0.05) - 2025/02/17 21:43:02
Table 'RushAndCash634419' 6-max Seat #1 is the button
Seat 1: 657ee1fc ($7.46 in chips)
Seat 2: ac140cb9 ($4.06 in chips)
Seat 3: 3d4f4b4c ($5.14 in chips)
Seat 4: Hero ($7.68 in chips)
Seat 5: 42065dde ($5.93 in chips)
Seat 6: 697412e ($10.12 in chips)
ac140cb9: posts small blind $0.02
3d4f4b4c: posts big blind $0.05
*** HOLE CARDS ***
Dealt to 657ee1fc 
Dealt to ac140cb9 
Dealt to 3d4f4b4c 
Dealt to Hero [2h Js]
Dealt to 42065dde 
Dealt to 697412e 
Hero: folds
42065dde: folds
697412e: raises $0.06 to $0.11
657ee1fc: folds
ac140cb9: folds
3d4f4b4c: calls $0.06
*** FLOP *** [As Kd 4d]
3d4f4b4c: checks
697412e: bets $0.08
3d4f4b4c: calls $0.08
*** TURN *** [As Kd 4d] [Jc]
3d4f4b4c: checks
697412e: checks
*** RIVER *** [As Kd 4d Jc] [5d]
3d4f4b4c: checks
697412e: bets $0.2
3d4f4b4c: calls $0.2
697412e: shows [9s Ad] (Pair of Aces)
3d4f4b4c: shows [Ah 8c] (Pair of Aces)
*** SHOWDOWN ***
697412e collected $0.76 from pot
*** SUMMARY ***
Total pot $0.8 | Rake $0.04 | Jackpot $0 | Bingo $0 | Fortune $0 | Tax $0
Board [As Kd 4d Jc 5d]
Seat 1: 657ee1fc (button) folded before Flop (didn't bet)
Seat 2: ac140cb9 (small blind) folded before Flop
Seat 3: 3d4f4b4c (big blind) showed [Ah 8c] and lost with Pair of Aces
Seat 4: Hero folded before Flop (didn't bet)
Seat 5: 42065dde folded before Flop (didn't bet)
Seat 6: 697412e showed [9s Ad] and won ($0.76) with Pair of Aces


Poker Hand #RC3334598963: Hold'em No Limit ($0.02/$0.05) - 2025/02/17 21:42:39
Table 'RushAndCash634223' 6-max Seat #1 is the button
Seat 1: 76e7cdfc ($4.86 in chips)
Seat 2: d42cee79 ($5 in chips)
Seat 3: 110fdc96 ($5 in chips)
Seat 4: Hero ($7.78 in chips)
Seat 5: 6e22a6c1 ($5.61 in chips)
Seat 6: 42065dde ($5.77 in chips)
d42cee79: posts small blind $0.02
110fdc96: posts big blind $0.05
*** HOLE CARDS ***
Dealt to 76e7cdfc 
Dealt to d42cee79 
Dealt to 110fdc96 
Dealt to Hero [Jh Ac]
Dealt to 6e22a6c1 
Dealt to 42065dde 
Hero: raises $0.05 to $0.1
6e22a6c1: folds
42065dde: raises $0.21 to $0.31
76e7cdfc: folds
d42cee79: folds
110fdc96: folds
Hero: folds
Uncalled bet ($0.21) returned to 42065dde
*** SHOWDOWN ***
42065dde collected $0.26 from pot
*** SUMMARY ***
Total pot $0.27 | Rake $0.01 | Jackpot $0 | Bingo $0 | Fortune $0 | Tax $0
Seat 1: 76e7cdfc (button) folded before Flop (didn't bet)
Seat 2: d42cee79 (small blind) folded before Flop
Seat 3: 110fdc96 (big blind) folded before Flop
Seat 4: Hero folded before Flop
Seat 5: 6e22a6c1 folded before Flop (didn't bet)
Seat 6: 42065dde collected ($0.26)


Poker Hand #RC3334598939: Hold'em No Limit ($0.02/$0.05) - 2025/02/17 21:42:35
Table 'RushAndCash634199' 6-max Seat #1 is the button
Seat 1: Hero ($7.78 in chips)
Seat 2: 80c22e34 ($7.65 in chips)
Seat 3: 56d81d8 ($5.63 in chips)
Seat 4: d49c6b7d ($5 in chips)
Seat 5: 62e1fc77 ($5.05 in chips)
Seat 6: 87d5083b ($21.23 in chips)
80c22e34: posts small blind $0.02
56d81d8: posts big blind $0.05
*** HOLE CARDS ***
Dealt to Hero [2h 5d]
Dealt to 80c22e34 
Dealt to 56d81d8 
Dealt to d49c6b7d 
Dealt to 62e1fc77 
Dealt to 87d5083b 
d49c6b7d: folds
62e1fc77: raises $0.05 to $0.1
87d5083b: folds
Hero: folds
80c22e34: folds
56d81d8: folds
Uncalled bet ($0.05) returned to 62e1fc77
*** SHOWDOWN ***
62e1fc77 collected $0.12 from pot
*** SUMMARY ***
Total pot $0.12 | Rake $0 | Jackpot $0 | Bingo $0 | Fortune $0 | Tax $0
Seat 1: Hero (button) folded before Flop (didn't bet)
Seat 2: 80c22e34 (small blind) folded before Flop
Seat 3: 56d81d8 (big blind) folded before Flop
Seat 4: d49c6b7d folded before Flop (didn't bet)
Seat 5: 62e1fc77 collected ($0.12)
Seat 6: 87d5083b folded before Flop (didn't bet)


Poker Hand #RC3334598613: Hold'em No Limit ($0.02/$0.05) - 2025/02/17 21:41:57
Table 'RushAndCash633873' 6-max Seat #1 is the button
Seat 1: a664c86a ($6.65 in chips)
Seat 2: Hero ($7.56 in chips)
Seat 3: 76e7cdfc ($5 in chips)
Seat 4: 6ab3ea38 ($5.01 in chips)
Seat 5: 6d5fa70b ($5.13 in chips)
Seat 6: 56d81d8 ($5.82 in chips)
Hero: posts small blind $0.02
76e7cdfc: posts big blind $0.05
*** HOLE CARDS ***
Dealt to a664c86a 
Dealt to Hero [8d 8h]
Dealt to 76e7cdfc 
Dealt to 6ab3ea38 
Dealt to 6d5fa70b 
Dealt to 56d81d8 
6ab3ea38: folds
6d5fa70b: folds
56d81d8: raises $0.05 to $0.1
a664c86a: folds
Hero: calls $0.08
76e7cdfc: folds
*** FLOP *** [2d 5h Tc]
Hero: checks
56d81d8: bets $0.09
Hero: calls $0.09
*** TURN *** [2d 5h Tc] [Kc]
Hero: checks
56d81d8: checks
*** RIVER *** [2d 5h Tc Kc] [9s]
Hero: checks
56d81d8: checks
Hero: shows [8d 8h] (Pair of Eights)
56d81d8: shows [3h Ah] (Ace-High)
*** SHOWDOWN ***
Hero collected $0.41 from pot
*** SUMMARY ***
Total pot $0.43 | Rake $0.02 | Jackpot $0 | Bingo $0 | Fortune $0 | Tax $0
Board [2d 5h Tc Kc 9s]
Seat 1: a664c86a (button) folded before Flop (didn't bet)
Seat 2: Hero (small blind) showed [8d 8h] and won ($0.41) with Pair of Eights
Seat 3: 76e7cdfc (big blind) folded before Flop
Seat 4: 6ab3ea38 folded before Flop (didn't bet)
Seat 5: 6d5fa70b folded before Flop (didn't bet)
Seat 6: 56d81d8 showed [3h Ah] and lost with Ace-High


Poker Hand #RC3334598583: Hold'em No Limit ($0.02/$0.05) - 2025/02/17 21:41:53
Table 'RushAndCash633843' 6-max Seat #1 is the button
Seat 1: 720edd8b ($2.65 in chips)
Seat 2: Hero ($7.58 in chips)
Seat 3: dc99401b ($5.12 in chips)
Seat 4: 6e22a6c1 ($5.61 in chips)
Seat 5: 37bc5b77 ($5.6 in chips)
Seat 6: 4afebef ($5.58 in chips)
Hero: posts small blind $0.02
dc99401b: posts big blind $0.05
*** HOLE CARDS ***
Dealt to 720edd8b 
Dealt to Hero [Jd 3s]
Dealt to dc99401b 
Dealt to 6e22a6c1 
Dealt to 37bc5b77 
Dealt to 4afebef 
6e22a6c1: folds
37bc5b77: folds
4afebef: folds
720edd8b: folds
Hero: folds
Uncalled bet ($0.03) returned to dc99401b
*** SHOWDOWN ***
dc99401b collected $0.04 from pot
*** SUMMARY ***
Total pot $0.04 | Rake $0 | Jackpot $0 | Bingo $0 | Fortune $0 | Tax $0
Seat 1: 720edd8b (button) folded before Flop (didn't bet)
Seat 2: Hero (small blind) folded before Flop
Seat 3: dc99401b (big blind) collected ($0.04)
Seat 4: 6e22a6c1 folded before Flop (didn't bet)
Seat 5: 37bc5b77 folded before Flop (didn't bet)
Seat 6: 4afebef folded before Flop (didn't bet)


Poker Hand #RC3334598555: Hold'em No Limit ($0.02/$0.05) - 2025/02/17 21:41:50
Table 'RushAndCash633815' 6-max Seat #1 is the button
Seat 1: 6e22a6c1 ($5.61 in chips)
Seat 2: 2aa9c26c ($4.96 in chips)
Seat 3: 46971127 ($9.83 in chips)
Seat 4: Hero ($7.58 in chips)
Seat 5: 720edd8b ($2.65 in chips)
Seat 6: 81b0c107 ($7.12 in chips)
2aa9c26c: posts small blind $0.02
46971127: posts big blind $0.05
*** HOLE CARDS ***
Dealt to 6e22a6c1 
Dealt to 2aa9c26c 
Dealt to 46971127 
Dealt to Hero [2d 6d]
Dealt to 720edd8b 
Dealt to 81b0c107 
Hero: folds
720edd8b: folds
81b0c107: folds
6e22a6c1: folds
2aa9c26c: folds
Uncalled bet ($0.03) returned to 46971127
*** SHOWDOWN ***
46971127 collected $0.04 from pot
*** SUMMARY ***
Total pot $0.04 | Rake $0 | Jackpot $0 | Bingo $0 | Fortune $0 | Tax $0
Seat 1: 6e22a6c1 (button) folded before Flop (didn't bet)
Seat 2: 2aa9c26c (small blind) folded before Flop
Seat 3: 46971127 (big blind) collected ($0.04)
Seat 4: Hero folded before Flop (didn't bet)
Seat 5: 720edd8b folded before Flop (didn't bet)
Seat 6: 81b0c107 folded before Flop (didn't bet)


Poker Hand #RC3334598528: Hold'em No Limit ($0.02/$0.05) - 2025/02/17 21:41:47
Table 'RushAndCash633788' 6-max Seat #1 is the button
Seat 1: 7f13dd41 ($5.75 in chips)
Seat 2: 9b1a3dd2 ($14.86 in chips)
Seat 3: Hero ($7.63 in chips)
Seat 4: cbfc1dd3 ($5 in chips)
Seat 5: f23a8d23 ($6.32 in chips)
Seat 6: c83a952b ($5.89 in chips)
9b1a3dd2: posts small blind $0.02
Hero: posts big blind $0.05
*** HOLE CARDS ***
Dealt to 7f13dd41 
Dealt to 9b1a3dd2 
Dealt to Hero [4c Th]
Dealt to cbfc1dd3 
Dealt to f23a8d23 
Dealt to c83a952b 
cbfc1dd3: raises $0.05 to $0.1
f23a8d23: folds
c83a952b: raises $0.21 to $0.31
7f13dd41: folds
9b1a3dd2: folds
Hero: folds
cbfc1dd3: folds
Uncalled bet ($0.21) returned to c83a952b
*** SHOWDOWN ***
c83a952b collected $0.26 from pot
*** SUMMARY ***
Total pot $0.27 | Rake $0.01 | Jackpot $0 | Bingo $0 | Fortune $0 | Tax $0
Seat 1: 7f13dd41 (button) folded before Flop (didn't bet)
Seat 2: 9b1a3dd2 (small blind) folded before Flop
Seat 3: Hero (big blind) folded before Flop
Seat 4: cbfc1dd3 folded before Flop
Seat 5: f23a8d23 folded before Flop (didn't bet)
Seat 6: c83a952b collected ($0.26)


Poker Hand #RC3334598497: Hold'em No Limit ($0.02/$0.05) - 2025/02/17 21:41:43
Table 'RushAndCash633757' 6-max Seat #1 is the button
Seat 1: ab43c8b8 ($8.78 in chips)
Seat 2: b2f44cb6 ($11.01 in chips)
Seat 3: b3aefb75 ($8.61 in chips)
Seat 4: 49694b0f ($7.02 in chips)
Seat 5: d7a83a17 ($5 in chips)
Seat 6: Hero ($7.63 in chips)
b2f44cb6: posts small blind $0.02
b3aefb75: posts big blind $0.05
*** HOLE CARDS ***
Dealt to ab43c8b8 
Dealt to b2f44cb6 
Dealt to b3aefb75 
Dealt to 49694b0f 
Dealt to d7a83a17 
Dealt to Hero [6c 5s]
49694b0f: folds
d7a83a17: folds
Hero: folds
ab43c8b8: raises $0.05 to $0.1
b2f44cb6: folds
b3aefb75: folds
Uncalled bet ($0.05) returned to ab43c8b8
*** SHOWDOWN ***
ab43c8b8 collected $0.12 from pot
*** SUMMARY ***
Total pot $0.12 | Rake $0 | Jackpot $0 | Bingo $0 | Fortune $0 | Tax $0
Seat 1: ab43c8b8 (button) collected ($0.12)
Seat 2: b2f44cb6 (small blind) folded before Flop
Seat 3: b3aefb75 (big blind) folded before Flop
Seat 4: 49694b0f folded before Flop (didn't bet)
Seat 5: d7a83a17 folded before Flop (didn't bet)
Seat 6: Hero folded before Flop (didn't bet)


Poker Hand #RC3334598469: Hold'em No Limit ($0.02/$0.05) - 2025/02/17 21:41:40
Table 'RushAndCash633729' 6-max Seat #1 is the button
Seat 1: 27d0ae63 ($5 in chips)
Seat 2: 2ec306f3 ($5.29 in chips)
Seat 3: 1f960832 ($5 in chips)
Seat 4: Hero ($7.63 in chips)
Seat 5: b66c51bb ($5.78 in chips)
Seat 6: 8cef9d5b ($5.05 in chips)
2ec306f3: posts small blind $0.02
1f960832: posts big blind $0.05
*** HOLE CARDS ***
Dealt to 27d0ae63 
Dealt to 2ec306f3 
Dealt to 1f960832 
Dealt to Hero [7h Kc]
Dealt to b66c51bb 
Dealt to 8cef9d5b 
Hero: folds
b66c51bb: folds
8cef9d5b: folds
27d0ae63: folds
2ec306f3: raises $0.05 to $0.1
1f960832: folds
Uncalled bet ($0.05) returned to 2ec306f3
*** SHOWDOWN ***
2ec306f3 collected $0.1 from pot
*** SUMMARY ***
Total pot $0.1 | Rake $0 | Jackpot $0 | Bingo $0 | Fortune $0 | Tax $0
Seat 1: 27d0ae63 (button) folded before Flop (didn't bet)
Seat 2: 2ec306f3 (small blind) collected ($0.1)
Seat 3: 1f960832 (big blind) folded before Flop
Seat 4: Hero folded before Flop (didn't bet)
Seat 5: b66c51bb folded before Flop (didn't bet)
Seat 6: 8cef9d5b folded before Flop (didn't bet)


Poker Hand #RC3334598442: Hold'em No Limit ($0.02/$0.05) - 2025/02/17 21:41:37
Table 'RushAndCash633702' 6-max Seat #1 is the button
Seat 1: b6ef8553 ($4.8 in chips)
Seat 2: 442376ec ($5.42 in chips)
Seat 3: f198691e ($5 in chips)
Seat 4: c9f8ff1c ($5.39 in chips)
Seat 5: Hero ($7.63 in chips)
Seat 6: 87205baf ($11.37 in chips)
442376ec: posts small blind $0.02
f198691e: posts big blind $0.05
*** HOLE CARDS ***
Dealt to b6ef8553 
Dealt to 442376ec 
Dealt to f198691e 
Dealt to c9f8ff1c 
Dealt to Hero [Qd 8c]
Dealt to 87205baf 
c9f8ff1c: folds
Hero: folds
87205baf: raises $0.07 to $0.12
b6ef8553: folds
442376ec: folds
f198691e: folds
Uncalled bet ($0.07) returned to 87205baf
*** SHOWDOWN ***
87205baf collected $0.12 from pot
*** SUMMARY ***
Total pot $0.12 | Rake $0 | Jackpot $0 | Bingo $0 | Fortune $0 | Tax $0
Seat 1: b6ef8553 (button) folded before Flop (didn't bet)
Seat 2: 442376ec (small blind) folded before Flop
Seat 3: f198691e (big blind) folded before Flop
Seat 4: c9f8ff1c folded before Flop (didn't bet)
Seat 5: Hero folded before Flop (didn't bet)
Seat 6: 87205baf collected ($0.12)


Poker Hand #RC3334598399: Hold'em No Limit ($0.02/$0.05) - 2025/02/17 21:41:32
Table 'RushAndCash633659' 6-max Seat #1 is the button
Seat 1: e5dc0403 ($5 in chips)
Seat 2: 4ec50768 ($5.1 in chips)
Seat 3: 4afebef ($5.65 in chips)
Seat 4: a95b1a3c ($5 in chips)
Seat 5: Hero ($7.63 in chips)
Seat 6: 8862e1e9 ($7.04 in chips)
4ec50768: posts small blind $0.02
4afebef: posts big blind $0.05
*** HOLE CARDS ***
Dealt to e5dc0403 
Dealt to 4ec50768 
Dealt to 4afebef 
Dealt to a95b1a3c 
Dealt to Hero [Js 8s]
Dealt to 8862e1e9 
a95b1a3c: folds
Hero: folds
8862e1e9: folds
e5dc0403: raises $0.05 to $0.1
4ec50768: raises $0.38 to $0.48
4afebef: folds
e5dc0403: folds
Uncalled bet ($0.38) returned to 4ec50768
*** SHOWDOWN ***
4ec50768 collected $0.24 from pot
*** SUMMARY ***
Total pot $0.25 | Rake $0.01 | Jackpot $0 | Bingo $0 | Fortune $0 | Tax $0
Seat 1: e5dc0403 (button) folded before Flop
Seat 2: 4ec50768 (small blind) collected ($0.24)
Seat 3: 4afebef (big blind) folded before Flop
Seat 4: a95b1a3c folded before Flop (didn't bet)
Seat 5: Hero folded before Flop (didn't bet)
Seat 6: 8862e1e9 folded before Flop (didn't bet)


Poker Hand #RC3334598374: Hold'em No Limit ($0.02/$0.05) - 2025/02/17 21:41:29
Table 'RushAndCash633634' 6-max Seat #1 is the button
Seat 1: 9b09147b ($5.08 in chips)
Seat 2: 24aff26b ($7.5 in chips)
Seat 3: Hero ($7.68 in chips)
Seat 4: df1d9475 ($5 in chips)
Seat 5: 5b79005a ($5.59 in chips)
Seat 6: e3c32f29 ($5.34 in chips)
24aff26b: posts small blind $0.02
Hero: posts big blind $0.05
*** HOLE CARDS ***
Dealt to 9b09147b 
Dealt to 24aff26b 
Dealt to Hero [8s 5d]
Dealt to df1d9475 
Dealt to 5b79005a 
Dealt to e3c32f29 
df1d9475: raises $0.1 to $0.15
5b79005a: folds
e3c32f29: raises $0.3 to $0.45
9b09147b: folds
24aff26b: folds
Hero: folds
df1d9475: folds
Uncalled bet ($0.3) returned to e3c32f29
*** SHOWDOWN ***
e3c32f29 collected $0.36 from pot
*** SUMMARY ***
Total pot $0.37 | Rake $0.01 | Jackpot $0 | Bingo $0 | Fortune $0 | Tax $0
Seat 1: 9b09147b (button) folded before Flop (didn't bet)
Seat 2: 24aff26b (small blind) folded before Flop
Seat 3: Hero (big blind) folded before Flop
Seat 4: df1d9475 folded before Flop
Seat 5: 5b79005a folded before Flop (didn't bet)
Seat 6: e3c32f29 collected ($0.36)


Poker Hand #RC3334598341: Hold'em No Limit ($0.02/$0.05) - 2025/02/17 21:41:25
Table 'RushAndCash633601' 6-max Seat #1 is the button
Seat 1: c999165 ($2.74 in chips)
Seat 2: ccabd9d2 ($4.44 in chips)
Seat 3: d691d846 ($4.04 in chips)
Seat 4: b59fc0b9 ($5.16 in chips)
Seat 5: 79d81faa ($8.71 in chips)
Seat 6: Hero ($7.68 in chips)
ccabd9d2: posts small blind $0.02
d691d846: posts big blind $0.05
*** HOLE CARDS ***
Dealt to c999165 
Dealt to ccabd9d2 
Dealt to d691d846 
Dealt to b59fc0b9 
Dealt to 79d81faa 
Dealt to Hero [Ts 8d]
b59fc0b9: folds
79d81faa: folds
Hero: folds
c999165: folds
ccabd9d2: raises $0.09 to $0.14
d691d846: folds
Uncalled bet ($0.09) returned to ccabd9d2
*** SHOWDOWN ***
ccabd9d2 collected $0.1 from pot
*** SUMMARY ***
Total pot $0.1 | Rake $0 | Jackpot $0 | Bingo $0 | Fortune $0 | Tax $0
Seat 1: c999165 (button) folded before Flop (didn't bet)
Seat 2: ccabd9d2 (small blind) collected ($0.1)
Seat 3: d691d846 (big blind) folded before Flop
Seat 4: b59fc0b9 folded before Flop (didn't bet)
Seat 5: 79d81faa folded before Flop (didn't bet)
Seat 6: Hero folded before Flop (didn't bet)


Poker Hand #RC3334598308: Hold'em No Limit ($0.02/$0.05) - 2025/02/17 21:41:21
Table 'RushAndCash633568' 6-max Seat #1 is the button
Seat 1: 486aa946 ($4.73 in chips)
Seat 2: a91946aa ($2.28 in chips)
Seat 3: e16b78a9 ($6.7 in chips)
Seat 4: Hero ($7.68 in chips)
Seat 5: 87395f7a ($5.16 in chips)
Seat 6: ac56502f ($2.09 in chips)
a91946aa: posts small blind $0.02
e16b78a9: posts big blind $0.05
*** HOLE CARDS ***
Dealt to 486aa946 
Dealt to a91946aa 
Dealt to e16b78a9 
Dealt to Hero [Ad 9s]
Dealt to 87395f7a 
Dealt to ac56502f 
Hero: folds
87395f7a: folds
ac56502f: raises $0.08 to $0.13
486aa946: folds
a91946aa: folds
e16b78a9: folds
Uncalled bet ($0.08) returned to ac56502f
*** SHOWDOWN ***
ac56502f collected $0.12 from pot
*** SUMMARY ***
Total pot $0.12 | Rake $0 | Jackpot $0 | Bingo $0 | Fortune $0 | Tax $0
Seat 1: 486aa946 (button) folded before Flop (didn't bet)
Seat 2: a91946aa (small blind) folded before Flop
Seat 3: e16b78a9 (big blind) folded before Flop
Seat 4: Hero folded before Flop (didn't bet)
Seat 5: 87395f7a folded before Flop (didn't bet)
Seat 6: ac56502f collected ($0.12)


Poker Hand #RC3334598281: Hold'em No Limit ($0.02/$0.05) - 2025/02/17 21:41:18
Table 'RushAndCash633541' 6-max Seat #1 is the button
Seat 1: Hero ($7.68 in chips)
Seat 2: e16b78a9 ($6.72 in chips)
Seat 3: a91946aa ($2.33 in chips)
Seat 4: 9fa2589a ($4.32 in chips)
Seat 5: 40df0724 ($4.82 in chips)
Seat 6: d03e7668 ($5.39 in chips)
e16b78a9: posts small blind $0.02
a91946aa: posts big blind $0.05
*** HOLE CARDS ***
Dealt to Hero [7s 9d]
Dealt to e16b78a9 
Dealt to a91946aa 
Dealt to 9fa2589a 
Dealt to 40df0724 
Dealt to d03e7668 
9fa2589a: folds
40df0724: folds
d03e7668: raises $0.05 to $0.1
Hero: folds
e16b78a9: folds
a91946aa: folds
Uncalled bet ($0.05) returned to d03e7668
*** SHOWDOWN ***
d03e7668 collected $0.12 from pot
*** SUMMARY ***
Total pot $0.12 | Rake $0 | Jackpot $0 | Bingo $0 | Fortune $0 | Tax $0
Seat 1: Hero (button) folded before Flop (didn't bet)
Seat 2: e16b78a9 (small blind) folded before Flop
Seat 3: a91946aa (big blind) folded before Flop
Seat 4: 9fa2589a folded before Flop (didn't bet)
Seat 5: 40df0724 folded before Flop (didn't bet)
Seat 6: d03e7668 collected ($0.12)


Poker Hand #RC3334598255: Hold'em No Limit ($0.02/$0.05) - 2025/02/17 21:41:15
Table 'RushAndCash633515' 6-max Seat #1 is the button
Seat 1: 64b39229 ($5.75 in chips)
Seat 2: 5b79005a ($5.63 in chips)
Seat 3: d037279c ($6.98 in chips)
Seat 4: Hero ($7.68 in chips)
Seat 5: 411d6d13 ($5 in chips)
Seat 6: 8e93231a ($5.07 in chips)
5b79005a: posts small blind $0.02
d037279c: posts big blind $0.05
*** HOLE CARDS ***
Dealt to 64b39229 
Dealt to 5b79005a 
Dealt to d037279c 
Dealt to Hero [4d 9c]
Dealt to 411d6d13 
Dealt to 8e93231a 
Hero: folds
411d6d13: folds
8e93231a: folds
64b39229: folds
5b79005a: folds
Uncalled bet ($0.03) returned to d037279c
*** SHOWDOWN ***
d037279c collected $0.04 from pot
*** SUMMARY ***
Total pot $0.04 | Rake $0 | Jackpot $0 | Bingo $0 | Fortune $0 | Tax $0
Seat 1: 64b39229 (button) folded before Flop (didn't bet)
Seat 2: 5b79005a (small blind) folded before Flop
Seat 3: d037279c (big blind) collected ($0.04)
Seat 4: Hero folded before Flop (didn't bet)
Seat 5: 411d6d13 folded before Flop (didn't bet)
Seat 6: 8e93231a folded before Flop (didn't bet)


Poker Hand #RC3334598225: Hold'em No Limit ($0.02/$0.05) - 2025/02/17 21:41:12
Table 'RushAndCash633485' 6-max Seat #1 is the button
Seat 1: d03e7668 ($5.39 in chips)
Seat 2: fa499268 ($8.57 in chips)
Seat 3: 419eb9fb ($11.44 in chips)
Seat 4: 66981141 ($13.63 in chips)
Seat 5: d8f38484 ($6.06 in chips)
Seat 6: Hero ($7.68 in chips)
fa499268: posts small blind $0.02
419eb9fb: posts big blind $0.05
*** HOLE CARDS ***
Dealt to d03e7668 
Dealt to fa499268 
Dealt to 419eb9fb 
Dealt to 66981141 
Dealt to d8f38484 
Dealt to Hero [5c Ah]
66981141: folds
d8f38484: folds
Hero: folds
d03e7668: folds
fa499268: raises $0.1 to $0.15
419eb9fb: folds
Uncalled bet ($0.1) returned to fa499268
*** SHOWDOWN ***
fa499268 collected $0.1 from pot
*** SUMMARY ***
Total pot $0.1 | Rake $0 | Jackpot $0 | Bingo $0 | Fortune $0 | Tax $0
Seat 1: d03e7668 (button) folded before Flop (didn't bet)
Seat 2: fa499268 (small blind) collected ($0.1)
Seat 3: 419eb9fb (big blind) folded before Flop
Seat 4: 66981141 folded before Flop (didn't bet)
Seat 5: d8f38484 folded before Flop (didn't bet)
Seat 6: Hero folded before Flop (didn't bet)


Poker Hand #RC3334598198: Hold'em No Limit ($0.02/$0.05) - 2025/02/17 21:41:09
Table 'RushAndCash633458' 6-max Seat #1 is the button
Seat 1: Hero ($7.68 in chips)
Seat 2: 198a1e4 ($7.9 in chips)
Seat 3: 64542a04 ($5.03 in chips)
Seat 4: 67ca8637 ($3.45 in chips)
Seat 5: 3e301744 ($15.37 in chips)
Seat 6: 58e1e47f ($5.33 in chips)
198a1e4: posts small blind $0.02
64542a04: posts big blind $0.05
*** HOLE CARDS ***
Dealt to Hero [Qd 3d]
Dealt to 198a1e4 
Dealt to 64542a04 
Dealt to 67ca8637 
Dealt to 3e301744 
Dealt to 58e1e47f 
67ca8637: calls $0.05
3e301744: folds
58e1e47f: folds
Hero: folds
198a1e4: folds
64542a04: checks
*** FLOP *** [Ts 9d 2d]
64542a04: checks
67ca8637: bets $0.12
64542a04: calls $0.12
*** TURN *** [Ts 9d 2d] [5c]
64542a04: checks
67ca8637: bets $0.12
64542a04: calls $0.12
*** RIVER *** [Ts 9d 2d 5c] [8s]
64542a04: checks
67ca8637: bets $0.2
64542a04: calls $0.2
67ca8637: shows [4d 4c] (Pair of Fours)
64542a04: shows [Tc Ah] (Pair of Tens)
*** SHOWDOWN ***
64542a04 collected $0.95 from pot
*** SUMMARY ***
Total pot $1 | Rake $0.05 | Jackpot $0 | Bingo $0 | Fortune $0 | Tax $0
Board [Ts 9d 2d 5c 8s]
Seat 1: Hero (button) folded before Flop (didn't bet)
Seat 2: 198a1e4 (small blind) folded before Flop
Seat 3: 64542a04 (big blind) showed [Tc Ah] and won ($0.95) with Pair of Tens
Seat 4: 67ca8637 showed [4d 4c] and lost with Pair of Fours
Seat 5: 3e301744 folded before Flop (didn't bet)
Seat 6: 58e1e47f folded before Flop (didn't bet)


Poker Hand #RC3334598141: Hold'em No Limit ($0.02/$0.05) - 2025/02/17 21:41:03
Table 'RushAndCash633401' 6-max Seat #1 is the button
Seat 1: 61652819 ($5 in chips)
Seat 2: c7e9103c ($11.18 in chips)
Seat 3: Hero ($7.73 in chips)
Seat 4: ae36de25 ($5.57 in chips)
Seat 5: e2d5acdf ($5.66 in chips)
Seat 6: 2dc40675 ($7.77 in chips)
c7e9103c: posts small blind $0.02
Hero: posts big blind $0.05
*** HOLE CARDS ***
Dealt to 61652819 
Dealt to c7e9103c 
Dealt to Hero [5s Ac]
Dealt to ae36de25 
Dealt to e2d5acdf 
Dealt to 2dc40675 
ae36de25: folds
e2d5acdf: folds
2dc40675: folds
61652819: raises $0.05 to $0.1
c7e9103c: raises $0.35 to $0.45
Hero: folds
61652819: calls $0.35
*** FLOP *** [2c Qc 4h]
c7e9103c: bets $0.35
61652819: calls $0.35
*** TURN *** [2c Qc 4h] [Td]
c7e9103c: bets $1.2
61652819: calls $1.2
*** RIVER *** [2c Qc 4h Td] [6c]
c7e9103c: checks
61652819: checks
c7e9103c: shows [Jd 9d] (Queen-High)
61652819: shows [Th Jh] (Pair of Tens)
*** SHOWDOWN ***
61652819 collected $3.83 from pot
*** SUMMARY ***
Total pot $4.05 | Rake $0.15 | Jackpot $0.07 | Bingo $0 | Fortune $0 | Tax $0
Board [2c Qc 4h Td 6c]
Seat 1: 61652819 (button) showed [Th Jh] and won ($3.83) with Pair of Tens
Seat 2: c7e9103c (small blind) showed [Jd 9d] and lost with Queen-High
Seat 3: Hero (big blind) folded before Flop
Seat 4: ae36de25 folded before Flop (didn't bet)
Seat 5: e2d5acdf folded before Flop (didn't bet)
Seat 6: 2dc40675 folded before Flop (didn't bet)


Poker Hand #RC3334598106: Hold'em No Limit ($0.02/$0.05) - 2025/02/17 21:40:59
Table 'RushAndCash633366' 6-max Seat #1 is the button
Seat 1: d60e3ce5 ($5.76 in chips)
Seat 2: 42fca4f9 ($14.55 in chips)
Seat 3: 9fe0040c ($3.15 in chips)
Seat 4: 256d985c ($5 in chips)
Seat 5: e2d5acdf ($5.66 in chips)
Seat 6: Hero ($7.73 in chips)
42fca4f9: posts small blind $0.02
9fe0040c: posts big blind $0.05
*** HOLE CARDS ***
Dealt to d60e3ce5 
Dealt to 42fca4f9 
Dealt to 9fe0040c 
Dealt to 256d985c 
Dealt to e2d5acdf 
Dealt to Hero [3d Js]
256d985c: raises $0.08 to $0.13
e2d5acdf: folds
Hero: folds
d60e3ce5: folds
42fca4f9: folds
9fe0040c: folds
Uncalled bet ($0.08) returned to 256d985c
*** SHOWDOWN ***
256d985c collected $0.12 from pot
*** SUMMARY ***
Total pot $0.12 | Rake $0 | Jackpot $0 | Bingo $0 | Fortune $0 | Tax $0
Seat 1: d60e3ce5 (button) folded before Flop (didn't bet)
Seat 2: 42fca4f9 (small blind) folded before Flop
Seat 3: 9fe0040c (big blind) folded before Flop
Seat 4: 256d985c collected ($0.12)
Seat 5: e2d5acdf folded before Flop (didn't bet)
Seat 6: Hero folded before Flop (didn't bet)


Poker Hand #RC3334598079: Hold'em No Limit ($0.02/$0.05) - 2025/02/17 21:40:56
Table 'RushAndCash633339' 6-max Seat #1 is the button
Seat 1: 421a6d95 ($6 in chips)
Seat 2: 235dd2d1 ($16.28 in chips)
Seat 3: 658c386e ($5 in chips)
Seat 4: 86b969db ($5.49 in chips)
Seat 5: f85679bb ($5.12 in chips)
Seat 6: Hero ($7.73 in chips)
235dd2d1: posts small blind $0.02
658c386e: posts big blind $0.05
*** HOLE CARDS ***
Dealt to 421a6d95 
Dealt to 235dd2d1 
Dealt to 658c386e 
Dealt to 86b969db 
Dealt to f85679bb 
Dealt to Hero [3c 6h]
86b969db: folds
f85679bb: folds
Hero: folds
421a6d95: raises $0.06 to $0.11
235dd2d1: folds
658c386e: folds
Uncalled bet ($0.06) returned to 421a6d95
*** SHOWDOWN ***
421a6d95 collected $0.12 from pot
*** SUMMARY ***
Total pot $0.12 | Rake $0 | Jackpot $0 | Bingo $0 | Fortune $0 | Tax $0
Seat 1: 421a6d95 (button) collected ($0.12)
Seat 2: 235dd2d1 (small blind) folded before Flop
Seat 3: 658c386e (big blind) folded before Flop
Seat 4: 86b969db folded before Flop (didn't bet)
Seat 5: f85679bb folded before Flop (didn't bet)
Seat 6: Hero folded before Flop (didn't bet)


Poker Hand #RC3334598036: Hold'em No Limit ($0.02/$0.05) - 2025/02/17 21:40:51
Table 'RushAndCash633296' 6-max Seat #1 is the button
Seat 1: Hero ($7.73 in chips)
Seat 2: c6e11d19 ($5.37 in chips)
Seat 3: fd236f26 ($5.77 in chips)
Seat 4: 93056ee9 ($10.62 in chips)
Seat 5: c10f0de8 ($5.21 in chips)
Seat 6: 5466aa49 ($6.08 in chips)
c6e11d19: posts small blind $0.02
fd236f26: posts big blind $0.05
*** HOLE CARDS ***
Dealt to Hero [3d Ts]
Dealt to c6e11d19 
Dealt to fd236f26 
Dealt to 93056ee9 
Dealt to c10f0de8 
Dealt to 5466aa49 
93056ee9: folds
c10f0de8: folds
5466aa49: folds
Hero: folds
c6e11d19: raises $0.07 to $0.12
fd236f26: folds
Uncalled bet ($0.07) returned to c6e11d19
*** SHOWDOWN ***
c6e11d19 collected $0.1 from pot
*** SUMMARY ***
Total pot $0.1 | Rake $0 | Jackpot $0 | Bingo $0 | Fortune $0 | Tax $0
Seat 1: Hero (button) folded before Flop (didn't bet)
Seat 2: c6e11d19 (small blind) collected ($0.1)
Seat 3: fd236f26 (big blind) folded before Flop
Seat 4: 93056ee9 folded before Flop (didn't bet)
Seat 5: c10f0de8 folded before Flop (didn't bet)
Seat 6: 5466aa49 folded before Flop (didn't bet)


Poker Hand #RC3334598007: Hold'em No Limit ($0.02/$0.05) - 2025/02/17 21:40:48
Table 'RushAndCash633267' 6-max Seat #1 is the button
Seat 1: bf4557c ($1.97 in chips)
Seat 2: 2dc40675 ($7.79 in chips)
Seat 3: ef96c0c8 ($6.71 in chips)
Seat 4: d47282a4 ($6.45 in chips)
Seat 5: 3e3946b0 ($5.13 in chips)
Seat 6: Hero ($7.73 in chips)
2dc40675: posts small blind $0.02
ef96c0c8: posts big blind $0.05
*** HOLE CARDS ***
Dealt to bf4557c 
Dealt to 2dc40675 
Dealt to ef96c0c8 
Dealt to d47282a4 
Dealt to 3e3946b0 
Dealt to Hero [2d 7h]
d47282a4: folds
3e3946b0: raises $0.1 to $0.15
Hero: folds
bf4557c: folds
2dc40675: folds
ef96c0c8: folds
Uncalled bet ($0.1) returned to 3e3946b0
*** SHOWDOWN ***
3e3946b0 collected $0.12 from pot
*** SUMMARY ***
Total pot $0.12 | Rake $0 | Jackpot $0 | Bingo $0 | Fortune $0 | Tax $0
Seat 1: bf4557c (button) folded before Flop (didn't bet)
Seat 2: 2dc40675 (small blind) folded before Flop
Seat 3: ef96c0c8 (big blind) folded before Flop
Seat 4: d47282a4 folded before Flop (didn't bet)
Seat 5: 3e3946b0 collected ($0.12)
Seat 6: Hero folded before Flop (didn't bet)


Poker Hand #RC3334597962: Hold'em No Limit ($0.02/$0.05) - 2025/02/17 21:40:43
Table 'RushAndCash633222' 6-max Seat #1 is the button
Seat 1: Hero ($7.66 in chips)
Seat 2: 23c23672 ($6.69 in chips)
Seat 3: 827649ff ($5 in chips)
Seat 4: 1e474bac ($6.56 in chips)
Seat 5: ef1c45d4 ($6.76 in chips)
Seat 6: 1fa8537 ($9.65 in chips)
23c23672: posts small blind $0.02
827649ff: posts big blind $0.05
*** HOLE CARDS ***
Dealt to Hero [2h 9c]
Dealt to 23c23672 
Dealt to 827649ff 
Dealt to 1e474bac 
Dealt to ef1c45d4 
Dealt to 1fa8537 
1e474bac: folds
ef1c45d4: folds
1fa8537: folds
Hero: folds
23c23672: raises $0.06 to $0.11
827649ff: folds
Uncalled bet ($0.06) returned to 23c23672
*** SHOWDOWN ***
23c23672 collected $0.1 from pot
*** SUMMARY ***
Total pot $0.1 | Rake $0 | Jackpot $0 | Bingo $0 | Fortune $0 | Tax $0
Seat 1: Hero (button) folded before Flop (didn't bet)
Seat 2: 23c23672 (small blind) collected ($0.1)
Seat 3: 827649ff (big blind) folded before Flop
Seat 4: 1e474bac folded before Flop (didn't bet)
Seat 5: ef1c45d4 folded before Flop (didn't bet)
Seat 6: 1fa8537 folded before Flop (didn't bet)


Poker Hand #RC3334597930: Hold'em No Limit ($0.02/$0.05) - 2025/02/17 21:40:39
Table 'RushAndCash633190' 6-max Seat #1 is the button
Seat 1: 27b4c2a6 ($9.37 in chips)
Seat 2: debb9287 ($5.18 in chips)
Seat 3: Hero ($7.71 in chips)
Seat 4: 53a8c2fd ($9.76 in chips)
Seat 5: a4bd9290 ($6.16 in chips)
Seat 6: 18767060 ($8.99 in chips)
debb9287: posts small blind $0.02
Hero: posts big blind $0.05
*** HOLE CARDS ***
Dealt to 27b4c2a6 
Dealt to debb9287 
Dealt to Hero [9c 7d]
Dealt to 53a8c2fd 
Dealt to a4bd9290 
Dealt to 18767060 
53a8c2fd: folds
a4bd9290: folds
18767060: folds
27b4c2a6: folds
debb9287: folds
Uncalled bet ($0.03) returned to Hero
*** SHOWDOWN ***
Hero collected $0.04 from pot
*** SUMMARY ***
Total pot $0.04 | Rake $0 | Jackpot $0 | Bingo $0 | Fortune $0 | Tax $0
Seat 1: 27b4c2a6 (button) folded before Flop (didn't bet)
Seat 2: debb9287 (small blind) folded before Flop
Seat 3: Hero (big blind) collected ($0.04)
Seat 4: 53a8c2fd folded before Flop (didn't bet)
Seat 5: a4bd9290 folded before Flop (didn't bet)
Seat 6: 18767060 folded before Flop (didn't bet)


Poker Hand #RC3334597903: Hold'em No Limit ($0.02/$0.05) - 2025/02/17 21:40:36
Table 'RushAndCash633163' 6-max Seat #1 is the button
Seat 1: 4305bf97 ($5.46 in chips)
Seat 2: e61a8cfb ($5.01 in chips)
Seat 3: 29497ac7 ($3.35 in chips)
Seat 4: 23c23672 ($6.69 in chips)
Seat 5: fd236f26 ($5.79 in chips)
Seat 6: Hero ($7.71 in chips)
e61a8cfb: posts small blind $0.02
29497ac7: posts big blind $0.05
*** HOLE CARDS ***
Dealt to 4305bf97 
Dealt to e61a8cfb 
Dealt to 29497ac7 
Dealt to 23c23672 
Dealt to fd236f26 
Dealt to Hero [Ts 9c]
23c23672: folds
fd236f26: folds
Hero: folds
4305bf97: raises $0.06 to $0.11
e61a8cfb: folds
29497ac7: raises $0.12 to $0.23
4305bf97: calls $0.12
*** FLOP *** [Kd 8h 6c]
29497ac7: checks
4305bf97: bets $0.05
29497ac7: calls $0.05
*** TURN *** [Kd 8h 6c] [As]
29497ac7: checks
4305bf97: checks
*** RIVER *** [Kd 8h 6c As] [Kc]
29497ac7: checks
4305bf97: bets $0.44
29497ac7: folds
Uncalled bet ($0.44) returned to 4305bf97
*** SHOWDOWN ***
4305bf97 collected $0.56 from pot
*** SUMMARY ***
Total pot $0.58 | Rake $0.02 | Jackpot $0 | Bingo $0 | Fortune $0 | Tax $0
Board [Kd 8h 6c As Kc]
Seat 1: 4305bf97 (button) won ($0.56)
Seat 2: e61a8cfb (small blind) folded before Flop
Seat 3: 29497ac7 (big blind) folded on the River
Seat 4: 23c23672 folded before Flop (didn't bet)
Seat 5: fd236f26 folded before Flop (didn't bet)
Seat 6: Hero folded before Flop (didn't bet)


Poker Hand #RC3334597860: Hold'em No Limit ($0.02/$0.05) - 2025/02/17 21:40:32
Table 'RushAndCash633120' 6-max Seat #1 is the button
Seat 1: 545ae247 ($7.02 in chips)
Seat 2: c606a534 ($10.62 in chips)
Seat 3: 33caafa3 ($5 in chips)
Seat 4: Hero ($7.71 in chips)
Seat 5: 3d4f4b4c ($5.14 in chips)
Seat 6: 8e93231a ($5 in chips)
c606a534: posts small blind $0.02
33caafa3: posts big blind $0.05
*** HOLE CARDS ***
Dealt to 545ae247 
Dealt to c606a534 
Dealt to 33caafa3 
Dealt to Hero [Ks 6d]
Dealt to 3d4f4b4c 
Dealt to 8e93231a 
Hero: folds
3d4f4b4c: folds
8e93231a: folds
545ae247: folds
c606a534: folds
Uncalled bet ($0.03) returned to 33caafa3
*** SHOWDOWN ***
33caafa3 collected $0.04 from pot
*** SUMMARY ***
Total pot $0.04 | Rake $0 | Jackpot $0 | Bingo $0 | Fortune $0 | Tax $0
Seat 1: 545ae247 (button) folded before Flop (didn't bet)
Seat 2: c606a534 (small blind) folded before Flop
Seat 3: 33caafa3 (big blind) collected ($0.04)
Seat 4: Hero folded before Flop (didn't bet)
Seat 5: 3d4f4b4c folded before Flop (didn't bet)
Seat 6: 8e93231a folded before Flop (didn't bet)


Poker Hand #RC3334597766: Hold'em No Limit ($0.02/$0.05) - 2025/02/17 21:40:21
Table 'RushAndCash633026' 6-max Seat #1 is the button
Seat 1: 4ebd5be6 ($5.74 in chips)
Seat 2: Hero ($7.73 in chips)
Seat 3: f0600331 ($8.3 in chips)
Seat 4: 4ce7d5f4 ($5.76 in chips)
Seat 5: b72def64 ($5 in chips)
Seat 6: 81b0c107 ($6.86 in chips)
Hero: posts small blind $0.02
f0600331: posts big blind $0.05
*** HOLE CARDS ***
Dealt to 4ebd5be6 
Dealt to Hero [Td Ks]
Dealt to f0600331 
Dealt to 4ce7d5f4 
Dealt to b72def64 
Dealt to 81b0c107 
4ce7d5f4: folds
b72def64: folds
81b0c107: folds
4ebd5be6: raises $0.06 to $0.11
Hero: folds
f0600331: folds
Uncalled bet ($0.06) returned to 4ebd5be6
*** SHOWDOWN ***
4ebd5be6 collected $0.12 from pot
*** SUMMARY ***
Total pot $0.12 | Rake $0 | Jackpot $0 | Bingo $0 | Fortune $0 | Tax $0
Seat 1: 4ebd5be6 (button) collected ($0.12)
Seat 2: Hero (small blind) folded before Flop
Seat 3: f0600331 (big blind) folded before Flop
Seat 4: 4ce7d5f4 folded before Flop (didn't bet)
Seat 5: b72def64 folded before Flop (didn't bet)
Seat 6: 81b0c107 folded before Flop (didn't bet)


Poker Hand #RC3334597735: Hold'em No Limit ($0.02/$0.05) - 2025/02/17 21:40:17
Table 'RushAndCash632995' 6-max Seat #1 is the button
Seat 1: ca7c2b72 ($5 in chips)
Seat 2: 82c6ccfb ($10.72 in chips)
Seat 3: 32972137 ($8.4 in chips)
Seat 4: 188c8947 ($5.81 in chips)
Seat 5: Hero ($7.73 in chips)
Seat 6: 4fa289e4 ($5.51 in chips)
82c6ccfb: posts small blind $0.02
32972137: posts big blind $0.05
*** HOLE CARDS ***
Dealt to ca7c2b72 
Dealt to 82c6ccfb 
Dealt to 32972137 
Dealt to 188c8947 
Dealt to Hero [5s 9c]
Dealt to 4fa289e4 
188c8947: raises $0.07 to $0.12
Hero: folds
4fa289e4: folds
ca7c2b72: folds
82c6ccfb: folds
32972137: folds
Uncalled bet ($0.07) returned to 188c8947
*** SHOWDOWN ***
188c8947 collected $0.12 from pot
*** SUMMARY ***
Total pot $0.12 | Rake $0 | Jackpot $0 | Bingo $0 | Fortune $0 | Tax $0
Seat 1: ca7c2b72 (button) folded before Flop (didn't bet)
Seat 2: 82c6ccfb (small blind) folded before Flop
Seat 3: 32972137 (big blind) folded before Flop
Seat 4: 188c8947 collected ($0.12)
Seat 5: Hero folded before Flop (didn't bet)
Seat 6: 4fa289e4 folded before Flop (didn't bet)


Poker Hand #RC3334597643: Hold'em No Limit ($0.02/$0.05) - 2025/02/17 21:40:07
Table 'RushAndCash632903' 6-max Seat #1 is the button
Seat 1: 47b2c33d ($5.3 in chips)
Seat 2: Hero ($7.75 in chips)
Seat 3: 42fdd5b8 ($5.33 in chips)
Seat 4: cc91d9ca ($10.07 in chips)
Seat 5: 8cf3ad10 ($11.36 in chips)
Seat 6: 419eb9fb ($11.61 in chips)
Hero: posts small blind $0.02
42fdd5b8: posts big blind $0.05
*** HOLE CARDS ***
Dealt to 47b2c33d 
Dealt to Hero [9h Ah]
Dealt to 42fdd5b8 
Dealt to cc91d9ca 
Dealt to 8cf3ad10 
Dealt to 419eb9fb 
cc91d9ca: folds
8cf3ad10: raises $0.05 to $0.1
419eb9fb: calls $0.1
47b2c33d: folds
Hero: folds
42fdd5b8: calls $0.05
*** FLOP *** [Tc 9d As]
42fdd5b8: checks
8cf3ad10: checks
419eb9fb: checks
*** TURN *** [Tc 9d As] [Qc]
42fdd5b8: checks
8cf3ad10: checks
419eb9fb: checks
*** RIVER *** [Tc 9d As Qc] [7c]
42fdd5b8: checks
8cf3ad10: bets $0.16
419eb9fb: folds
42fdd5b8: folds
Uncalled bet ($0.16) returned to 8cf3ad10
*** SHOWDOWN ***
8cf3ad10 collected $0.31 from pot
*** SUMMARY ***
Total pot $0.32 | Rake $0.01 | Jackpot $0 | Bingo $0 | Fortune $0 | Tax $0
Board [Tc 9d As Qc 7c]
Seat 1: 47b2c33d (button) folded before Flop (didn't bet)
Seat 2: Hero (small blind) folded before Flop
Seat 3: 42fdd5b8 (big blind) folded on the River
Seat 4: cc91d9ca folded before Flop (didn't bet)
Seat 5: 8cf3ad10 won ($0.31)
Seat 6: 419eb9fb folded on the River


Poker Hand #RC3334597613: Hold'em No Limit ($0.02/$0.05) - 2025/02/17 21:40:04
Table 'RushAndCash632873' 6-max Seat #1 is the button
Seat 1: 877b03ec ($5 in chips)
Seat 2: f71501ed ($5.14 in chips)
Seat 3: 38005dc9 ($3.69 in chips)
Seat 4: Hero ($7.75 in chips)
Seat 5: e61a8cfb ($5.08 in chips)
Seat 6: 6608ec00 ($5 in chips)
f71501ed: posts small blind $0.02
38005dc9: posts big blind $0.05
*** HOLE CARDS ***
Dealt to 877b03ec 
Dealt to f71501ed 
Dealt to 38005dc9 
Dealt to Hero [4h 2h]
Dealt to e61a8cfb 
Dealt to 6608ec00 
Hero: folds
e61a8cfb: folds
6608ec00: folds
877b03ec: raises $0.06 to $0.11
f71501ed: raises $0.39 to $0.5
38005dc9: folds
877b03ec: folds
Uncalled bet ($0.39) returned to f71501ed
*** SHOWDOWN ***
f71501ed collected $0.26 from pot
*** SUMMARY ***
Total pot $0.27 | Rake $0.01 | Jackpot $0 | Bingo $0 | Fortune $0 | Tax $0
Seat 1: 877b03ec (button) folded before Flop
Seat 2: f71501ed (small blind) collected ($0.26)
Seat 3: 38005dc9 (big blind) folded before Flop
Seat 4: Hero folded before Flop (didn't bet)
Seat 5: e61a8cfb folded before Flop (didn't bet)
Seat 6: 6608ec00 folded before Flop (didn't bet)


Poker Hand #RC3334597584: Hold'em No Limit ($0.02/$0.05) - 2025/02/17 21:40:00
Table 'RushAndCash632844' 6-max Seat #1 is the button
Seat 1: 9f09d482 ($12.71 in chips)
Seat 2: b5e885d5 ($5.06 in chips)
Seat 3: Hero ($7.8 in chips)
Seat 4: 110fdc96 ($5.07 in chips)
Seat 5: e3c32f29 ($5.94 in chips)
Seat 6: 24aff26b ($7.06 in chips)
b5e885d5: posts small blind $0.02
Hero: posts big blind $0.05
*** HOLE CARDS ***
Dealt to 9f09d482 
Dealt to b5e885d5 
Dealt to Hero [5d 4s]
Dealt to 110fdc96 
Dealt to e3c32f29 
Dealt to 24aff26b 
110fdc96: folds
e3c32f29: raises $0.08 to $0.13
24aff26b: raises $0.24 to $0.37
9f09d482: folds
b5e885d5: folds
Hero: folds
e3c32f29: calls $0.24
*** FLOP *** [9s Tc 9h]
e3c32f29: checks
24aff26b: bets $0.21
e3c32f29: folds
Uncalled bet ($0.21) returned to 24aff26b
*** SHOWDOWN ***
24aff26b collected $0.77 from pot
*** SUMMARY ***
Total pot $0.81 | Rake $0.04 | Jackpot $0 | Bingo $0 | Fortune $0 | Tax $0
Board [9s Tc 9h]
Seat 1: 9f09d482 (button) folded before Flop (didn't bet)
Seat 2: b5e885d5 (small blind) folded before Flop
Seat 3: Hero (big blind) folded before Flop
Seat 4: 110fdc96 folded before Flop (didn't bet)
Seat 5: e3c32f29 folded on the Flop
Seat 6: 24aff26b won ($0.77)


Poker Hand #RC3334597295: Hold'em No Limit ($0.02/$0.05) - 2025/02/17 21:39:24
Table 'RushAndCash632555' 6-max Seat #1 is the button
Seat 1: Hero ($7.69 in chips)
Seat 2: b66c51bb ($5.89 in chips)
Seat 3: b5e885d5 ($5.16 in chips)
Seat 4: d897e841 ($5 in chips)
Seat 5: 94cb065d ($7.25 in chips)
Seat 6: bc8371cb ($5 in chips)
b66c51bb: posts small blind $0.02
b5e885d5: posts big blind $0.05
*** HOLE CARDS ***
Dealt to Hero [Ad Th]
Dealt to b66c51bb 
Dealt to b5e885d5 
Dealt to d897e841 
Dealt to 94cb065d 
Dealt to bc8371cb 
d897e841: folds
94cb065d: folds
bc8371cb: folds
Hero: raises $0.05 to $0.1
b66c51bb: folds
b5e885d5: calls $0.05
*** FLOP *** [3d 8h 7h]
b5e885d5: checks
Hero: checks
*** TURN *** [3d 8h 7h] [2d]
b5e885d5: checks
Hero: checks
*** RIVER *** [3d 8h 7h 2d] [8c]
b5e885d5: checks
Hero: checks
b5e885d5: shows [4s Kh] (Pair of Eights)
Hero: shows [Ad Th] (Pair of Eights)
*** SHOWDOWN ***
Hero collected $0.21 from pot
*** SUMMARY ***
Total pot $0.22 | Rake $0.01 | Jackpot $0 | Bingo $0 | Fortune $0 | Tax $0
Board [3d 8h 7h 2d 8c]
Seat 1: Hero (button) showed [Ad Th] and won ($0.21) with Pair of Eights
Seat 2: b66c51bb (small blind) folded before Flop
Seat 3: b5e885d5 (big blind) showed [4s Kh] and lost with Pair of Eights
Seat 4: d897e841 folded before Flop (didn't bet)
Seat 5: 94cb065d folded before Flop (didn't bet)
Seat 6: bc8371cb folded before Flop (didn't bet)


Poker Hand #RC3334597256: Hold'em No Limit ($0.02/$0.05) - 2025/02/17 21:39:19
Table 'RushAndCash632516' 6-max Seat #1 is the button
Seat 1: 56d81d8 ($5.15 in chips)
Seat 2: 3a228f55 ($5 in chips)
Seat 3: b59fc0b9 ($5.41 in chips)
Seat 4: Hero ($7.69 in chips)
Seat 5: 1e2c3e8b ($10.32 in chips)
Seat 6: 73ccb7bc ($5.12 in chips)
3a228f55: posts small blind $0.02
b59fc0b9: posts big blind $0.05
*** HOLE CARDS ***
Dealt to 56d81d8 
Dealt to 3a228f55 
Dealt to b59fc0b9 
Dealt to Hero [Ad 5c]
Dealt to 1e2c3e8b 
Dealt to 73ccb7bc 
Hero: folds
1e2c3e8b: raises $0.08 to $0.13
73ccb7bc: folds
56d81d8: folds
3a228f55: folds
b59fc0b9: folds
Uncalled bet ($0.08) returned to 1e2c3e8b
*** SHOWDOWN ***
1e2c3e8b collected $0.12 from pot
*** SUMMARY ***
Total pot $0.12 | Rake $0 | Jackpot $0 | Bingo $0 | Fortune $0 | Tax $0
Seat 1: 56d81d8 (button) folded before Flop (didn't bet)
Seat 2: 3a228f55 (small blind) folded before Flop
Seat 3: b59fc0b9 (big blind) folded before Flop
Seat 4: Hero folded before Flop (didn't bet)
Seat 5: 1e2c3e8b collected ($0.12)
Seat 6: 73ccb7bc folded before Flop (didn't bet)


Poker Hand #RC3334597232: Hold'em No Limit ($0.02/$0.05) - 2025/02/17 21:39:16
Table 'RushAndCash632492' 6-max Seat #1 is the button
Seat 1: e1132427 ($13.47 in chips)
Seat 2: Hero ($7.71 in chips)
Seat 3: 55630016 ($9.88 in chips)
Seat 4: 18767060 ($8.66 in chips)
Seat 5: debb9287 ($5.41 in chips)
Seat 6: f85679bb ($5.07 in chips)
Hero: posts small blind $0.02
55630016: posts big blind $0.05
*** HOLE CARDS ***
Dealt to e1132427 
Dealt to Hero [6d Kc]
Dealt to 55630016 
Dealt to 18767060 
Dealt to debb9287 
Dealt to f85679bb 
18767060: folds
debb9287: folds
f85679bb: folds
e1132427: folds
Hero: folds
Uncalled bet ($0.03) returned to 55630016
*** SHOWDOWN ***
55630016 collected $0.04 from pot
*** SUMMARY ***
Total pot $0.04 | Rake $0 | Jackpot $0 | Bingo $0 | Fortune $0 | Tax $0
Seat 1: e1132427 (button) folded before Flop (didn't bet)
Seat 2: Hero (small blind) folded before Flop
Seat 3: 55630016 (big blind) collected ($0.04)
Seat 4: 18767060 folded before Flop (didn't bet)
Seat 5: debb9287 folded before Flop (didn't bet)
Seat 6: f85679bb folded before Flop (didn't bet)


Poker Hand #RC3334597207: Hold'em No Limit ($0.02/$0.05) - 2025/02/17 21:39:13
Table 'RushAndCash632467' 6-max Seat #1 is the button
Seat 1: 1dd0b66b ($5.14 in chips)
Seat 2: f6b7f191 ($5.71 in chips)
Seat 3: Hero ($7.76 in chips)
Seat 4: af90d8d7 ($11.73 in chips)
Seat 5: 110fdc96 ($5 in chips)
Seat 6: 8d0bc73f ($10.14 in chips)
f6b7f191: posts small blind $0.02
Hero: posts big blind $0.05
*** HOLE CARDS ***
Dealt to 1dd0b66b 
Dealt to f6b7f191 
Dealt to Hero [Tc 9s]
Dealt to af90d8d7 
Dealt to 110fdc96 
Dealt to 8d0bc73f 
af90d8d7: folds
110fdc96: raises $0.06 to $0.11
8d0bc73f: folds
1dd0b66b: calls $0.11
f6b7f191: folds
Hero: folds
*** FLOP *** [6c Td Ad]
110fdc96: checks
1dd0b66b: checks
*** TURN *** [6c Td Ad] [Js]
110fdc96: bets $0.15
1dd0b66b: calls $0.15
*** RIVER *** [6c Td Ad Js] [Jh]
110fdc96: checks
1dd0b66b: bets $0.6
110fdc96: folds
Uncalled bet ($0.6) returned to 1dd0b66b
*** SHOWDOWN ***
1dd0b66b collected $0.56 from pot
*** SUMMARY ***
Total pot $0.59 | Rake $0.03 | Jackpot $0 | Bingo $0 | Fortune $0 | Tax $0
Board [6c Td Ad Js Jh]
Seat 1: 1dd0b66b (button) won ($0.56)
Seat 2: f6b7f191 (small blind) folded before Flop
Seat 3: Hero (big blind) folded before Flop
Seat 4: af90d8d7 folded before Flop (didn't bet)
Seat 5: 110fdc96 folded on the River
Seat 6: 8d0bc73f folded before Flop (didn't bet)


Poker Hand #RC3334597173: Hold'em No Limit ($0.02/$0.05) - 2025/02/17 21:39:09
Table 'RushAndCash632433' 6-max Seat #1 is the button
Seat 1: 64b39229 ($5.48 in chips)
Seat 2: f3614ba1 ($8.02 in chips)
Seat 3: f6b7f191 ($5.76 in chips)
Seat 4: d57e790f ($8.39 in chips)
Seat 5: 2e24bede ($5.08 in chips)
Seat 6: Hero ($7.76 in chips)
f3614ba1: posts small blind $0.02
f6b7f191: posts big blind $0.05
*** HOLE CARDS ***
Dealt to 64b39229 
Dealt to f3614ba1 
Dealt to f6b7f191 
Dealt to d57e790f 
Dealt to 2e24bede 
Dealt to Hero [2h 3h]
d57e790f: folds
2e24bede: folds
Hero: folds
64b39229: raises $0.05 to $0.1
f3614ba1: folds
f6b7f191: folds
Uncalled bet ($0.05) returned to 64b39229
*** SHOWDOWN ***
64b39229 collected $0.12 from pot
*** SUMMARY ***
Total pot $0.12 | Rake $0 | Jackpot $0 | Bingo $0 | Fortune $0 | Tax $0
Seat 1: 64b39229 (button) collected ($0.12)
Seat 2: f3614ba1 (small blind) folded before Flop
Seat 3: f6b7f191 (big blind) folded before Flop
Seat 4: d57e790f folded before Flop (didn't bet)
Seat 5: 2e24bede folded before Flop (didn't bet)
Seat 6: Hero folded before Flop (didn't bet)


Poker Hand #RC3334597133: Hold'em No Limit ($0.02/$0.05) - 2025/02/17 21:39:05
Table 'RushAndCash632393' 6-max Seat #1 is the button
Seat 1: b2f44cb6 ($11.26 in chips)
Seat 2: 71e00d83 ($5.92 in chips)
Seat 3: 6ab3ea38 ($5.2 in chips)
Seat 4: 2596103a ($1.84 in chips)
Seat 5: Hero ($7.76 in chips)
Seat 6: e97b3270 ($22.67 in chips)
71e00d83: posts small blind $0.02
6ab3ea38: posts big blind $0.05
*** HOLE CARDS ***
Dealt to b2f44cb6 
Dealt to 71e00d83 
Dealt to 6ab3ea38 
Dealt to 2596103a 
Dealt to Hero [7s Td]
Dealt to e97b3270 
2596103a: raises $0.05 to $0.1
Hero: folds
e97b3270: folds
b2f44cb6: folds
71e00d83: folds
6ab3ea38: folds
Uncalled bet ($0.05) returned to 2596103a
*** SHOWDOWN ***
2596103a collected $0.12 from pot
*** SUMMARY ***
Total pot $0.12 | Rake $0 | Jackpot $0 | Bingo $0 | Fortune $0 | Tax $0
Seat 1: b2f44cb6 (button) folded before Flop (didn't bet)
Seat 2: 71e00d83 (small blind) folded before Flop
Seat 3: 6ab3ea38 (big blind) folded before Flop
Seat 4: 2596103a collected ($0.12)
Seat 5: Hero folded before Flop (didn't bet)
Seat 6: e97b3270 folded before Flop (didn't bet)


Poker Hand #RC3334596713: Hold'em No Limit ($0.02/$0.05) - 2025/02/17 21:38:18
Table 'RushAndCash631973' 6-max Seat #1 is the button
Seat 1: 826a79b4 ($7.09 in chips)
Seat 2: Hero ($7.86 in chips)
Seat 3: ec0e24ed ($5.08 in chips)
Seat 4: c3ca6759 ($5 in chips)
Seat 5: e4385e67 ($5.3 in chips)
Seat 6: fcfd355a ($5.07 in chips)
Hero: posts small blind $0.02
ec0e24ed: posts big blind $0.05
*** HOLE CARDS ***
Dealt to 826a79b4 
Dealt to Hero [7h 6h]
Dealt to ec0e24ed 
Dealt to c3ca6759 
Dealt to e4385e67 
Dealt to fcfd355a 
c3ca6759: raises $0.05 to $0.1
e4385e67: folds
fcfd355a: folds
826a79b4: folds
Hero: calls $0.08
ec0e24ed: folds
*** FLOP *** [2s Jh 9h]
Hero: checks
c3ca6759: checks
*** TURN *** [2s Jh 9h] [Jd]
Hero: checks
c3ca6759: checks
*** RIVER *** [2s Jh 9h Jd] [2d]
Hero: checks
c3ca6759: checks
Hero: shows [7h 6h] (Pair of Jacks and Pair of Twos)
c3ca6759: shows [3c 3h] (Pair of Jacks and Pair of Treys)
*** SHOWDOWN ***
c3ca6759 collected $0.24 from pot
*** SUMMARY ***
Total pot $0.25 | Rake $0.01 | Jackpot $0 | Bingo $0 | Fortune $0 | Tax $0
Board [2s Jh 9h Jd 2d]
Seat 1: 826a79b4 (button) folded before Flop (didn't bet)
Seat 2: Hero (small blind) showed [7h 6h] and lost with Pair of Jacks and Pair of Twos
Seat 3: ec0e24ed (big blind) folded before Flop
Seat 4: c3ca6759 showed [3c 3h] and won ($0.24) with Pair of Jacks and Pair of Treys
Seat 5: e4385e67 folded before Flop (didn't bet)
Seat 6: fcfd355a folded before Flop (didn't bet)


Poker Hand #RC3334596279: Hold'em No Limit ($0.02/$0.05) - 2025/02/17 21:37:26
Table 'RushAndCash631539' 6-max Seat #1 is the button
Seat 1: b0c3ff95 ($9.81 in chips)
Seat 2: 256d985c ($5.5 in chips)
Seat 3: c565c977 ($5.85 in chips)
Seat 4: Hero ($8.08 in chips)
Seat 5: 2aa9c26c ($5.45 in chips)
Seat 6: 981b7542 ($5.07 in chips)
256d985c: posts small blind $0.02
c565c977: posts big blind $0.05
*** HOLE CARDS ***
Dealt to b0c3ff95 
Dealt to 256d985c 
Dealt to c565c977 
Dealt to Hero [As Qs]
Dealt to 2aa9c26c 
Dealt to 981b7542 
Hero: raises $0.05 to $0.1
2aa9c26c: calls $0.1
981b7542: folds
b0c3ff95: folds
256d985c: folds
c565c977: calls $0.05
*** FLOP *** [2s 7s Kd]
c565c977: checks
Hero: bets $0.12
2aa9c26c: calls $0.12
c565c977: calls $0.12
*** TURN *** [2s 7s Kd] [8h]
c565c977: checks
Hero: checks
2aa9c26c: checks
*** RIVER *** [2s 7s Kd 8h] [Th]
c565c977: checks
Hero: checks
2aa9c26c: bets $0.34
c565c977: folds
Hero: folds
Uncalled bet ($0.34) returned to 2aa9c26c
*** SHOWDOWN ***
2aa9c26c collected $0.65 from pot
*** SUMMARY ***
Total pot $0.68 | Rake $0.03 | Jackpot $0 | Bingo $0 | Fortune $0 | Tax $0
Board [2s 7s Kd 8h Th]
Seat 1: b0c3ff95 (button) folded before Flop (didn't bet)
Seat 2: 256d985c (small blind) folded before Flop
Seat 3: c565c977 (big blind) folded on the River
Seat 4: Hero folded on the River
Seat 5: 2aa9c26c won ($0.65)
Seat 6: 981b7542 folded before Flop (didn't bet)


Poker Hand #RC3334596024: Hold'em No Limit ($0.02/$0.05) - 2025/02/17 21:36:54
Table 'RushAndCash631284' 6-max Seat #1 is the button
Seat 1: d917dee0 ($5.47 in chips)
Seat 2: 5c8c19b7 ($12.41 in chips)
Seat 3: Hero ($7.58 in chips)
Seat 4: 442376ec ($6.39 in chips)
Seat 5: bc8371cb ($5.1 in chips)
Seat 6: d11ba472 ($7.17 in chips)
5c8c19b7: posts small blind $0.02
Hero: posts big blind $0.05
*** HOLE CARDS ***
Dealt to d917dee0 
Dealt to 5c8c19b7 
Dealt to Hero [Qd 8d]
Dealt to 442376ec 
Dealt to bc8371cb 
Dealt to d11ba472 
442376ec: folds
bc8371cb: folds
d11ba472: folds
d917dee0: raises $0.12 to $0.17
5c8c19b7: folds
Hero: calls $0.12
*** FLOP *** [8c Qc Js]
Hero: checks
d917dee0: checks
*** TURN *** [8c Qc Js] [Ac]
Hero: checks
d917dee0: bets $0.36
Hero: calls $0.36
*** RIVER *** [8c Qc Js Ac] [Kd]
Hero: checks
d917dee0: checks
Hero: shows [Qd 8d] (Pair of Queens and Pair of Eights)
d917dee0: shows [3d 4h] (Ace-High)
*** SHOWDOWN ***
Hero collected $1.03 from pot
*** SUMMARY ***
Total pot $1.08 | Rake $0.05 | Jackpot $0 | Bingo $0 | Fortune $0 | Tax $0
Board [8c Qc Js Ac Kd]
Seat 1: d917dee0 (button) showed [3d 4h] and lost with Ace-High
Seat 2: 5c8c19b7 (small blind) folded before Flop
Seat 3: Hero (big blind) showed [Qd 8d] and won ($1.03) with Pair of Queens and Pair of Eights
Seat 4: 442376ec folded before Flop (didn't bet)
Seat 5: bc8371cb folded before Flop (didn't bet)
Seat 6: d11ba472 folded before Flop (didn't bet)


Poker Hand #RC3334595995: Hold'em No Limit ($0.02/$0.05) - 2025/02/17 21:36:51
Table 'RushAndCash631255' 6-max Seat #1 is the button
Seat 1: 719071b8 ($6.11 in chips)
Seat 2: 2808c418 ($5.08 in chips)
Seat 3: 49694b0f ($4.78 in chips)
Seat 4: 5c8c19b7 ($12.41 in chips)
Seat 5: 2bfd1d0c ($10.5 in chips)
Seat 6: Hero ($7.58 in chips)
2808c418: posts small blind $0.02
49694b0f: posts big blind $0.05
*** HOLE CARDS ***
Dealt to 719071b8 
Dealt to 2808c418 
Dealt to 49694b0f 
Dealt to 5c8c19b7 
Dealt to 2bfd1d0c 
Dealt to Hero [7s Kc]
5c8c19b7: folds
2bfd1d0c: folds
Hero: folds
719071b8: raises $0.06 to $0.11
2808c418: folds
49694b0f: folds
Uncalled bet ($0.06) returned to 719071b8
*** SHOWDOWN ***
719071b8 collected $0.12 from pot
*** SUMMARY ***
Total pot $0.12 | Rake $0 | Jackpot $0 | Bingo $0 | Fortune $0 | Tax $0
Seat 1: 719071b8 (button) collected ($0.12)
Seat 2: 2808c418 (small blind) folded before Flop
Seat 3: 49694b0f (big blind) folded before Flop
Seat 4: 5c8c19b7 folded before Flop (didn't bet)
Seat 5: 2bfd1d0c folded before Flop (didn't bet)
Seat 6: Hero folded before Flop (didn't bet)


Poker Hand #RC3334595970: Hold'em No Limit ($0.02/$0.05) - 2025/02/17 21:36:47
Table 'RushAndCash631230' 6-max Seat #1 is the button
Seat 1: 37bc5b77 ($5.11 in chips)
Seat 2: 100d4f9e ($4.79 in chips)
Seat 3: 1c0eec17 ($5.06 in chips)
Seat 4: c95c6ae6 ($15.31 in chips)
Seat 5: bacb67c8 ($9.56 in chips)
Seat 6: Hero ($7.58 in chips)
100d4f9e: posts small blind $0.02
1c0eec17: posts big blind $0.05
*** HOLE CARDS ***
Dealt to 37bc5b77 
Dealt to 100d4f9e 
Dealt to 1c0eec17 
Dealt to c95c6ae6 
Dealt to bacb67c8 
Dealt to Hero [Jh 2c]
c95c6ae6: raises $0.05 to $0.1
bacb67c8: folds
Hero: folds
37bc5b77: folds
100d4f9e: folds
1c0eec17: folds
Uncalled bet ($0.05) returned to c95c6ae6
*** SHOWDOWN ***
c95c6ae6 collected $0.12 from pot
*** SUMMARY ***
Total pot $0.12 | Rake $0 | Jackpot $0 | Bingo $0 | Fortune $0 | Tax $0
Seat 1: 37bc5b77 (button) folded before Flop (didn't bet)
Seat 2: 100d4f9e (small blind) folded before Flop
Seat 3: 1c0eec17 (big blind) folded before Flop
Seat 4: c95c6ae6 collected ($0.12)
Seat 5: bacb67c8 folded before Flop (didn't bet)
Seat 6: Hero folded before Flop (didn't bet)


Poker Hand #RC3334595943: Hold'em No Limit ($0.02/$0.05) - 2025/02/17 21:36:44
Table 'RushAndCash631203' 6-max Seat #1 is the button
Seat 1: 79d81faa ($7.55 in chips)
Seat 2: bacb67c8 ($9.58 in chips)
Seat 3: beffcf8a ($5.85 in chips)
Seat 4: 93056ee9 ($6.78 in chips)
Seat 5: Hero ($7.58 in chips)
Seat 6: f0463362 ($5.64 in chips)
bacb67c8: posts small blind $0.02
beffcf8a: posts big blind $0.05
*** HOLE CARDS ***
Dealt to 79d81faa 
Dealt to bacb67c8 
Dealt to beffcf8a 
Dealt to 93056ee9 
Dealt to Hero [Qs 6s]
Dealt to f0463362 
93056ee9: raises $0.15 to $0.2
Hero: folds
f0463362: folds
79d81faa: folds
bacb67c8: folds
beffcf8a: folds
Uncalled bet ($0.15) returned to 93056ee9
*** SHOWDOWN ***
93056ee9 collected $0.12 from pot
*** SUMMARY ***
Total pot $0.12 | Rake $0 | Jackpot $0 | Bingo $0 | Fortune $0 | Tax $0
Seat 1: 79d81faa (button) folded before Flop (didn't bet)
Seat 2: bacb67c8 (small blind) folded before Flop
Seat 3: beffcf8a (big blind) folded before Flop
Seat 4: 93056ee9 collected ($0.12)
Seat 5: Hero folded before Flop (didn't bet)
Seat 6: f0463362 folded before Flop (didn't bet)


Poker Hand #RC3334595454: Hold'em No Limit ($0.02/$0.05) - 2025/02/17 21:35:48
Table 'RushAndCash630714' 6-max Seat #1 is the button
Seat 1: Hero ($7.79 in chips)
Seat 2: 62fdcc3c ($5.95 in chips)
Seat 3: 93056ee9 ($6.88 in chips)
Seat 4: f9d64f1a ($5.42 in chips)
Seat 5: c7471beb ($5 in chips)
Seat 6: beffcf8a ($5.54 in chips)
62fdcc3c: posts small blind $0.02
93056ee9: posts big blind $0.05
*** HOLE CARDS ***
Dealt to Hero [9s Ts]
Dealt to 62fdcc3c 
Dealt to 93056ee9 
Dealt to f9d64f1a 
Dealt to c7471beb 
Dealt to beffcf8a 
f9d64f1a: folds
c7471beb: folds
beffcf8a: raises $0.05 to $0.1
Hero: calls $0.1
62fdcc3c: folds
93056ee9: calls $0.05
*** FLOP *** [5h Jc Qs]
93056ee9: checks
beffcf8a: bets $0.11
Hero: calls $0.11
93056ee9: folds
*** TURN *** [5h Jc Qs] [Qc]
beffcf8a: checks
Hero: checks
*** RIVER *** [5h Jc Qs Qc] [Ad]
beffcf8a: bets $0.36
Hero: folds
Uncalled bet ($0.36) returned to beffcf8a
*** SHOWDOWN ***
beffcf8a collected $0.52 from pot
*** SUMMARY ***
Total pot $0.54 | Rake $0.02 | Jackpot $0 | Bingo $0 | Fortune $0 | Tax $0
Board [5h Jc Qs Qc Ad]
Seat 1: Hero (button) folded on the River
Seat 2: 62fdcc3c (small blind) folded before Flop
Seat 3: 93056ee9 (big blind) folded on the Flop
Seat 4: f9d64f1a folded before Flop (didn't bet)
Seat 5: c7471beb folded before Flop (didn't bet)
Seat 6: beffcf8a won ($0.52)


Poker Hand #RC3334595419: Hold'em No Limit ($0.02/$0.05) - 2025/02/17 21:35:43
Table 'RushAndCash630679' 6-max Seat #1 is the button
Seat 1: Hero ($7.79 in chips)
Seat 2: db0f0c64 ($7.18 in chips)
Seat 3: f98823c7 ($6.59 in chips)
Seat 4: 6c641898 ($5 in chips)
Seat 5: beffcf8a ($5.54 in chips)
Seat 6: ab43c8b8 ($8.87 in chips)
db0f0c64: posts small blind $0.02
f98823c7: posts big blind $0.05
*** HOLE CARDS ***
Dealt to Hero [Kc 4d]
Dealt to db0f0c64 
Dealt to f98823c7 
Dealt to 6c641898 
Dealt to beffcf8a 
Dealt to ab43c8b8 
6c641898: folds
beffcf8a: folds
ab43c8b8: raises $0.05 to $0.1
Hero: folds
db0f0c64: folds
f98823c7: folds
Uncalled bet ($0.05) returned to ab43c8b8
*** SHOWDOWN ***
ab43c8b8 collected $0.12 from pot
*** SUMMARY ***
Total pot $0.12 | Rake $0 | Jackpot $0 | Bingo $0 | Fortune $0 | Tax $0
Seat 1: Hero (button) folded before Flop (didn't bet)
Seat 2: db0f0c64 (small blind) folded before Flop
Seat 3: f98823c7 (big blind) folded before Flop
Seat 4: 6c641898 folded before Flop (didn't bet)
Seat 5: beffcf8a folded before Flop (didn't bet)
Seat 6: ab43c8b8 collected ($0.12)


Poker Hand #RC3334595351: Hold'em No Limit ($0.02/$0.05) - 2025/02/17 21:35:35
Table 'RushAndCash630611' 6-max Seat #1 is the button
Seat 1: Hero ($7.79 in chips)
Seat 2: ca7c2b72 ($5.57 in chips)
Seat 3: 21bff972 ($8.07 in chips)
Seat 4: 92fd04c6 ($5.37 in chips)
Seat 5: 726ab14e ($6.59 in chips)
Seat 6: c4483bd8 ($4.78 in chips)
ca7c2b72: posts small blind $0.02
21bff972: posts big blind $0.05
*** HOLE CARDS ***
Dealt to Hero [3d Ks]
Dealt to ca7c2b72 
Dealt to 21bff972 
Dealt to 92fd04c6 
Dealt to 726ab14e 
Dealt to c4483bd8 
92fd04c6: raises $0.05 to $0.1
726ab14e: folds
c4483bd8: folds
Hero: folds
ca7c2b72: folds
21bff972: calls $0.05
*** FLOP *** [Jc 2h Kd]
21bff972: checks
92fd04c6: checks
*** TURN *** [Jc 2h Kd] [7c]
21bff972: bets $0.05
92fd04c6: folds
Uncalled bet ($0.05) returned to 21bff972
*** SHOWDOWN ***
21bff972 collected $0.21 from pot
*** SUMMARY ***
Total pot $0.22 | Rake $0.01 | Jackpot $0 | Bingo $0 | Fortune $0 | Tax $0
Board [Jc 2h Kd 7c]
Seat 1: Hero (button) folded before Flop (didn't bet)
Seat 2: ca7c2b72 (small blind) folded before Flop
Seat 3: 21bff972 (big blind) won ($0.21)
Seat 4: 92fd04c6 folded on the Turn
Seat 5: 726ab14e folded before Flop (didn't bet)
Seat 6: c4483bd8 folded before Flop (didn't bet)


Poker Hand #RC3334595324: Hold'em No Limit ($0.02/$0.05) - 2025/02/17 21:35:31
Table 'RushAndCash630584' 6-max Seat #1 is the button
Seat 1: 9c00bca7 ($5.11 in chips)
Seat 2: Hero ($7.81 in chips)
Seat 3: 91ad3969 ($9.31 in chips)
Seat 4: d42cee79 ($5 in chips)
Seat 5: aa5c1aba ($6 in chips)
Seat 6: 92fd04c6 ($5.37 in chips)
Hero: posts small blind $0.02
91ad3969: posts big blind $0.05
*** HOLE CARDS ***
Dealt to 9c00bca7 
Dealt to Hero [4s 6d]
Dealt to 91ad3969 
Dealt to d42cee79 
Dealt to aa5c1aba 
Dealt to 92fd04c6 
d42cee79: raises $0.08 to $0.13
aa5c1aba: folds
92fd04c6: folds
9c00bca7: folds
Hero: folds
91ad3969: calls $0.08
*** FLOP *** [4h 9d 6h]
91ad3969: checks
d42cee79: checks
*** TURN *** [4h 9d 6h] [8h]
91ad3969: checks
d42cee79: checks
*** RIVER *** [4h 9d 6h 8h] [3s]
91ad3969: bets $0.09
d42cee79: folds
Uncalled bet ($0.09) returned to 91ad3969
*** SHOWDOWN ***
91ad3969 collected $0.27 from pot
*** SUMMARY ***
Total pot $0.28 | Rake $0.01 | Jackpot $0 | Bingo $0 | Fortune $0 | Tax $0
Board [4h 9d 6h 8h 3s]
Seat 1: 9c00bca7 (button) folded before Flop (didn't bet)
Seat 2: Hero (small blind) folded before Flop
Seat 3: 91ad3969 (big blind) won ($0.27)
Seat 4: d42cee79 folded on the River
Seat 5: aa5c1aba folded before Flop (didn't bet)
Seat 6: 92fd04c6 folded before Flop (didn't bet)


Poker Hand #RC3334595062: Hold'em No Limit ($0.02/$0.05) - 2025/02/17 21:34:59
Table 'RushAndCash630322' 6-max Seat #1 is the button
Seat 1: b10195a2 ($5 in chips)
Seat 2: Hero ($7.84 in chips)
Seat 3: eb078c31 ($5.07 in chips)
Seat 4: a3b43a4c ($5.68 in chips)
Seat 5: 87205baf ($11.65 in chips)
Seat 6: 7b9ea1f3 ($5.45 in chips)
Hero: posts small blind $0.02
eb078c31: posts big blind $0.05
*** HOLE CARDS ***
Dealt to b10195a2 
Dealt to Hero [Qh Ks]
Dealt to eb078c31 
Dealt to a3b43a4c 
Dealt to 87205baf 
Dealt to 7b9ea1f3 
a3b43a4c: folds
87205baf: folds
7b9ea1f3: raises $0.05 to $0.1
b10195a2: folds
Hero: calls $0.08
eb078c31: calls $0.05
*** FLOP *** [4s 6c 5s]
Hero: checks
eb078c31: checks
7b9ea1f3: checks
*** TURN *** [4s 6c 5s] [Th]
Hero: checks
eb078c31: bets $0.2
7b9ea1f3: raises $0.37 to $0.57
Hero: folds
eb078c31: folds
Uncalled bet ($0.37) returned to 7b9ea1f3
*** SHOWDOWN ***
7b9ea1f3 collected $0.67 from pot
*** SUMMARY ***
Total pot $0.7 | Rake $0.03 | Jackpot $0 | Bingo $0 | Fortune $0 | Tax $0
Board [4s 6c 5s Th]
Seat 1: b10195a2 (button) folded before Flop (didn't bet)
Seat 2: Hero (small blind) folded on the Turn
Seat 3: eb078c31 (big blind) folded on the Turn
Seat 4: a3b43a4c folded before Flop (didn't bet)
Seat 5: 87205baf folded before Flop (didn't bet)
Seat 6: 7b9ea1f3 won ($0.67)


Poker Hand #RC3334595003: Hold'em No Limit ($0.02/$0.05) - 2025/02/17 21:34:53
Table 'RushAndCash630263' 6-max Seat #1 is the button
Seat 1: 692417ff ($11.85 in chips)
Seat 2: eed867f5 ($9.22 in chips)
Seat 3: Hero ($7.89 in chips)
Seat 4: 3f9611b6 ($4.73 in chips)
Seat 5: 34498263 ($5.53 in chips)
Seat 6: ad31dea3 ($5.37 in chips)
eed867f5: posts small blind $0.02
Hero: posts big blind $0.05
*** HOLE CARDS ***
Dealt to 692417ff 
Dealt to eed867f5 
Dealt to Hero [2d 3s]
Dealt to 3f9611b6 
Dealt to 34498263 
Dealt to ad31dea3 
3f9611b6: folds
34498263: folds
ad31dea3: folds
692417ff: folds
eed867f5: folds
Uncalled bet ($0.03) returned to Hero
*** SHOWDOWN ***
Hero collected $0.04 from pot
*** SUMMARY ***
Total pot $0.04 | Rake $0 | Jackpot $0 | Bingo $0 | Fortune $0 | Tax $0
Seat 1: 692417ff (button) folded before Flop (didn't bet)
Seat 2: eed867f5 (small blind) folded before Flop
Seat 3: Hero (big blind) collected ($0.04)
Seat 4: 3f9611b6 folded before Flop (didn't bet)
Seat 5: 34498263 folded before Flop (didn't bet)
Seat 6: ad31dea3 folded before Flop (didn't bet)


Poker Hand #RC3334594950: Hold'em No Limit ($0.02/$0.05) - 2025/02/17 21:34:47
Table 'RushAndCash630210' 6-max Seat #1 is the button
Seat 1: b0c3ff95 ($10.51 in chips)
Seat 2: 191b60c1 ($8.63 in chips)
Seat 3: 4afebef ($6.15 in chips)
Seat 4: 9013f95e ($8.74 in chips)
Seat 5: 38a4c833 ($10.85 in chips)
Seat 6: Hero ($7.89 in chips)
191b60c1: posts small blind $0.02
4afebef: posts big blind $0.05
*** HOLE CARDS ***
Dealt to b0c3ff95 
Dealt to 191b60c1 
Dealt to 4afebef 
Dealt to 9013f95e 
Dealt to 38a4c833 
Dealt to Hero [7h Qs]
9013f95e: folds
38a4c833: folds
Hero: folds
b0c3ff95: folds
191b60c1: raises $0.1 to $0.15
4afebef: raises $0.31 to $0.46
191b60c1: folds
Uncalled bet ($0.31) returned to 4afebef
*** SHOWDOWN ***
4afebef collected $0.29 from pot
*** SUMMARY ***
Total pot $0.3 | Rake $0.01 | Jackpot $0 | Bingo $0 | Fortune $0 | Tax $0
Seat 1: b0c3ff95 (button) folded before Flop (didn't bet)
Seat 2: 191b60c1 (small blind) folded before Flop
Seat 3: 4afebef (big blind) collected ($0.29)
Seat 4: 9013f95e folded before Flop (didn't bet)
Seat 5: 38a4c833 folded before Flop (didn't bet)
Seat 6: Hero folded before Flop (didn't bet)


Poker Hand #RC3334594915: Hold'em No Limit ($0.02/$0.05) - 2025/02/17 21:34:42
Table 'RushAndCash630175' 6-max Seat #1 is the button
Seat 1: 9babc997 ($6.46 in chips)
Seat 2: Hero ($7.91 in chips)
Seat 3: 9b7148f5 ($10.09 in chips)
Seat 4: 6d5fa70b ($5.34 in chips)
Seat 5: b262f9e1 ($8.76 in chips)
Seat 6: eb078c31 ($5 in chips)
Hero: posts small blind $0.02
9b7148f5: posts big blind $0.05
*** HOLE CARDS ***
Dealt to 9babc997 
Dealt to Hero [9s Jd]
Dealt to 9b7148f5 
Dealt to 6d5fa70b 
Dealt to b262f9e1 
Dealt to eb078c31 
6d5fa70b: folds
b262f9e1: raises $0.05 to $0.1
eb078c31: folds
9babc997: raises $0.23 to $0.33
Hero: folds
9b7148f5: folds
b262f9e1: folds
Uncalled bet ($0.23) returned to 9babc997
*** SHOWDOWN ***
9babc997 collected $0.26 from pot
*** SUMMARY ***
Total pot $0.27 | Rake $0.01 | Jackpot $0 | Bingo $0 | Fortune $0 | Tax $0
Seat 1: 9babc997 (button) collected ($0.26)
Seat 2: Hero (small blind) folded before Flop
Seat 3: 9b7148f5 (big blind) folded before Flop
Seat 4: 6d5fa70b folded before Flop (didn't bet)
Seat 5: b262f9e1 folded before Flop
Seat 6: eb078c31 folded before Flop (didn't bet)


Poker Hand #RC3334564548: Hold'em No Limit ($0.02/$0.05) - 2025/02/17 21:33:57
Table 'RushAndCash629808' 6-max Seat #1 is the button
Seat 1: 55630016 ($8.26 in chips)
Seat 2: 9b7148f5 ($9.9 in chips)
Seat 3: c582715a ($5.07 in chips)
Seat 4: 57a66aa7 ($7.86 in chips)
Seat 5: Hero ($8.01 in chips)
Seat 6: 88068d2c ($5.28 in chips)
9b7148f5: posts small blind $0.02
c582715a: posts big blind $0.05
*** HOLE CARDS ***
Dealt to 55630016 
Dealt to 9b7148f5 
Dealt to c582715a 
Dealt to 57a66aa7 
Dealt to Hero [6s 5s]
Dealt to 88068d2c 
57a66aa7: folds
Hero: raises $0.05 to $0.1
88068d2c: folds
55630016: folds
9b7148f5: calls $0.08
c582715a: calls $0.05
*** FLOP *** [Jd Ad Jc]
9b7148f5: checks
c582715a: checks
Hero: checks
*** TURN *** [Jd Ad Jc] [Js]
9b7148f5: checks
c582715a: checks
Hero: checks
*** RIVER *** [Jd Ad Jc Js] [3c]
9b7148f5: checks
c582715a: checks
Hero: checks
9b7148f5: shows [Ts Ks] (Three Jacks)
c582715a: shows [Tc Qd] (Three Jacks)
Hero: shows [6s 5s] (Three Jacks)
*** SHOWDOWN ***
9b7148f5 collected $0.29 from pot
*** SUMMARY ***
Total pot $0.3 | Rake $0.01 | Jackpot $0 | Bingo $0 | Fortune $0 | Tax $0
Board [Jd Ad Jc Js 3c]
Seat 1: 55630016 (button) folded before Flop (didn't bet)
Seat 2: 9b7148f5 (small blind) showed [Ts Ks] and won ($0.29) with Three Jacks
Seat 3: c582715a (big blind) showed [Tc Qd] and lost with Three Jacks
Seat 4: 57a66aa7 folded before Flop (didn't bet)
Seat 5: Hero showed [6s 5s] and lost with Three Jacks
Seat 6: 88068d2c folded before Flop (didn't bet)


Poker Hand #RC3334564521: Hold'em No Limit ($0.02/$0.05) - 2025/02/17 21:33:54
Table 'RushAndCash629781' 6-max Seat #1 is the button
Seat 1: 981b7542 ($5 in chips)
Seat 2: 4fa289e4 ($6.01 in chips)
Seat 3: 6c1c4416 ($12.32 in chips)
Seat 4: 3eaff3e7 ($4.56 in chips)
Seat 5: Hero ($8.01 in chips)
Seat 6: 191b60c1 ($8.42 in chips)
4fa289e4: posts small blind $0.02
6c1c4416: posts big blind $0.05
*** HOLE CARDS ***
Dealt to 981b7542 
Dealt to 4fa289e4 
Dealt to 6c1c4416 
Dealt to 3eaff3e7 
Dealt to Hero [3s 4d]
Dealt to 191b60c1 
3eaff3e7: folds
Hero: folds
191b60c1: raises $0.07 to $0.12
981b7542: folds
4fa289e4: folds
6c1c4416: calls $0.07
*** FLOP *** [Ad 7h Kh]
6c1c4416: bets $0.09
191b60c1: raises $0.45 to $0.54
6c1c4416: folds
Uncalled bet ($0.45) returned to 191b60c1
*** SHOWDOWN ***
191b60c1 collected $0.42 from pot
*** SUMMARY ***
Total pot $0.44 | Rake $0.02 | Jackpot $0 | Bingo $0 | Fortune $0 | Tax $0
Board [Ad 7h Kh]
Seat 1: 981b7542 (button) folded before Flop (didn't bet)
Seat 2: 4fa289e4 (small blind) folded before Flop
Seat 3: 6c1c4416 (big blind) folded on the Flop
Seat 4: 3eaff3e7 folded before Flop (didn't bet)
Seat 5: Hero folded before Flop (didn't bet)
Seat 6: 191b60c1 won ($0.42)


Poker Hand #RC3334564486: Hold'em No Limit ($0.02/$0.05) - 2025/02/17 21:33:49
Table 'RushAndCash629746' 6-max Seat #1 is the button
Seat 1: 89bcbb95 ($9.66 in chips)
Seat 2: 9dd1ff39 ($5.19 in chips)
Seat 3: Hero ($8.06 in chips)
Seat 4: dbb7a28 ($10.29 in chips)
Seat 5: 9c1c8cec ($4.8 in chips)
Seat 6: e8992002 ($17.24 in chips)
9dd1ff39: posts small blind $0.02
Hero: posts big blind $0.05
*** HOLE CARDS ***
Dealt to 89bcbb95 
Dealt to 9dd1ff39 
Dealt to Hero [7d 2d]
Dealt to dbb7a28 
Dealt to 9c1c8cec 
Dealt to e8992002 
dbb7a28: folds
9c1c8cec: calls $0.05
e8992002: folds
89bcbb95: folds
9dd1ff39: folds
Hero: checks
*** FLOP *** [6s 3s Td]
Hero: checks
9c1c8cec: bets $0.05
Hero: folds
Uncalled bet ($0.05) returned to 9c1c8cec
*** SHOWDOWN ***
9c1c8cec collected $0.12 from pot
*** SUMMARY ***
Total pot $0.12 | Rake $0 | Jackpot $0 | Bingo $0 | Fortune $0 | Tax $0
Board [6s 3s Td]
Seat 1: 89bcbb95 (button) folded before Flop (didn't bet)
Seat 2: 9dd1ff39 (small blind) folded before Flop
Seat 3: Hero (big blind) folded on the Flop
Seat 4: dbb7a28 folded before Flop (didn't bet)
Seat 5: 9c1c8cec won ($0.12)
Seat 6: e8992002 folded before Flop (didn't bet)


Poker Hand #RC3334564456: Hold'em No Limit ($0.02/$0.05) - 2025/02/17 21:33:46
Table 'RushAndCash629716' 6-max Seat #1 is the button
Seat 1: 24aff26b ($9.41 in chips)
Seat 2: 3d4f4b4c ($5 in chips)
Seat 3: 34028f01 ($9.35 in chips)
Seat 4: 229ec9a7 ($8.42 in chips)
Seat 5: Hero ($8.06 in chips)
Seat 6: b0c3ff95 ($10.32 in chips)
3d4f4b4c: posts small blind $0.02
34028f01: posts big blind $0.05
*** HOLE CARDS ***
Dealt to 24aff26b 
Dealt to 3d4f4b4c 
Dealt to 34028f01 
Dealt to 229ec9a7 
Dealt to Hero [5c 7h]
Dealt to b0c3ff95 
229ec9a7: folds
Hero: folds
b0c3ff95: folds
24aff26b: folds
3d4f4b4c: folds
Uncalled bet ($0.03) returned to 34028f01
*** SHOWDOWN ***
34028f01 collected $0.04 from pot
*** SUMMARY ***
Total pot $0.04 | Rake $0 | Jackpot $0 | Bingo $0 | Fortune $0 | Tax $0
Seat 1: 24aff26b (button) folded before Flop (didn't bet)
Seat 2: 3d4f4b4c (small blind) folded before Flop
Seat 3: 34028f01 (big blind) collected ($0.04)
Seat 4: 229ec9a7 folded before Flop (didn't bet)
Seat 5: Hero folded before Flop (didn't bet)
Seat 6: b0c3ff95 folded before Flop (didn't bet)


Poker Hand #RC3334564426: Hold'em No Limit ($0.02/$0.05) - 2025/02/17 21:33:42
Table 'RushAndCash629686' 6-max Seat #1 is the button
Seat 1: 229ec9a7 ($8.42 in chips)
Seat 2: 3b701823 ($5 in chips)
Seat 3: c7197736 ($8.16 in chips)
Seat 4: 50b3f230 ($5.07 in chips)
Seat 5: Hero ($8.06 in chips)
Seat 6: ef8af083 ($5.02 in chips)
3b701823: posts small blind $0.02
c7197736: posts big blind $0.05
*** HOLE CARDS ***
Dealt to 229ec9a7 
Dealt to 3b701823 
Dealt to c7197736 
Dealt to 50b3f230 
Dealt to Hero [5s 9c]
Dealt to ef8af083 
50b3f230: raises $0.05 to $0.1
Hero: folds
ef8af083: folds
229ec9a7: folds
3b701823: folds
c7197736: folds
Uncalled bet ($0.05) returned to 50b3f230
*** SHOWDOWN ***
50b3f230 collected $0.12 from pot
*** SUMMARY ***
Total pot $0.12 | Rake $0 | Jackpot $0 | Bingo $0 | Fortune $0 | Tax $0
Seat 1: 229ec9a7 (button) folded before Flop (didn't bet)
Seat 2: 3b701823 (small blind) folded before Flop
Seat 3: c7197736 (big blind) folded before Flop
Seat 4: 50b3f230 collected ($0.12)
Seat 5: Hero folded before Flop (didn't bet)
Seat 6: ef8af083 folded before Flop (didn't bet)


Poker Hand #RC3334564396: Hold'em No Limit ($0.02/$0.05) - 2025/02/17 21:33:39
Table 'RushAndCash629656' 6-max Seat #1 is the button
Seat 1: Hero ($8.06 in chips)
Seat 2: f9d64f1a ($5.58 in chips)
Seat 3: e3b51b04 ($11.53 in chips)
Seat 4: b28541cc ($5.66 in chips)
Seat 5: 1662188f ($5 in chips)
Seat 6: f0600331 ($9.34 in chips)
f9d64f1a: posts small blind $0.02
e3b51b04: posts big blind $0.05
*** HOLE CARDS ***
Dealt to Hero [8h 3d]
Dealt to f9d64f1a 
Dealt to e3b51b04 
Dealt to b28541cc 
Dealt to 1662188f 
Dealt to f0600331 
b28541cc: folds
1662188f: folds
f0600331: folds
Hero: folds
f9d64f1a: folds
Uncalled bet ($0.03) returned to e3b51b04
*** SHOWDOWN ***
e3b51b04 collected $0.04 from pot
*** SUMMARY ***
Total pot $0.04 | Rake $0 | Jackpot $0 | Bingo $0 | Fortune $0 | Tax $0
Seat 1: Hero (button) folded before Flop (didn't bet)
Seat 2: f9d64f1a (small blind) folded before Flop
Seat 3: e3b51b04 (big blind) collected ($0.04)
Seat 4: b28541cc folded before Flop (didn't bet)
Seat 5: 1662188f folded before Flop (didn't bet)
Seat 6: f0600331 folded before Flop (didn't bet)


Poker Hand #RC3334564364: Hold'em No Limit ($0.02/$0.05) - 2025/02/17 21:33:35
Table 'RushAndCash629624' 6-max Seat #1 is the button
Seat 1: 787e1958 ($5.41 in chips)
Seat 2: b28541cc ($5.68 in chips)
Seat 3: a81aa4e3 ($5.42 in chips)
Seat 4: 1fa8537 ($8.91 in chips)
Seat 5: Hero ($8.06 in chips)
Seat 6: 33554b00 ($5 in chips)
b28541cc: posts small blind $0.02
a81aa4e3: posts big blind $0.05
*** HOLE CARDS ***
Dealt to 787e1958 
Dealt to b28541cc 
Dealt to a81aa4e3 
Dealt to 1fa8537 
Dealt to Hero [Jc 7s]
Dealt to 33554b00 
1fa8537: raises $0.06 to $0.11
Hero: folds
33554b00: folds
787e1958: folds
b28541cc: folds
a81aa4e3: folds
Uncalled bet ($0.06) returned to 1fa8537
*** SHOWDOWN ***
1fa8537 collected $0.12 from pot
*** SUMMARY ***
Total pot $0.12 | Rake $0 | Jackpot $0 | Bingo $0 | Fortune $0 | Tax $0
Seat 1: 787e1958 (button) folded before Flop (didn't bet)
Seat 2: b28541cc (small blind) folded before Flop
Seat 3: a81aa4e3 (big blind) folded before Flop
Seat 4: 1fa8537 collected ($0.12)
Seat 5: Hero folded before Flop (didn't bet)
Seat 6: 33554b00 folded before Flop (didn't bet)


Poker Hand #RC3334564336: Hold'em No Limit ($0.02/$0.05) - 2025/02/17 21:33:32
Table 'RushAndCash629596' 6-max Seat #1 is the button
Seat 1: cda83b9b ($5.6 in chips)
Seat 2: 223a5c5d ($5.07 in chips)
Seat 3: Hero ($8.11 in chips)
Seat 4: abef7df7 ($1 in chips)
Seat 5: 4fa289e4 ($5.94 in chips)
Seat 6: 72b3f81 ($5.05 in chips)
223a5c5d: posts small blind $0.02
Hero: posts big blind $0.05
*** HOLE CARDS ***
Dealt to cda83b9b 
Dealt to 223a5c5d 
Dealt to Hero [2c Td]
Dealt to abef7df7 
Dealt to 4fa289e4 
Dealt to 72b3f81 
abef7df7: folds
4fa289e4: raises $0.05 to $0.1
72b3f81: folds
cda83b9b: folds
223a5c5d: folds
Hero: folds
Uncalled bet ($0.05) returned to 4fa289e4
*** SHOWDOWN ***
4fa289e4 collected $0.12 from pot
*** SUMMARY ***
Total pot $0.12 | Rake $0 | Jackpot $0 | Bingo $0 | Fortune $0 | Tax $0
Seat 1: cda83b9b (button) folded before Flop (didn't bet)
Seat 2: 223a5c5d (small blind) folded before Flop
Seat 3: Hero (big blind) folded before Flop
Seat 4: abef7df7 folded before Flop (didn't bet)
Seat 5: 4fa289e4 collected ($0.12)
Seat 6: 72b3f81 folded before Flop (didn't bet)


Poker Hand #RC3334564291: Hold'em No Limit ($0.02/$0.05) - 2025/02/17 21:33:27
Table 'RushAndCash629551' 6-max Seat #1 is the button
Seat 1: 4305bf97 ($5.19 in chips)
Seat 2: f23a8d23 ($5.77 in chips)
Seat 3: eae3d655 ($5.24 in chips)
Seat 4: 33b2f32d ($5 in chips)
Seat 5: Hero ($8.11 in chips)
Seat 6: 988dc015 ($9.33 in chips)
f23a8d23: posts small blind $0.02
eae3d655: posts big blind $0.05
*** HOLE CARDS ***
Dealt to 4305bf97 
Dealt to f23a8d23 
Dealt to eae3d655 
Dealt to 33b2f32d 
Dealt to Hero [Jh Td]
Dealt to 988dc015 
33b2f32d: folds
Hero: folds
988dc015: folds
4305bf97: raises $0.06 to $0.11
f23a8d23: folds
eae3d655: folds
Uncalled bet ($0.06) returned to 4305bf97
*** SHOWDOWN ***
4305bf97 collected $0.12 from pot
*** SUMMARY ***
Total pot $0.12 | Rake $0 | Jackpot $0 | Bingo $0 | Fortune $0 | Tax $0
Seat 1: 4305bf97 (button) collected ($0.12)
Seat 2: f23a8d23 (small blind) folded before Flop
Seat 3: eae3d655 (big blind) folded before Flop
Seat 4: 33b2f32d folded before Flop (didn't bet)
Seat 5: Hero folded before Flop (didn't bet)
Seat 6: 988dc015 folded before Flop (didn't bet)


Poker Hand #RC3334564014: Hold'em No Limit ($0.02/$0.05) - 2025/02/17 21:32:55
Table 'RushAndCash629274' 6-max Seat #1 is the button
Seat 1: 988dc015 ($9.4 in chips)
Seat 2: e5fa3450 ($6.04 in chips)
Seat 3: f23a8d23 ($5.66 in chips)
Seat 4: Hero ($8.21 in chips)
Seat 5: f4ed7f83 ($5 in chips)
Seat 6: a3b43a4c ($5.83 in chips)
e5fa3450: posts small blind $0.02
f23a8d23: posts big blind $0.05
*** HOLE CARDS ***
Dealt to 988dc015 
Dealt to e5fa3450 
Dealt to f23a8d23 
Dealt to Hero [7s 7d]
Dealt to f4ed7f83 
Dealt to a3b43a4c 
Hero: raises $0.05 to $0.1
f4ed7f83: folds
a3b43a4c: folds
988dc015: folds
e5fa3450: folds
f23a8d23: raises $0.5 to $0.6
Hero: folds
Uncalled bet ($0.5) returned to f23a8d23
*** SHOWDOWN ***
f23a8d23 collected $0.21 from pot
*** SUMMARY ***
Total pot $0.22 | Rake $0.01 | Jackpot $0 | Bingo $0 | Fortune $0 | Tax $0
Seat 1: 988dc015 (button) folded before Flop (didn't bet)
Seat 2: e5fa3450 (small blind) folded before Flop
Seat 3: f23a8d23 (big blind) collected ($0.21)
Seat 4: Hero folded before Flop
Seat 5: f4ed7f83 folded before Flop (didn't bet)
Seat 6: a3b43a4c folded before Flop (didn't bet)


Poker Hand #RC3334563985: Hold'em No Limit ($0.02/$0.05) - 2025/02/17 21:32:52
Table 'RushAndCash629245' 6-max Seat #1 is the button
Seat 1: 6d5fa70b ($5.44 in chips)
Seat 2: 57a66aa7 ($8 in chips)
Seat 3: b5e885d5 ($5 in chips)
Seat 4: Hero ($8.21 in chips)
Seat 5: 96564827 ($5.44 in chips)
Seat 6: ac140cb9 ($5 in chips)
57a66aa7: posts small blind $0.02
b5e885d5: posts big blind $0.05
*** HOLE CARDS ***
Dealt to 6d5fa70b 
Dealt to 57a66aa7 
Dealt to b5e885d5 
Dealt to Hero [4c Jc]
Dealt to 96564827 
Dealt to ac140cb9 
Hero: folds
96564827: folds
ac140cb9: folds
6d5fa70b: folds
57a66aa7: folds
Uncalled bet ($0.03) returned to b5e885d5
*** SHOWDOWN ***
b5e885d5 collected $0.04 from pot
*** SUMMARY ***
Total pot $0.04 | Rake $0 | Jackpot $0 | Bingo $0 | Fortune $0 | Tax $0
Seat 1: 6d5fa70b (button) folded before Flop (didn't bet)
Seat 2: 57a66aa7 (small blind) folded before Flop
Seat 3: b5e885d5 (big blind) collected ($0.04)
Seat 4: Hero folded before Flop (didn't bet)
Seat 5: 96564827 folded before Flop (didn't bet)
Seat 6: ac140cb9 folded before Flop (didn't bet)


Poker Hand #RC3334563957: Hold'em No Limit ($0.02/$0.05) - 2025/02/17 21:32:48
Table 'RushAndCash629217' 6-max Seat #1 is the button
Seat 1: 5381eb4c ($6.76 in chips)
Seat 2: 42fdd5b8 ($5 in chips)
Seat 3: 9b09147b ($7.1 in chips)
Seat 4: b4cd57cf ($5.8 in chips)
Seat 5: a8c71cd6 ($5 in chips)
Seat 6: Hero ($8.21 in chips)
42fdd5b8: posts small blind $0.02
9b09147b: posts big blind $0.05
*** HOLE CARDS ***
Dealt to 5381eb4c 
Dealt to 42fdd5b8 
Dealt to 9b09147b 
Dealt to b4cd57cf 
Dealt to a8c71cd6 
Dealt to Hero [3s Ac]
b4cd57cf: folds
a8c71cd6: folds
Hero: folds
5381eb4c: raises $0.08 to $0.13
42fdd5b8: folds
9b09147b: calls $0.08
*** FLOP *** [Tc Qc 8c]
9b09147b: checks
5381eb4c: bets $0.21
9b09147b: calls $0.21
*** TURN *** [Tc Qc 8c] [4c]
9b09147b: checks
5381eb4c: checks
*** RIVER *** [Tc Qc 8c 4c] [Ks]
9b09147b: checks
5381eb4c: checks
9b09147b: shows [6d Qd] (Pair of Queens)
5381eb4c: shows [Js 9h] (Kings-High Straight)
*** SHOWDOWN ***
5381eb4c collected $0.67 from pot
*** SUMMARY ***
Total pot $0.7 | Rake $0.03 | Jackpot $0 | Bingo $0 | Fortune $0 | Tax $0
Board [Tc Qc 8c 4c Ks]
Seat 1: 5381eb4c (button) showed [Js 9h] and won ($0.67) with Kings-High Straight
Seat 2: 42fdd5b8 (small blind) folded before Flop
Seat 3: 9b09147b (big blind) showed [6d Qd] and lost with Pair of Queens
Seat 4: b4cd57cf folded before Flop (didn't bet)
Seat 5: a8c71cd6 folded before Flop (didn't bet)
Seat 6: Hero folded before Flop (didn't bet)


Poker Hand #RC3334563929: Hold'em No Limit ($0.02/$0.05) - 2025/02/17 21:32:45
Table 'RushAndCash629189' 6-max Seat #1 is the button
Seat 1: 717e9861 ($5.6 in chips)
Seat 2: 2e8ab509 ($6.38 in chips)
Seat 3: 65e854ab ($5.97 in chips)
Seat 4: 730098b8 ($6.15 in chips)
Seat 5: Hero ($8.21 in chips)
Seat 6: 19259657 ($6.93 in chips)
2e8ab509: posts small blind $0.02
65e854ab: posts big blind $0.05
*** HOLE CARDS ***
Dealt to 717e9861 
Dealt to 2e8ab509 
Dealt to 65e854ab 
Dealt to 730098b8 
Dealt to Hero [2s As]
Dealt to 19259657 
730098b8: folds
Hero: folds
19259657: raises $0.05 to $0.1
717e9861: folds
2e8ab509: raises $0.35 to $0.45
65e854ab: folds
19259657: folds
Uncalled bet ($0.35) returned to 2e8ab509
*** SHOWDOWN ***
2e8ab509 collected $0.24 from pot
*** SUMMARY ***
Total pot $0.25 | Rake $0.01 | Jackpot $0 | Bingo $0 | Fortune $0 | Tax $0
Seat 1: 717e9861 (button) folded before Flop (didn't bet)
Seat 2: 2e8ab509 (small blind) collected ($0.24)
Seat 3: 65e854ab (big blind) folded before Flop
Seat 4: 730098b8 folded before Flop (didn't bet)
Seat 5: Hero folded before Flop (didn't bet)
Seat 6: 19259657 folded before Flop


Poker Hand #RC3334563886: Hold'em No Limit ($0.02/$0.05) - 2025/02/17 21:32:40
Table 'RushAndCash629146' 6-max Seat #1 is the button
Seat 1: 39c237fe ($2.48 in chips)
Seat 2: Hero ($8.23 in chips)
Seat 3: b66c51bb ($5.52 in chips)
Seat 4: dad15618 ($3.3 in chips)
Seat 5: 4238ab48 ($7.73 in chips)
Seat 6: 5e2a2694 ($5.86 in chips)
Hero: posts small blind $0.02
b66c51bb: posts big blind $0.05
*** HOLE CARDS ***
Dealt to 39c237fe 
Dealt to Hero [Ad 4d]
Dealt to b66c51bb 
Dealt to dad15618 
Dealt to 4238ab48 
Dealt to 5e2a2694 
dad15618: raises $0.05 to $0.1
4238ab48: folds
5e2a2694: folds
39c237fe: folds
Hero: folds
b66c51bb: folds
Uncalled bet ($0.05) returned to dad15618
*** SHOWDOWN ***
dad15618 collected $0.12 from pot
*** SUMMARY ***
Total pot $0.12 | Rake $0 | Jackpot $0 | Bingo $0 | Fortune $0 | Tax $0
Seat 1: 39c237fe (button) folded before Flop (didn't bet)
Seat 2: Hero (small blind) folded before Flop
Seat 3: b66c51bb (big blind) folded before Flop
Seat 4: dad15618 collected ($0.12)
Seat 5: 4238ab48 folded before Flop (didn't bet)
Seat 6: 5e2a2694 folded before Flop (didn't bet)


Poker Hand #RC3334563855: Hold'em No Limit ($0.02/$0.05) - 2025/02/17 21:32:36
Table 'RushAndCash629115' 6-max Seat #1 is the button
Seat 1: 577aa3d3 ($9.84 in chips)
Seat 2: Hero ($8.25 in chips)
Seat 3: 87afea2d ($5.39 in chips)
Seat 4: 5f0ff48e ($5.83 in chips)
Seat 5: 67b2dab9 ($6.38 in chips)
Seat 6: b144f063 ($7.43 in chips)
Hero: posts small blind $0.02
87afea2d: posts big blind $0.05
*** HOLE CARDS ***
Dealt to 577aa3d3 
Dealt to Hero [6s Qh]
Dealt to 87afea2d 
Dealt to 5f0ff48e 
Dealt to 67b2dab9 
Dealt to b144f063 
5f0ff48e: folds
67b2dab9: folds
b144f063: folds
577aa3d3: folds
Hero: folds
Uncalled bet ($0.03) returned to 87afea2d
*** SHOWDOWN ***
87afea2d collected $0.04 from pot
*** SUMMARY ***
Total pot $0.04 | Rake $0 | Jackpot $0 | Bingo $0 | Fortune $0 | Tax $0
Seat 1: 577aa3d3 (button) folded before Flop (didn't bet)
Seat 2: Hero (small blind) folded before Flop
Seat 3: 87afea2d (big blind) collected ($0.04)
Seat 4: 5f0ff48e folded before Flop (didn't bet)
Seat 5: 67b2dab9 folded before Flop (didn't bet)
Seat 6: b144f063 folded before Flop (didn't bet)


Poker Hand #RC3334563661: Hold'em No Limit ($0.02/$0.05) - 2025/02/17 21:32:12
Table 'RushAndCash628921' 6-max Seat #1 is the button
Seat 1: b9ae439d ($6.16 in chips)
Seat 2: f6efd55a ($9.13 in chips)
Seat 3: Hero ($8.37 in chips)
Seat 4: a223d3ca ($5.07 in chips)
Seat 5: 21e0e4ee ($5.22 in chips)
Seat 6: c7e9103c ($11.88 in chips)
f6efd55a: posts small blind $0.02
Hero: posts big blind $0.05
*** HOLE CARDS ***
Dealt to b9ae439d 
Dealt to f6efd55a 
Dealt to Hero [3c Ac]
Dealt to a223d3ca 
Dealt to 21e0e4ee 
Dealt to c7e9103c 
a223d3ca: folds
21e0e4ee: raises $0.07 to $0.12
c7e9103c: folds
b9ae439d: folds
f6efd55a: folds
Hero: calls $0.07
*** FLOP *** [Qs 2s Qh]
Hero: checks
21e0e4ee: checks
*** TURN *** [Qs 2s Qh] [9s]
Hero: checks
21e0e4ee: bets $0.15
Hero: folds
Uncalled bet ($0.15) returned to 21e0e4ee
*** SHOWDOWN ***
21e0e4ee collected $0.25 from pot
*** SUMMARY ***
Total pot $0.26 | Rake $0.01 | Jackpot $0 | Bingo $0 | Fortune $0 | Tax $0
Board [Qs 2s Qh 9s]
Seat 1: b9ae439d (button) folded before Flop (didn't bet)
Seat 2: f6efd55a (small blind) folded before Flop
Seat 3: Hero (big blind) folded on the Turn
Seat 4: a223d3ca folded before Flop (didn't bet)
Seat 5: 21e0e4ee won ($0.25)
Seat 6: c7e9103c folded before Flop (didn't bet)


Poker Hand #RC3334563239: Hold'em No Limit ($0.02/$0.05) - 2025/02/17 21:31:23
Table 'RushAndCash628499' 6-max Seat #1 is the button
Seat 1: Hero ($8.73 in chips)
Seat 2: 9b09147b ($7.25 in chips)
Seat 3: 8c3789e ($6.38 in chips)
Seat 4: ad40d3d9 ($7.89 in chips)
Seat 5: 44b5c3bb ($5 in chips)
Seat 6: 86fb354d ($5.52 in chips)
9b09147b: posts small blind $0.02
8c3789e: posts big blind $0.05
*** HOLE CARDS ***
Dealt to Hero [9c 9h]
Dealt to 9b09147b 
Dealt to 8c3789e 
Dealt to ad40d3d9 
Dealt to 44b5c3bb 
Dealt to 86fb354d 
ad40d3d9: folds
44b5c3bb: raises $0.08 to $0.13
86fb354d: calls $0.13
Hero: calls $0.13
9b09147b: folds
8c3789e: folds
*** FLOP *** [9s Ts 8c]
44b5c3bb: checks
86fb354d: bets $0.23
Hero: calls $0.23
44b5c3bb: calls $0.23
*** TURN *** [9s Ts 8c] [7h]
44b5c3bb: checks
86fb354d: checks
Hero: checks
*** RIVER *** [9s Ts 8c 7h] [4c]
44b5c3bb: checks
86fb354d: bets $0.38
Hero: folds
44b5c3bb: folds
Uncalled bet ($0.38) returned to 86fb354d
*** SHOWDOWN ***
86fb354d collected $1.1 from pot
*** SUMMARY ***
Total pot $1.15 | Rake $0.05 | Jackpot $0 | Bingo $0 | Fortune $0 | Tax $0
Board [9s Ts 8c 7h 4c]
Seat 1: Hero (button) folded on the River
Seat 2: 9b09147b (small blind) folded before Flop
Seat 3: 8c3789e (big blind) folded before Flop
Seat 4: ad40d3d9 folded before Flop (didn't bet)
Seat 5: 44b5c3bb folded on the River
Seat 6: 86fb354d won ($1.1)


Poker Hand #RC3334563147: Hold'em No Limit ($0.02/$0.05) - 2025/02/17 21:31:13
Table 'RushAndCash628407' 6-max Seat #1 is the button
Seat 1: Hero ($8.73 in chips)
Seat 2: a73946fe ($7.18 in chips)
Seat 3: 5c8c19b7 ($13.89 in chips)
Seat 4: 8c8bf19e ($5.11 in chips)
Seat 5: 33554b00 ($5.07 in chips)
Seat 6: 866d801a ($5 in chips)
a73946fe: posts small blind $0.02
5c8c19b7: posts big blind $0.05
*** HOLE CARDS ***
Dealt to Hero [8c 6c]
Dealt to a73946fe 
Dealt to 5c8c19b7 
Dealt to 8c8bf19e 
Dealt to 33554b00 
Dealt to 866d801a 
8c8bf19e: folds
33554b00: raises $0.1 to $0.15
866d801a: folds
Hero: folds
a73946fe: folds
5c8c19b7: folds
Uncalled bet ($0.1) returned to 33554b00
*** SHOWDOWN ***
33554b00 collected $0.12 from pot
*** SUMMARY ***
Total pot $0.12 | Rake $0 | Jackpot $0 | Bingo $0 | Fortune $0 | Tax $0
Seat 1: Hero (button) folded before Flop (didn't bet)
Seat 2: a73946fe (small blind) folded before Flop
Seat 3: 5c8c19b7 (big blind) folded before Flop
Seat 4: 8c8bf19e folded before Flop (didn't bet)
Seat 5: 33554b00 collected ($0.12)
Seat 6: 866d801a folded before Flop (didn't bet)


Poker Hand #RC3334563117: Hold'em No Limit ($0.02/$0.05) - 2025/02/17 21:31:09
Table 'RushAndCash628377' 6-max Seat #1 is the button
Seat 1: c6158c9d ($5 in chips)
Seat 2: 3ed1e77f ($5.64 in chips)
Seat 3: d201e5fe ($8.48 in chips)
Seat 4: 33554b00 ($5.07 in chips)
Seat 5: Hero ($8.73 in chips)
Seat 6: 39c237fe ($2.13 in chips)
3ed1e77f: posts small blind $0.02
d201e5fe: posts big blind $0.05
*** HOLE CARDS ***
Dealt to c6158c9d 
Dealt to 3ed1e77f 
Dealt to d201e5fe 
Dealt to 33554b00 
Dealt to Hero [7d Qh]
Dealt to 39c237fe 
33554b00: folds
Hero: folds
39c237fe: folds
c6158c9d: folds
3ed1e77f: raises $0.1 to $0.15
d201e5fe: folds
Uncalled bet ($0.1) returned to 3ed1e77f
*** SHOWDOWN ***
3ed1e77f collected $0.1 from pot
*** SUMMARY ***
Total pot $0.1 | Rake $0 | Jackpot $0 | Bingo $0 | Fortune $0 | Tax $0
Seat 1: c6158c9d (button) folded before Flop (didn't bet)
Seat 2: 3ed1e77f (small blind) collected ($0.1)
Seat 3: d201e5fe (big blind) folded before Flop
Seat 4: 33554b00 folded before Flop (didn't bet)
Seat 5: Hero folded before Flop (didn't bet)
Seat 6: 39c237fe folded before Flop (didn't bet)


Poker Hand #RC3334563081: Hold'em No Limit ($0.02/$0.05) - 2025/02/17 21:31:05
Table 'RushAndCash628341' 6-max Seat #1 is the button
Seat 1: edbb0bb6 ($5.1 in chips)
Seat 2: ad31dea3 ($5.11 in chips)
Seat 3: beffcf8a ($5.35 in chips)
Seat 4: b2f44cb6 ($10.59 in chips)
Seat 5: Hero ($8.73 in chips)
Seat 6: a28ca95c ($27.61 in chips)
ad31dea3: posts small blind $0.02
beffcf8a: posts big blind $0.05
*** HOLE CARDS ***
Dealt to edbb0bb6 
Dealt to ad31dea3 
Dealt to beffcf8a 
Dealt to b2f44cb6 
Dealt to Hero [7h Kd]
Dealt to a28ca95c 
b2f44cb6: folds
Hero: folds
a28ca95c: folds
edbb0bb6: folds
ad31dea3: raises $0.05 to $0.1
beffcf8a: folds
Uncalled bet ($0.05) returned to ad31dea3
*** SHOWDOWN ***
ad31dea3 collected $0.1 from pot
*** SUMMARY ***
Total pot $0.1 | Rake $0 | Jackpot $0 | Bingo $0 | Fortune $0 | Tax $0
Seat 1: edbb0bb6 (button) folded before Flop (didn't bet)
Seat 2: ad31dea3 (small blind) collected ($0.1)
Seat 3: beffcf8a (big blind) folded before Flop
Seat 4: b2f44cb6 folded before Flop (didn't bet)
Seat 5: Hero folded before Flop (didn't bet)
Seat 6: a28ca95c folded before Flop (didn't bet)


Poker Hand #RC3334563056: Hold'em No Limit ($0.02/$0.05) - 2025/02/17 21:31:02
Table 'RushAndCash628316' 6-max Seat #1 is the button
Seat 1: Hero ($8.73 in chips)
Seat 2: 95096c6a ($8.4 in chips)
Seat 3: 757f29d9 ($5.2 in chips)
Seat 4: eae3d655 ($5.25 in chips)
Seat 5: 7a5bf293 ($6.69 in chips)
Seat 6: 2db50b0f ($5.28 in chips)
95096c6a: posts small blind $0.02
757f29d9: posts big blind $0.05
*** HOLE CARDS ***
Dealt to Hero [Qs 3d]
Dealt to 95096c6a 
Dealt to 757f29d9 
Dealt to eae3d655 
Dealt to 7a5bf293 
Dealt to 2db50b0f 
eae3d655: folds
7a5bf293: folds
2db50b0f: raises $0.05 to $0.1
Hero: folds
95096c6a: folds
757f29d9: folds
Uncalled bet ($0.05) returned to 2db50b0f
*** SHOWDOWN ***
2db50b0f collected $0.12 from pot
*** SUMMARY ***
Total pot $0.12 | Rake $0 | Jackpot $0 | Bingo $0 | Fortune $0 | Tax $0
Seat 1: Hero (button) folded before Flop (didn't bet)
Seat 2: 95096c6a (small blind) folded before Flop
Seat 3: 757f29d9 (big blind) folded before Flop
Seat 4: eae3d655 folded before Flop (didn't bet)
Seat 5: 7a5bf293 folded before Flop (didn't bet)
Seat 6: 2db50b0f collected ($0.12)


Poker Hand #RC3334562968: Hold'em No Limit ($0.02/$0.05) - 2025/02/17 21:30:52
Table 'RushAndCash628228' 6-max Seat #1 is the button
Seat 1: e20e5cfc ($5.23 in chips)
Seat 2: Hero ($8.61 in chips)
Seat 3: 258a2071 ($7.59 in chips)
Seat 4: 39109629 ($5 in chips)
Seat 5: e297f049 ($5.48 in chips)
Seat 6: 628590b2 ($6.41 in chips)
Hero: posts small blind $0.02
258a2071: posts big blind $0.05
*** HOLE CARDS ***
Dealt to e20e5cfc 
Dealt to Hero [Kd Qh]
Dealt to 258a2071 
Dealt to 39109629 
Dealt to e297f049 
Dealt to 628590b2 
39109629: folds
e297f049: folds
628590b2: folds
e20e5cfc: folds
Hero: raises $0.1 to $0.15
258a2071: folds
Uncalled bet ($0.1) returned to Hero
*** SHOWDOWN ***
Hero collected $0.1 from pot
*** SUMMARY ***
Total pot $0.1 | Rake $0 | Jackpot $0 | Bingo $0 | Fortune $0 | Tax $0
Seat 1: e20e5cfc (button) folded before Flop (didn't bet)
Seat 2: Hero (small blind) collected ($0.1)
Seat 3: 258a2071 (big blind) folded before Flop
Seat 4: 39109629 folded before Flop (didn't bet)
Seat 5: e297f049 folded before Flop (didn't bet)
Seat 6: 628590b2 folded before Flop (didn't bet)


Poker Hand #RC3334562932: Hold'em No Limit ($0.02/$0.05) - 2025/02/17 21:30:48
Table 'RushAndCash628192' 6-max Seat #1 is the button
Seat 1: d278c831 ($7.43 in chips)
Seat 2: a2123cbe ($6.45 in chips)
Seat 3: Hero ($8.66 in chips)
Seat 4: e20e5cfc ($5.23 in chips)
Seat 5: e6aa09ff ($7.28 in chips)
Seat 6: e89071f6 ($13.33 in chips)
a2123cbe: posts small blind $0.02
Hero: posts big blind $0.05
*** HOLE CARDS ***
Dealt to d278c831 
Dealt to a2123cbe 
Dealt to Hero [Qs 5d]
Dealt to e20e5cfc 
Dealt to e6aa09ff 
Dealt to e89071f6 
e20e5cfc: folds
e6aa09ff: folds
e89071f6: folds
d278c831: folds
a2123cbe: folds
Uncalled bet ($0.03) returned to Hero
*** SHOWDOWN ***
Hero collected $0.04 from pot
*** SUMMARY ***
Total pot $0.04 | Rake $0 | Jackpot $0 | Bingo $0 | Fortune $0 | Tax $0
Seat 1: d278c831 (button) folded before Flop (didn't bet)
Seat 2: a2123cbe (small blind) folded before Flop
Seat 3: Hero (big blind) collected ($0.04)
Seat 4: e20e5cfc folded before Flop (didn't bet)
Seat 5: e6aa09ff folded before Flop (didn't bet)
Seat 6: e89071f6 folded before Flop (didn't bet)


Poker Hand #RC3334562906: Hold'em No Limit ($0.02/$0.05) - 2025/02/17 21:30:45
Table 'RushAndCash628166' 6-max Seat #1 is the button
Seat 1: b8a41e4 ($5.07 in chips)
Seat 2: 2a10169c ($5.2 in chips)
Seat 3: a4227633 ($6.03 in chips)
Seat 4: Hero ($8.66 in chips)
Seat 5: 510f8c9f ($7.16 in chips)
Seat 6: af90d8d7 ($8.06 in chips)
2a10169c: posts small blind $0.02
a4227633: posts big blind $0.05
*** HOLE CARDS ***
Dealt to b8a41e4 
Dealt to 2a10169c 
Dealt to a4227633 
Dealt to Hero [3h Qs]
Dealt to 510f8c9f 
Dealt to af90d8d7 
Hero: folds
510f8c9f: folds
af90d8d7: folds
b8a41e4: folds
2a10169c: folds
Uncalled bet ($0.03) returned to a4227633
*** SHOWDOWN ***
a4227633 collected $0.04 from pot
*** SUMMARY ***
Total pot $0.04 | Rake $0 | Jackpot $0 | Bingo $0 | Fortune $0 | Tax $0
Seat 1: b8a41e4 (button) folded before Flop (didn't bet)
Seat 2: 2a10169c (small blind) folded before Flop
Seat 3: a4227633 (big blind) collected ($0.04)
Seat 4: Hero folded before Flop (didn't bet)
Seat 5: 510f8c9f folded before Flop (didn't bet)
Seat 6: af90d8d7 folded before Flop (didn't bet)


Poker Hand #RC3334562874: Hold'em No Limit ($0.02/$0.05) - 2025/02/17 21:30:41
Table 'RushAndCash628134' 6-max Seat #1 is the button
Seat 1: 93056ee9 ($6.17 in chips)
Seat 2: 2aa9c26c ($4.88 in chips)
Seat 3: 4e53b23f ($5.27 in chips)
Seat 4: 91e92de9 ($5 in chips)
Seat 5: c723772e ($11.56 in chips)
Seat 6: Hero ($8.66 in chips)
2aa9c26c: posts small blind $0.02
4e53b23f: posts big blind $0.05
*** HOLE CARDS ***
Dealt to 93056ee9 
Dealt to 2aa9c26c 
Dealt to 4e53b23f 
Dealt to 91e92de9 
Dealt to c723772e 
Dealt to Hero [4c Ah]
91e92de9: folds
c723772e: folds
Hero: folds
93056ee9: raises $0.05 to $0.1
2aa9c26c: folds
4e53b23f: calls $0.05
*** FLOP *** [6h 9d Kd]
4e53b23f: checks
93056ee9: checks
*** TURN *** [6h 9d Kd] [Kh]
4e53b23f: checks
93056ee9: checks
*** RIVER *** [6h 9d Kd Kh] [7d]
4e53b23f: checks
93056ee9: checks
4e53b23f: shows [2s 2d] (Pair of Kings and Pair of Twos)
93056ee9: shows [6s Ts] (Pair of Kings and Pair of Sixes)
*** SHOWDOWN ***
93056ee9 collected $0.21 from pot
*** SUMMARY ***
Total pot $0.22 | Rake $0.01 | Jackpot $0 | Bingo $0 | Fortune $0 | Tax $0
Board [6h 9d Kd Kh 7d]
Seat 1: 93056ee9 (button) showed [6s Ts] and won ($0.21) with Pair of Kings and Pair of Sixes
Seat 2: 2aa9c26c (small blind) folded before Flop
Seat 3: 4e53b23f (big blind) showed [2s 2d] and lost with Pair of Kings and Pair of Twos
Seat 4: 91e92de9 folded before Flop (didn't bet)
Seat 5: c723772e folded before Flop (didn't bet)
Seat 6: Hero folded before Flop (didn't bet)


Poker Hand #RC3334562846: Hold'em No Limit ($0.02/$0.05) - 2025/02/17 21:30:38
Table 'RushAndCash628106' 6-max Seat #1 is the button
Seat 1: 42065dde ($5.05 in chips)
Seat 2: 9c1c8cec ($3.72 in chips)
Seat 3: 4e3c3196 ($30.57 in chips)
Seat 4: 35fb946f ($10.55 in chips)
Seat 5: Hero ($8.66 in chips)
Seat 6: 65900825 ($4.1 in chips)
9c1c8cec: posts small blind $0.02
4e3c3196: posts big blind $0.05
*** HOLE CARDS ***
Dealt to 42065dde 
Dealt to 9c1c8cec 
Dealt to 4e3c3196 
Dealt to 35fb946f 
Dealt to Hero [Kd 9h]
Dealt to 65900825 
35fb946f: raises $0.05 to $0.1
Hero: folds
65900825: folds
42065dde: folds
9c1c8cec: folds
4e3c3196: folds
Uncalled bet ($0.05) returned to 35fb946f
*** SHOWDOWN ***
35fb946f collected $0.12 from pot
*** SUMMARY ***
Total pot $0.12 | Rake $0 | Jackpot $0 | Bingo $0 | Fortune $0 | Tax $0
Seat 1: 42065dde (button) folded before Flop (didn't bet)
Seat 2: 9c1c8cec (small blind) folded before Flop
Seat 3: 4e3c3196 (big blind) folded before Flop
Seat 4: 35fb946f collected ($0.12)
Seat 5: Hero folded before Flop (didn't bet)
Seat 6: 65900825 folded before Flop (didn't bet)


Poker Hand #RC3334562820: Hold'em No Limit ($0.02/$0.05) - 2025/02/17 21:30:35
Table 'RushAndCash628080' 6-max Seat #1 is the button
Seat 1: d691d846 ($3.64 in chips)
Seat 2: Hero ($8.68 in chips)
Seat 3: f6efd55a ($9.77 in chips)
Seat 4: d60e3ce5 ($5.63 in chips)
Seat 5: 76135c78 ($13.15 in chips)
Seat 6: f18b40b7 ($5.77 in chips)
Hero: posts small blind $0.02
f6efd55a: posts big blind $0.05
*** HOLE CARDS ***
Dealt to d691d846 
Dealt to Hero [4h Qh]
Dealt to f6efd55a 
Dealt to d60e3ce5 
Dealt to 76135c78 
Dealt to f18b40b7 
d60e3ce5: folds
76135c78: folds
f18b40b7: folds
d691d846: raises $0.05 to $0.1
Hero: folds
f6efd55a: folds
Uncalled bet ($0.05) returned to d691d846
*** SHOWDOWN ***
d691d846 collected $0.12 from pot
*** SUMMARY ***
Total pot $0.12 | Rake $0 | Jackpot $0 | Bingo $0 | Fortune $0 | Tax $0
Seat 1: d691d846 (button) collected ($0.12)
Seat 2: Hero (small blind) folded before Flop
Seat 3: f6efd55a (big blind) folded before Flop
Seat 4: d60e3ce5 folded before Flop (didn't bet)
Seat 5: 76135c78 folded before Flop (didn't bet)
Seat 6: f18b40b7 folded before Flop (didn't bet)


Poker Hand #RC3334562778: Hold'em No Limit ($0.02/$0.05) - 2025/02/17 21:30:30
Table 'RushAndCash628038' 6-max Seat #1 is the button
Seat 1: Hero ($8.68 in chips)
Seat 2: fad81e68 ($6.84 in chips)
Seat 3: 6ac4af54 ($12.62 in chips)
Seat 4: 9604af2 ($6.51 in chips)
Seat 5: 3e301744 ($7.01 in chips)
Seat 6: 3db4c32a ($6.02 in chips)
fad81e68: posts small blind $0.02
6ac4af54: posts big blind $0.05
*** HOLE CARDS ***
Dealt to Hero [As 6d]
Dealt to fad81e68 
Dealt to 6ac4af54 
Dealt to 9604af2 
Dealt to 3e301744 
Dealt to 3db4c32a 
9604af2: folds
3e301744: folds
3db4c32a: raises $0.06 to $0.11
Hero: folds
fad81e68: folds
6ac4af54: calls $0.06
*** FLOP *** [3s 2d 4h]
6ac4af54: bets $0.16
3db4c32a: raises $0.16 to $0.32
6ac4af54: folds
Uncalled bet ($0.16) returned to 3db4c32a
*** SHOWDOWN ***
3db4c32a collected $0.54 from pot
*** SUMMARY ***
Total pot $0.56 | Rake $0.02 | Jackpot $0 | Bingo $0 | Fortune $0 | Tax $0
Board [3s 2d 4h]
Seat 1: Hero (button) folded before Flop (didn't bet)
Seat 2: fad81e68 (small blind) folded before Flop
Seat 3: 6ac4af54 (big blind) folded on the Flop
Seat 4: 9604af2 folded before Flop (didn't bet)
Seat 5: 3e301744 folded before Flop (didn't bet)
Seat 6: 3db4c32a won ($0.54)


Poker Hand #RC3334562380: Hold'em No Limit ($0.02/$0.05) - 2025/02/17 21:29:42
Table 'RushAndCash627640' 6-max Seat #1 is the button
Seat 1: ef1c45d4 ($5 in chips)
Seat 2: aabba297 ($5.15 in chips)
Seat 3: Hero ($8.45 in chips)
Seat 4: f994138c ($9.48 in chips)
Seat 5: b59fc0b9 ($5 in chips)
Seat 6: 2aa9c26c ($5.06 in chips)
aabba297: posts small blind $0.02
Hero: posts big blind $0.05
*** HOLE CARDS ***
Dealt to ef1c45d4 
Dealt to aabba297 
Dealt to Hero [Qd Td]
Dealt to f994138c 
Dealt to b59fc0b9 
Dealt to 2aa9c26c 
f994138c: folds
b59fc0b9: folds
2aa9c26c: folds
ef1c45d4: folds
aabba297: raises $0.1 to $0.15
Hero: calls $0.1
*** FLOP *** [7d Jh 6h]
aabba297: bets $0.1
Hero: calls $0.1
*** TURN *** [7d Jh 6h] [Jd]
aabba297: checks
Hero: checks
*** RIVER *** [7d Jh 6h Jd] [9h]
aabba297: checks
Hero: bets $0.38
aabba297: folds
Uncalled bet ($0.38) returned to Hero
*** SHOWDOWN ***
Hero collected $0.48 from pot
*** SUMMARY ***
Total pot $0.5 | Rake $0.02 | Jackpot $0 | Bingo $0 | Fortune $0 | Tax $0
Board [7d Jh 6h Jd 9h]
Seat 1: ef1c45d4 (button) folded before Flop (didn't bet)
Seat 2: aabba297 (small blind) folded on the River
Seat 3: Hero (big blind) won ($0.48)
Seat 4: f994138c folded before Flop (didn't bet)
Seat 5: b59fc0b9 folded before Flop (didn't bet)
Seat 6: 2aa9c26c folded before Flop (didn't bet)


Poker Hand #RC3334562298: Hold'em No Limit ($0.02/$0.05) - 2025/02/17 21:29:34
Table 'RushAndCash627558' 6-max Seat #1 is the button
Seat 1: 2b8b2921 ($9.65 in chips)
Seat 2: 692417ff ($5.87 in chips)
Seat 3: Hero ($8.43 in chips)
Seat 4: 7dd18ea7 ($10.89 in chips)
Seat 5: 21e0e4ee ($5 in chips)
Seat 6: 577bd292 ($5.66 in chips)
692417ff: posts small blind $0.02
Hero: posts big blind $0.05
*** HOLE CARDS ***
Dealt to 2b8b2921 
Dealt to 692417ff 
Dealt to Hero [5s 3d]
Dealt to 7dd18ea7 
Dealt to 21e0e4ee 
Dealt to 577bd292 
7dd18ea7: folds
21e0e4ee: folds
577bd292: folds
2b8b2921: folds
692417ff: folds
Uncalled bet ($0.03) returned to Hero
*** SHOWDOWN ***
Hero collected $0.04 from pot
*** SUMMARY ***
Total pot $0.04 | Rake $0 | Jackpot $0 | Bingo $0 | Fortune $0 | Tax $0
Seat 1: 2b8b2921 (button) folded before Flop (didn't bet)
Seat 2: 692417ff (small blind) folded before Flop
Seat 3: Hero (big blind) collected ($0.04)
Seat 4: 7dd18ea7 folded before Flop (didn't bet)
Seat 5: 21e0e4ee folded before Flop (didn't bet)
Seat 6: 577bd292 folded before Flop (didn't bet)


Poker Hand #RC3334562272: Hold'em No Limit ($0.02/$0.05) - 2025/02/17 21:29:31
Table 'RushAndCash627532' 6-max Seat #1 is the button
Seat 1: e44002e9 ($6.42 in chips)
Seat 2: edcc4eda ($5 in chips)
Seat 3: bf4557c ($1.62 in chips)
Seat 4: 933f6ef1 ($5 in chips)
Seat 5: Hero ($8.43 in chips)
Seat 6: f1be594d ($5.3 in chips)
edcc4eda: posts small blind $0.02
bf4557c: posts big blind $0.05
*** HOLE CARDS ***
Dealt to e44002e9 
Dealt to edcc4eda 
Dealt to bf4557c 
Dealt to 933f6ef1 
Dealt to Hero [5d Jc]
Dealt to f1be594d 
933f6ef1: calls $0.05
Hero: folds
f1be594d: folds
e44002e9: folds
edcc4eda: folds
bf4557c: checks
*** FLOP *** [Qh Jh 7s]
bf4557c: checks
933f6ef1: checks
*** TURN *** [Qh Jh 7s] [6d]
bf4557c: checks
933f6ef1: checks
*** RIVER *** [Qh Jh 7s 6d] [Kd]
bf4557c: checks
933f6ef1: checks
bf4557c: shows [5s Ad] (Ace-High)
933f6ef1: shows [4s 4d] (Pair of Fours)
*** SHOWDOWN ***
933f6ef1 collected $0.12 from pot
*** SUMMARY ***
Total pot $0.12 | Rake $0 | Jackpot $0 | Bingo $0 | Fortune $0 | Tax $0
Board [Qh Jh 7s 6d Kd]
Seat 1: e44002e9 (button) folded before Flop (didn't bet)
Seat 2: edcc4eda (small blind) folded before Flop
Seat 3: bf4557c (big blind) showed [5s Ad] and lost with Ace-High
Seat 4: 933f6ef1 showed [4s 4d] and won ($0.12) with Pair of Fours
Seat 5: Hero folded before Flop (didn't bet)
Seat 6: f1be594d folded before Flop (didn't bet)


Poker Hand #RC3334562217: Hold'em No Limit ($0.02/$0.05) - 2025/02/17 21:29:25
Table 'RushAndCash627477' 6-max Seat #1 is the button
Seat 1: b258f9f9 ($5.1 in chips)
Seat 2: 1c0eec17 ($5.02 in chips)
Seat 3: 3e3946b0 ($6.39 in chips)
Seat 4: Hero ($8.43 in chips)
Seat 5: a75d2a3b ($3.8 in chips)
Seat 6: ef7b5599 ($34.28 in chips)
1c0eec17: posts small blind $0.02
3e3946b0: posts big blind $0.05
*** HOLE CARDS ***
Dealt to b258f9f9 
Dealt to 1c0eec17 
Dealt to 3e3946b0 
Dealt to Hero [3c As]
Dealt to a75d2a3b 
Dealt to ef7b5599 
Hero: folds
a75d2a3b: calls $0.05
ef7b5599: folds
b258f9f9: folds
1c0eec17: folds
3e3946b0: checks
*** FLOP *** [Kh 9s Ac]
3e3946b0: bets $0.1
a75d2a3b: calls $0.1
*** TURN *** [Kh 9s Ac] [Tc]
3e3946b0: bets $0.11
a75d2a3b: calls $0.11
*** RIVER *** [Kh 9s Ac Tc] [5d]
3e3946b0: checks
a75d2a3b: checks
3e3946b0: shows [4h Ad] (Pair of Aces)
a75d2a3b: shows [7c 8c] (Ace-High)
*** SHOWDOWN ***
3e3946b0 collected $0.52 from pot
*** SUMMARY ***
Total pot $0.54 | Rake $0.02 | Jackpot $0 | Bingo $0 | Fortune $0 | Tax $0
Board [Kh 9s Ac Tc 5d]
Seat 1: b258f9f9 (button) folded before Flop (didn't bet)
Seat 2: 1c0eec17 (small blind) folded before Flop
Seat 3: 3e3946b0 (big blind) showed [4h Ad] and won ($0.52) with Pair of Aces
Seat 4: Hero folded before Flop (didn't bet)
Seat 5: a75d2a3b showed [7c 8c] and lost with Ace-High
Seat 6: ef7b5599 folded before Flop (didn't bet)


Poker Hand #RC3334562161: Hold'em No Limit ($0.02/$0.05) - 2025/02/17 21:29:18
Table 'RushAndCash627421' 6-max Seat #1 is the button
Seat 1: 62fdcc3c ($5.05 in chips)
Seat 2: Hero ($8.45 in chips)
Seat 3: 8e93231a ($6.05 in chips)
Seat 4: 1c0eec17 ($5.02 in chips)
Seat 5: 3d537b07 ($4.9 in chips)
Seat 6: eb63e0f4 ($1.14 in chips)
Hero: posts small blind $0.02
8e93231a: posts big blind $0.05
*** HOLE CARDS ***
Dealt to 62fdcc3c 
Dealt to Hero [5h 6c]
Dealt to 8e93231a 
Dealt to 1c0eec17 
Dealt to 3d537b07 
Dealt to eb63e0f4 
1c0eec17: folds
3d537b07: folds
eb63e0f4: calls $0.05
62fdcc3c: folds
Hero: folds
8e93231a: checks
*** FLOP *** [4s Qc Kd]
8e93231a: checks
eb63e0f4: bets $0.06
8e93231a: folds
Uncalled bet ($0.06) returned to eb63e0f4
*** SHOWDOWN ***
eb63e0f4 collected $0.12 from pot
*** SUMMARY ***
Total pot $0.12 | Rake $0 | Jackpot $0 | Bingo $0 | Fortune $0 | Tax $0
Board [4s Qc Kd]
Seat 1: 62fdcc3c (button) folded before Flop (didn't bet)
Seat 2: Hero (small blind) folded before Flop
Seat 3: 8e93231a (big blind) folded on the Flop
Seat 4: 1c0eec17 folded before Flop (didn't bet)
Seat 5: 3d537b07 folded before Flop (didn't bet)
Seat 6: eb63e0f4 won ($0.12)


Poker Hand #RC3334562118: Hold'em No Limit ($0.02/$0.05) - 2025/02/17 21:29:13
Table 'RushAndCash627378' 6-max Seat #1 is the button
Seat 1: e76863c8 ($6.41 in chips)
Seat 2: 21be8833 ($5.09 in chips)
Seat 3: 677c4b25 ($12 in chips)
Seat 4: 577aa3d3 ($9.24 in chips)
Seat 5: a730170a ($5.25 in chips)
Seat 6: Hero ($8.45 in chips)
21be8833: posts small blind $0.02
677c4b25: posts big blind $0.05
*** HOLE CARDS ***
Dealt to e76863c8 
Dealt to 21be8833 
Dealt to 677c4b25 
Dealt to 577aa3d3 
Dealt to a730170a 
Dealt to Hero [Ks 6d]
577aa3d3: folds
a730170a: folds
Hero: folds
e76863c8: folds
21be8833: folds
Uncalled bet ($0.03) returned to 677c4b25
*** SHOWDOWN ***
677c4b25 collected $0.04 from pot
*** SUMMARY ***
Total pot $0.04 | Rake $0 | Jackpot $0 | Bingo $0 | Fortune $0 | Tax $0
Seat 1: e76863c8 (button) folded before Flop (didn't bet)
Seat 2: 21be8833 (small blind) folded before Flop
Seat 3: 677c4b25 (big blind) collected ($0.04)
Seat 4: 577aa3d3 folded before Flop (didn't bet)
Seat 5: a730170a folded before Flop (didn't bet)
Seat 6: Hero folded before Flop (didn't bet)


Poker Hand #RC3334562094: Hold'em No Limit ($0.02/$0.05) - 2025/02/17 21:29:10
Table 'RushAndCash627354' 6-max Seat #1 is the button
Seat 1: c5f37c20 ($2.97 in chips)
Seat 2: ccabd9d2 ($5.51 in chips)
Seat 3: aa2d17c0 ($6.59 in chips)
Seat 4: f1be594d ($5.37 in chips)
Seat 5: f72bf77b ($5.48 in chips)
Seat 6: Hero ($8.45 in chips)
ccabd9d2: posts small blind $0.02
aa2d17c0: posts big blind $0.05
*** HOLE CARDS ***
Dealt to c5f37c20 
Dealt to ccabd9d2 
Dealt to aa2d17c0 
Dealt to f1be594d 
Dealt to f72bf77b 
Dealt to Hero [Js 2s]
f1be594d: folds
f72bf77b: folds
Hero: folds
c5f37c20: folds
ccabd9d2: folds
Uncalled bet ($0.03) returned to aa2d17c0
*** SHOWDOWN ***
aa2d17c0 collected $0.04 from pot
*** SUMMARY ***
Total pot $0.04 | Rake $0 | Jackpot $0 | Bingo $0 | Fortune $0 | Tax $0
Seat 1: c5f37c20 (button) folded before Flop (didn't bet)
Seat 2: ccabd9d2 (small blind) folded before Flop
Seat 3: aa2d17c0 (big blind) collected ($0.04)
Seat 4: f1be594d folded before Flop (didn't bet)
Seat 5: f72bf77b folded before Flop (didn't bet)
Seat 6: Hero folded before Flop (didn't bet)


Poker Hand #RC3334562070: Hold'em No Limit ($0.02/$0.05) - 2025/02/17 21:29:07
Table 'RushAndCash627330' 6-max Seat #1 is the button
Seat 1: Hero ($8.45 in chips)
Seat 2: 433fbf8f ($5 in chips)
Seat 3: e1132427 ($7.99 in chips)
Seat 4: d49c6b7d ($5.42 in chips)
Seat 5: af7760fa ($5 in chips)
Seat 6: 8f77797e ($3.76 in chips)
433fbf8f: posts small blind $0.02
e1132427: posts big blind $0.05
*** HOLE CARDS ***
Dealt to Hero [2s Kh]
Dealt to 433fbf8f 
Dealt to e1132427 
Dealt to d49c6b7d 
Dealt to af7760fa 
Dealt to 8f77797e 
d49c6b7d: folds
af7760fa: folds
8f77797e: raises $0.05 to $0.1
Hero: folds
433fbf8f: raises $0.35 to $0.45
e1132427: folds
8f77797e: calls $0.35
*** FLOP *** [6d 2d 3h]
433fbf8f: checks
8f77797e: bets $0.48
433fbf8f: raises $0.96 to $1.44
8f77797e: folds
Uncalled bet ($0.96) returned to 433fbf8f
*** SHOWDOWN ***
433fbf8f collected $1.73 from pot
*** SUMMARY ***
Total pot $1.91 | Rake $0.11 | Jackpot $0.07 | Bingo $0 | Fortune $0 | Tax $0
Board [6d 2d 3h]
Seat 1: Hero (button) folded before Flop (didn't bet)
Seat 2: 433fbf8f (small blind) won ($1.73)
Seat 3: e1132427 (big blind) folded before Flop
Seat 4: d49c6b7d folded before Flop (didn't bet)
Seat 5: af7760fa folded before Flop (didn't bet)
Seat 6: 8f77797e folded on the Flop


Poker Hand #RC3334562041: Hold'em No Limit ($0.02/$0.05) - 2025/02/17 21:29:03
Table 'RushAndCash627301' 6-max Seat #1 is the button
Seat 1: e7a0ba42 ($21.68 in chips)
Seat 2: 9dd1ff39 ($5 in chips)
Seat 3: Hero ($8.5 in chips)
Seat 4: 6b09dc81 ($4.82 in chips)
Seat 5: 57a66aa7 ($5 in chips)
Seat 6: 8d0bc73f ($5.28 in chips)
9dd1ff39: posts small blind $0.02
Hero: posts big blind $0.05
*** HOLE CARDS ***
Dealt to e7a0ba42 
Dealt to 9dd1ff39 
Dealt to Hero [3s 6h]
Dealt to 6b09dc81 
Dealt to 57a66aa7 
Dealt to 8d0bc73f 
6b09dc81: folds
57a66aa7: folds
8d0bc73f: raises $0.06 to $0.11
e7a0ba42: folds
9dd1ff39: folds
Hero: folds
Uncalled bet ($0.06) returned to 8d0bc73f
*** SHOWDOWN ***
8d0bc73f collected $0.12 from pot
*** SUMMARY ***
Total pot $0.12 | Rake $0 | Jackpot $0 | Bingo $0 | Fortune $0 | Tax $0
Seat 1: e7a0ba42 (button) folded before Flop (didn't bet)
Seat 2: 9dd1ff39 (small blind) folded before Flop
Seat 3: Hero (big blind) folded before Flop
Seat 4: 6b09dc81 folded before Flop (didn't bet)
Seat 5: 57a66aa7 folded before Flop (didn't bet)
Seat 6: 8d0bc73f collected ($0.12)


Poker Hand #RC3334562020: Hold'em No Limit ($0.02/$0.05) - 2025/02/17 21:29:00
Table 'RushAndCash627280' 6-max Seat #1 is the button
Seat 1: 7b0814a4 ($5.48 in chips)
Seat 2: aa5c1aba ($4.95 in chips)
Seat 3: 15fafcaa ($5.27 in chips)
Seat 4: f71501ed ($5.43 in chips)
Seat 5: Hero ($8.5 in chips)
Seat 6: f6efd55a ($10.1 in chips)
aa5c1aba: posts small blind $0.02
15fafcaa: posts big blind $0.05
*** HOLE CARDS ***
Dealt to 7b0814a4 
Dealt to aa5c1aba 
Dealt to 15fafcaa 
Dealt to f71501ed 
Dealt to Hero [8h Tc]
Dealt to f6efd55a 
f71501ed: folds
Hero: folds
f6efd55a: folds
7b0814a4: calls $0.05
aa5c1aba: raises $0.08 to $0.13
15fafcaa: folds
7b0814a4: calls $0.08
*** FLOP *** [Ks 4h Ts]
aa5c1aba: checks
7b0814a4: bets $0.11
aa5c1aba: folds
Uncalled bet ($0.11) returned to 7b0814a4
*** SHOWDOWN ***
7b0814a4 collected $0.3 from pot
*** SUMMARY ***
Total pot $0.31 | Rake $0.01 | Jackpot $0 | Bingo $0 | Fortune $0 | Tax $0
Board [Ks 4h Ts]
Seat 1: 7b0814a4 (button) won ($0.3)
Seat 2: aa5c1aba (small blind) folded on the Flop
Seat 3: 15fafcaa (big blind) folded before Flop
Seat 4: f71501ed folded before Flop (didn't bet)
Seat 5: Hero folded before Flop (didn't bet)
Seat 6: f6efd55a folded before Flop (didn't bet)


Poker Hand #RC3334561994: Hold'em No Limit ($0.02/$0.05) - 2025/02/17 21:28:57
Table 'RushAndCash627254' 6-max Seat #1 is the button
Seat 1: 8858e1f1 ($6.38 in chips)
Seat 2: eb21bc62 ($3.39 in chips)
Seat 3: b9ae439d ($5.37 in chips)
Seat 4: 21be8833 ($5.07 in chips)
Seat 5: Hero ($8.5 in chips)
Seat 6: a7365f1c ($9.05 in chips)
eb21bc62: posts small blind $0.02
b9ae439d: posts big blind $0.05
*** HOLE CARDS ***
Dealt to 8858e1f1 
Dealt to eb21bc62 
Dealt to b9ae439d 
Dealt to 21be8833 
Dealt to Hero [Ks 8c]
Dealt to a7365f1c 
21be8833: raises $0.08 to $0.13
Hero: folds
a7365f1c: folds
8858e1f1: folds
eb21bc62: folds
b9ae439d: folds
Uncalled bet ($0.08) returned to 21be8833
*** SHOWDOWN ***
21be8833 collected $0.12 from pot
*** SUMMARY ***
Total pot $0.12 | Rake $0 | Jackpot $0 | Bingo $0 | Fortune $0 | Tax $0
Seat 1: 8858e1f1 (button) folded before Flop (didn't bet)
Seat 2: eb21bc62 (small blind) folded before Flop
Seat 3: b9ae439d (big blind) folded before Flop
Seat 4: 21be8833 collected ($0.12)
Seat 5: Hero folded before Flop (didn't bet)
Seat 6: a7365f1c folded before Flop (didn't bet)


Poker Hand #RC3334561798: Hold'em No Limit ($0.02/$0.05) - 2025/02/17 21:28:32
Table 'RushAndCash627058' 6-max Seat #1 is the button
Seat 1: 95096c6a ($8.92 in chips)
Seat 2: a9eb9f38 ($7.19 in chips)
Seat 3: 21e0e4ee ($5 in chips)
Seat 4: Hero ($8.6 in chips)
Seat 5: 3113f559 ($3.7 in chips)
Seat 6: fb90f143 ($9.84 in chips)
a9eb9f38: posts small blind $0.02
21e0e4ee: posts big blind $0.05
*** HOLE CARDS ***
Dealt to 95096c6a 
Dealt to a9eb9f38 
Dealt to 21e0e4ee 
Dealt to Hero [Kh Jd]
Dealt to 3113f559 
Dealt to fb90f143 
Hero: raises $0.05 to $0.1
3113f559: folds
fb90f143: folds
95096c6a: folds
a9eb9f38: raises $0.44 to $0.54
21e0e4ee: folds
Hero: folds
Uncalled bet ($0.44) returned to a9eb9f38
*** SHOWDOWN ***
a9eb9f38 collected $0.24 from pot
*** SUMMARY ***
Total pot $0.25 | Rake $0.01 | Jackpot $0 | Bingo $0 | Fortune $0 | Tax $0
Seat 1: 95096c6a (button) folded before Flop (didn't bet)
Seat 2: a9eb9f38 (small blind) showed [As Kd] and collected ($0.24)
Seat 3: 21e0e4ee (big blind) folded before Flop
Seat 4: Hero folded before Flop
Seat 5: 3113f559 folded before Flop (didn't bet)
Seat 6: fb90f143 folded before Flop (didn't bet)


Poker Hand #RC3334561733: Hold'em No Limit ($0.02/$0.05) - 2025/02/17 21:28:24
Table 'RushAndCash626993' 6-max Seat #1 is the button
Seat 1: 3b85f8e6 ($13.16 in chips)
Seat 2: 304e7bcd ($4.47 in chips)
Seat 3: Hero ($8.65 in chips)
Seat 4: cf7f09c2 ($16.34 in chips)
Seat 5: 35fb946f ($10.57 in chips)
Seat 6: c62b7a0b ($22.21 in chips)
304e7bcd: posts small blind $0.02
Hero: posts big blind $0.05
*** HOLE CARDS ***
Dealt to 3b85f8e6 
Dealt to 304e7bcd 
Dealt to Hero [5s Ts]
Dealt to cf7f09c2 
Dealt to 35fb946f 
Dealt to c62b7a0b 
cf7f09c2: folds
35fb946f: folds
c62b7a0b: folds
3b85f8e6: raises $0.09 to $0.14
304e7bcd: folds
Hero: folds
Uncalled bet ($0.09) returned to 3b85f8e6
*** SHOWDOWN ***
3b85f8e6 collected $0.12 from pot
*** SUMMARY ***
Total pot $0.12 | Rake $0 | Jackpot $0 | Bingo $0 | Fortune $0 | Tax $0
Seat 1: 3b85f8e6 (button) collected ($0.12)
Seat 2: 304e7bcd (small blind) folded before Flop
Seat 3: Hero (big blind) folded before Flop
Seat 4: cf7f09c2 folded before Flop (didn't bet)
Seat 5: 35fb946f folded before Flop (didn't bet)
Seat 6: c62b7a0b folded before Flop (didn't bet)


Poker Hand #RC3334561708: Hold'em No Limit ($0.02/$0.05) - 2025/02/17 21:28:21
Table 'RushAndCash626968' 6-max Seat #1 is the button
Seat 1: 57a66aa7 ($5 in chips)
Seat 2: Hero ($8.67 in chips)
Seat 3: a19fb924 ($7.81 in chips)
Seat 4: 35fb946f ($10.57 in chips)
Seat 5: 93056ee9 ($7.3 in chips)
Seat 6: 820e1571 ($5 in chips)
Hero: posts small blind $0.02
a19fb924: posts big blind $0.05
*** HOLE CARDS ***
Dealt to 57a66aa7 
Dealt to Hero [6c Ks]
Dealt to a19fb924 
Dealt to 35fb946f 
Dealt to 93056ee9 
Dealt to 820e1571 
35fb946f: folds
93056ee9: folds
820e1571: folds
57a66aa7: folds
Hero: folds
Uncalled bet ($0.03) returned to a19fb924
*** SHOWDOWN ***
a19fb924 collected $0.04 from pot
*** SUMMARY ***
Total pot $0.04 | Rake $0 | Jackpot $0 | Bingo $0 | Fortune $0 | Tax $0
Seat 1: 57a66aa7 (button) folded before Flop (didn't bet)
Seat 2: Hero (small blind) folded before Flop
Seat 3: a19fb924 (big blind) collected ($0.04)
Seat 4: 35fb946f folded before Flop (didn't bet)
Seat 5: 93056ee9 folded before Flop (didn't bet)
Seat 6: 820e1571 folded before Flop (didn't bet)


Poker Hand #RC3334561654: Hold'em No Limit ($0.02/$0.05) - 2025/02/17 21:28:15
Table 'RushAndCash626914' 6-max Seat #1 is the button
Seat 1: 65ca9276 ($10.26 in chips)
Seat 2: 9ccadbb5 ($10.06 in chips)
Seat 3: b8a41e4 ($5.44 in chips)
Seat 4: c0a90b1a ($5 in chips)
Seat 5: Hero ($8.67 in chips)
Seat 6: eb1bbc7a ($5.27 in chips)
9ccadbb5: posts small blind $0.02
b8a41e4: posts big blind $0.05
*** HOLE CARDS ***
Dealt to 65ca9276 
Dealt to 9ccadbb5 
Dealt to b8a41e4 
Dealt to c0a90b1a 
Dealt to Hero [Ks 5s]
Dealt to eb1bbc7a 
c0a90b1a: raises $0.08 to $0.13
Hero: folds
eb1bbc7a: folds
65ca9276: folds
9ccadbb5: folds
b8a41e4: folds
Uncalled bet ($0.08) returned to c0a90b1a
*** SHOWDOWN ***
c0a90b1a collected $0.12 from pot
*** SUMMARY ***
Total pot $0.12 | Rake $0 | Jackpot $0 | Bingo $0 | Fortune $0 | Tax $0
Seat 1: 65ca9276 (button) folded before Flop (didn't bet)
Seat 2: 9ccadbb5 (small blind) folded before Flop
Seat 3: b8a41e4 (big blind) folded before Flop
Seat 4: c0a90b1a collected ($0.12)
Seat 5: Hero folded before Flop (didn't bet)
Seat 6: eb1bbc7a folded before Flop (didn't bet)


Poker Hand #RC3334561623: Hold'em No Limit ($0.02/$0.05) - 2025/02/17 21:28:12
Table 'RushAndCash626883' 6-max Seat #1 is the button
Seat 1: b2966865 ($12.69 in chips)
Seat 2: Hero ($8.69 in chips)
Seat 3: e5c03448 ($4.71 in chips)
Seat 4: f0600331 ($9.36 in chips)
Seat 5: 96564827 ($5.16 in chips)
Seat 6: a28ca95c ($29.62 in chips)
Hero: posts small blind $0.02
e5c03448: posts big blind $0.05
*** HOLE CARDS ***
Dealt to b2966865 
Dealt to Hero [7c Ah]
Dealt to e5c03448 
Dealt to f0600331 
Dealt to 96564827 
Dealt to a28ca95c 
f0600331: folds
96564827: raises $0.07 to $0.12
a28ca95c: calls $0.12
b2966865: folds
Hero: folds
e5c03448: folds
*** FLOP *** [Qs 5d 2h]
96564827: bets $0.11
a28ca95c: calls $0.11
*** TURN *** [Qs 5d 2h] [Kd]
96564827: bets $0.48
a28ca95c: calls $0.48
*** RIVER *** [Qs 5d 2h Kd] [5s]
96564827: checks
a28ca95c: checks
96564827: shows [Jd Ad] (Pair of Fives)
a28ca95c: shows [Jh Th] (Pair of Fives)
*** SHOWDOWN ***
96564827 collected $1.42 from pot
*** SUMMARY ***
Total pot $1.49 | Rake $0.07 | Jackpot $0 | Bingo $0 | Fortune $0 | Tax $0
Board [Qs 5d 2h Kd 5s]
Seat 1: b2966865 (button) folded before Flop (didn't bet)
Seat 2: Hero (small blind) folded before Flop
Seat 3: e5c03448 (big blind) folded before Flop
Seat 4: f0600331 folded before Flop (didn't bet)
Seat 5: 96564827 showed [Jd Ad] and won ($1.42) with Pair of Fives
Seat 6: a28ca95c showed [Jh Th] and lost with Pair of Fives


Poker Hand #RC3334561376: Hold'em No Limit ($0.02/$0.05) - 2025/02/17 21:27:42
Table 'RushAndCash626636' 6-max Seat #1 is the button
Seat 1: ead6cfaf ($5 in chips)
Seat 2: cea9730b ($8.01 in chips)
Seat 3: 4a2c171f ($5.63 in chips)
Seat 4: 3e301744 ($8.02 in chips)
Seat 5: 1e474bac ($5 in chips)
Seat 6: Hero ($8.89 in chips)
cea9730b: posts small blind $0.02
4a2c171f: posts big blind $0.05
*** HOLE CARDS ***
Dealt to ead6cfaf 
Dealt to cea9730b 
Dealt to 4a2c171f 
Dealt to 3e301744 
Dealt to 1e474bac 
Dealt to Hero [Td Tc]
3e301744: folds
1e474bac: raises $0.05 to $0.1
Hero: calls $0.1
ead6cfaf: folds
cea9730b: folds
4a2c171f: folds
*** FLOP *** [Ks 4c Ad]
1e474bac: checks
Hero: bets $0.1
1e474bac: raises $0.22 to $0.32
Hero: folds
Uncalled bet ($0.22) returned to 1e474bac
*** SHOWDOWN ***
1e474bac collected $0.45 from pot
*** SUMMARY ***
Total pot $0.47 | Rake $0.02 | Jackpot $0 | Bingo $0 | Fortune $0 | Tax $0
Board [Ks 4c Ad]
Seat 1: ead6cfaf (button) folded before Flop (didn't bet)
Seat 2: cea9730b (small blind) folded before Flop
Seat 3: 4a2c171f (big blind) folded before Flop
Seat 4: 3e301744 folded before Flop (didn't bet)
Seat 5: 1e474bac won ($0.45)
Seat 6: Hero folded on the Flop


Poker Hand #RC3334561351: Hold'em No Limit ($0.02/$0.05) - 2025/02/17 21:27:39
Table 'RushAndCash626611' 6-max Seat #1 is the button
Seat 1: 1fa8537 ($8.59 in chips)
Seat 2: f9d64f1a ($5.78 in chips)
Seat 3: beffcf8a ($5.07 in chips)
Seat 4: Hero ($8.89 in chips)
Seat 5: e4d8df1d ($8.34 in chips)
Seat 6: b48f0b59 ($5.07 in chips)
f9d64f1a: posts small blind $0.02
beffcf8a: posts big blind $0.05
*** HOLE CARDS ***
Dealt to 1fa8537 
Dealt to f9d64f1a 
Dealt to beffcf8a 
Dealt to Hero [Js 8h]
Dealt to e4d8df1d 
Dealt to b48f0b59 
Hero: folds
e4d8df1d: folds
b48f0b59: folds
1fa8537: folds
f9d64f1a: raises $0.09 to $0.14
beffcf8a: folds
Uncalled bet ($0.09) returned to f9d64f1a
*** SHOWDOWN ***
f9d64f1a collected $0.1 from pot
*** SUMMARY ***
Total pot $0.1 | Rake $0 | Jackpot $0 | Bingo $0 | Fortune $0 | Tax $0
Seat 1: 1fa8537 (button) folded before Flop (didn't bet)
Seat 2: f9d64f1a (small blind) collected ($0.1)
Seat 3: beffcf8a (big blind) folded before Flop
Seat 4: Hero folded before Flop (didn't bet)
Seat 5: e4d8df1d folded before Flop (didn't bet)
Seat 6: b48f0b59 folded before Flop (didn't bet)


Poker Hand #RC3334561327: Hold'em No Limit ($0.02/$0.05) - 2025/02/17 21:27:36
Table 'RushAndCash626587' 6-max Seat #1 is the button
Seat 1: 3db4c32a ($5.23 in chips)
Seat 2: baaf0b0d ($13.49 in chips)
Seat 3: 93dfef8b ($12.79 in chips)
Seat 4: e56c8107 ($6.17 in chips)
Seat 5: Hero ($8.89 in chips)
Seat 6: b144f063 ($9.19 in chips)
baaf0b0d: posts small blind $0.02
93dfef8b: posts big blind $0.05
*** HOLE CARDS ***
Dealt to 3db4c32a 
Dealt to baaf0b0d 
Dealt to 93dfef8b 
Dealt to e56c8107 
Dealt to Hero [3c Ad]
Dealt to b144f063 
e56c8107: folds
Hero: folds
b144f063: raises $0.05 to $0.1
3db4c32a: folds
baaf0b0d: folds
93dfef8b: folds
Uncalled bet ($0.05) returned to b144f063
*** SHOWDOWN ***
b144f063 collected $0.12 from pot
*** SUMMARY ***
Total pot $0.12 | Rake $0 | Jackpot $0 | Bingo $0 | Fortune $0 | Tax $0
Seat 1: 3db4c32a (button) folded before Flop (didn't bet)
Seat 2: baaf0b0d (small blind) folded before Flop
Seat 3: 93dfef8b (big blind) folded before Flop
Seat 4: e56c8107 folded before Flop (didn't bet)
Seat 5: Hero folded before Flop (didn't bet)
Seat 6: b144f063 collected ($0.12)


Poker Hand #RC3334561292: Hold'em No Limit ($0.02/$0.05) - 2025/02/17 21:27:32
Table 'RushAndCash626552' 6-max Seat #1 is the button
Seat 1: Hero ($8.89 in chips)
Seat 2: 4e5ae3cb ($6.6 in chips)
Seat 3: a2b7d805 ($5.48 in chips)
Seat 4: 4afebef ($5.01 in chips)
Seat 5: c35cd20e ($5.33 in chips)
Seat 6: 3e301744 ($8.04 in chips)
4e5ae3cb: posts small blind $0.02
a2b7d805: posts big blind $0.05
*** HOLE CARDS ***
Dealt to Hero [6c Ts]
Dealt to 4e5ae3cb 
Dealt to a2b7d805 
Dealt to 4afebef 
Dealt to c35cd20e 
Dealt to 3e301744 
4afebef: folds
c35cd20e: raises $0.08 to $0.13
3e301744: folds
Hero: folds
4e5ae3cb: folds
a2b7d805: calls $0.08
*** FLOP *** [Kh 4d Th]
a2b7d805: checks
c35cd20e: bets $0.14
a2b7d805: folds
Uncalled bet ($0.14) returned to c35cd20e
*** SHOWDOWN ***
c35cd20e collected $0.27 from pot
*** SUMMARY ***
Total pot $0.28 | Rake $0.01 | Jackpot $0 | Bingo $0 | Fortune $0 | Tax $0
Board [Kh 4d Th]
Seat 1: Hero (button) folded before Flop (didn't bet)
Seat 2: 4e5ae3cb (small blind) folded before Flop
Seat 3: a2b7d805 (big blind) folded on the Flop
Seat 4: 4afebef folded before Flop (didn't bet)
Seat 5: c35cd20e won ($0.27)
Seat 6: 3e301744 folded before Flop (didn't bet)


Poker Hand #RC3334561266: Hold'em No Limit ($0.02/$0.05) - 2025/02/17 21:27:29
Table 'RushAndCash626526' 6-max Seat #1 is the button
Seat 1: Hero ($8.89 in chips)
Seat 2: 4a2c171f ($5.65 in chips)
Seat 3: 47d6aff8 ($5.1 in chips)
Seat 4: 69c3afd2 ($4.72 in chips)
Seat 5: 229ec9a7 ($8.88 in chips)
Seat 6: ef96c0c8 ($5 in chips)
4a2c171f: posts small blind $0.02
47d6aff8: posts big blind $0.05
*** HOLE CARDS ***
Dealt to Hero [Kd 3c]
Dealt to 4a2c171f 
Dealt to 47d6aff8 
Dealt to 69c3afd2 
Dealt to 229ec9a7 
Dealt to ef96c0c8 
69c3afd2: folds
229ec9a7: folds
ef96c0c8: folds
Hero: folds
4a2c171f: folds
Uncalled bet ($0.03) returned to 47d6aff8
*** SHOWDOWN ***
47d6aff8 collected $0.04 from pot
*** SUMMARY ***
Total pot $0.04 | Rake $0 | Jackpot $0 | Bingo $0 | Fortune $0 | Tax $0
Seat 1: Hero (button) folded before Flop (didn't bet)
Seat 2: 4a2c171f (small blind) folded before Flop
Seat 3: 47d6aff8 (big blind) collected ($0.04)
Seat 4: 69c3afd2 folded before Flop (didn't bet)
Seat 5: 229ec9a7 folded before Flop (didn't bet)
Seat 6: ef96c0c8 folded before Flop (didn't bet)


Poker Hand #RC3334560828: Hold'em No Limit ($0.02/$0.05) - 2025/02/17 21:26:37
Table 'RushAndCash626088' 6-max Seat #1 is the button
Seat 1: b0d0d63c ($12.62 in chips)
Seat 2: 69c3afd2 ($4.85 in chips)
Seat 3: Hero ($8.65 in chips)
Seat 4: 229ec9a7 ($9.01 in chips)
Seat 5: fad7078a ($6.38 in chips)
Seat 6: 9fa2589a ($3.56 in chips)
69c3afd2: posts small blind $0.02
Hero: posts big blind $0.05
*** HOLE CARDS ***
Dealt to b0d0d63c 
Dealt to 69c3afd2 
Dealt to Hero [Th 8h]
Dealt to 229ec9a7 
Dealt to fad7078a 
Dealt to 9fa2589a 
229ec9a7: raises $0.08 to $0.13
fad7078a: folds
9fa2589a: folds
b0d0d63c: folds
69c3afd2: calls $0.11
Hero: calls $0.08
*** FLOP *** [Kc 6s 5s]
69c3afd2: checks
Hero: checks
229ec9a7: checks
*** TURN *** [Kc 6s 5s] [Kd]
69c3afd2: checks
Hero: checks
229ec9a7: checks
*** RIVER *** [Kc 6s 5s Kd] [8s]
69c3afd2: checks
Hero: checks
229ec9a7: checks
69c3afd2: shows [Qs 9c] (Pair of Kings)
Hero: shows [Th 8h] (Pair of Kings and Pair of Eights)
229ec9a7: shows [Qc Ad] (Pair of Kings)
*** SHOWDOWN ***
Hero collected $0.37 from pot
*** SUMMARY ***
Total pot $0.39 | Rake $0.02 | Jackpot $0 | Bingo $0 | Fortune $0 | Tax $0
Board [Kc 6s 5s Kd 8s]
Seat 1: b0d0d63c (button) folded before Flop (didn't bet)
Seat 2: 69c3afd2 (small blind) showed [Qs 9c] and lost with Pair of Kings
Seat 3: Hero (big blind) showed [Th 8h] and won ($0.37) with Pair of Kings and Pair of Eights
Seat 4: 229ec9a7 showed [Qc Ad] and lost with Pair of Kings
Seat 5: fad7078a folded before Flop (didn't bet)
Seat 6: 9fa2589a folded before Flop (didn't bet)


Poker Hand #RC3334560799: Hold'em No Limit ($0.02/$0.05) - 2025/02/17 21:26:34
Table 'RushAndCash626059' 6-max Seat #1 is the button
Seat 1: a2b7d805 ($5.29 in chips)
Seat 2: eb21bc62 ($3.73 in chips)
Seat 3: 5b97e983 ($5.92 in chips)
Seat 4: Hero ($8.65 in chips)
Seat 5: 8f9fd8b1 ($12.81 in chips)
Seat 6: e4d8df1d ($8.46 in chips)
eb21bc62: posts small blind $0.02
5b97e983: posts big blind $0.05
*** HOLE CARDS ***
Dealt to a2b7d805 
Dealt to eb21bc62 
Dealt to 5b97e983 
Dealt to Hero [Th 7h]
Dealt to 8f9fd8b1 
Dealt to e4d8df1d 
Hero: folds
8f9fd8b1: folds
e4d8df1d: folds
a2b7d805: raises $0.08 to $0.13
eb21bc62: folds
5b97e983: folds
Uncalled bet ($0.08) returned to a2b7d805
*** SHOWDOWN ***
a2b7d805 collected $0.12 from pot
*** SUMMARY ***
Total pot $0.12 | Rake $0 | Jackpot $0 | Bingo $0 | Fortune $0 | Tax $0
Seat 1: a2b7d805 (button) collected ($0.12)
Seat 2: eb21bc62 (small blind) folded before Flop
Seat 3: 5b97e983 (big blind) folded before Flop
Seat 4: Hero folded before Flop (didn't bet)
Seat 5: 8f9fd8b1 folded before Flop (didn't bet)
Seat 6: e4d8df1d folded before Flop (didn't bet)


Poker Hand #RC3334560774: Hold'em No Limit ($0.02/$0.05) - 2025/02/17 21:26:31
Table 'RushAndCash626034' 6-max Seat #1 is the button
Seat 1: 5bf5cd50 ($5.85 in chips)
Seat 2: 577bd292 ($5.38 in chips)
Seat 3: ba806aaa ($2.72 in chips)
Seat 4: 180915b9 ($5.76 in chips)
Seat 5: b0d0d63c ($12.62 in chips)
Seat 6: Hero ($8.65 in chips)
577bd292: posts small blind $0.02
ba806aaa: posts big blind $0.05
*** HOLE CARDS ***
Dealt to 5bf5cd50 
Dealt to 577bd292 
Dealt to ba806aaa 
Dealt to 180915b9 
Dealt to b0d0d63c 
Dealt to Hero [3h 5c]
180915b9: folds
b0d0d63c: folds
Hero: folds
5bf5cd50: folds
577bd292: raises $0.08 to $0.13
ba806aaa: calls $0.08
*** FLOP *** [Ks 9h 4c]
577bd292: checks
ba806aaa: checks
*** TURN *** [Ks 9h 4c] [Jd]
577bd292: checks
ba806aaa: bets $0.5
577bd292: folds
Uncalled bet ($0.5) returned to ba806aaa
*** SHOWDOWN ***
ba806aaa collected $0.25 from pot
*** SUMMARY ***
Total pot $0.26 | Rake $0.01 | Jackpot $0 | Bingo $0 | Fortune $0 | Tax $0
Board [Ks 9h 4c Jd]
Seat 1: 5bf5cd50 (button) folded before Flop (didn't bet)
Seat 2: 577bd292 (small blind) folded on the Turn
Seat 3: ba806aaa (big blind) won ($0.25)
Seat 4: 180915b9 folded before Flop (didn't bet)
Seat 5: b0d0d63c folded before Flop (didn't bet)
Seat 6: Hero folded before Flop (didn't bet)


Poker Hand #RC3334560662: Hold'em No Limit ($0.02/$0.05) - 2025/02/17 21:26:18
Table 'RushAndCash625922' 6-max Seat #1 is the button
Seat 1: b88dd991 ($5 in chips)
Seat 2: Hero ($8.6 in chips)
Seat 3: 8f77797e ($5.39 in chips)
Seat 4: ac6c5037 ($6.27 in chips)
Seat 5: 54fe77bd ($12.82 in chips)
Seat 6: 6c641898 ($5.07 in chips)
Hero: posts small blind $0.02
8f77797e: posts big blind $0.05
*** HOLE CARDS ***
Dealt to b88dd991 
Dealt to Hero [8h Qh]
Dealt to 8f77797e 
Dealt to ac6c5037 
Dealt to 54fe77bd 
Dealt to 6c641898 
ac6c5037: folds
54fe77bd: folds
6c641898: folds
b88dd991: folds
Hero: calls $0.03
8f77797e: checks
*** FLOP *** [6d 2s Tc]
Hero: checks
8f77797e: checks
*** TURN *** [6d 2s Tc] [9d]
Hero: bets $0.05
8f77797e: folds
Uncalled bet ($0.05) returned to Hero
*** SHOWDOWN ***
Hero collected $0.1 from pot
*** SUMMARY ***
Total pot $0.1 | Rake $0 | Jackpot $0 | Bingo $0 | Fortune $0 | Tax $0
Board [6d 2s Tc 9d]
Seat 1: b88dd991 (button) folded before Flop (didn't bet)
Seat 2: Hero (small blind) won ($0.1)
Seat 3: 8f77797e (big blind) folded on the Turn
Seat 4: ac6c5037 folded before Flop (didn't bet)
Seat 5: 54fe77bd folded before Flop (didn't bet)
Seat 6: 6c641898 folded before Flop (didn't bet)


Poker Hand #RC3334560631: Hold'em No Limit ($0.02/$0.05) - 2025/02/17 21:26:14
Table 'RushAndCash625891' 6-max Seat #1 is the button
Seat 1: aeb50acd ($5.19 in chips)
Seat 2: b4c33f6c ($6.72 in chips)
Seat 3: 46f37de2 ($5.24 in chips)
Seat 4: 9b09147b ($5.61 in chips)
Seat 5: 67b2dab9 ($5.14 in chips)
Seat 6: Hero ($8.6 in chips)
b4c33f6c: posts small blind $0.02
46f37de2: posts big blind $0.05
*** HOLE CARDS ***
Dealt to aeb50acd 
Dealt to b4c33f6c 
Dealt to 46f37de2 
Dealt to 9b09147b 
Dealt to 67b2dab9 
Dealt to Hero [4c 8d]
9b09147b: folds
67b2dab9: folds
Hero: folds
aeb50acd: raises $0.09 to $0.14
b4c33f6c: folds
46f37de2: calls $0.09
*** FLOP *** [Qs Qc 3c]
46f37de2: checks
aeb50acd: bets $0.15
46f37de2: calls $0.15
*** TURN *** [Qs Qc 3c] [5d]
46f37de2: checks
aeb50acd: bets $0.3
46f37de2: raises $0.9 to $1.2
aeb50acd: calls $0.9
*** RIVER *** [Qs Qc 3c 5d] [Ad]
46f37de2: bets $0.99
aeb50acd: raises $2.71 to $3.7 and is all-in
46f37de2: calls $2.71
aeb50acd: shows [5h 5s] (Fives Full over Queens)
46f37de2: shows [5c 7c] (Pair of Queens and Pair of Fives)
*** SHOWDOWN ***
aeb50acd collected $10.18 from pot
*** SUMMARY ***
Total pot $10.4 | Rake $0.15 | Jackpot $0.07 | Bingo $0 | Fortune $0 | Tax $0
Board [Qs Qc 3c 5d Ad]
Seat 1: aeb50acd (button) showed [5h 5s] and won ($10.18) with Fives Full over Queens
Seat 2: b4c33f6c (small blind) folded before Flop
Seat 3: 46f37de2 (big blind) showed [5c 7c] and lost with Pair of Queens and Pair of Fives
Seat 4: 9b09147b folded before Flop (didn't bet)
Seat 5: 67b2dab9 folded before Flop (didn't bet)
Seat 6: Hero folded before Flop (didn't bet)


Poker Hand #RC3334560475: Hold'em No Limit ($0.02/$0.05) - 2025/02/17 21:25:55
Table 'RushAndCash625735' 6-max Seat #1 is the button
Seat 1: 9f09d482 ($11.08 in chips)
Seat 2: f52f15b4 ($1.74 in chips)
Seat 3: 9e5a32b5 ($11.06 in chips)
Seat 4: 21bff972 ($5.63 in chips)
Seat 5: 9ccadbb5 ($10.04 in chips)
Seat 6: Hero ($8.53 in chips)
f52f15b4: posts small blind $0.02
9e5a32b5: posts big blind $0.05
*** HOLE CARDS ***
Dealt to 9f09d482 
Dealt to f52f15b4 
Dealt to 9e5a32b5 
Dealt to 21bff972 
Dealt to 9ccadbb5 
Dealt to Hero [Kd Qh]
21bff972: folds
9ccadbb5: folds
Hero: raises $0.05 to $0.1
9f09d482: folds
f52f15b4: folds
9e5a32b5: folds
Uncalled bet ($0.05) returned to Hero
*** SHOWDOWN ***
Hero collected $0.12 from pot
*** SUMMARY ***
Total pot $0.12 | Rake $0 | Jackpot $0 | Bingo $0 | Fortune $0 | Tax $0
Seat 1: 9f09d482 (button) folded before Flop (didn't bet)
Seat 2: f52f15b4 (small blind) folded before Flop
Seat 3: 9e5a32b5 (big blind) folded before Flop
Seat 4: 21bff972 folded before Flop (didn't bet)
Seat 5: 9ccadbb5 folded before Flop (didn't bet)
Seat 6: Hero collected ($0.12)


Poker Hand #RC3334560437: Hold'em No Limit ($0.02/$0.05) - 2025/02/17 21:25:50
Table 'RushAndCash625697' 6-max Seat #1 is the button
Seat 1: Hero ($8.53 in chips)
Seat 2: 24aff26b ($9.03 in chips)
Seat 3: ccabd9d2 ($4.57 in chips)
Seat 4: 167e28c4 ($10.04 in chips)
Seat 5: 5f0ff48e ($5.16 in chips)
Seat 6: af90d8d7 ($4.93 in chips)
24aff26b: posts small blind $0.02
ccabd9d2: posts big blind $0.05
*** HOLE CARDS ***
Dealt to Hero [6s 8h]
Dealt to 24aff26b 
Dealt to ccabd9d2 
Dealt to 167e28c4 
Dealt to 5f0ff48e 
Dealt to af90d8d7 
167e28c4: folds
5f0ff48e: folds
af90d8d7: raises $0.08 to $0.13
Hero: folds
24aff26b: folds
ccabd9d2: folds
Uncalled bet ($0.08) returned to af90d8d7
*** SHOWDOWN ***
af90d8d7 collected $0.12 from pot
*** SUMMARY ***
Total pot $0.12 | Rake $0 | Jackpot $0 | Bingo $0 | Fortune $0 | Tax $0
Seat 1: Hero (button) folded before Flop (didn't bet)
Seat 2: 24aff26b (small blind) folded before Flop
Seat 3: ccabd9d2 (big blind) folded before Flop
Seat 4: 167e28c4 folded before Flop (didn't bet)
Seat 5: 5f0ff48e folded before Flop (didn't bet)
Seat 6: af90d8d7 collected ($0.12)


Poker Hand #RC3334560167: Hold'em No Limit ($0.02/$0.05) - 2025/02/17 21:25:19
Table 'RushAndCash625427' 6-max Seat #1 is the button
Seat 1: 2e8ab509 ($5.43 in chips)
Seat 2: c585480d ($11.52 in chips)
Seat 3: Hero ($8.42 in chips)
Seat 4: a8fd1cce ($5.09 in chips)
Seat 5: 7dd18ea7 ($12.27 in chips)
Seat 6: 37bc5b77 ($5 in chips)
c585480d: posts small blind $0.02
Hero: posts big blind $0.05
*** HOLE CARDS ***
Dealt to 2e8ab509 
Dealt to c585480d 
Dealt to Hero [Tc Ts]
Dealt to a8fd1cce 
Dealt to 7dd18ea7 
Dealt to 37bc5b77 
a8fd1cce: folds
7dd18ea7: raises $0.05 to $0.1
37bc5b77: folds
2e8ab509: folds
c585480d: folds
Hero: calls $0.05
*** FLOP *** [Jc 3s 5c]
Hero: checks
7dd18ea7: checks
*** TURN *** [Jc 3s 5c] [As]
Hero: checks
7dd18ea7: checks
*** RIVER *** [Jc 3s 5c As] [8h]
Hero: checks
7dd18ea7: checks
Hero: shows [Tc Ts] (Pair of Tens)
7dd18ea7: shows [Ks Qh] (Ace-High)
*** SHOWDOWN ***
Hero collected $0.21 from pot
*** SUMMARY ***
Total pot $0.22 | Rake $0.01 | Jackpot $0 | Bingo $0 | Fortune $0 | Tax $0
Board [Jc 3s 5c As 8h]
Seat 1: 2e8ab509 (button) folded before Flop (didn't bet)
Seat 2: c585480d (small blind) folded before Flop
Seat 3: Hero (big blind) showed [Tc Ts] and won ($0.21) with Pair of Tens
Seat 4: a8fd1cce folded before Flop (didn't bet)
Seat 5: 7dd18ea7 showed [Ks Qh] and lost with Ace-High
Seat 6: 37bc5b77 folded before Flop (didn't bet)


Poker Hand #RC3334560065: Hold'em No Limit ($0.02/$0.05) - 2025/02/17 21:25:07
Table 'RushAndCash625325' 6-max Seat #1 is the button
Seat 1: 80c22e34 ($6.57 in chips)
Seat 2: Hero ($8.44 in chips)
Seat 3: 167e28c4 ($10.18 in chips)
Seat 4: 11224f8 ($5 in chips)
Seat 5: b54d616e ($5 in chips)
Seat 6: fc77b046 ($7.7 in chips)
Hero: posts small blind $0.02
167e28c4: posts big blind $0.05
*** HOLE CARDS ***
Dealt to 80c22e34 
Dealt to Hero [6c 3c]
Dealt to 167e28c4 
Dealt to 11224f8 
Dealt to b54d616e 
Dealt to fc77b046 
11224f8: folds
b54d616e: folds
fc77b046: folds
80c22e34: raises $0.08 to $0.13
Hero: folds
167e28c4: folds
Uncalled bet ($0.08) returned to 80c22e34
*** SHOWDOWN ***
80c22e34 collected $0.12 from pot
*** SUMMARY ***
Total pot $0.12 | Rake $0 | Jackpot $0 | Bingo $0 | Fortune $0 | Tax $0
Seat 1: 80c22e34 (button) collected ($0.12)
Seat 2: Hero (small blind) folded before Flop
Seat 3: 167e28c4 (big blind) folded before Flop
Seat 4: 11224f8 folded before Flop (didn't bet)
Seat 5: b54d616e folded before Flop (didn't bet)
Seat 6: fc77b046 folded before Flop (didn't bet)


Poker Hand #RC3334560017: Hold'em No Limit ($0.02/$0.05) - 2025/02/17 21:25:01
Table 'RushAndCash625277' 6-max Seat #1 is the button
Seat 1: f18b40b7 ($6.53 in chips)
Seat 2: c6e11d19 ($5.07 in chips)
Seat 3: 6ac4af54 ($13.3 in chips)
Seat 4: beffcf8a ($5 in chips)
Seat 5: 21e0e4ee ($5.02 in chips)
Seat 6: Hero ($8.44 in chips)
c6e11d19: posts small blind $0.02
6ac4af54: posts big blind $0.05
*** HOLE CARDS ***
Dealt to f18b40b7 
Dealt to c6e11d19 
Dealt to 6ac4af54 
Dealt to beffcf8a 
Dealt to 21e0e4ee 
Dealt to Hero [Ts 5h]
beffcf8a: folds
21e0e4ee: raises $0.07 to $0.12
Hero: folds
f18b40b7: raises $0.11 to $0.23
c6e11d19: folds
6ac4af54: folds
21e0e4ee: calls $0.11
*** FLOP *** [Jc 2s Th]
21e0e4ee: checks
f18b40b7: checks
*** TURN *** [Jc 2s Th] [3s]
21e0e4ee: checks
f18b40b7: bets $0.27
21e0e4ee: folds
Uncalled bet ($0.27) returned to f18b40b7
*** SHOWDOWN ***
f18b40b7 collected $0.51 from pot
*** SUMMARY ***
Total pot $0.53 | Rake $0.02 | Jackpot $0 | Bingo $0 | Fortune $0 | Tax $0
Board [Jc 2s Th 3s]
Seat 1: f18b40b7 (button) won ($0.51)
Seat 2: c6e11d19 (small blind) folded before Flop
Seat 3: 6ac4af54 (big blind) folded before Flop
Seat 4: beffcf8a folded before Flop (didn't bet)
Seat 5: 21e0e4ee folded on the Turn
Seat 6: Hero folded before Flop (didn't bet)


Poker Hand #RC3334559970: Hold'em No Limit ($0.02/$0.05) - 2025/02/17 21:24:55
Table 'RushAndCash625230' 6-max Seat #1 is the button
Seat 1: Hero ($8.44 in chips)
Seat 2: 4b3dba4 ($7.14 in chips)
Seat 3: 21be8833 ($5 in chips)
Seat 4: 4238ab48 ($7.35 in chips)
Seat 5: bfef046a ($18.32 in chips)
Seat 6: 5337265e ($7.83 in chips)
4b3dba4: posts small blind $0.02
21be8833: posts big blind $0.05
*** HOLE CARDS ***
Dealt to Hero [Kh 6s]
Dealt to 4b3dba4 
Dealt to 21be8833 
Dealt to 4238ab48 
Dealt to bfef046a 
Dealt to 5337265e 
4238ab48: folds
bfef046a: folds
5337265e: folds
Hero: folds
4b3dba4: folds
Uncalled bet ($0.03) returned to 21be8833
*** SHOWDOWN ***
21be8833 collected $0.04 from pot
*** SUMMARY ***
Total pot $0.04 | Rake $0 | Jackpot $0 | Bingo $0 | Fortune $0 | Tax $0
Seat 1: Hero (button) folded before Flop (didn't bet)
Seat 2: 4b3dba4 (small blind) folded before Flop
Seat 3: 21be8833 (big blind) collected ($0.04)
Seat 4: 4238ab48 folded before Flop (didn't bet)
Seat 5: bfef046a folded before Flop (didn't bet)
Seat 6: 5337265e folded before Flop (didn't bet)


Poker Hand #RC3334559945: Hold'em No Limit ($0.02/$0.05) - 2025/02/17 21:24:52
Table 'RushAndCash625205' 6-max Seat #1 is the button
Seat 1: d691d846 ($3.24 in chips)
Seat 2: 86b969db ($5.02 in chips)
Seat 3: 598d859f ($15.1 in chips)
Seat 4: Hero ($8.44 in chips)
Seat 5: bc8371cb ($6.84 in chips)
Seat 6: be461b7a ($5.36 in chips)
86b969db: posts small blind $0.02
598d859f: posts big blind $0.05
*** HOLE CARDS ***
Dealt to d691d846 
Dealt to 86b969db 
Dealt to 598d859f 
Dealt to Hero [5c 3c]
Dealt to bc8371cb 
Dealt to be461b7a 
Hero: folds
bc8371cb: folds
be461b7a: folds
d691d846: folds
86b969db: folds
Uncalled bet ($0.03) returned to 598d859f
*** SHOWDOWN ***
598d859f collected $0.04 from pot
*** SUMMARY ***
Total pot $0.04 | Rake $0 | Jackpot $0 | Bingo $0 | Fortune $0 | Tax $0
Seat 1: d691d846 (button) folded before Flop (didn't bet)
Seat 2: 86b969db (small blind) folded before Flop
Seat 3: 598d859f (big blind) collected ($0.04)
Seat 4: Hero folded before Flop (didn't bet)
Seat 5: bc8371cb folded before Flop (didn't bet)
Seat 6: be461b7a folded before Flop (didn't bet)


Poker Hand #RC3334559867: Hold'em No Limit ($0.02/$0.05) - 2025/02/17 21:24:41
Table 'RushAndCash625127' 6-max Seat #1 is the button
Seat 1: 3b85f8e6 ($12.64 in chips)
Seat 2: Hero ($8.39 in chips)
Seat 3: 8c1d44c9 ($5.96 in chips)
Seat 4: 4812f5c8 ($5 in chips)
Seat 5: c0f2432 ($4.39 in chips)
Seat 6: 54fe77bd ($13.02 in chips)
Hero: posts small blind $0.02
8c1d44c9: posts big blind $0.05
*** HOLE CARDS ***
Dealt to 3b85f8e6 
Dealt to Hero [Qs Kd]
Dealt to 8c1d44c9 
Dealt to 4812f5c8 
Dealt to c0f2432 
Dealt to 54fe77bd 
4812f5c8: folds
c0f2432: folds
54fe77bd: folds
3b85f8e6: folds
Hero: raises $0.1 to $0.15
8c1d44c9: folds
Uncalled bet ($0.1) returned to Hero
*** SHOWDOWN ***
Hero collected $0.1 from pot
*** SUMMARY ***
Total pot $0.1 | Rake $0 | Jackpot $0 | Bingo $0 | Fortune $0 | Tax $0
Seat 1: 3b85f8e6 (button) folded before Flop (didn't bet)
Seat 2: Hero (small blind) collected ($0.1)
Seat 3: 8c1d44c9 (big blind) folded before Flop
Seat 4: 4812f5c8 folded before Flop (didn't bet)
Seat 5: c0f2432 folded before Flop (didn't bet)
Seat 6: 54fe77bd folded before Flop (didn't bet)


Poker Hand #RC3334559435: Hold'em No Limit ($0.02/$0.05) - 2025/02/17 21:23:47
Table 'RushAndCash624695' 6-max Seat #1 is the button
Seat 1: bc8371cb ($6.91 in chips)
Seat 2: 69c3afd2 ($5.53 in chips)
Seat 3: Hero ($7.88 in chips)
Seat 4: aa2d17c0 ($5.8 in chips)
Seat 5: 442376ec ($5.65 in chips)
Seat 6: 8f9fd8b1 ($13.47 in chips)
69c3afd2: posts small blind $0.02
Hero: posts big blind $0.05
*** HOLE CARDS ***
Dealt to bc8371cb 
Dealt to 69c3afd2 
Dealt to Hero [8s 8h]
Dealt to aa2d17c0 
Dealt to 442376ec 
Dealt to 8f9fd8b1 
aa2d17c0: folds
442376ec: folds
8f9fd8b1: raises $0.07 to $0.12
bc8371cb: folds
69c3afd2: folds
Hero: calls $0.07
*** FLOP *** [8d Kh 4h]
Hero: checks
8f9fd8b1: checks
*** TURN *** [8d Kh 4h] [Ks]
Hero: bets $0.14
8f9fd8b1: calls $0.14
*** RIVER *** [8d Kh 4h Ks] [6d]
Hero: bets $0.28
8f9fd8b1: calls $0.28
Hero: shows [8s 8h] (Eights Full over Kings)
8f9fd8b1: shows [Js As] (Pair of Kings)
*** SHOWDOWN ***
Hero collected $1.05 from pot
*** SUMMARY ***
Total pot $1.1 | Rake $0.05 | Jackpot $0 | Bingo $0 | Fortune $0 | Tax $0
Board [8d Kh 4h Ks 6d]
Seat 1: bc8371cb (button) folded before Flop (didn't bet)
Seat 2: 69c3afd2 (small blind) folded before Flop
Seat 3: Hero (big blind) showed [8s 8h] and won ($1.05) with Eights Full over Kings
Seat 4: aa2d17c0 folded before Flop (didn't bet)
Seat 5: 442376ec folded before Flop (didn't bet)
Seat 6: 8f9fd8b1 showed [Js As] and lost with Pair of Kings


Poker Hand #RC3334559410: Hold'em No Limit ($0.02/$0.05) - 2025/02/17 21:23:44
Table 'RushAndCash624670' 6-max Seat #1 is the button
Seat 1: 1b6c31ec ($7.58 in chips)
Seat 2: 95d29c49 ($5.51 in chips)
Seat 3: 4506a4f6 ($5.46 in chips)
Seat 4: b48f0b59 ($5.72 in chips)
Seat 5: Hero ($7.88 in chips)
Seat 6: e87181cd ($5.3 in chips)
95d29c49: posts small blind $0.02
4506a4f6: posts big blind $0.05
*** HOLE CARDS ***
Dealt to 1b6c31ec 
Dealt to 95d29c49 
Dealt to 4506a4f6 
Dealt to b48f0b59 
Dealt to Hero [Qc Ts]
Dealt to e87181cd 
b48f0b59: folds
Hero: folds
e87181cd: folds
1b6c31ec: folds
95d29c49: raises $0.05 to $0.1
4506a4f6: calls $0.05
*** FLOP *** [4s 8d 6s]
95d29c49: bets $0.05
4506a4f6: raises $0.15 to $0.2
95d29c49: folds
Uncalled bet ($0.15) returned to 4506a4f6
*** SHOWDOWN ***
4506a4f6 collected $0.29 from pot
*** SUMMARY ***
Total pot $0.3 | Rake $0.01 | Jackpot $0 | Bingo $0 | Fortune $0 | Tax $0
Board [4s 8d 6s]
Seat 1: 1b6c31ec (button) folded before Flop (didn't bet)
Seat 2: 95d29c49 (small blind) folded on the Flop
Seat 3: 4506a4f6 (big blind) won ($0.29)
Seat 4: b48f0b59 folded before Flop (didn't bet)
Seat 5: Hero folded before Flop (didn't bet)
Seat 6: e87181cd folded before Flop (didn't bet)


Poker Hand #RC3334559116: Hold'em No Limit ($0.02/$0.05) - 2025/02/17 21:23:07
Table 'RushAndCash624376' 6-max Seat #1 is the button
Seat 1: e8a5680c ($5.31 in chips)
Seat 2: 5ddfff80 ($4.83 in chips)
Seat 3: 95d29c49 ($5.78 in chips)
Seat 4: a63aa4b7 ($17.23 in chips)
Seat 5: 1e474bac ($5 in chips)
Seat 6: Hero ($7.61 in chips)
5ddfff80: posts small blind $0.02
95d29c49: posts big blind $0.05
*** HOLE CARDS ***
Dealt to e8a5680c 
Dealt to 5ddfff80 
Dealt to 95d29c49 
Dealt to a63aa4b7 
Dealt to 1e474bac 
Dealt to Hero [Ks Tc]
a63aa4b7: folds
1e474bac: folds
Hero: raises $0.05 to $0.1
e8a5680c: folds
5ddfff80: folds
95d29c49: calls $0.05
*** FLOP *** [2s Jc As]
95d29c49: checks
Hero: checks
*** TURN *** [2s Jc As] [3s]
95d29c49: bets $0.17
Hero: calls $0.17
*** RIVER *** [2s Jc As 3s] [Qs]
95d29c49: checks
Hero: bets $0.42
95d29c49: folds
Uncalled bet ($0.42) returned to Hero
*** SHOWDOWN ***
Hero collected $0.54 from pot
*** SUMMARY ***
Total pot $0.56 | Rake $0.02 | Jackpot $0 | Bingo $0 | Fortune $0 | Tax $0
Board [2s Jc As 3s Qs]
Seat 1: e8a5680c (button) folded before Flop (didn't bet)
Seat 2: 5ddfff80 (small blind) folded before Flop
Seat 3: 95d29c49 (big blind) folded on the River
Seat 4: a63aa4b7 folded before Flop (didn't bet)
Seat 5: 1e474bac folded before Flop (didn't bet)
Seat 6: Hero won ($0.54)


Poker Hand #RC3334558974: Hold'em No Limit ($0.02/$0.05) - 2025/02/17 21:22:48
Table 'RushAndCash624234' 6-max Seat #1 is the button
Seat 1: Hero ($7.71 in chips)
Seat 2: 81004403 ($4.97 in chips)
Seat 3: e8a5680c ($5.2 in chips)
Seat 4: cf7f09c2 ($16.71 in chips)
Seat 5: 50254767 ($5.51 in chips)
Seat 6: d201e5fe ($9.13 in chips)
81004403: posts small blind $0.02
e8a5680c: posts big blind $0.05
*** HOLE CARDS ***
Dealt to Hero [As 7d]
Dealt to 81004403 
Dealt to e8a5680c 
Dealt to cf7f09c2 
Dealt to 50254767 
Dealt to d201e5fe 
cf7f09c2: folds
50254767: folds
d201e5fe: folds
Hero: raises $0.05 to $0.1
81004403: folds
e8a5680c: raises $0.32 to $0.42
Hero: folds
Uncalled bet ($0.32) returned to e8a5680c
*** SHOWDOWN ***
e8a5680c collected $0.21 from pot
*** SUMMARY ***
Total pot $0.22 | Rake $0.01 | Jackpot $0 | Bingo $0 | Fortune $0 | Tax $0
Seat 1: Hero (button) folded before Flop
Seat 2: 81004403 (small blind) folded before Flop
Seat 3: e8a5680c (big blind) collected ($0.21)
Seat 4: cf7f09c2 folded before Flop (didn't bet)
Seat 5: 50254767 folded before Flop (didn't bet)
Seat 6: d201e5fe folded before Flop (didn't bet)


Poker Hand #RC3334558945: Hold'em No Limit ($0.02/$0.05) - 2025/02/17 21:22:45
Table 'RushAndCash624205' 6-max Seat #1 is the button
Seat 1: 6be17d4e ($6.57 in chips)
Seat 2: 92fa3d91 ($5.03 in chips)
Seat 3: d037279c ($5 in chips)
Seat 4: c5f37c20 ($2.72 in chips)
Seat 5: Hero ($7.71 in chips)
Seat 6: a223d3ca ($5.05 in chips)
92fa3d91: posts small blind $0.02
d037279c: posts big blind $0.05
*** HOLE CARDS ***
Dealt to 6be17d4e 
Dealt to 92fa3d91 
Dealt to d037279c 
Dealt to c5f37c20 
Dealt to Hero [4h 5s]
Dealt to a223d3ca 
c5f37c20: folds
Hero: folds
a223d3ca: folds
6be17d4e: raises $0.08 to $0.13
92fa3d91: folds
d037279c: folds
Uncalled bet ($0.08) returned to 6be17d4e
*** SHOWDOWN ***
6be17d4e collected $0.12 from pot
*** SUMMARY ***
Total pot $0.12 | Rake $0 | Jackpot $0 | Bingo $0 | Fortune $0 | Tax $0
Seat 1: 6be17d4e (button) collected ($0.12)
Seat 2: 92fa3d91 (small blind) folded before Flop
Seat 3: d037279c (big blind) folded before Flop
Seat 4: c5f37c20 folded before Flop (didn't bet)
Seat 5: Hero folded before Flop (didn't bet)
Seat 6: a223d3ca folded before Flop (didn't bet)


Poker Hand #RC3334558893: Hold'em No Limit ($0.02/$0.05) - 2025/02/17 21:22:38
Table 'RushAndCash624153' 6-max Seat #1 is the button
Seat 1: a9d8ced4 ($5 in chips)
Seat 2: a63aa4b7 ($17.3 in chips)
Seat 3: 6f565fd ($5.45 in chips)
Seat 4: a7365f1c ($6.22 in chips)
Seat 5: 42c7d5a0 ($5 in chips)
Seat 6: Hero ($7.71 in chips)
a63aa4b7: posts small blind $0.02
6f565fd: posts big blind $0.05
*** HOLE CARDS ***
Dealt to a9d8ced4 
Dealt to a63aa4b7 
Dealt to 6f565fd 
Dealt to a7365f1c 
Dealt to 42c7d5a0 
Dealt to Hero [2d Tc]
a7365f1c: folds
42c7d5a0: folds
Hero: folds
a9d8ced4: raises $0.05 to $0.1
a63aa4b7: folds
6f565fd: folds
Uncalled bet ($0.05) returned to a9d8ced4
*** SHOWDOWN ***
a9d8ced4 collected $0.12 from pot
*** SUMMARY ***
Total pot $0.12 | Rake $0 | Jackpot $0 | Bingo $0 | Fortune $0 | Tax $0
Seat 1: a9d8ced4 (button) collected ($0.12)
Seat 2: a63aa4b7 (small blind) folded before Flop
Seat 3: 6f565fd (big blind) folded before Flop
Seat 4: a7365f1c folded before Flop (didn't bet)
Seat 5: 42c7d5a0 folded before Flop (didn't bet)
Seat 6: Hero folded before Flop (didn't bet)


Poker Hand #RC3334558850: Hold'em No Limit ($0.02/$0.05) - 2025/02/17 21:22:32
Table 'RushAndCash624110' 6-max Seat #1 is the button
Seat 1: 22a3f0e8 ($5.08 in chips)
Seat 2: Hero ($7.73 in chips)
Seat 3: ae52b2e0 ($5 in chips)
Seat 4: aa08a1c ($5 in chips)
Seat 5: 3b701823 ($5.64 in chips)
Seat 6: 3ed1e77f ($5.06 in chips)
Hero: posts small blind $0.02
ae52b2e0: posts big blind $0.05
*** HOLE CARDS ***
Dealt to 22a3f0e8 
Dealt to Hero [Qs Tc]
Dealt to ae52b2e0 
Dealt to aa08a1c 
Dealt to 3b701823 
Dealt to 3ed1e77f 
aa08a1c: folds
3b701823: raises $0.08 to $0.13
3ed1e77f: folds
22a3f0e8: calls $0.13
Hero: folds
ae52b2e0: folds
*** FLOP *** [Kh Td 7h]
3b701823: bets $0.26
22a3f0e8: calls $0.26
*** TURN *** [Kh Td 7h] [4c]
3b701823: bets $0.51
22a3f0e8: calls $0.51
*** RIVER *** [Kh Td 7h 4c] [5d]
3b701823: bets $0.5
22a3f0e8: raises $3.68 to $4.18 and is all-in
3b701823: folds
Uncalled bet ($3.68) returned to 22a3f0e8
*** SHOWDOWN ***
22a3f0e8 collected $2.66 from pot
*** SUMMARY ***
Total pot $2.87 | Rake $0.14 | Jackpot $0.07 | Bingo $0 | Fortune $0 | Tax $0
Board [Kh Td 7h 4c 5d]
Seat 1: 22a3f0e8 (button) won ($2.66)
Seat 2: Hero (small blind) folded before Flop
Seat 3: ae52b2e0 (big blind) folded before Flop
Seat 4: aa08a1c folded before Flop (didn't bet)
Seat 5: 3b701823 folded on the River
Seat 6: 3ed1e77f folded before Flop (didn't bet)


Poker Hand #RC3334558621: Hold'em No Limit ($0.02/$0.05) - 2025/02/17 21:22:03
Table 'RushAndCash623881' 6-max Seat #1 is the button
Seat 1: d2fb1cd9 ($7.69 in chips)
Seat 2: 93a9dba6 ($5 in chips)
Seat 3: c7197736 ($9.14 in chips)
Seat 4: Hero ($7.25 in chips)
Seat 5: b2f44cb6 ($5.15 in chips)
Seat 6: fc99599f ($1.42 in chips)
93a9dba6: posts small blind $0.02
c7197736: posts big blind $0.05
*** HOLE CARDS ***
Dealt to d2fb1cd9 
Dealt to 93a9dba6 
Dealt to c7197736 
Dealt to Hero [Ad Ah]
Dealt to b2f44cb6 
Dealt to fc99599f 
Hero: raises $0.05 to $0.1
b2f44cb6: folds
fc99599f: folds
d2fb1cd9: folds
93a9dba6: raises $0.38 to $0.48
c7197736: folds
Hero: raises $0.76 to $1.24
93a9dba6: folds
Uncalled bet ($0.76) returned to Hero
*** SHOWDOWN ***
Hero collected $0.96 from pot
*** SUMMARY ***
Total pot $1.01 | Rake $0.05 | Jackpot $0 | Bingo $0 | Fortune $0 | Tax $0
Seat 1: d2fb1cd9 (button) folded before Flop (didn't bet)
Seat 2: 93a9dba6 (small blind) folded before Flop
Seat 3: c7197736 (big blind) folded before Flop
Seat 4: Hero collected ($0.96)
Seat 5: b2f44cb6 folded before Flop (didn't bet)
Seat 6: fc99599f folded before Flop (didn't bet)


Poker Hand #RC3334558591: Hold'em No Limit ($0.02/$0.05) - 2025/02/17 21:21:59
Table 'RushAndCash623851' 6-max Seat #1 is the button
Seat 1: e3c32f29 ($6.62 in chips)
Seat 2: 180915b9 ($5.53 in chips)
Seat 3: Hero ($7.3 in chips)
Seat 4: e8a5680c ($5.2 in chips)
Seat 5: fc99599f ($1.42 in chips)
Seat 6: 21c758a ($6.31 in chips)
180915b9: posts small blind $0.02
Hero: posts big blind $0.05
*** HOLE CARDS ***
Dealt to e3c32f29 
Dealt to 180915b9 
Dealt to Hero [3c 5s]
Dealt to e8a5680c 
Dealt to fc99599f 
Dealt to 21c758a 
e8a5680c: folds
fc99599f: folds
21c758a: folds
e3c32f29: folds
180915b9: raises $0.05 to $0.1
Hero: folds
Uncalled bet ($0.05) returned to 180915b9
*** SHOWDOWN ***
180915b9 collected $0.1 from pot
*** SUMMARY ***
Total pot $0.1 | Rake $0 | Jackpot $0 | Bingo $0 | Fortune $0 | Tax $0
Seat 1: e3c32f29 (button) folded before Flop (didn't bet)
Seat 2: 180915b9 (small blind) collected ($0.1)
Seat 3: Hero (big blind) folded before Flop
Seat 4: e8a5680c folded before Flop (didn't bet)
Seat 5: fc99599f folded before Flop (didn't bet)
Seat 6: 21c758a folded before Flop (didn't bet)


Poker Hand #RC3334558559: Hold'em No Limit ($0.02/$0.05) - 2025/02/17 21:21:55
Table 'RushAndCash623819' 6-max Seat #1 is the button
Seat 1: a63aa4b7 ($17.39 in chips)
Seat 2: b3362681 ($5.38 in chips)
Seat 3: dedffe42 ($3.1 in chips)
Seat 4: ab43c8b8 ($6.28 in chips)
Seat 5: e20e5cfc ($5.41 in chips)
Seat 6: Hero ($7.3 in chips)
b3362681: posts small blind $0.02
dedffe42: posts big blind $0.05
*** HOLE CARDS ***
Dealt to a63aa4b7 
Dealt to b3362681 
Dealt to dedffe42 
Dealt to ab43c8b8 
Dealt to e20e5cfc 
Dealt to Hero [9h 7c]
ab43c8b8: raises $0.05 to $0.1
e20e5cfc: folds
Hero: folds
a63aa4b7: folds
b3362681: folds
dedffe42: calls $0.05
*** FLOP *** [Ac 7s Tc]
dedffe42: checks
ab43c8b8: bets $0.13
dedffe42: calls $0.13
*** TURN *** [Ac 7s Tc] [Ad]
dedffe42: checks
ab43c8b8: bets $0.26
dedffe42: calls $0.26
*** RIVER *** [Ac 7s Tc Ad] [4c]
dedffe42: checks
ab43c8b8: bets $0.43
dedffe42: raises $1.23 to $1.66
ab43c8b8: raises $4.13 to $5.79 and is all-in
dedffe42: calls $0.95 and is all-in
Uncalled bet ($3.18) returned to ab43c8b8
ab43c8b8: shows [Ah Ts] (Aces Full over Tens)
dedffe42: shows [As 4s] (Aces Full over Fours)
*** SHOWDOWN ***
ab43c8b8 collected $6 from pot
*** SUMMARY ***
Total pot $6.22 | Rake $0.15 | Jackpot $0.07 | Bingo $0 | Fortune $0 | Tax $0
Board [Ac 7s Tc Ad 4c]
Seat 1: a63aa4b7 (button) folded before Flop (didn't bet)
Seat 2: b3362681 (small blind) folded before Flop
Seat 3: dedffe42 (big blind) showed [As 4s] and lost with Aces Full over Fours
Seat 4: ab43c8b8 showed [Ah Ts] and won ($6) with Aces Full over Tens
Seat 5: e20e5cfc folded before Flop (didn't bet)
Seat 6: Hero folded before Flop (didn't bet)


Poker Hand #RC3334558507: Hold'em No Limit ($0.02/$0.05) - 2025/02/17 21:21:49
Table 'RushAndCash623767' 6-max Seat #1 is the button
Seat 1: Hero ($7.3 in chips)
Seat 2: b282789b ($11.69 in chips)
Seat 3: a39b5beb ($5.07 in chips)
Seat 4: a0b33aca ($5.01 in chips)
Seat 5: c7e9103c ($12.16 in chips)
Seat 6: b9d877b0 ($5 in chips)
b282789b: posts small blind $0.02
a39b5beb: posts big blind $0.05
*** HOLE CARDS ***
Dealt to Hero [9c 7s]
Dealt to b282789b 
Dealt to a39b5beb 
Dealt to a0b33aca 
Dealt to c7e9103c 
Dealt to b9d877b0 
a0b33aca: folds
c7e9103c: folds
b9d877b0: folds
Hero: folds
b282789b: raises $0.1 to $0.15
a39b5beb: calls $0.1
*** FLOP *** [2d 2h Qc]
b282789b: checks
a39b5beb: bets $0.15
b282789b: calls $0.15
*** TURN *** [2d 2h Qc] [Qh]
b282789b: checks
a39b5beb: bets $0.3
b282789b: calls $0.3
*** RIVER *** [2d 2h Qc Qh] [2s]
b282789b: checks
a39b5beb: checks
b282789b: shows [7c As] (Twos Full over Queens)
a39b5beb: shows [8d 8s] (Twos Full over Queens)
*** SHOWDOWN ***
b282789b collected $0.57 from pot
a39b5beb collected $0.57 from pot
*** SUMMARY ***
Total pot $1.2 | Rake $0.06 | Jackpot $0 | Bingo $0 | Fortune $0 | Tax $0
Board [2d 2h Qc Qh 2s]
Seat 1: Hero (button) folded before Flop (didn't bet)
Seat 2: b282789b (small blind) showed [7c As] and won ($0.57) with Twos Full over Queens
Seat 3: a39b5beb (big blind) showed [8d 8s] and won ($0.57) with Twos Full over Queens
Seat 4: a0b33aca folded before Flop (didn't bet)
Seat 5: c7e9103c folded before Flop (didn't bet)
Seat 6: b9d877b0 folded before Flop (didn't bet)


Poker Hand #RC3334558480: Hold'em No Limit ($0.02/$0.05) - 2025/02/17 21:21:46
Table 'RushAndCash623740' 6-max Seat #1 is the button
Seat 1: 64542a04 ($5 in chips)
Seat 2: ee3fdfd8 ($5.44 in chips)
Seat 3: 3d2a56c8 ($5 in chips)
Seat 4: 6ebc3323 ($8.24 in chips)
Seat 5: 65900825 ($5.07 in chips)
Seat 6: Hero ($7.3 in chips)
ee3fdfd8: posts small blind $0.02
3d2a56c8: posts big blind $0.05
*** HOLE CARDS ***
Dealt to 64542a04 
Dealt to ee3fdfd8 
Dealt to 3d2a56c8 
Dealt to 6ebc3323 
Dealt to 65900825 
Dealt to Hero [6s Th]
6ebc3323: raises $0.1 to $0.15
65900825: folds
Hero: folds
64542a04: folds
ee3fdfd8: folds
3d2a56c8: folds
Uncalled bet ($0.1) returned to 6ebc3323
*** SHOWDOWN ***
6ebc3323 collected $0.12 from pot
*** SUMMARY ***
Total pot $0.12 | Rake $0 | Jackpot $0 | Bingo $0 | Fortune $0 | Tax $0
Seat 1: 64542a04 (button) folded before Flop (didn't bet)
Seat 2: ee3fdfd8 (small blind) folded before Flop
Seat 3: 3d2a56c8 (big blind) folded before Flop
Seat 4: 6ebc3323 collected ($0.12)
Seat 5: 65900825 folded before Flop (didn't bet)
Seat 6: Hero folded before Flop (didn't bet)


Poker Hand #RC3334558167: Hold'em No Limit ($0.02/$0.05) - 2025/02/17 21:21:07
Table 'RushAndCash623427' 6-max Seat #1 is the button
Seat 1: d201e5fe ($9.18 in chips)
Seat 2: c35cd20e ($5 in chips)
Seat 3: c1f4858e ($5.05 in chips)
Seat 4: 1b6c31ec ($6.45 in chips)
Seat 5: ab01942e ($4.61 in chips)
Seat 6: Hero ($6.69 in chips)
c35cd20e: posts small blind $0.02
c1f4858e: posts big blind $0.05
*** HOLE CARDS ***
Dealt to d201e5fe 
Dealt to c35cd20e 
Dealt to c1f4858e 
Dealt to 1b6c31ec 
Dealt to ab01942e 
Dealt to Hero [8h 8c]
1b6c31ec: folds
ab01942e: folds
Hero: raises $0.05 to $0.1
d201e5fe: folds
c35cd20e: folds
c1f4858e: raises $0.22 to $0.32
Hero: calls $0.22
*** FLOP *** [Td Ah 8d]
c1f4858e: bets $0.33
Hero: calls $0.33
*** TURN *** [Td Ah 8d] [5d]
c1f4858e: checks
Hero: bets $0.66
c1f4858e: folds
Uncalled bet ($0.66) returned to Hero
*** SHOWDOWN ***
Hero collected $1.26 from pot
*** SUMMARY ***
Total pot $1.32 | Rake $0.06 | Jackpot $0 | Bingo $0 | Fortune $0 | Tax $0
Board [Td Ah 8d 5d]
Seat 1: d201e5fe (button) folded before Flop (didn't bet)
Seat 2: c35cd20e (small blind) folded before Flop
Seat 3: c1f4858e (big blind) folded on the Turn
Seat 4: 1b6c31ec folded before Flop (didn't bet)
Seat 5: ab01942e folded before Flop (didn't bet)
Seat 6: Hero won ($1.26)


Poker Hand #RC3334558140: Hold'em No Limit ($0.02/$0.05) - 2025/02/17 21:21:03
Table 'RushAndCash623400' 6-max Seat #1 is the button
Seat 1: 10b5ea2f ($10.44 in chips)
Seat 2: 5cfa2d9a ($4.51 in chips)
Seat 3: 21bff972 ($7.05 in chips)
Seat 4: Hero ($6.69 in chips)
Seat 5: a28ca95c ($32.47 in chips)
Seat 6: e183d966 ($5 in chips)
5cfa2d9a: posts small blind $0.02
21bff972: posts big blind $0.05
*** HOLE CARDS ***
Dealt to 10b5ea2f 
Dealt to 5cfa2d9a 
Dealt to 21bff972 
Dealt to Hero [7d Qh]
Dealt to a28ca95c 
Dealt to e183d966 
Hero: folds
a28ca95c: folds
e183d966: folds
10b5ea2f: folds
5cfa2d9a: raises $0.1 to $0.15
21bff972: raises $0.45 to $0.6
5cfa2d9a: folds
Uncalled bet ($0.45) returned to 21bff972
*** SHOWDOWN ***
21bff972 collected $0.29 from pot
*** SUMMARY ***
Total pot $0.3 | Rake $0.01 | Jackpot $0 | Bingo $0 | Fortune $0 | Tax $0
Seat 1: 10b5ea2f (button) folded before Flop (didn't bet)
Seat 2: 5cfa2d9a (small blind) folded before Flop
Seat 3: 21bff972 (big blind) collected ($0.29)
Seat 4: Hero folded before Flop (didn't bet)
Seat 5: a28ca95c folded before Flop (didn't bet)
Seat 6: e183d966 folded before Flop (didn't bet)


Poker Hand #RC3334558114: Hold'em No Limit ($0.02/$0.05) - 2025/02/17 21:21:00
Table 'RushAndCash623374' 6-max Seat #1 is the button
Seat 1: 33caafa3 ($5 in chips)
Seat 2: 15fafcaa ($5.23 in chips)
Seat 3: 50cbaebe ($5.26 in chips)
Seat 4: Hero ($6.69 in chips)
Seat 5: 493e7626 ($5 in chips)
Seat 6: f6efd55a ($9.64 in chips)
15fafcaa: posts small blind $0.02
50cbaebe: posts big blind $0.05
*** HOLE CARDS ***
Dealt to 33caafa3 
Dealt to 15fafcaa 
Dealt to 50cbaebe 
Dealt to Hero [4d Jh]
Dealt to 493e7626 
Dealt to f6efd55a 
Hero: folds
493e7626: raises $0.1 to $0.15
f6efd55a: folds
33caafa3: folds
15fafcaa: folds
50cbaebe: folds
Uncalled bet ($0.1) returned to 493e7626
*** SHOWDOWN ***
493e7626 collected $0.12 from pot
*** SUMMARY ***
Total pot $0.12 | Rake $0 | Jackpot $0 | Bingo $0 | Fortune $0 | Tax $0
Seat 1: 33caafa3 (button) folded before Flop (didn't bet)
Seat 2: 15fafcaa (small blind) folded before Flop
Seat 3: 50cbaebe (big blind) folded before Flop
Seat 4: Hero folded before Flop (didn't bet)
Seat 5: 493e7626 collected ($0.12)
Seat 6: f6efd55a folded before Flop (didn't bet)


Poker Hand #RC3334558089: Hold'em No Limit ($0.02/$0.05) - 2025/02/17 21:20:57
Table 'RushAndCash623349' 6-max Seat #1 is the button
Seat 1: b8c09f2 ($6.76 in chips)
Seat 2: cd53b3fd ($5.02 in chips)
Seat 3: Hero ($6.74 in chips)
Seat 4: 769f9172 ($6.57 in chips)
Seat 5: 33caafa3 ($5 in chips)
Seat 6: a5be70d9 ($12.03 in chips)
cd53b3fd: posts small blind $0.02
Hero: posts big blind $0.05
*** HOLE CARDS ***
Dealt to b8c09f2 
Dealt to cd53b3fd 
Dealt to Hero [4c 5h]
Dealt to 769f9172 
Dealt to 33caafa3 
Dealt to a5be70d9 
769f9172: raises $0.05 to $0.1
33caafa3: folds
a5be70d9: folds
b8c09f2: folds
cd53b3fd: folds
Hero: folds
Uncalled bet ($0.05) returned to 769f9172
*** SHOWDOWN ***
769f9172 collected $0.12 from pot
*** SUMMARY ***
Total pot $0.12 | Rake $0 | Jackpot $0 | Bingo $0 | Fortune $0 | Tax $0
Seat 1: b8c09f2 (button) folded before Flop (didn't bet)
Seat 2: cd53b3fd (small blind) folded before Flop
Seat 3: Hero (big blind) folded before Flop
Seat 4: 769f9172 collected ($0.12)
Seat 5: 33caafa3 folded before Flop (didn't bet)
Seat 6: a5be70d9 folded before Flop (didn't bet)


Poker Hand #RC3334558067: Hold'em No Limit ($0.02/$0.05) - 2025/02/17 21:20:54
Table 'RushAndCash623327' 6-max Seat #1 is the button
Seat 1: 1e474bac ($5.05 in chips)
Seat 2: Hero ($6.76 in chips)
Seat 3: 6c641898 ($5 in chips)
Seat 4: ad943a18 ($5 in chips)
Seat 5: 50cbaebe ($5.26 in chips)
Seat 6: 577aa3d3 ($8.43 in chips)
Hero: posts small blind $0.02
6c641898: posts big blind $0.05
*** HOLE CARDS ***
Dealt to 1e474bac 
Dealt to Hero [5d Td]
Dealt to 6c641898 
Dealt to ad943a18 
Dealt to 50cbaebe 
Dealt to 577aa3d3 
ad943a18: folds
50cbaebe: folds
577aa3d3: folds
1e474bac: raises $0.07 to $0.12
Hero: folds
6c641898: folds
Uncalled bet ($0.07) returned to 1e474bac
*** SHOWDOWN ***
1e474bac collected $0.12 from pot
*** SUMMARY ***
Total pot $0.12 | Rake $0 | Jackpot $0 | Bingo $0 | Fortune $0 | Tax $0
Seat 1: 1e474bac (button) collected ($0.12)
Seat 2: Hero (small blind) folded before Flop
Seat 3: 6c641898 (big blind) folded before Flop
Seat 4: ad943a18 folded before Flop (didn't bet)
Seat 5: 50cbaebe folded before Flop (didn't bet)
Seat 6: 577aa3d3 folded before Flop (didn't bet)


Poker Hand #RC3334558044: Hold'em No Limit ($0.02/$0.05) - 2025/02/17 21:20:51
Table 'RushAndCash623304' 6-max Seat #1 is the button
Seat 1: Hero ($6.69 in chips)
Seat 2: 4812f5c8 ($5 in chips)
Seat 3: 8f77797e ($5.77 in chips)
Seat 4: df2ec599 ($3.54 in chips)
Seat 5: 697412e ($5.2 in chips)
Seat 6: 8ab2eae7 ($5 in chips)
4812f5c8: posts small blind $0.02
8f77797e: posts big blind $0.05
*** HOLE CARDS ***
Dealt to Hero [7s 9d]
Dealt to 4812f5c8 
Dealt to 8f77797e 
Dealt to df2ec599 
Dealt to 697412e 
Dealt to 8ab2eae7 
df2ec599: folds
697412e: folds
8ab2eae7: folds
Hero: folds
4812f5c8: folds
Uncalled bet ($0.03) returned to 8f77797e
*** SHOWDOWN ***
8f77797e collected $0.04 from pot
*** SUMMARY ***
Total pot $0.04 | Rake $0 | Jackpot $0 | Bingo $0 | Fortune $0 | Tax $0
Seat 1: Hero (button) folded before Flop (didn't bet)
Seat 2: 4812f5c8 (small blind) folded before Flop
Seat 3: 8f77797e (big blind) collected ($0.04)
Seat 4: df2ec599 folded before Flop (didn't bet)
Seat 5: 697412e folded before Flop (didn't bet)
Seat 6: 8ab2eae7 folded before Flop (didn't bet)


Poker Hand #RC3334558021: Hold'em No Limit ($0.02/$0.05) - 2025/02/17 21:20:47
Table 'RushAndCash623281' 6-max Seat #1 is the button
Seat 1: Hero ($6.69 in chips)
Seat 2: 692e3a83 ($9.12 in chips)
Seat 3: c5f37c20 ($2.89 in chips)
Seat 4: b9d877b0 ($5 in chips)
Seat 5: 593fbe03 ($3.2 in chips)
Seat 6: ab08c5da ($3.41 in chips)
692e3a83: posts small blind $0.02
c5f37c20: posts big blind $0.05
*** HOLE CARDS ***
Dealt to Hero [7s 2h]
Dealt to 692e3a83 
Dealt to c5f37c20 
Dealt to b9d877b0 
Dealt to 593fbe03 
Dealt to ab08c5da 
b9d877b0: folds
593fbe03: folds
ab08c5da: folds
Hero: folds
692e3a83: folds
Uncalled bet ($0.03) returned to c5f37c20
*** SHOWDOWN ***
c5f37c20 collected $0.04 from pot
*** SUMMARY ***
Total pot $0.04 | Rake $0 | Jackpot $0 | Bingo $0 | Fortune $0 | Tax $0
Seat 1: Hero (button) folded before Flop (didn't bet)
Seat 2: 692e3a83 (small blind) folded before Flop
Seat 3: c5f37c20 (big blind) collected ($0.04)
Seat 4: b9d877b0 folded before Flop (didn't bet)
Seat 5: 593fbe03 folded before Flop (didn't bet)
Seat 6: ab08c5da folded before Flop (didn't bet)


Poker Hand #RC3334557995: Hold'em No Limit ($0.02/$0.05) - 2025/02/17 21:20:44
Table 'RushAndCash623255' 6-max Seat #1 is the button
Seat 1: b3362681 ($5.37 in chips)
Seat 2: 473117d5 ($5.02 in chips)
Seat 3: 9c3abcbf ($10.54 in chips)
Seat 4: Hero ($6.69 in chips)
Seat 5: 44a9f3f0 ($5.07 in chips)
Seat 6: 50cbaebe ($5.26 in chips)
473117d5: posts small blind $0.02
9c3abcbf: posts big blind $0.05
*** HOLE CARDS ***
Dealt to b3362681 
Dealt to 473117d5 
Dealt to 9c3abcbf 
Dealt to Hero [6c Jh]
Dealt to 44a9f3f0 
Dealt to 50cbaebe 
Hero: folds
44a9f3f0: folds
50cbaebe: folds
b3362681: raises $0.05 to $0.1
473117d5: folds
9c3abcbf: calls $0.05
*** FLOP *** [8d 4h Ac]
9c3abcbf: checks
b3362681: checks
*** TURN *** [8d 4h Ac] [9s]
9c3abcbf: bets $0.5
b3362681: folds
Uncalled bet ($0.5) returned to 9c3abcbf
*** SHOWDOWN ***
9c3abcbf collected $0.21 from pot
*** SUMMARY ***
Total pot $0.22 | Rake $0.01 | Jackpot $0 | Bingo $0 | Fortune $0 | Tax $0
Board [8d 4h Ac 9s]
Seat 1: b3362681 (button) folded on the Turn
Seat 2: 473117d5 (small blind) folded before Flop
Seat 3: 9c3abcbf (big blind) won ($0.21)
Seat 4: Hero folded before Flop (didn't bet)
Seat 5: 44a9f3f0 folded before Flop (didn't bet)
Seat 6: 50cbaebe folded before Flop (didn't bet)


Poker Hand #RC3334557969: Hold'em No Limit ($0.02/$0.05) - 2025/02/17 21:20:41
Table 'RushAndCash623229' 6-max Seat #1 is the button
Seat 1: 4c9f897a ($5 in chips)
Seat 2: 84667b37 ($4.9 in chips)
Seat 3: Hero ($6.74 in chips)
Seat 4: 19259657 ($6.09 in chips)
Seat 5: bc8371cb ($6.78 in chips)
Seat 6: 3c76a91d ($11 in chips)
84667b37: posts small blind $0.02
Hero: posts big blind $0.05
*** HOLE CARDS ***
Dealt to 4c9f897a 
Dealt to 84667b37 
Dealt to Hero [3s 5d]
Dealt to 19259657 
Dealt to bc8371cb 
Dealt to 3c76a91d 
19259657: folds
bc8371cb: folds
3c76a91d: folds
4c9f897a: folds
84667b37: folds
Uncalled bet ($0.03) returned to Hero
*** SHOWDOWN ***
Hero collected $0.04 from pot
*** SUMMARY ***
Total pot $0.04 | Rake $0 | Jackpot $0 | Bingo $0 | Fortune $0 | Tax $0
Seat 1: 4c9f897a (button) folded before Flop (didn't bet)
Seat 2: 84667b37 (small blind) folded before Flop
Seat 3: Hero (big blind) collected ($0.04)
Seat 4: 19259657 folded before Flop (didn't bet)
Seat 5: bc8371cb folded before Flop (didn't bet)
Seat 6: 3c76a91d folded before Flop (didn't bet)


Poker Hand #RC3334557404: Hold'em No Limit ($0.02/$0.05) - 2025/02/17 21:19:30
Table 'RushAndCash622664' 6-max Seat #1 is the button
Seat 1: 1941fa92 ($2.55 in chips)
Seat 2: Hero ($6.94 in chips)
Seat 3: c7e9103c ($11.41 in chips)
Seat 4: 568ae949 ($4 in chips)
Seat 5: 11224f8 ($5.52 in chips)
Seat 6: c1f4858e ($5.07 in chips)
Hero: posts small blind $0.02
c7e9103c: posts big blind $0.05
*** HOLE CARDS ***
Dealt to 1941fa92 
Dealt to Hero [Th Jh]
Dealt to c7e9103c 
Dealt to 568ae949 
Dealt to 11224f8 
Dealt to c1f4858e 
568ae949: folds
11224f8: folds
c1f4858e: folds
1941fa92: folds
Hero: calls $0.03
c7e9103c: raises $0.15 to $0.2
Hero: calls $0.15
*** FLOP *** [5h 4s 4c]
Hero: checks
c7e9103c: bets $0.2
Hero: folds
Uncalled bet ($0.2) returned to c7e9103c
*** SHOWDOWN ***
c7e9103c collected $0.38 from pot
*** SUMMARY ***
Total pot $0.4 | Rake $0.02 | Jackpot $0 | Bingo $0 | Fortune $0 | Tax $0
Board [5h 4s 4c]
Seat 1: 1941fa92 (button) folded before Flop (didn't bet)
Seat 2: Hero (small blind) folded on the Flop
Seat 3: c7e9103c (big blind) won ($0.38)
Seat 4: 568ae949 folded before Flop (didn't bet)
Seat 5: 11224f8 folded before Flop (didn't bet)
Seat 6: c1f4858e folded before Flop (didn't bet)


Poker Hand #RC3334557381: Hold'em No Limit ($0.02/$0.05) - 2025/02/17 21:19:27
Table 'RushAndCash622641' 6-max Seat #1 is the button
Seat 1: b39a93ce ($5.8 in chips)
Seat 2: cd69b3e5 ($6.28 in chips)
Seat 3: d58b99ca ($31.84 in chips)
Seat 4: 64b39229 ($5.14 in chips)
Seat 5: Hero ($6.94 in chips)
Seat 6: 8c3789e ($5.51 in chips)
cd69b3e5: posts small blind $0.02
d58b99ca: posts big blind $0.05
*** HOLE CARDS ***
Dealt to b39a93ce 
Dealt to cd69b3e5 
Dealt to d58b99ca 
Dealt to 64b39229 
Dealt to Hero [Ah 6h]
Dealt to 8c3789e 
64b39229: folds
Hero: folds
8c3789e: raises $0.08 to $0.13
b39a93ce: folds
cd69b3e5: calls $0.11
d58b99ca: folds
*** FLOP *** [6d 9d Ad]
cd69b3e5: checks
8c3789e: checks
*** TURN *** [6d 9d Ad] [Jd]
cd69b3e5: checks
8c3789e: bets $0.11
cd69b3e5: folds
Uncalled bet ($0.11) returned to 8c3789e
*** SHOWDOWN ***
8c3789e collected $0.3 from pot
*** SUMMARY ***
Total pot $0.31 | Rake $0.01 | Jackpot $0 | Bingo $0 | Fortune $0 | Tax $0
Board [6d 9d Ad Jd]
Seat 1: b39a93ce (button) folded before Flop (didn't bet)
Seat 2: cd69b3e5 (small blind) folded on the Turn
Seat 3: d58b99ca (big blind) folded before Flop
Seat 4: 64b39229 folded before Flop (didn't bet)
Seat 5: Hero folded before Flop (didn't bet)
Seat 6: 8c3789e won ($0.3)


Poker Hand #RC3334557334: Hold'em No Limit ($0.02/$0.05) - 2025/02/17 21:19:21
Table 'RushAndCash622594' 6-max Seat #1 is the button
Seat 1: 14d966a6 ($5.22 in chips)
Seat 2: 5b7051ae ($4.25 in chips)
Seat 3: 3bfcd529 ($5.52 in chips)
Seat 4: fc99599f ($1.98 in chips)
Seat 5: e390e48e ($9.51 in chips)
Seat 6: Hero ($6.94 in chips)
5b7051ae: posts small blind $0.02
3bfcd529: posts big blind $0.05
*** HOLE CARDS ***
Dealt to 14d966a6 
Dealt to 5b7051ae 
Dealt to 3bfcd529 
Dealt to fc99599f 
Dealt to e390e48e 
Dealt to Hero [8s As]
fc99599f: raises $0.15 to $0.2
e390e48e: folds
Hero: folds
14d966a6: folds
5b7051ae: folds
3bfcd529: folds
Uncalled bet ($0.15) returned to fc99599f
*** SHOWDOWN ***
fc99599f collected $0.12 from pot
*** SUMMARY ***
Total pot $0.12 | Rake $0 | Jackpot $0 | Bingo $0 | Fortune $0 | Tax $0
Seat 1: 14d966a6 (button) folded before Flop (didn't bet)
Seat 2: 5b7051ae (small blind) folded before Flop
Seat 3: 3bfcd529 (big blind) folded before Flop
Seat 4: fc99599f collected ($0.12)
Seat 5: e390e48e folded before Flop (didn't bet)
Seat 6: Hero folded before Flop (didn't bet)


Poker Hand #RC3334557311: Hold'em No Limit ($0.02/$0.05) - 2025/02/17 21:19:18
Table 'RushAndCash622571' 6-max Seat #1 is the button
Seat 1: e390e48e ($9.51 in chips)
Seat 2: 7aca7e93 ($5.59 in chips)
Seat 3: 769f9172 ($6.81 in chips)
Seat 4: Hero ($6.94 in chips)
Seat 5: 9dba8a1e ($6.59 in chips)
Seat 6: 14d966a6 ($5.22 in chips)
7aca7e93: posts small blind $0.02
769f9172: posts big blind $0.05
*** HOLE CARDS ***
Dealt to e390e48e 
Dealt to 7aca7e93 
Dealt to 769f9172 
Dealt to Hero [Qs 5h]
Dealt to 9dba8a1e 
Dealt to 14d966a6 
Hero: folds
9dba8a1e: raises $0.05 to $0.1
14d966a6: folds
e390e48e: folds
7aca7e93: folds
769f9172: calls $0.05
*** FLOP *** [9d Td As]
769f9172: checks
9dba8a1e: bets $0.17
769f9172: folds
Uncalled bet ($0.17) returned to 9dba8a1e
*** SHOWDOWN ***
9dba8a1e collected $0.21 from pot
*** SUMMARY ***
Total pot $0.22 | Rake $0.01 | Jackpot $0 | Bingo $0 | Fortune $0 | Tax $0
Board [9d Td As]
Seat 1: e390e48e (button) folded before Flop (didn't bet)
Seat 2: 7aca7e93 (small blind) folded before Flop
Seat 3: 769f9172 (big blind) folded on the Flop
Seat 4: Hero folded before Flop (didn't bet)
Seat 5: 9dba8a1e won ($0.21)
Seat 6: 14d966a6 folded before Flop (didn't bet)


Poker Hand #RC3334557136: Hold'em No Limit ($0.02/$0.05) - 2025/02/17 21:18:55
Table 'RushAndCash622396' 6-max Seat #1 is the button
Seat 1: d58b99ca ($31.86 in chips)
Seat 2: c585480d ($7.28 in chips)
Seat 3: 5a37a767 ($6.64 in chips)
Seat 4: 428cd8c2 ($5.54 in chips)
Seat 5: 8c1d44c9 ($5.82 in chips)
Seat 6: Hero ($6.87 in chips)
c585480d: posts small blind $0.02
5a37a767: posts big blind $0.05
*** HOLE CARDS ***
Dealt to d58b99ca 
Dealt to c585480d 
Dealt to 5a37a767 
Dealt to 428cd8c2 
Dealt to 8c1d44c9 
Dealt to Hero [Kc 9c]
428cd8c2: folds
8c1d44c9: folds
Hero: raises $0.05 to $0.1
d58b99ca: folds
c585480d: folds
5a37a767: folds
Uncalled bet ($0.05) returned to Hero
*** SHOWDOWN ***
Hero collected $0.12 from pot
*** SUMMARY ***
Total pot $0.12 | Rake $0 | Jackpot $0 | Bingo $0 | Fortune $0 | Tax $0
Seat 1: d58b99ca (button) folded before Flop (didn't bet)
Seat 2: c585480d (small blind) folded before Flop
Seat 3: 5a37a767 (big blind) folded before Flop
Seat 4: 428cd8c2 folded before Flop (didn't bet)
Seat 5: 8c1d44c9 folded before Flop (didn't bet)
Seat 6: Hero collected ($0.12)


Poker Hand #RC3334557110: Hold'em No Limit ($0.02/$0.05) - 2025/02/17 21:18:52
Table 'RushAndCash622370' 6-max Seat #1 is the button
Seat 1: Hero ($6.87 in chips)
Seat 2: 5b7051ae ($4.32 in chips)
Seat 3: d44882bc ($5 in chips)
Seat 4: 44a9f3f0 ($5 in chips)
Seat 5: 493e7626 ($5.02 in chips)
Seat 6: 428cd8c2 ($5.54 in chips)
5b7051ae: posts small blind $0.02
d44882bc: posts big blind $0.05
*** HOLE CARDS ***
Dealt to Hero [3h Td]
Dealt to 5b7051ae 
Dealt to d44882bc 
Dealt to 44a9f3f0 
Dealt to 493e7626 
Dealt to 428cd8c2 
44a9f3f0: folds
493e7626: folds
428cd8c2: folds
Hero: folds
5b7051ae: folds
Uncalled bet ($0.03) returned to d44882bc
*** SHOWDOWN ***
d44882bc collected $0.04 from pot
*** SUMMARY ***
Total pot $0.04 | Rake $0 | Jackpot $0 | Bingo $0 | Fortune $0 | Tax $0
Seat 1: Hero (button) folded before Flop (didn't bet)
Seat 2: 5b7051ae (small blind) folded before Flop
Seat 3: d44882bc (big blind) collected ($0.04)
Seat 4: 44a9f3f0 folded before Flop (didn't bet)
Seat 5: 493e7626 folded before Flop (didn't bet)
Seat 6: 428cd8c2 folded before Flop (didn't bet)


Poker Hand #RC3334557087: Hold'em No Limit ($0.02/$0.05) - 2025/02/17 21:18:48
Table 'RushAndCash622347' 6-max Seat #1 is the button
Seat 1: 57a66aa7 ($5.27 in chips)
Seat 2: Hero ($6.89 in chips)
Seat 3: 87205baf ($13.6 in chips)
Seat 4: 5fd404ad ($5.89 in chips)
Seat 5: f0463362 ($5 in chips)
Seat 6: 757f29d9 ($4.67 in chips)
Hero: posts small blind $0.02
87205baf: posts big blind $0.05
*** HOLE CARDS ***
Dealt to 57a66aa7 
Dealt to Hero [Jd 4c]
Dealt to 87205baf 
Dealt to 5fd404ad 
Dealt to f0463362 
Dealt to 757f29d9 
5fd404ad: folds
f0463362: raises $0.05 to $0.1
757f29d9: folds
57a66aa7: folds
Hero: folds
87205baf: calls $0.05
*** FLOP *** [Th 5s 7s]
87205baf: checks
f0463362: bets $0.17
87205baf: calls $0.17
*** TURN *** [Th 5s 7s] [7d]
87205baf: checks
f0463362: checks
*** RIVER *** [Th 5s 7s 7d] [6s]
87205baf: checks
f0463362: checks
87205baf: shows [8c 8h] (Pair of Eights and Pair of Sevens)
f0463362: shows [Tc As] (Pair of Tens and Pair of Sevens)
*** SHOWDOWN ***
f0463362 collected $0.54 from pot
*** SUMMARY ***
Total pot $0.56 | Rake $0.02 | Jackpot $0 | Bingo $0 | Fortune $0 | Tax $0
Board [Th 5s 7s 7d 6s]
Seat 1: 57a66aa7 (button) folded before Flop (didn't bet)
Seat 2: Hero (small blind) folded before Flop
Seat 3: 87205baf (big blind) showed [8c 8h] and lost with Pair of Eights and Pair of Sevens
Seat 4: 5fd404ad folded before Flop (didn't bet)
Seat 5: f0463362 showed [Tc As] and won ($0.54) with Pair of Tens and Pair of Sevens
Seat 6: 757f29d9 folded before Flop (didn't bet)


Poker Hand #RC3334557042: Hold'em No Limit ($0.02/$0.05) - 2025/02/17 21:18:42
Table 'RushAndCash622302' 6-max Seat #1 is the button
Seat 1: 73d087f7 ($5.37 in chips)
Seat 2: 808dd9c ($7.3 in chips)
Seat 3: 1e76a4d8 ($6.32 in chips)
Seat 4: c62b7a0b ($22.93 in chips)
Seat 5: 15125d65 ($14.76 in chips)
Seat 6: Hero ($6.82 in chips)
808dd9c: posts small blind $0.02
1e76a4d8: posts big blind $0.05
*** HOLE CARDS ***
Dealt to 73d087f7 
Dealt to 808dd9c 
Dealt to 1e76a4d8 
Dealt to c62b7a0b 
Dealt to 15125d65 
Dealt to Hero [3s 8c]
c62b7a0b: folds
15125d65: folds
Hero: folds
73d087f7: folds
808dd9c: folds
Uncalled bet ($0.03) returned to 1e76a4d8
*** SHOWDOWN ***
1e76a4d8 collected $0.04 from pot
*** SUMMARY ***
Total pot $0.04 | Rake $0 | Jackpot $0 | Bingo $0 | Fortune $0 | Tax $0
Seat 1: 73d087f7 (button) folded before Flop (didn't bet)
Seat 2: 808dd9c (small blind) folded before Flop
Seat 3: 1e76a4d8 (big blind) collected ($0.04)
Seat 4: c62b7a0b folded before Flop (didn't bet)
Seat 5: 15125d65 folded before Flop (didn't bet)
Seat 6: Hero folded before Flop (didn't bet)


Poker Hand #RC3334556993: Hold'em No Limit ($0.02/$0.05) - 2025/02/17 21:18:36
Table 'RushAndCash622253' 6-max Seat #1 is the button
Seat 1: 5ddfff80 ($4.93 in chips)
Seat 2: 57a66aa7 ($5.29 in chips)
Seat 3: Hero ($6.87 in chips)
Seat 4: a291e856 ($5 in chips)
Seat 5: 3b85f8e6 ($8.61 in chips)
Seat 6: 4e53b23f ($5.2 in chips)
57a66aa7: posts small blind $0.02
Hero: posts big blind $0.05
*** HOLE CARDS ***
Dealt to 5ddfff80 
Dealt to 57a66aa7 
Dealt to Hero [7d Ks]
Dealt to a291e856 
Dealt to 3b85f8e6 
Dealt to 4e53b23f 
a291e856: folds
3b85f8e6: folds
4e53b23f: folds
5ddfff80: folds
57a66aa7: folds
Uncalled bet ($0.03) returned to Hero
*** SHOWDOWN ***
Hero collected $0.04 from pot
*** SUMMARY ***
Total pot $0.04 | Rake $0 | Jackpot $0 | Bingo $0 | Fortune $0 | Tax $0
Seat 1: 5ddfff80 (button) folded before Flop (didn't bet)
Seat 2: 57a66aa7 (small blind) folded before Flop
Seat 3: Hero (big blind) collected ($0.04)
Seat 4: a291e856 folded before Flop (didn't bet)
Seat 5: 3b85f8e6 folded before Flop (didn't bet)
Seat 6: 4e53b23f folded before Flop (didn't bet)


Poker Hand #RC3334556970: Hold'em No Limit ($0.02/$0.05) - 2025/02/17 21:18:33
Table 'RushAndCash622230' 6-max Seat #1 is the button
Seat 1: 9b152430 ($5.92 in chips)
Seat 2: 887ed1a2 ($5.57 in chips)
Seat 3: Hero ($6.92 in chips)
Seat 4: 3c76a91d ($11.07 in chips)
Seat 5: 7a5bf293 ($9.24 in chips)
Seat 6: 5466aa49 ($5.8 in chips)
887ed1a2: posts small blind $0.02
Hero: posts big blind $0.05
*** HOLE CARDS ***
Dealt to 9b152430 
Dealt to 887ed1a2 
Dealt to Hero [Qc 2h]
Dealt to 3c76a91d 
Dealt to 7a5bf293 
Dealt to 5466aa49 
3c76a91d: folds
7a5bf293: folds
5466aa49: raises $0.06 to $0.11
9b152430: raises $0.1 to $0.21
887ed1a2: calls $0.19
Hero: folds
5466aa49: calls $0.1
*** FLOP *** [Th 6h Ks]
887ed1a2: checks
5466aa49: bets $0.23
9b152430: calls $0.23
887ed1a2: folds
*** TURN *** [Th 6h Ks] [Kd]
5466aa49: bets $0.86
9b152430: calls $0.86
*** RIVER *** [Th 6h Ks Kd] [Qd]
5466aa49: bets $4.5 and is all-in
9b152430: folds
Uncalled bet ($4.5) returned to 5466aa49
*** SHOWDOWN ***
5466aa49 collected $2.65 from pot
*** SUMMARY ***
Total pot $2.86 | Rake $0.14 | Jackpot $0.07 | Bingo $0 | Fortune $0 | Tax $0
Board [Th 6h Ks Kd Qd]
Seat 1: 9b152430 (button) folded on the River
Seat 2: 887ed1a2 (small blind) folded on the Flop
Seat 3: Hero (big blind) folded before Flop
Seat 4: 3c76a91d folded before Flop (didn't bet)
Seat 5: 7a5bf293 folded before Flop (didn't bet)
Seat 6: 5466aa49 won ($2.65)


Poker Hand #RC3334556944: Hold'em No Limit ($0.02/$0.05) - 2025/02/17 21:18:30
Table 'RushAndCash622204' 6-max Seat #1 is the button
Seat 1: 266a98da ($1.64 in chips)
Seat 2: Hero ($6.94 in chips)
Seat 3: ccabd9d2 ($5.09 in chips)
Seat 4: 1095926a ($5.07 in chips)
Seat 5: 8974621f ($4.84 in chips)
Seat 6: c1784884 ($7.89 in chips)
Hero: posts small blind $0.02
ccabd9d2: posts big blind $0.05
*** HOLE CARDS ***
Dealt to 266a98da 
Dealt to Hero [Ts 4h]
Dealt to ccabd9d2 
Dealt to 1095926a 
Dealt to 8974621f 
Dealt to c1784884 
1095926a: raises $0.08 to $0.13
8974621f: folds
c1784884: calls $0.13
266a98da: folds
Hero: folds
ccabd9d2: folds
*** FLOP *** [3c 4c 6c]
1095926a: checks
c1784884: bets $0.11
1095926a: folds
Uncalled bet ($0.11) returned to c1784884
*** SHOWDOWN ***
c1784884 collected $0.32 from pot
*** SUMMARY ***
Total pot $0.33 | Rake $0.01 | Jackpot $0 | Bingo $0 | Fortune $0 | Tax $0
Board [3c 4c 6c]
Seat 1: 266a98da (button) folded before Flop (didn't bet)
Seat 2: Hero (small blind) folded before Flop
Seat 3: ccabd9d2 (big blind) folded before Flop
Seat 4: 1095926a folded on the Flop
Seat 5: 8974621f folded before Flop (didn't bet)
Seat 6: c1784884 won ($0.32)


Poker Hand #RC3334556919: Hold'em No Limit ($0.02/$0.05) - 2025/02/17 21:18:27
Table 'RushAndCash622179' 6-max Seat #1 is the button
Seat 1: bda9ba33 ($5.98 in chips)
Seat 2: Hero ($6.96 in chips)
Seat 3: a0b33aca ($5.58 in chips)
Seat 4: fcc3c3cc ($12.67 in chips)
Seat 5: 7fc44808 ($10.89 in chips)
Seat 6: 50cbaebe ($5.4 in chips)
Hero: posts small blind $0.02
a0b33aca: posts big blind $0.05
*** HOLE CARDS ***
Dealt to bda9ba33 
Dealt to Hero [Td 3c]
Dealt to a0b33aca 
Dealt to fcc3c3cc 
Dealt to 7fc44808 
Dealt to 50cbaebe 
fcc3c3cc: folds
7fc44808: folds
50cbaebe: folds
bda9ba33: folds
Hero: folds
Uncalled bet ($0.03) returned to a0b33aca
*** SHOWDOWN ***
a0b33aca collected $0.04 from pot
*** SUMMARY ***
Total pot $0.04 | Rake $0 | Jackpot $0 | Bingo $0 | Fortune $0 | Tax $0
Seat 1: bda9ba33 (button) folded before Flop (didn't bet)
Seat 2: Hero (small blind) folded before Flop
Seat 3: a0b33aca (big blind) collected ($0.04)
Seat 4: fcc3c3cc folded before Flop (didn't bet)
Seat 5: 7fc44808 folded before Flop (didn't bet)
Seat 6: 50cbaebe folded before Flop (didn't bet)


Poker Hand #RC3334556892: Hold'em No Limit ($0.02/$0.05) - 2025/02/17 21:18:24
Table 'RushAndCash622152' 6-max Seat #1 is the button
Seat 1: Hero ($6.96 in chips)
Seat 2: 151b0c91 ($4.7 in chips)
Seat 3: a73946fe ($5.79 in chips)
Seat 4: f85679bb ($5.3 in chips)
Seat 5: 22e7e468 ($5.7 in chips)
Seat 6: 598d859f ($11.88 in chips)
151b0c91: posts small blind $0.02
a73946fe: posts big blind $0.05
*** HOLE CARDS ***
Dealt to Hero [2d 6d]
Dealt to 151b0c91 
Dealt to a73946fe 
Dealt to f85679bb 
Dealt to 22e7e468 
Dealt to 598d859f 
f85679bb: folds
22e7e468: folds
598d859f: folds
Hero: folds
151b0c91: raises $0.05 to $0.1
a73946fe: folds
Uncalled bet ($0.05) returned to 151b0c91
*** SHOWDOWN ***
151b0c91 collected $0.1 from pot
*** SUMMARY ***
Total pot $0.1 | Rake $0 | Jackpot $0 | Bingo $0 | Fortune $0 | Tax $0
Seat 1: Hero (button) folded before Flop (didn't bet)
Seat 2: 151b0c91 (small blind) collected ($0.1)
Seat 3: a73946fe (big blind) folded before Flop
Seat 4: f85679bb folded before Flop (didn't bet)
Seat 5: 22e7e468 folded before Flop (didn't bet)
Seat 6: 598d859f folded before Flop (didn't bet)


Poker Hand #RC3334556819: Hold'em No Limit ($0.02/$0.05) - 2025/02/17 21:18:14
Table 'RushAndCash622079' 6-max Seat #1 is the button
Seat 1: 9dba8a1e ($6.62 in chips)
Seat 2: 5b79005a ($5.13 in chips)
Seat 3: 9ccadbb5 ($9.83 in chips)
Seat 4: e20e5cfc ($5.88 in chips)
Seat 5: Hero ($6.82 in chips)
Seat 6: 3565018d ($5.27 in chips)
5b79005a: posts small blind $0.02
9ccadbb5: posts big blind $0.05
*** HOLE CARDS ***
Dealt to 9dba8a1e 
Dealt to 5b79005a 
Dealt to 9ccadbb5 
Dealt to e20e5cfc 
Dealt to Hero [Kh Qc]
Dealt to 3565018d 
e20e5cfc: folds
Hero: raises $0.05 to $0.1
3565018d: folds
9dba8a1e: folds
5b79005a: folds
9ccadbb5: folds
Uncalled bet ($0.05) returned to Hero
*** SHOWDOWN ***
Hero collected $0.12 from pot
*** SUMMARY ***
Total pot $0.12 | Rake $0 | Jackpot $0 | Bingo $0 | Fortune $0 | Tax $0
Seat 1: 9dba8a1e (button) folded before Flop (didn't bet)
Seat 2: 5b79005a (small blind) folded before Flop
Seat 3: 9ccadbb5 (big blind) folded before Flop
Seat 4: e20e5cfc folded before Flop (didn't bet)
Seat 5: Hero collected ($0.12)
Seat 6: 3565018d folded before Flop (didn't bet)


Poker Hand #RC3334556794: Hold'em No Limit ($0.02/$0.05) - 2025/02/17 21:18:11
Table 'RushAndCash622054' 6-max Seat #1 is the button
Seat 1: 3ff27d73 ($5.42 in chips)
Seat 2: 493e7626 ($5.02 in chips)
Seat 3: Hero ($6.87 in chips)
Seat 4: 8c6d38f2 ($9.61 in chips)
Seat 5: fb90f143 ($11.74 in chips)
Seat 6: 7fe74cc5 ($10.88 in chips)
493e7626: posts small blind $0.02
Hero: posts big blind $0.05
*** HOLE CARDS ***
Dealt to 3ff27d73 
Dealt to 493e7626 
Dealt to Hero [8c 7s]
Dealt to 8c6d38f2 
Dealt to fb90f143 
Dealt to 7fe74cc5 
8c6d38f2: folds
fb90f143: folds
7fe74cc5: folds
3ff27d73: folds
493e7626: folds
Uncalled bet ($0.03) returned to Hero
*** SHOWDOWN ***
Hero collected $0.04 from pot
*** SUMMARY ***
Total pot $0.04 | Rake $0 | Jackpot $0 | Bingo $0 | Fortune $0 | Tax $0
Seat 1: 3ff27d73 (button) folded before Flop (didn't bet)
Seat 2: 493e7626 (small blind) folded before Flop
Seat 3: Hero (big blind) collected ($0.04)
Seat 4: 8c6d38f2 folded before Flop (didn't bet)
Seat 5: fb90f143 folded before Flop (didn't bet)
Seat 6: 7fe74cc5 folded before Flop (didn't bet)


Poker Hand #RC3334556764: Hold'em No Limit ($0.02/$0.05) - 2025/02/17 21:18:07
Table 'RushAndCash622024' 6-max Seat #1 is the button
Seat 1: 9bddfdba ($4.79 in chips)
Seat 2: ceaf3b1d ($5 in chips)
Seat 3: 7c8b3964 ($7.43 in chips)
Seat 4: 4e55fa29 ($2.93 in chips)
Seat 5: b9a80b8b ($4.47 in chips)
Seat 6: Hero ($6.87 in chips)
ceaf3b1d: posts small blind $0.02
7c8b3964: posts big blind $0.05
*** HOLE CARDS ***
Dealt to 9bddfdba 
Dealt to ceaf3b1d 
Dealt to 7c8b3964 
Dealt to 4e55fa29 
Dealt to b9a80b8b 
Dealt to Hero [5s Ad]
4e55fa29: folds
b9a80b8b: raises $0.05 to $0.1
Hero: folds
9bddfdba: folds
ceaf3b1d: raises $0.35 to $0.45
7c8b3964: folds
b9a80b8b: folds
Uncalled bet ($0.35) returned to ceaf3b1d
*** SHOWDOWN ***
ceaf3b1d collected $0.24 from pot
*** SUMMARY ***
Total pot $0.25 | Rake $0.01 | Jackpot $0 | Bingo $0 | Fortune $0 | Tax $0
Seat 1: 9bddfdba (button) folded before Flop (didn't bet)
Seat 2: ceaf3b1d (small blind) collected ($0.24)
Seat 3: 7c8b3964 (big blind) folded before Flop
Seat 4: 4e55fa29 folded before Flop (didn't bet)
Seat 5: b9a80b8b folded before Flop
Seat 6: Hero folded before Flop (didn't bet)


Poker Hand #RC3334556738: Hold'em No Limit ($0.02/$0.05) - 2025/02/17 21:18:04
Table 'RushAndCash621998' 6-max Seat #1 is the button
Seat 1: c585480d ($7.4 in chips)
Seat 2: 442376ec ($5.02 in chips)
Seat 3: bacb67c8 ($7.56 in chips)
Seat 4: Hero ($6.87 in chips)
Seat 5: 10b5ea2f ($10.15 in chips)
Seat 6: fa36f7b1 ($9.81 in chips)
442376ec: posts small blind $0.02
bacb67c8: posts big blind $0.05
*** HOLE CARDS ***
Dealt to c585480d 
Dealt to 442376ec 
Dealt to bacb67c8 
Dealt to Hero [4h Qc]
Dealt to 10b5ea2f 
Dealt to fa36f7b1 
Hero: folds
10b5ea2f: folds
fa36f7b1: folds
c585480d: folds
442376ec: folds
Uncalled bet ($0.03) returned to bacb67c8
*** SHOWDOWN ***
bacb67c8 collected $0.04 from pot
*** SUMMARY ***
Total pot $0.04 | Rake $0 | Jackpot $0 | Bingo $0 | Fortune $0 | Tax $0
Seat 1: c585480d (button) folded before Flop (didn't bet)
Seat 2: 442376ec (small blind) folded before Flop
Seat 3: bacb67c8 (big blind) collected ($0.04)
Seat 4: Hero folded before Flop (didn't bet)
Seat 5: 10b5ea2f folded before Flop (didn't bet)
Seat 6: fa36f7b1 folded before Flop (didn't bet)


Poker Hand #RC3334556713: Hold'em No Limit ($0.02/$0.05) - 2025/02/17 21:18:01
Table 'RushAndCash621973' 6-max Seat #1 is the button
Seat 1: 22e7e468 ($5.82 in chips)
Seat 2: 9604af2 ($8.23 in chips)
Seat 3: 598d859f ($11.75 in chips)
Seat 4: 6dcd0788 ($15.26 in chips)
Seat 5: Hero ($6.87 in chips)
Seat 6: 7c65d0bd ($5 in chips)
9604af2: posts small blind $0.02
598d859f: posts big blind $0.05
*** HOLE CARDS ***
Dealt to 22e7e468 
Dealt to 9604af2 
Dealt to 598d859f 
Dealt to 6dcd0788 
Dealt to Hero [9h 7c]
Dealt to 7c65d0bd 
6dcd0788: folds
Hero: folds
7c65d0bd: folds
22e7e468: raises $0.07 to $0.12
9604af2: folds
598d859f: raises $0.43 to $0.55
22e7e468: folds
Uncalled bet ($0.43) returned to 598d859f
*** SHOWDOWN ***
598d859f collected $0.25 from pot
*** SUMMARY ***
Total pot $0.26 | Rake $0.01 | Jackpot $0 | Bingo $0 | Fortune $0 | Tax $0
Seat 1: 22e7e468 (button) folded before Flop
Seat 2: 9604af2 (small blind) folded before Flop
Seat 3: 598d859f (big blind) collected ($0.25)
Seat 4: 6dcd0788 folded before Flop (didn't bet)
Seat 5: Hero folded before Flop (didn't bet)
Seat 6: 7c65d0bd folded before Flop (didn't bet)


Poker Hand #RC3334556577: Hold'em No Limit ($0.02/$0.05) - 2025/02/17 21:17:43
Table 'RushAndCash621837' 6-max Seat #1 is the button
Seat 1: Hero ($6.9 in chips)
Seat 2: d47cb19 ($5.39 in chips)
Seat 3: 3d537b07 ($5.61 in chips)
Seat 4: c3c40ffa ($5.66 in chips)
Seat 5: 9b152430 ($5.94 in chips)
Seat 6: 3bfcd529 ($5.66 in chips)
d47cb19: posts small blind $0.02
3d537b07: posts big blind $0.05
*** HOLE CARDS ***
Dealt to Hero [4h Ah]
Dealt to d47cb19 
Dealt to 3d537b07 
Dealt to c3c40ffa 
Dealt to 9b152430 
Dealt to 3bfcd529 
c3c40ffa: folds
9b152430: folds
3bfcd529: folds
Hero: raises $0.05 to $0.1
d47cb19: raises $0.25 to $0.35
3d537b07: folds
Hero: folds
Uncalled bet ($0.25) returned to d47cb19
*** SHOWDOWN ***
d47cb19 collected $0.24 from pot
*** SUMMARY ***
Total pot $0.25 | Rake $0.01 | Jackpot $0 | Bingo $0 | Fortune $0 | Tax $0
Seat 1: Hero (button) folded before Flop
Seat 2: d47cb19 (small blind) collected ($0.24)
Seat 3: 3d537b07 (big blind) folded before Flop
Seat 4: c3c40ffa folded before Flop (didn't bet)
Seat 5: 9b152430 folded before Flop (didn't bet)
Seat 6: 3bfcd529 folded before Flop (didn't bet)


Poker Hand #RC3334556539: Hold'em No Limit ($0.02/$0.05) - 2025/02/17 21:17:38
Table 'RushAndCash621799' 6-max Seat #1 is the button
Seat 1: 75d5d480 ($7.12 in chips)
Seat 2: 5f1cdd27 ($7.24 in chips)
Seat 3: cedf4726 ($14.17 in chips)
Seat 4: 9f76b15b ($2.44 in chips)
Seat 5: Hero ($6.9 in chips)
Seat 6: 9dd1ff39 ($6.74 in chips)
5f1cdd27: posts small blind $0.02
cedf4726: posts big blind $0.05
*** HOLE CARDS ***
Dealt to 75d5d480 
Dealt to 5f1cdd27 
Dealt to cedf4726 
Dealt to 9f76b15b 
Dealt to Hero [Kh 5h]
Dealt to 9dd1ff39 
9f76b15b: folds
Hero: folds
9dd1ff39: folds
75d5d480: folds
5f1cdd27: folds
Uncalled bet ($0.03) returned to cedf4726
*** SHOWDOWN ***
cedf4726 collected $0.04 from pot
*** SUMMARY ***
Total pot $0.04 | Rake $0 | Jackpot $0 | Bingo $0 | Fortune $0 | Tax $0
Seat 1: 75d5d480 (button) folded before Flop (didn't bet)
Seat 2: 5f1cdd27 (small blind) folded before Flop
Seat 3: cedf4726 (big blind) collected ($0.04)
Seat 4: 9f76b15b folded before Flop (didn't bet)
Seat 5: Hero folded before Flop (didn't bet)
Seat 6: 9dd1ff39 folded before Flop (didn't bet)


Poker Hand #RC3334556501: Hold'em No Limit ($0.02/$0.05) - 2025/02/17 21:17:34
Table 'RushAndCash621761' 6-max Seat #1 is the button
Seat 1: ae4e82ab ($5 in chips)
Seat 2: d201e5fe ($9.59 in chips)
Seat 3: Hero ($6.95 in chips)
Seat 4: 45e11cdb ($4.98 in chips)
Seat 5: 1e474bac ($5 in chips)
Seat 6: e97b3270 ($17.89 in chips)
d201e5fe: posts small blind $0.02
Hero: posts big blind $0.05
*** HOLE CARDS ***
Dealt to ae4e82ab 
Dealt to d201e5fe 
Dealt to Hero [8s Td]
Dealt to 45e11cdb 
Dealt to 1e474bac 
Dealt to e97b3270 
45e11cdb: folds
1e474bac: folds
e97b3270: folds
ae4e82ab: folds
d201e5fe: folds
Uncalled bet ($0.03) returned to Hero
*** SHOWDOWN ***
Hero collected $0.04 from pot
*** SUMMARY ***
Total pot $0.04 | Rake $0 | Jackpot $0 | Bingo $0 | Fortune $0 | Tax $0
Seat 1: ae4e82ab (button) folded before Flop (didn't bet)
Seat 2: d201e5fe (small blind) folded before Flop
Seat 3: Hero (big blind) collected ($0.04)
Seat 4: 45e11cdb folded before Flop (didn't bet)
Seat 5: 1e474bac folded before Flop (didn't bet)
Seat 6: e97b3270 folded before Flop (didn't bet)


Poker Hand #RC3334556448: Hold'em No Limit ($0.02/$0.05) - 2025/02/17 21:17:27
Table 'RushAndCash621708' 6-max Seat #1 is the button
Seat 1: ee30c63a ($7.34 in chips)
Seat 2: 5748837e ($5.29 in chips)
Seat 3: 4f7979c7 ($5.38 in chips)
Seat 4: cd69b3e5 ($6.04 in chips)
Seat 5: Hero ($6.95 in chips)
Seat 6: 66be2112 ($5.09 in chips)
5748837e: posts small blind $0.02
4f7979c7: posts big blind $0.05
*** HOLE CARDS ***
Dealt to ee30c63a 
Dealt to 5748837e 
Dealt to 4f7979c7 
Dealt to cd69b3e5 
Dealt to Hero [Jh 5s]
Dealt to 66be2112 
cd69b3e5: raises $0.06 to $0.11
Hero: folds
66be2112: folds
ee30c63a: calls $0.11
5748837e: folds
4f7979c7: folds
*** FLOP *** [Th 7h 5d]
cd69b3e5: bets $0.1
ee30c63a: folds
Uncalled bet ($0.1) returned to cd69b3e5
*** SHOWDOWN ***
cd69b3e5 collected $0.28 from pot
*** SUMMARY ***
Total pot $0.29 | Rake $0.01 | Jackpot $0 | Bingo $0 | Fortune $0 | Tax $0
Board [Th 7h 5d]
Seat 1: ee30c63a (button) folded on the Flop
Seat 2: 5748837e (small blind) folded before Flop
Seat 3: 4f7979c7 (big blind) folded before Flop
Seat 4: cd69b3e5 won ($0.28)
Seat 5: Hero folded before Flop (didn't bet)
Seat 6: 66be2112 folded before Flop (didn't bet)


Poker Hand #RC3334556245: Hold'em No Limit ($0.02/$0.05) - 2025/02/17 21:17:02
Table 'RushAndCash621505' 6-max Seat #1 is the button
Seat 1: 95e89c51 ($5.35 in chips)
Seat 2: Hero ($6.76 in chips)
Seat 3: ac6c5037 ($5 in chips)
Seat 4: c635f4d8 ($5.65 in chips)
Seat 5: 93056ee9 ($7.37 in chips)
Seat 6: 91ad3969 ($5.14 in chips)
Hero: posts small blind $0.02
ac6c5037: posts big blind $0.05
*** HOLE CARDS ***
Dealt to 95e89c51 
Dealt to Hero [As Kh]
Dealt to ac6c5037 
Dealt to c635f4d8 
Dealt to 93056ee9 
Dealt to 91ad3969 
c635f4d8: folds
93056ee9: calls $0.05
91ad3969: folds
95e89c51: raises $0.05 to $0.1
Hero: raises $0.38 to $0.48
ac6c5037: folds
93056ee9: folds
95e89c51: folds
Uncalled bet ($0.38) returned to Hero
*** SHOWDOWN ***
Hero collected $0.29 from pot
*** SUMMARY ***
Total pot $0.3 | Rake $0.01 | Jackpot $0 | Bingo $0 | Fortune $0 | Tax $0
Seat 1: 95e89c51 (button) folded before Flop
Seat 2: Hero (small blind) collected ($0.29)
Seat 3: ac6c5037 (big blind) folded before Flop
Seat 4: c635f4d8 folded before Flop (didn't bet)
Seat 5: 93056ee9 folded before Flop
Seat 6: 91ad3969 folded before Flop (didn't bet)


Poker Hand #RC3334556211: Hold'em No Limit ($0.02/$0.05) - 2025/02/17 21:16:58
Table 'RushAndCash621471' 6-max Seat #1 is the button
Seat 1: 23c23672 ($5 in chips)
Seat 2: 8e5db286 ($10.79 in chips)
Seat 3: cda83b9b ($7.19 in chips)
Seat 4: 2d6a0da2 ($6.12 in chips)
Seat 5: 38a4c833 ($4.2 in chips)
Seat 6: Hero ($6.76 in chips)
8e5db286: posts small blind $0.02
cda83b9b: posts big blind $0.05
*** HOLE CARDS ***
Dealt to 23c23672 
Dealt to 8e5db286 
Dealt to cda83b9b 
Dealt to 2d6a0da2 
Dealt to 38a4c833 
Dealt to Hero [8c 6s]
2d6a0da2: folds
38a4c833: folds
Hero: folds
23c23672: raises $0.07 to $0.12
8e5db286: folds
cda83b9b: folds
Uncalled bet ($0.07) returned to 23c23672
*** SHOWDOWN ***
23c23672 collected $0.12 from pot
*** SUMMARY ***
Total pot $0.12 | Rake $0 | Jackpot $0 | Bingo $0 | Fortune $0 | Tax $0
Seat 1: 23c23672 (button) collected ($0.12)
Seat 2: 8e5db286 (small blind) folded before Flop
Seat 3: cda83b9b (big blind) folded before Flop
Seat 4: 2d6a0da2 folded before Flop (didn't bet)
Seat 5: 38a4c833 folded before Flop (didn't bet)
Seat 6: Hero folded before Flop (didn't bet)


Poker Hand #RC3334556171: Hold'em No Limit ($0.02/$0.05) - 2025/02/17 21:16:52
Table 'RushAndCash621431' 6-max Seat #1 is the button
Seat 1: 180915b9 ($4.93 in chips)
Seat 2: 24aff26b ($6.05 in chips)
Seat 3: 2ffae4a2 ($14.83 in chips)
Seat 4: Hero ($6.76 in chips)
Seat 5: 7cef55a1 ($5 in chips)
Seat 6: 2ae4e16 ($4.29 in chips)
24aff26b: posts small blind $0.02
2ffae4a2: posts big blind $0.05
*** HOLE CARDS ***
Dealt to 180915b9 
Dealt to 24aff26b 
Dealt to 2ffae4a2 
Dealt to Hero [9h 4d]
Dealt to 7cef55a1 
Dealt to 2ae4e16 
Hero: folds
7cef55a1: folds
2ae4e16: folds
180915b9: raises $0.07 to $0.12
24aff26b: folds
2ffae4a2: calls $0.07
*** FLOP *** [4s 7h 8c]
2ffae4a2: checks
180915b9: checks
*** TURN *** [4s 7h 8c] [8h]
2ffae4a2: checks
180915b9: bets $0.2
2ffae4a2: calls $0.2
*** RIVER *** [4s 7h 8c 8h] [Kc]
2ffae4a2: checks
180915b9: checks
2ffae4a2: shows [Qd Ad] (Pair of Eights)
180915b9: shows [3d 3h] (Pair of Eights and Pair of Treys)
*** SHOWDOWN ***
180915b9 collected $0.63 from pot
*** SUMMARY ***
Total pot $0.66 | Rake $0.03 | Jackpot $0 | Bingo $0 | Fortune $0 | Tax $0
Board [4s 7h 8c 8h Kc]
Seat 1: 180915b9 (button) showed [3d 3h] and won ($0.63) with Pair of Eights and Pair of Treys
Seat 2: 24aff26b (small blind) folded before Flop
Seat 3: 2ffae4a2 (big blind) showed [Qd Ad] and lost with Pair of Eights
Seat 4: Hero folded before Flop (didn't bet)
Seat 5: 7cef55a1 folded before Flop (didn't bet)
Seat 6: 2ae4e16 folded before Flop (didn't bet)


Poker Hand #RC3334556134: Hold'em No Limit ($0.02/$0.05) - 2025/02/17 21:16:47
Table 'RushAndCash621394' 6-max Seat #1 is the button
Seat 1: cda83b9b ($7.19 in chips)
Seat 2: 14620cce ($15.51 in chips)
Seat 3: 4c9f897a ($5.75 in chips)
Seat 4: e87181cd ($5 in chips)
Seat 5: Hero ($6.76 in chips)
Seat 6: 9ccadbb5 ($10.42 in chips)
14620cce: posts small blind $0.02
4c9f897a: posts big blind $0.05
*** HOLE CARDS ***
Dealt to cda83b9b 
Dealt to 14620cce 
Dealt to 4c9f897a 
Dealt to e87181cd 
Dealt to Hero [6h 4d]
Dealt to 9ccadbb5 
e87181cd: folds
Hero: folds
9ccadbb5: folds
cda83b9b: folds
14620cce: raises $0.1 to $0.15
4c9f897a: folds
Uncalled bet ($0.1) returned to 14620cce
*** SHOWDOWN ***
14620cce collected $0.1 from pot
*** SUMMARY ***
Total pot $0.1 | Rake $0 | Jackpot $0 | Bingo $0 | Fortune $0 | Tax $0
Seat 1: cda83b9b (button) folded before Flop (didn't bet)
Seat 2: 14620cce (small blind) collected ($0.1)
Seat 3: 4c9f897a (big blind) folded before Flop
Seat 4: e87181cd folded before Flop (didn't bet)
Seat 5: Hero folded before Flop (didn't bet)
Seat 6: 9ccadbb5 folded before Flop (didn't bet)


Poker Hand #RC3334556081: Hold'em No Limit ($0.02/$0.05) - 2025/02/17 21:16:41
Table 'RushAndCash621341' 6-max Seat #1 is the button
Seat 1: 8507bdad ($5.24 in chips)
Seat 2: 918d412c ($2.43 in chips)
Seat 3: 81acf14c ($9.95 in chips)
Seat 4: 4262311b ($5.07 in chips)
Seat 5: Hero ($6.76 in chips)
Seat 6: 573eb753 ($4.71 in chips)
918d412c: posts small blind $0.02
81acf14c: posts big blind $0.05
*** HOLE CARDS ***
Dealt to 8507bdad 
Dealt to 918d412c 
Dealt to 81acf14c 
Dealt to 4262311b 
Dealt to Hero [5s 2c]
Dealt to 573eb753 
4262311b: raises $0.05 to $0.1
Hero: folds
573eb753: folds
8507bdad: folds
918d412c: calls $0.08
81acf14c: folds
*** FLOP *** [Kc Td Qs]
918d412c: checks
4262311b: checks
*** TURN *** [Kc Td Qs] [4d]
918d412c: bets $0.15
4262311b: calls $0.15
*** RIVER *** [Kc Td Qs 4d] [Tc]
918d412c: checks
4262311b: bets $0.4
918d412c: folds
Uncalled bet ($0.4) returned to 4262311b
*** SHOWDOWN ***
4262311b collected $0.53 from pot
*** SUMMARY ***
Total pot $0.55 | Rake $0.02 | Jackpot $0 | Bingo $0 | Fortune $0 | Tax $0
Board [Kc Td Qs 4d Tc]
Seat 1: 8507bdad (button) folded before Flop (didn't bet)
Seat 2: 918d412c (small blind) folded on the River
Seat 3: 81acf14c (big blind) folded before Flop
Seat 4: 4262311b won ($0.53)
Seat 5: Hero folded before Flop (didn't bet)
Seat 6: 573eb753 folded before Flop (didn't bet)


Poker Hand #RC3334556054: Hold'em No Limit ($0.02/$0.05) - 2025/02/17 21:16:38
Table 'RushAndCash621314' 6-max Seat #1 is the button
Seat 1: fcc3c3cc ($13.53 in chips)
Seat 2: 18767060 ($10.7 in chips)
Seat 3: b8a41e4 ($5.96 in chips)
Seat 4: Hero ($6.76 in chips)
Seat 5: f7c51ea2 ($5.41 in chips)
Seat 6: 9165e0e3 ($6.24 in chips)
18767060: posts small blind $0.02
b8a41e4: posts big blind $0.05
*** HOLE CARDS ***
Dealt to fcc3c3cc 
Dealt to 18767060 
Dealt to b8a41e4 
Dealt to Hero [9s 4d]
Dealt to f7c51ea2 
Dealt to 9165e0e3 
Hero: folds
f7c51ea2: raises $0.06 to $0.11
9165e0e3: folds
fcc3c3cc: folds
18767060: folds
b8a41e4: folds
Uncalled bet ($0.06) returned to f7c51ea2
*** SHOWDOWN ***
f7c51ea2 collected $0.12 from pot
*** SUMMARY ***
Total pot $0.12 | Rake $0 | Jackpot $0 | Bingo $0 | Fortune $0 | Tax $0
Seat 1: fcc3c3cc (button) folded before Flop (didn't bet)
Seat 2: 18767060 (small blind) folded before Flop
Seat 3: b8a41e4 (big blind) folded before Flop
Seat 4: Hero folded before Flop (didn't bet)
Seat 5: f7c51ea2 collected ($0.12)
Seat 6: 9165e0e3 folded before Flop (didn't bet)


Poker Hand #RC3334556024: Hold'em No Limit ($0.02/$0.05) - 2025/02/17 21:16:34
Table 'RushAndCash621284' 6-max Seat #1 is the button
Seat 1: aa08a1c ($5 in chips)
Seat 2: 38a4c833 ($4.27 in chips)
Seat 3: Hero ($6.81 in chips)
Seat 4: dbb7a28 ($10.39 in chips)
Seat 5: 4f7979c7 ($5.4 in chips)
Seat 6: 5cfa2d9a ($5.09 in chips)
38a4c833: posts small blind $0.02
Hero: posts big blind $0.05
*** HOLE CARDS ***
Dealt to aa08a1c 
Dealt to 38a4c833 
Dealt to Hero [6h 9c]
Dealt to dbb7a28 
Dealt to 4f7979c7 
Dealt to 5cfa2d9a 
dbb7a28: raises $0.05 to $0.1
4f7979c7: folds
5cfa2d9a: folds
aa08a1c: folds
38a4c833: folds
Hero: folds
Uncalled bet ($0.05) returned to dbb7a28
*** SHOWDOWN ***
dbb7a28 collected $0.12 from pot
*** SUMMARY ***
Total pot $0.12 | Rake $0 | Jackpot $0 | Bingo $0 | Fortune $0 | Tax $0
Seat 1: aa08a1c (button) folded before Flop (didn't bet)
Seat 2: 38a4c833 (small blind) folded before Flop
Seat 3: Hero (big blind) folded before Flop
Seat 4: dbb7a28 collected ($0.12)
Seat 5: 4f7979c7 folded before Flop (didn't bet)
Seat 6: 5cfa2d9a folded before Flop (didn't bet)


Poker Hand #RC3334555993: Hold'em No Limit ($0.02/$0.05) - 2025/02/17 21:16:31
Table 'RushAndCash621253' 6-max Seat #1 is the button
Seat 1: fcc3c3cc ($13.53 in chips)
Seat 2: 64542a04 ($7.13 in chips)
Seat 3: fbd2add5 ($7.53 in chips)
Seat 4: 9a69a3a0 ($10.57 in chips)
Seat 5: 621c3c07 ($5.28 in chips)
Seat 6: Hero ($6.81 in chips)
64542a04: posts small blind $0.02
fbd2add5: posts big blind $0.05
*** HOLE CARDS ***
Dealt to fcc3c3cc 
Dealt to 64542a04 
Dealt to fbd2add5 
Dealt to 9a69a3a0 
Dealt to 621c3c07 
Dealt to Hero [4s 6c]
9a69a3a0: folds
621c3c07: folds
Hero: folds
fcc3c3cc: folds
64542a04: raises $0.06 to $0.11
fbd2add5: calls $0.06
*** FLOP *** [5c 6s 5s]
64542a04: bets $0.1
fbd2add5: calls $0.1
*** TURN *** [5c 6s 5s] [5d]
64542a04: checks
fbd2add5: checks
*** RIVER *** [5c 6s 5s 5d] [Ah]
64542a04: checks
fbd2add5: checks
64542a04: shows [Kd 7h] (Three Fives)
fbd2add5: shows [3c 3s] (Fives Full over Treys)
*** SHOWDOWN ***
fbd2add5 collected $0.4 from pot
*** SUMMARY ***
Total pot $0.42 | Rake $0.02 | Jackpot $0 | Bingo $0 | Fortune $0 | Tax $0
Board [5c 6s 5s 5d Ah]
Seat 1: fcc3c3cc (button) folded before Flop (didn't bet)
Seat 2: 64542a04 (small blind) showed [Kd 7h] and lost with Three Fives
Seat 3: fbd2add5 (big blind) showed [3c 3s] and won ($0.4) with Fives Full over Treys
Seat 4: 9a69a3a0 folded before Flop (didn't bet)
Seat 5: 621c3c07 folded before Flop (didn't bet)
Seat 6: Hero folded before Flop (didn't bet)


Poker Hand #RC3334555969: Hold'em No Limit ($0.02/$0.05) - 2025/02/17 21:16:28
Table 'RushAndCash621229' 6-max Seat #1 is the button
Seat 1: Hero ($6.81 in chips)
Seat 2: dbf5f543 ($5.67 in chips)
Seat 3: 75a97e80 ($7.39 in chips)
Seat 4: 5cfa2d9a ($5.09 in chips)
Seat 5: 77d77e59 ($5.04 in chips)
Seat 6: a63aa4b7 ($18.24 in chips)
dbf5f543: posts small blind $0.02
75a97e80: posts big blind $0.05
*** HOLE CARDS ***
Dealt to Hero [9d 4c]
Dealt to dbf5f543 
Dealt to 75a97e80 
Dealt to 5cfa2d9a 
Dealt to 77d77e59 
Dealt to a63aa4b7 
5cfa2d9a: folds
77d77e59: folds
a63aa4b7: raises $0.08 to $0.13
Hero: folds
dbf5f543: folds
75a97e80: folds
Uncalled bet ($0.08) returned to a63aa4b7
*** SHOWDOWN ***
a63aa4b7 collected $0.12 from pot
*** SUMMARY ***
Total pot $0.12 | Rake $0 | Jackpot $0 | Bingo $0 | Fortune $0 | Tax $0
Seat 1: Hero (button) folded before Flop (didn't bet)
Seat 2: dbf5f543 (small blind) folded before Flop
Seat 3: 75a97e80 (big blind) folded before Flop
Seat 4: 5cfa2d9a folded before Flop (didn't bet)
Seat 5: 77d77e59 folded before Flop (didn't bet)
Seat 6: a63aa4b7 collected ($0.12)


Poker Hand #RC3334555938: Hold'em No Limit ($0.02/$0.05) - 2025/02/17 21:16:24
Table 'RushAndCash621198' 6-max Seat #1 is the button
Seat 1: 7cef55a1 ($5 in chips)
Seat 2: Hero ($6.83 in chips)
Seat 3: bda9ba33 ($5.97 in chips)
Seat 4: f3614ba1 ($9.97 in chips)
Seat 5: b86c29aa ($9.97 in chips)
Seat 6: c806dd25 ($13.19 in chips)
Hero: posts small blind $0.02
bda9ba33: posts big blind $0.05
*** HOLE CARDS ***
Dealt to 7cef55a1 
Dealt to Hero [2s 5s]
Dealt to bda9ba33 
Dealt to f3614ba1 
Dealt to b86c29aa 
Dealt to c806dd25 
f3614ba1: folds
b86c29aa: folds
c806dd25: folds
7cef55a1: folds
Hero: folds
Uncalled bet ($0.03) returned to bda9ba33
*** SHOWDOWN ***
bda9ba33 collected $0.04 from pot
*** SUMMARY ***
Total pot $0.04 | Rake $0 | Jackpot $0 | Bingo $0 | Fortune $0 | Tax $0
Seat 1: 7cef55a1 (button) folded before Flop (didn't bet)
Seat 2: Hero (small blind) folded before Flop
Seat 3: bda9ba33 (big blind) collected ($0.04)
Seat 4: f3614ba1 folded before Flop (didn't bet)
Seat 5: b86c29aa folded before Flop (didn't bet)
Seat 6: c806dd25 folded before Flop (didn't bet)


Poker Hand #RC3334555912: Hold'em No Limit ($0.02/$0.05) - 2025/02/17 21:16:21
Table 'RushAndCash621172' 6-max Seat #1 is the button
Seat 1: ab43c8b8 ($6.4 in chips)
Seat 2: d47cb19 ($5.49 in chips)
Seat 3: a63aa4b7 ($18.24 in chips)
Seat 4: ead6cfaf ($5 in chips)
Seat 5: Hero ($6.83 in chips)
Seat 6: 2e8ab509 ($5.14 in chips)
d47cb19: posts small blind $0.02
a63aa4b7: posts big blind $0.05
*** HOLE CARDS ***
Dealt to ab43c8b8 
Dealt to d47cb19 
Dealt to a63aa4b7 
Dealt to ead6cfaf 
Dealt to Hero [6s Kd]
Dealt to 2e8ab509 
ead6cfaf: folds
Hero: folds
2e8ab509: folds
ab43c8b8: folds
d47cb19: folds
Uncalled bet ($0.03) returned to a63aa4b7
*** SHOWDOWN ***
a63aa4b7 collected $0.04 from pot
*** SUMMARY ***
Total pot $0.04 | Rake $0 | Jackpot $0 | Bingo $0 | Fortune $0 | Tax $0
Seat 1: ab43c8b8 (button) folded before Flop (didn't bet)
Seat 2: d47cb19 (small blind) folded before Flop
Seat 3: a63aa4b7 (big blind) collected ($0.04)
Seat 4: ead6cfaf folded before Flop (didn't bet)
Seat 5: Hero folded before Flop (didn't bet)
Seat 6: 2e8ab509 folded before Flop (didn't bet)


Poker Hand #RC3334555825: Hold'em No Limit ($0.02/$0.05) - 2025/02/17 21:16:09
Table 'RushAndCash621085' 6-max Seat #1 is the button
Seat 1: Hero ($6.76 in chips)
Seat 2: 93dfef8b ($10.97 in chips)
Seat 3: ef96c0c8 ($6.08 in chips)
Seat 4: cc45300b ($5 in chips)
Seat 5: 356c5079 ($5.33 in chips)
Seat 6: c7197736 ($5 in chips)
93dfef8b: posts small blind $0.02
ef96c0c8: posts big blind $0.05
*** HOLE CARDS ***
Dealt to Hero [4h Ah]
Dealt to 93dfef8b 
Dealt to ef96c0c8 
Dealt to cc45300b 
Dealt to 356c5079 
Dealt to c7197736 
cc45300b: folds
356c5079: folds
c7197736: folds
Hero: raises $0.05 to $0.1
93dfef8b: folds
ef96c0c8: folds
Uncalled bet ($0.05) returned to Hero
*** SHOWDOWN ***
Hero collected $0.12 from pot
*** SUMMARY ***
Total pot $0.12 | Rake $0 | Jackpot $0 | Bingo $0 | Fortune $0 | Tax $0
Seat 1: Hero (button) collected ($0.12)
Seat 2: 93dfef8b (small blind) folded before Flop
Seat 3: ef96c0c8 (big blind) folded before Flop
Seat 4: cc45300b folded before Flop (didn't bet)
Seat 5: 356c5079 folded before Flop (didn't bet)
Seat 6: c7197736 folded before Flop (didn't bet)


Poker Hand #RC3334555783: Hold'em No Limit ($0.02/$0.05) - 2025/02/17 21:16:04
Table 'RushAndCash621043' 6-max Seat #1 is the button
Seat 1: Hero ($6.76 in chips)
Seat 2: 6de2662f ($6.78 in chips)
Seat 3: 4e5ae3cb ($6.12 in chips)
Seat 4: 15125d65 ($14.9 in chips)
Seat 5: a375b232 ($5 in chips)
Seat 6: a28ca95c ($22.39 in chips)
6de2662f: posts small blind $0.02
4e5ae3cb: posts big blind $0.05
*** HOLE CARDS ***
Dealt to Hero [5d 4s]
Dealt to 6de2662f 
Dealt to 4e5ae3cb 
Dealt to 15125d65 
Dealt to a375b232 
Dealt to a28ca95c 
15125d65: folds
a375b232: folds
a28ca95c: folds
Hero: folds
6de2662f: calls $0.03
4e5ae3cb: checks
*** FLOP *** [8s 2c Ac]
6de2662f: bets $0.05
4e5ae3cb: folds
Uncalled bet ($0.05) returned to 6de2662f
*** SHOWDOWN ***
6de2662f collected $0.1 from pot
*** SUMMARY ***
Total pot $0.1 | Rake $0 | Jackpot $0 | Bingo $0 | Fortune $0 | Tax $0
Board [8s 2c Ac]
Seat 1: Hero (button) folded before Flop (didn't bet)
Seat 2: 6de2662f (small blind) won ($0.1)
Seat 3: 4e5ae3cb (big blind) folded on the Flop
Seat 4: 15125d65 folded before Flop (didn't bet)
Seat 5: a375b232 folded before Flop (didn't bet)
Seat 6: a28ca95c folded before Flop (didn't bet)


Poker Hand #RC3334555757: Hold'em No Limit ($0.02/$0.05) - 2025/02/17 21:16:00
Table 'RushAndCash621017' 6-max Seat #1 is the button
Seat 1: be86537 ($6.95 in chips)
Seat 2: d5150c28 ($6.04 in chips)
Seat 3: 8c6d38f2 ($9.66 in chips)
Seat 4: 7a5bf293 ($9.4 in chips)
Seat 5: e4fd27d ($23.04 in chips)
Seat 6: Hero ($6.76 in chips)
d5150c28: posts small blind $0.02
8c6d38f2: posts big blind $0.05
*** HOLE CARDS ***
Dealt to be86537 
Dealt to d5150c28 
Dealt to 8c6d38f2 
Dealt to 7a5bf293 
Dealt to e4fd27d 
Dealt to Hero [Qh 4d]
7a5bf293: raises $0.05 to $0.1
e4fd27d: folds
Hero: folds
be86537: folds
d5150c28: folds
8c6d38f2: folds
Uncalled bet ($0.05) returned to 7a5bf293
*** SHOWDOWN ***
7a5bf293 collected $0.12 from pot
*** SUMMARY ***
Total pot $0.12 | Rake $0 | Jackpot $0 | Bingo $0 | Fortune $0 | Tax $0
Seat 1: be86537 (button) folded before Flop (didn't bet)
Seat 2: d5150c28 (small blind) folded before Flop
Seat 3: 8c6d38f2 (big blind) folded before Flop
Seat 4: 7a5bf293 collected ($0.12)
Seat 5: e4fd27d folded before Flop (didn't bet)
Seat 6: Hero folded before Flop (didn't bet)


Poker Hand #RC3334555728: Hold'em No Limit ($0.02/$0.05) - 2025/02/17 21:15:56
Table 'RushAndCash620988' 6-max Seat #1 is the button
Seat 1: f0a8dabb ($5.1 in chips)
Seat 2: 191b60c1 ($8.15 in chips)
Seat 3: b7bd1225 ($6.54 in chips)
Seat 4: Hero ($6.76 in chips)
Seat 5: 598d859f ($11.26 in chips)
Seat 6: c62b7a0b ($22.43 in chips)
191b60c1: posts small blind $0.02
b7bd1225: posts big blind $0.05
*** HOLE CARDS ***
Dealt to f0a8dabb 
Dealt to 191b60c1 
Dealt to b7bd1225 
Dealt to Hero [3c 2d]
Dealt to 598d859f 
Dealt to c62b7a0b 
Hero: folds
598d859f: folds
c62b7a0b: folds
f0a8dabb: folds
191b60c1: folds
Uncalled bet ($0.03) returned to b7bd1225
*** SHOWDOWN ***
b7bd1225 collected $0.04 from pot
*** SUMMARY ***
Total pot $0.04 | Rake $0 | Jackpot $0 | Bingo $0 | Fortune $0 | Tax $0
Seat 1: f0a8dabb (button) folded before Flop (didn't bet)
Seat 2: 191b60c1 (small blind) folded before Flop
Seat 3: b7bd1225 (big blind) collected ($0.04)
Seat 4: Hero folded before Flop (didn't bet)
Seat 5: 598d859f folded before Flop (didn't bet)
Seat 6: c62b7a0b folded before Flop (didn't bet)


Poker Hand #RC3334555480: Hold'em No Limit ($0.02/$0.05) - 2025/02/17 21:15:23
Table 'RushAndCash620740' 6-max Seat #1 is the button
Seat 1: ed18a71b ($5.28 in chips)
Seat 2: f0a8dabb ($5.01 in chips)
Seat 3: Hero ($6.86 in chips)
Seat 4: b88dd991 ($5.44 in chips)
Seat 5: 381c6d82 ($5.09 in chips)
Seat 6: cda83b9b ($7.84 in chips)
f0a8dabb: posts small blind $0.02
Hero: posts big blind $0.05
*** HOLE CARDS ***
Dealt to ed18a71b 
Dealt to f0a8dabb 
Dealt to Hero [2d 2s]
Dealt to b88dd991 
Dealt to 381c6d82 
Dealt to cda83b9b 
b88dd991: folds
381c6d82: folds
cda83b9b: folds
ed18a71b: folds
f0a8dabb: raises $0.05 to $0.1
Hero: calls $0.05
*** FLOP *** [4c 5c 9s]
f0a8dabb: checks
Hero: checks
*** TURN *** [4c 5c 9s] [Qh]
f0a8dabb: checks
Hero: checks
*** RIVER *** [4c 5c 9s Qh] [Ah]
f0a8dabb: checks
Hero: checks
f0a8dabb: shows [Tc Ts] (Pair of Tens)
Hero: shows [2d 2s] (Pair of Twos)
*** SHOWDOWN ***
f0a8dabb collected $0.19 from pot
*** SUMMARY ***
Total pot $0.2 | Rake $0.01 | Jackpot $0 | Bingo $0 | Fortune $0 | Tax $0
Board [4c 5c 9s Qh Ah]
Seat 1: ed18a71b (button) folded before Flop (didn't bet)
Seat 2: f0a8dabb (small blind) showed [Tc Ts] and won ($0.19) with Pair of Tens
Seat 3: Hero (big blind) showed [2d 2s] and lost with Pair of Twos
Seat 4: b88dd991 folded before Flop (didn't bet)
Seat 5: 381c6d82 folded before Flop (didn't bet)
Seat 6: cda83b9b folded before Flop (didn't bet)


Poker Hand #RC3334555446: Hold'em No Limit ($0.02/$0.05) - 2025/02/17 21:15:19
Table 'RushAndCash620706' 6-max Seat #1 is the button
Seat 1: c2790014 ($5.16 in chips)
Seat 2: Hero ($6.88 in chips)
Seat 3: 2e8ab509 ($5 in chips)
Seat 4: bfe01d88 ($5.5 in chips)
Seat 5: c9e4cf57 ($5.65 in chips)
Seat 6: a86de18f ($2.72 in chips)
Hero: posts small blind $0.02
2e8ab509: posts big blind $0.05
*** HOLE CARDS ***
Dealt to c2790014 
Dealt to Hero [2h Tc]
Dealt to 2e8ab509 
Dealt to bfe01d88 
Dealt to c9e4cf57 
Dealt to a86de18f 
bfe01d88: folds
c9e4cf57: folds
a86de18f: folds
c2790014: raises $0.05 to $0.1
Hero: folds
2e8ab509: folds
Uncalled bet ($0.05) returned to c2790014
*** SHOWDOWN ***
c2790014 collected $0.12 from pot
*** SUMMARY ***
Total pot $0.12 | Rake $0 | Jackpot $0 | Bingo $0 | Fortune $0 | Tax $0
Seat 1: c2790014 (button) collected ($0.12)
Seat 2: Hero (small blind) folded before Flop
Seat 3: 2e8ab509 (big blind) folded before Flop
Seat 4: bfe01d88 folded before Flop (didn't bet)
Seat 5: c9e4cf57 folded before Flop (didn't bet)
Seat 6: a86de18f folded before Flop (didn't bet)


Poker Hand #RC3334555418: Hold'em No Limit ($0.02/$0.05) - 2025/02/17 21:15:15
Table 'RushAndCash620678' 6-max Seat #1 is the button
Seat 1: Hero ($6.88 in chips)
Seat 2: a05482e7 ($5.21 in chips)
Seat 3: 5b79005a ($4.58 in chips)
Seat 4: fad7078a ($5.57 in chips)
Seat 5: ef7b5599 ($35.02 in chips)
Seat 6: 8f77797e ($5.99 in chips)
a05482e7: posts small blind $0.02
5b79005a: posts big blind $0.05
*** HOLE CARDS ***
Dealt to Hero [2d 3d]
Dealt to a05482e7 
Dealt to 5b79005a 
Dealt to fad7078a 
Dealt to ef7b5599 
Dealt to 8f77797e 
fad7078a: folds
ef7b5599: folds
8f77797e: folds
Hero: folds
a05482e7: raises $0.1 to $0.15
5b79005a: folds
Uncalled bet ($0.1) returned to a05482e7
*** SHOWDOWN ***
a05482e7 collected $0.1 from pot
*** SUMMARY ***
Total pot $0.1 | Rake $0 | Jackpot $0 | Bingo $0 | Fortune $0 | Tax $0
Seat 1: Hero (button) folded before Flop (didn't bet)
Seat 2: a05482e7 (small blind) collected ($0.1)
Seat 3: 5b79005a (big blind) folded before Flop
Seat 4: fad7078a folded before Flop (didn't bet)
Seat 5: ef7b5599 folded before Flop (didn't bet)
Seat 6: 8f77797e folded before Flop (didn't bet)


Poker Hand #RC3334555393: Hold'em No Limit ($0.02/$0.05) - 2025/02/17 21:15:12
Table 'RushAndCash620653' 6-max Seat #1 is the button
Seat 1: 7da7ba8a ($6.2 in chips)
Seat 2: Hero ($6.9 in chips)
Seat 3: f0a8dabb ($5.06 in chips)
Seat 4: e3c32f29 ($5.82 in chips)
Seat 5: c9e4cf57 ($5.65 in chips)
Seat 6: 151b0c91 ($5.71 in chips)
Hero: posts small blind $0.02
f0a8dabb: posts big blind $0.05
*** HOLE CARDS ***
Dealt to 7da7ba8a 
Dealt to Hero [8h 9c]
Dealt to f0a8dabb 
Dealt to e3c32f29 
Dealt to c9e4cf57 
Dealt to 151b0c91 
e3c32f29: folds
c9e4cf57: folds
151b0c91: raises $0.1 to $0.15
7da7ba8a: folds
Hero: folds
f0a8dabb: folds
Uncalled bet ($0.1) returned to 151b0c91
*** SHOWDOWN ***
151b0c91 collected $0.12 from pot
*** SUMMARY ***
Total pot $0.12 | Rake $0 | Jackpot $0 | Bingo $0 | Fortune $0 | Tax $0
Seat 1: 7da7ba8a (button) folded before Flop (didn't bet)
Seat 2: Hero (small blind) folded before Flop
Seat 3: f0a8dabb (big blind) folded before Flop
Seat 4: e3c32f29 folded before Flop (didn't bet)
Seat 5: c9e4cf57 folded before Flop (didn't bet)
Seat 6: 151b0c91 collected ($0.12)


Poker Hand #RC3334555366: Hold'em No Limit ($0.02/$0.05) - 2025/02/17 21:15:09
Table 'RushAndCash620626' 6-max Seat #1 is the button
Seat 1: c7d7e6aa ($24.61 in chips)
Seat 2: 3d2a56c8 ($5.69 in chips)
Seat 3: Hero ($6.95 in chips)
Seat 4: 9f9e1094 ($6.95 in chips)
Seat 5: 1b6c31ec ($7.23 in chips)
Seat 6: e4fd27d ($23.16 in chips)
3d2a56c8: posts small blind $0.02
Hero: posts big blind $0.05
*** HOLE CARDS ***
Dealt to c7d7e6aa 
Dealt to 3d2a56c8 
Dealt to Hero [Kd 2h]
Dealt to 9f9e1094 
Dealt to 1b6c31ec 
Dealt to e4fd27d 
9f9e1094: folds
1b6c31ec: folds
e4fd27d: folds
c7d7e6aa: raises $0.07 to $0.12
3d2a56c8: raises $0.38 to $0.5
Hero: folds
c7d7e6aa: raises $0.63 to $1.13
3d2a56c8: folds
Uncalled bet ($0.63) returned to c7d7e6aa
*** SHOWDOWN ***
c7d7e6aa collected $1 from pot
*** SUMMARY ***
Total pot $1.05 | Rake $0.05 | Jackpot $0 | Bingo $0 | Fortune $0 | Tax $0
Seat 1: c7d7e6aa (button) collected ($1)
Seat 2: 3d2a56c8 (small blind) folded before Flop
Seat 3: Hero (big blind) folded before Flop
Seat 4: 9f9e1094 folded before Flop (didn't bet)
Seat 5: 1b6c31ec folded before Flop (didn't bet)
Seat 6: e4fd27d folded before Flop (didn't bet)


Poker Hand #RC3334555344: Hold'em No Limit ($0.02/$0.05) - 2025/02/17 21:15:06
Table 'RushAndCash620604' 6-max Seat #1 is the button
Seat 1: d2fb1cd9 ($8.11 in chips)
Seat 2: 93dfef8b ($11.02 in chips)
Seat 3: Hero ($7 in chips)
Seat 4: 802a8ffb ($5 in chips)
Seat 5: 256d985c ($5.92 in chips)
Seat 6: 22005c45 ($4.48 in chips)
93dfef8b: posts small blind $0.02
Hero: posts big blind $0.05
*** HOLE CARDS ***
Dealt to d2fb1cd9 
Dealt to 93dfef8b 
Dealt to Hero [8s Td]
Dealt to 802a8ffb 
Dealt to 256d985c 
Dealt to 22005c45 
802a8ffb: folds
256d985c: folds
22005c45: folds
d2fb1cd9: raises $0.07 to $0.12
93dfef8b: folds
Hero: folds
Uncalled bet ($0.07) returned to d2fb1cd9
*** SHOWDOWN ***
d2fb1cd9 collected $0.12 from pot
*** SUMMARY ***
Total pot $0.12 | Rake $0 | Jackpot $0 | Bingo $0 | Fortune $0 | Tax $0
Seat 1: d2fb1cd9 (button) collected ($0.12)
Seat 2: 93dfef8b (small blind) folded before Flop
Seat 3: Hero (big blind) folded before Flop
Seat 4: 802a8ffb folded before Flop (didn't bet)
Seat 5: 256d985c folded before Flop (didn't bet)
Seat 6: 22005c45 folded before Flop (didn't bet)


Poker Hand #RC3334555307: Hold'em No Limit ($0.02/$0.05) - 2025/02/17 21:15:01
Table 'RushAndCash620567' 6-max Seat #1 is the button
Seat 1: 25c12d13 ($5 in chips)
Seat 2: 5466aa49 ($5.28 in chips)
Seat 3: 7d495353 ($8.95 in chips)
Seat 4: Hero ($7 in chips)
Seat 5: 64b39229 ($5.07 in chips)
Seat 6: a2123cbe ($11.56 in chips)
5466aa49: posts small blind $0.02
7d495353: posts big blind $0.05
*** HOLE CARDS ***
Dealt to 25c12d13 
Dealt to 5466aa49 
Dealt to 7d495353 
Dealt to Hero [7h 8s]
Dealt to 64b39229 
Dealt to a2123cbe 
Hero: folds
64b39229: folds
a2123cbe: folds
25c12d13: folds
5466aa49: raises $0.1 to $0.15
7d495353: calls $0.1
*** FLOP *** [Jd 6d Kc]
5466aa49: bets $0.15
7d495353: folds
Uncalled bet ($0.15) returned to 5466aa49
*** SHOWDOWN ***
5466aa49 collected $0.29 from pot
*** SUMMARY ***
Total pot $0.3 | Rake $0.01 | Jackpot $0 | Bingo $0 | Fortune $0 | Tax $0
Board [Jd 6d Kc]
Seat 1: 25c12d13 (button) folded before Flop (didn't bet)
Seat 2: 5466aa49 (small blind) won ($0.29)
Seat 3: 7d495353 (big blind) folded on the Flop
Seat 4: Hero folded before Flop (didn't bet)
Seat 5: 64b39229 folded before Flop (didn't bet)
Seat 6: a2123cbe folded before Flop (didn't bet)


Poker Hand #RC3334555284: Hold'em No Limit ($0.02/$0.05) - 2025/02/17 21:14:58
Table 'RushAndCash620544' 6-max Seat #1 is the button
Seat 1: Hero ($7 in chips)
Seat 2: 719071b8 ($5.1 in chips)
Seat 3: 1e2c3e8b ($6.64 in chips)
Seat 4: 69a18b01 ($5.23 in chips)
Seat 5: ef7e6107 ($5 in chips)
Seat 6: 70545399 ($7.23 in chips)
719071b8: posts small blind $0.02
1e2c3e8b: posts big blind $0.05
*** HOLE CARDS ***
Dealt to Hero [Qh 3h]
Dealt to 719071b8 
Dealt to 1e2c3e8b 
Dealt to 69a18b01 
Dealt to ef7e6107 
Dealt to 70545399 
69a18b01: folds
ef7e6107: folds
70545399: folds
Hero: folds
719071b8: raises $0.1 to $0.15
1e2c3e8b: calls $0.1
*** FLOP *** [Ah 4h Qc]
719071b8: bets $0.1
1e2c3e8b: calls $0.1
*** TURN *** [Ah 4h Qc] [9d]
719071b8: bets $0.25
1e2c3e8b: calls $0.25
*** RIVER *** [Ah 4h Qc 9d] [As]
719071b8: bets $1
1e2c3e8b: calls $1
719071b8: shows [Jd 3d] (Pair of Aces)
1e2c3e8b: shows [Qs Jh] (Pair of Aces and Pair of Queens)
*** SHOWDOWN ***
1e2c3e8b collected $2.79 from pot
*** SUMMARY ***
Total pot $3 | Rake $0.14 | Jackpot $0.07 | Bingo $0 | Fortune $0 | Tax $0
Board [Ah 4h Qc 9d As]
Seat 1: Hero (button) folded before Flop (didn't bet)
Seat 2: 719071b8 (small blind) showed [Jd 3d] and lost with Pair of Aces
Seat 3: 1e2c3e8b (big blind) showed [Qs Jh] and won ($2.79) with Pair of Aces and Pair of Queens
Seat 4: 69a18b01 folded before Flop (didn't bet)
Seat 5: ef7e6107 folded before Flop (didn't bet)
Seat 6: 70545399 folded before Flop (didn't bet)


Poker Hand #RC3334555263: Hold'em No Limit ($0.02/$0.05) - 2025/02/17 21:14:55
Table 'RushAndCash620523' 6-max Seat #1 is the button
Seat 1: abef7df7 ($3.35 in chips)
Seat 2: 23a65ab7 ($5.05 in chips)
Seat 3: a6f27d3d ($5.12 in chips)
Seat 4: 742ccfee ($2.36 in chips)
Seat 5: aa08a1c ($5.3 in chips)
Seat 6: Hero ($7 in chips)
23a65ab7: posts small blind $0.02
a6f27d3d: posts big blind $0.05
*** HOLE CARDS ***
Dealt to abef7df7 
Dealt to 23a65ab7 
Dealt to a6f27d3d 
Dealt to 742ccfee 
Dealt to aa08a1c 
Dealt to Hero [9d 4c]
742ccfee: folds
aa08a1c: folds
Hero: folds
abef7df7: folds
23a65ab7: folds
Uncalled bet ($0.03) returned to a6f27d3d
*** SHOWDOWN ***
a6f27d3d collected $0.04 from pot
*** SUMMARY ***
Total pot $0.04 | Rake $0 | Jackpot $0 | Bingo $0 | Fortune $0 | Tax $0
Seat 1: abef7df7 (button) folded before Flop (didn't bet)
Seat 2: 23a65ab7 (small blind) folded before Flop
Seat 3: a6f27d3d (big blind) collected ($0.04)
Seat 4: 742ccfee folded before Flop (didn't bet)
Seat 5: aa08a1c folded before Flop (didn't bet)
Seat 6: Hero folded before Flop (didn't bet)


Poker Hand #RC3334555064: Hold'em No Limit ($0.02/$0.05) - 2025/02/17 21:14:27
Table 'RushAndCash620324' 6-max Seat #1 is the button
Seat 1: d7f656ca ($6.26 in chips)
Seat 2: 742ccfee ($2.13 in chips)
Seat 3: 51e72d50 ($4.6 in chips)
Seat 4: bbace944 ($3.6 in chips)
Seat 5: Hero ($7.2 in chips)
Seat 6: fad7078a ($5.67 in chips)
742ccfee: posts small blind $0.02
51e72d50: posts big blind $0.05
*** HOLE CARDS ***
Dealt to d7f656ca 
Dealt to 742ccfee 
Dealt to 51e72d50 
Dealt to bbace944 
Dealt to Hero [4h 5h]
Dealt to fad7078a 
bbace944: folds
Hero: calls $0.05
fad7078a: folds
d7f656ca: folds
742ccfee: raises $0.15 to $0.2
51e72d50: folds
Hero: calls $0.15
*** FLOP *** [Kc Th As]
742ccfee: bets $0.45
Hero: folds
Uncalled bet ($0.45) returned to 742ccfee
*** SHOWDOWN ***
742ccfee collected $0.43 from pot
*** SUMMARY ***
Total pot $0.45 | Rake $0.02 | Jackpot $0 | Bingo $0 | Fortune $0 | Tax $0
Board [Kc Th As]
Seat 1: d7f656ca (button) folded before Flop (didn't bet)
Seat 2: 742ccfee (small blind) won ($0.43)
Seat 3: 51e72d50 (big blind) folded before Flop
Seat 4: bbace944 folded before Flop (didn't bet)
Seat 5: Hero folded on the Flop
Seat 6: fad7078a folded before Flop (didn't bet)


Poker Hand #RC3334555034: Hold'em No Limit ($0.02/$0.05) - 2025/02/17 21:14:24
Table 'RushAndCash620294' 6-max Seat #1 is the button
Seat 1: 966c483f ($5.02 in chips)
Seat 2: 742ccfee ($2.15 in chips)
Seat 3: fcfd355a ($5.73 in chips)
Seat 4: Hero ($7.2 in chips)
Seat 5: 1e76a4d8 ($6.27 in chips)
Seat 6: 9dd1ff39 ($6.27 in chips)
742ccfee: posts small blind $0.02
fcfd355a: posts big blind $0.05
*** HOLE CARDS ***
Dealt to 966c483f 
Dealt to 742ccfee 
Dealt to fcfd355a 
Dealt to Hero [Ts 5d]
Dealt to 1e76a4d8 
Dealt to 9dd1ff39 
Hero: folds
1e76a4d8: folds
9dd1ff39: folds
966c483f: folds
742ccfee: folds
Uncalled bet ($0.03) returned to fcfd355a
*** SHOWDOWN ***
fcfd355a collected $0.04 from pot
*** SUMMARY ***
Total pot $0.04 | Rake $0 | Jackpot $0 | Bingo $0 | Fortune $0 | Tax $0
Seat 1: 966c483f (button) folded before Flop (didn't bet)
Seat 2: 742ccfee (small blind) folded before Flop
Seat 3: fcfd355a (big blind) collected ($0.04)
Seat 4: Hero folded before Flop (didn't bet)
Seat 5: 1e76a4d8 folded before Flop (didn't bet)
Seat 6: 9dd1ff39 folded before Flop (didn't bet)


Poker Hand #RC3334555004: Hold'em No Limit ($0.02/$0.05) - 2025/02/17 21:14:20
Table 'RushAndCash620264' 6-max Seat #1 is the button
Seat 1: 7c8b3964 ($7.23 in chips)
Seat 2: 24aff26b ($5.93 in chips)
Seat 3: c4483bd8 ($6.1 in chips)
Seat 4: ceed678b ($8.84 in chips)
Seat 5: 2ae4e16 ($4.1 in chips)
Seat 6: Hero ($7.2 in chips)
24aff26b: posts small blind $0.02
c4483bd8: posts big blind $0.05
*** HOLE CARDS ***
Dealt to 7c8b3964 
Dealt to 24aff26b 
Dealt to c4483bd8 
Dealt to ceed678b 
Dealt to 2ae4e16 
Dealt to Hero [Th 9c]
ceed678b: folds
2ae4e16: raises $0.1 to $0.15
Hero: folds
7c8b3964: folds
24aff26b: folds
c4483bd8: folds
Uncalled bet ($0.1) returned to 2ae4e16
*** SHOWDOWN ***
2ae4e16 collected $0.12 from pot
*** SUMMARY ***
Total pot $0.12 | Rake $0 | Jackpot $0 | Bingo $0 | Fortune $0 | Tax $0
Seat 1: 7c8b3964 (button) folded before Flop (didn't bet)
Seat 2: 24aff26b (small blind) folded before Flop
Seat 3: c4483bd8 (big blind) folded before Flop
Seat 4: ceed678b folded before Flop (didn't bet)
Seat 5: 2ae4e16 collected ($0.12)
Seat 6: Hero folded before Flop (didn't bet)


Poker Hand #RC3334484700: Hold'em No Limit ($0.02/$0.05) - 2025/02/17 21:13:42
Table 'RushAndCash619960' 6-max Seat #1 is the button
Seat 1: 8f77797e ($5.87 in chips)
Seat 2: Hero ($7.3 in chips)
Seat 3: 7c8b3964 ($6.95 in chips)
Seat 4: 626359de ($12.46 in chips)
Seat 5: c4483bd8 ($6.2 in chips)
Seat 6: 860fa4c9 ($10.32 in chips)
Hero: posts small blind $0.02
7c8b3964: posts big blind $0.05
*** HOLE CARDS ***
Dealt to 8f77797e 
Dealt to Hero [3s 4s]
Dealt to 7c8b3964 
Dealt to 626359de 
Dealt to c4483bd8 
Dealt to 860fa4c9 
626359de: folds
c4483bd8: raises $0.05 to $0.1
860fa4c9: calls $0.1
8f77797e: folds
Hero: calls $0.08
7c8b3964: calls $0.05
*** FLOP *** [Qd 9s 7c]
Hero: checks
7c8b3964: checks
c4483bd8: checks
860fa4c9: checks
*** TURN *** [Qd 9s 7c] [Jc]
Hero: checks
7c8b3964: checks
c4483bd8: checks
860fa4c9: checks
*** RIVER *** [Qd 9s 7c Jc] [7d]
Hero: checks
7c8b3964: checks
c4483bd8: checks
860fa4c9: checks
Hero: shows [3s 4s] (Pair of Sevens)
7c8b3964: shows [2h 2s] (Pair of Sevens and Pair of Twos)
c4483bd8: shows [Ad 4d] (Pair of Sevens)
860fa4c9: shows [4c Ac] (Pair of Sevens)
*** SHOWDOWN ***
7c8b3964 collected $0.38 from pot
*** SUMMARY ***
Total pot $0.4 | Rake $0.02 | Jackpot $0 | Bingo $0 | Fortune $0 | Tax $0
Board [Qd 9s 7c Jc 7d]
Seat 1: 8f77797e (button) folded before Flop (didn't bet)
Seat 2: Hero (small blind) showed [3s 4s] and lost with Pair of Sevens
Seat 3: 7c8b3964 (big blind) showed [2h 2s] and won ($0.38) with Pair of Sevens and Pair of Twos
Seat 4: 626359de folded before Flop (didn't bet)
Seat 5: c4483bd8 showed [Ad 4d] and lost with Pair of Sevens
Seat 6: 860fa4c9 showed [4c Ac] and lost with Pair of Sevens


Poker Hand #RC3334484631: Hold'em No Limit ($0.02/$0.05) - 2025/02/17 21:13:32
Table 'RushAndCash619891' 6-max Seat #1 is the button
Seat 1: 22005c45 ($4.68 in chips)
Seat 2: ac6c5037 ($5.21 in chips)
Seat 3: db858978 ($5 in chips)
Seat 4: 29554a8c ($6.93 in chips)
Seat 5: 73d087f7 ($5.41 in chips)
Seat 6: Hero ($7.3 in chips)
Cash Drop to Pot : total $0.5 
ac6c5037: posts small blind $0.02
db858978: posts big blind $0.05
*** HOLE CARDS ***
Dealt to 22005c45 
Dealt to ac6c5037 
Dealt to db858978 
Dealt to 29554a8c 
Dealt to 73d087f7 
Dealt to Hero [Td 9h]
29554a8c: folds
73d087f7: folds
Hero: folds
22005c45: raises $0.08 to $0.13
ac6c5037: calls $0.11
db858978: calls $0.08
*** FLOP *** [Th 3s Jc]
ac6c5037: checks
db858978: checks
22005c45: checks
*** TURN *** [Th 3s Jc] [5s]
ac6c5037: checks
db858978: bets $0.86
22005c45: folds
ac6c5037: folds
Uncalled bet ($0.86) returned to db858978
*** SHOWDOWN ***
db858978 collected $0.85 from pot
*** SUMMARY ***
Total pot $0.89 | Rake $0.04 | Jackpot $0 | Bingo $0 | Fortune $0 | Tax $0
Board [Th 3s Jc 5s]
Seat 1: 22005c45 (button) folded on the Turn
Seat 2: ac6c5037 (small blind) folded on the Turn
Seat 3: db858978 (big blind) won ($0.85)
Seat 4: 29554a8c folded before Flop (didn't bet)
Seat 5: 73d087f7 folded before Flop (didn't bet)
Seat 6: Hero folded before Flop (didn't bet)


Poker Hand #RC3334484607: Hold'em No Limit ($0.02/$0.05) - 2025/02/17 21:13:29
Table 'RushAndCash619867' 6-max Seat #1 is the button
Seat 1: d201e5fe ($9.11 in chips)
Seat 2: 2a10169c ($5.07 in chips)
Seat 3: 14620cce ($16.64 in chips)
Seat 4: 6be17d4e ($5 in chips)
Seat 5: aaa792dc ($5.5 in chips)
Seat 6: Hero ($7.3 in chips)
2a10169c: posts small blind $0.02
14620cce: posts big blind $0.05
*** HOLE CARDS ***
Dealt to d201e5fe 
Dealt to 2a10169c 
Dealt to 14620cce 
Dealt to 6be17d4e 
Dealt to aaa792dc 
Dealt to Hero [Qh 2s]
6be17d4e: folds
aaa792dc: folds
Hero: folds
d201e5fe: folds
2a10169c: raises $0.07 to $0.12
14620cce: folds
Uncalled bet ($0.07) returned to 2a10169c
*** SHOWDOWN ***
2a10169c collected $0.1 from pot
*** SUMMARY ***
Total pot $0.1 | Rake $0 | Jackpot $0 | Bingo $0 | Fortune $0 | Tax $0
Seat 1: d201e5fe (button) folded before Flop (didn't bet)
Seat 2: 2a10169c (small blind) collected ($0.1)
Seat 3: 14620cce (big blind) folded before Flop
Seat 4: 6be17d4e folded before Flop (didn't bet)
Seat 5: aaa792dc folded before Flop (didn't bet)
Seat 6: Hero folded before Flop (didn't bet)


Poker Hand #RC3334484585: Hold'em No Limit ($0.02/$0.05) - 2025/02/17 21:13:26
Table 'RushAndCash619845' 6-max Seat #1 is the button
Seat 1: 4abcea5e ($6.1 in chips)
Seat 2: 3e301744 ($4.11 in chips)
Seat 3: 6f8bb9d1 ($4.08 in chips)
Seat 4: Hero ($7.3 in chips)
Seat 5: cc0e3d69 ($1.4 in chips)
Seat 6: 697412e ($5.17 in chips)
3e301744: posts small blind $0.02
6f8bb9d1: posts big blind $0.05
*** HOLE CARDS ***
Dealt to 4abcea5e 
Dealt to 3e301744 
Dealt to 6f8bb9d1 
Dealt to Hero [9c Kh]
Dealt to cc0e3d69 
Dealt to 697412e 
Hero: folds
cc0e3d69: folds
697412e: raises $0.06 to $0.11
4abcea5e: folds
3e301744: folds
6f8bb9d1: folds
Uncalled bet ($0.06) returned to 697412e
*** SHOWDOWN ***
697412e collected $0.12 from pot
*** SUMMARY ***
Total pot $0.12 | Rake $0 | Jackpot $0 | Bingo $0 | Fortune $0 | Tax $0
Seat 1: 4abcea5e (button) folded before Flop (didn't bet)
Seat 2: 3e301744 (small blind) folded before Flop
Seat 3: 6f8bb9d1 (big blind) folded before Flop
Seat 4: Hero folded before Flop (didn't bet)
Seat 5: cc0e3d69 folded before Flop (didn't bet)
Seat 6: 697412e collected ($0.12)


Poker Hand #RC3334484501: Hold'em No Limit ($0.02/$0.05) - 2025/02/17 21:13:16
Table 'RushAndCash619761' 6-max Seat #1 is the button
Seat 1: 32d40ce0 ($5.49 in chips)
Seat 2: ceaf3b1d ($5.26 in chips)
Seat 3: Hero ($7.28 in chips)
Seat 4: b9a80b8b ($4.65 in chips)
Seat 5: d86379c5 ($5.99 in chips)
Seat 6: 9864109b ($6.04 in chips)
ceaf3b1d: posts small blind $0.02
Hero: posts big blind $0.05
*** HOLE CARDS ***
Dealt to 32d40ce0 
Dealt to ceaf3b1d 
Dealt to Hero [Qs 9c]
Dealt to b9a80b8b 
Dealt to d86379c5 
Dealt to 9864109b 
b9a80b8b: folds
d86379c5: folds
9864109b: folds
32d40ce0: folds
ceaf3b1d: folds
Uncalled bet ($0.03) returned to Hero
*** SHOWDOWN ***
Hero collected $0.04 from pot
*** SUMMARY ***
Total pot $0.04 | Rake $0 | Jackpot $0 | Bingo $0 | Fortune $0 | Tax $0
Seat 1: 32d40ce0 (button) folded before Flop (didn't bet)
Seat 2: ceaf3b1d (small blind) folded before Flop
Seat 3: Hero (big blind) collected ($0.04)
Seat 4: b9a80b8b folded before Flop (didn't bet)
Seat 5: d86379c5 folded before Flop (didn't bet)
Seat 6: 9864109b folded before Flop (didn't bet)


Poker Hand #RC3334484479: Hold'em No Limit ($0.02/$0.05) - 2025/02/17 21:13:13
Table 'RushAndCash619739' 6-max Seat #1 is the button
Seat 1: Hero ($7.28 in chips)
Seat 2: 6a5a3ab6 ($4.02 in chips)
Seat 3: 33caafa3 ($5 in chips)
Seat 4: 2a10169c ($5 in chips)
Seat 5: 5c14c443 ($5.57 in chips)
Seat 6: c585480d ($7.34 in chips)
6a5a3ab6: posts small blind $0.02
33caafa3: posts big blind $0.05
*** HOLE CARDS ***
Dealt to Hero [3s 7h]
Dealt to 6a5a3ab6 
Dealt to 33caafa3 
Dealt to 2a10169c 
Dealt to 5c14c443 
Dealt to c585480d 
2a10169c: folds
5c14c443: raises $0.05 to $0.1
c585480d: folds
Hero: folds
6a5a3ab6: calls $0.08
33caafa3: folds
*** FLOP *** [9d 6c 3h]
6a5a3ab6: checks
5c14c443: checks
*** TURN *** [9d 6c 3h] [8d]
6a5a3ab6: checks
5c14c443: checks
*** RIVER *** [9d 6c 3h 8d] [4s]
6a5a3ab6: checks
5c14c443: checks
6a5a3ab6: shows [Qd Kc] (King-High)
5c14c443: shows [Qc Ad] (Ace-High)
*** SHOWDOWN ***
5c14c443 collected $0.24 from pot
*** SUMMARY ***
Total pot $0.25 | Rake $0.01 | Jackpot $0 | Bingo $0 | Fortune $0 | Tax $0
Board [9d 6c 3h 8d 4s]
Seat 1: Hero (button) folded before Flop (didn't bet)
Seat 2: 6a5a3ab6 (small blind) showed [Qd Kc] and lost with King-High
Seat 3: 33caafa3 (big blind) folded before Flop
Seat 4: 2a10169c folded before Flop (didn't bet)
Seat 5: 5c14c443 showed [Qc Ad] and won ($0.24) with Ace-High
Seat 6: c585480d folded before Flop (didn't bet)


Poker Hand #RC3334484420: Hold'em No Limit ($0.02/$0.05) - 2025/02/17 21:13:05
Table 'RushAndCash619680' 6-max Seat #1 is the button
Seat 1: d11ba472 ($5 in chips)
Seat 2: f3a68bc9 ($7.9 in chips)
Seat 3: Hero ($7.33 in chips)
Seat 4: 3ffb2c87 ($5 in chips)
Seat 5: a291e856 ($5 in chips)
Seat 6: 4ebd5be6 ($5.29 in chips)
f3a68bc9: posts small blind $0.02
Hero: posts big blind $0.05
*** HOLE CARDS ***
Dealt to d11ba472 
Dealt to f3a68bc9 
Dealt to Hero [Th 6h]
Dealt to 3ffb2c87 
Dealt to a291e856 
Dealt to 4ebd5be6 
3ffb2c87: raises $0.08 to $0.13
a291e856: folds
4ebd5be6: folds
d11ba472: calls $0.13
f3a68bc9: folds
Hero: folds
*** FLOP *** [Js Qc Ah]
3ffb2c87: checks
d11ba472: bets $0.25
3ffb2c87: calls $0.25
*** TURN *** [Js Qc Ah] [As]
3ffb2c87: checks
d11ba472: bets $0.63
3ffb2c87: calls $0.63
*** RIVER *** [Js Qc Ah As] [8c]
3ffb2c87: checks
d11ba472: bets $3.99 and is all-in
3ffb2c87: folds
Uncalled bet ($3.99) returned to d11ba472
*** SHOWDOWN ***
d11ba472 collected $1.92 from pot
*** SUMMARY ***
Total pot $2.09 | Rake $0.1 | Jackpot $0.07 | Bingo $0 | Fortune $0 | Tax $0
Board [Js Qc Ah As 8c]
Seat 1: d11ba472 (button) won ($1.92)
Seat 2: f3a68bc9 (small blind) folded before Flop
Seat 3: Hero (big blind) folded before Flop
Seat 4: 3ffb2c87 folded on the River
Seat 5: a291e856 folded before Flop (didn't bet)
Seat 6: 4ebd5be6 folded before Flop (didn't bet)


Poker Hand #RC3334484330: Hold'em No Limit ($0.02/$0.05) - 2025/02/17 21:12:53
Table 'RushAndCash619590' 6-max Seat #1 is the button
Seat 1: fa30bfa7 ($5 in chips)
Seat 2: Hero ($7.28 in chips)
Seat 3: 719071b8 ($5 in chips)
Seat 4: a6f27d3d ($5 in chips)
Seat 5: edf64ec2 ($5 in chips)
Seat 6: 53a8c2fd ($5 in chips)
Hero: posts small blind $0.02
719071b8: posts big blind $0.05
*** HOLE CARDS ***
Dealt to fa30bfa7 
Dealt to Hero [As 5c]
Dealt to 719071b8 
Dealt to a6f27d3d 
Dealt to edf64ec2 
Dealt to 53a8c2fd 
a6f27d3d: folds
edf64ec2: folds
53a8c2fd: folds
fa30bfa7: folds
Hero: calls $0.03
719071b8: checks
*** FLOP *** [2h 4h Kc]
Hero: bets $0.05
719071b8: folds
Uncalled bet ($0.05) returned to Hero
*** SHOWDOWN ***
Hero collected $0.1 from pot
*** SUMMARY ***
Total pot $0.1 | Rake $0 | Jackpot $0 | Bingo $0 | Fortune $0 | Tax $0
Board [2h 4h Kc]
Seat 1: fa30bfa7 (button) folded before Flop (didn't bet)
Seat 2: Hero (small blind) won ($0.1)
Seat 3: 719071b8 (big blind) folded on the Flop
Seat 4: a6f27d3d folded before Flop (didn't bet)
Seat 5: edf64ec2 folded before Flop (didn't bet)
Seat 6: 53a8c2fd folded before Flop (didn't bet)


Poker Hand #RC3334484276: Hold'em No Limit ($0.02/$0.05) - 2025/02/17 21:12:46
Table 'RushAndCash619536' 6-max Seat #1 is the button
Seat 1: c1f4858e ($5.07 in chips)
Seat 2: 5c14c443 ($5.52 in chips)
Seat 3: c8e834fc ($5.32 in chips)
Seat 4: 4238ab48 ($6.18 in chips)
Seat 5: Hero ($7.28 in chips)
Seat 6: b3aefb75 ($10.69 in chips)
5c14c443: posts small blind $0.02
c8e834fc: posts big blind $0.05
*** HOLE CARDS ***
Dealt to c1f4858e 
Dealt to 5c14c443 
Dealt to c8e834fc 
Dealt to 4238ab48 
Dealt to Hero [4h 5h]
Dealt to b3aefb75 
4238ab48: raises $0.08 to $0.13
Hero: folds
b3aefb75: folds
c1f4858e: folds
5c14c443: folds
c8e834fc: calls $0.08
*** FLOP *** [Qc 9h Kh]
c8e834fc: checks
4238ab48: bets $0.21
c8e834fc: folds
Uncalled bet ($0.21) returned to 4238ab48
*** SHOWDOWN ***
4238ab48 collected $0.27 from pot
*** SUMMARY ***
Total pot $0.28 | Rake $0.01 | Jackpot $0 | Bingo $0 | Fortune $0 | Tax $0
Board [Qc 9h Kh]
Seat 1: c1f4858e (button) folded before Flop (didn't bet)
Seat 2: 5c14c443 (small blind) folded before Flop
Seat 3: c8e834fc (big blind) folded on the Flop
Seat 4: 4238ab48 won ($0.27)
Seat 5: Hero folded before Flop (didn't bet)
Seat 6: b3aefb75 folded before Flop (didn't bet)


Poker Hand #RC3334484248: Hold'em No Limit ($0.02/$0.05) - 2025/02/17 21:12:42
Table 'RushAndCash619508' 6-max Seat #1 is the button
Seat 1: Hero ($7.28 in chips)
Seat 2: 83cc7f46 ($3.84 in chips)
Seat 3: ab01942e ($5.03 in chips)
Seat 4: fb6c913 ($9.53 in chips)
Seat 5: 9f9e1094 ($6.22 in chips)
Seat 6: 23c23672 ($5.24 in chips)
83cc7f46: posts small blind $0.02
ab01942e: posts big blind $0.05
*** HOLE CARDS ***
Dealt to Hero [5h 6c]
Dealt to 83cc7f46 
Dealt to ab01942e 
Dealt to fb6c913 
Dealt to 9f9e1094 
Dealt to 23c23672 
fb6c913: raises $0.05 to $0.1
9f9e1094: folds
23c23672: folds
Hero: folds
83cc7f46: raises $0.09 to $0.19
ab01942e: calls $0.14
fb6c913: calls $0.09
*** FLOP *** [Qh 3c 8d]
83cc7f46: bets $0.19
ab01942e: calls $0.19
fb6c913: folds
*** TURN *** [Qh 3c 8d] [Kd]
83cc7f46: bets $0.32
ab01942e: folds
Uncalled bet ($0.32) returned to 83cc7f46
*** SHOWDOWN ***
83cc7f46 collected $0.9 from pot
*** SUMMARY ***
Total pot $0.95 | Rake $0.05 | Jackpot $0 | Bingo $0 | Fortune $0 | Tax $0
Board [Qh 3c 8d Kd]
Seat 1: Hero (button) folded before Flop (didn't bet)
Seat 2: 83cc7f46 (small blind) won ($0.9)
Seat 3: ab01942e (big blind) folded on the Turn
Seat 4: fb6c913 folded on the Flop
Seat 5: 9f9e1094 folded before Flop (didn't bet)
Seat 6: 23c23672 folded before Flop (didn't bet)


Poker Hand #RC3334484226: Hold'em No Limit ($0.02/$0.05) - 2025/02/17 21:12:39
Table 'RushAndCash619486' 6-max Seat #1 is the button
Seat 1: 43a05b2c ($5.09 in chips)
Seat 2: fedfe7c6 ($13.77 in chips)
Seat 3: d92ddef8 ($5.05 in chips)
Seat 4: 5ef88743 ($5 in chips)
Seat 5: 9a69a3a0 ($10.98 in chips)
Seat 6: Hero ($7.28 in chips)
fedfe7c6: posts small blind $0.02
d92ddef8: posts big blind $0.05
*** HOLE CARDS ***
Dealt to 43a05b2c 
Dealt to fedfe7c6 
Dealt to d92ddef8 
Dealt to 5ef88743 
Dealt to 9a69a3a0 
Dealt to Hero [9c 4h]
5ef88743: raises $0.08 to $0.13
9a69a3a0: folds
Hero: folds
43a05b2c: calls $0.13
fedfe7c6: folds
d92ddef8: folds
*** FLOP *** [6h Tc 4c]
5ef88743: bets $0.17
43a05b2c: folds
Uncalled bet ($0.17) returned to 5ef88743
*** SHOWDOWN ***
5ef88743 collected $0.32 from pot
*** SUMMARY ***
Total pot $0.33 | Rake $0.01 | Jackpot $0 | Bingo $0 | Fortune $0 | Tax $0
Board [6h Tc 4c]
Seat 1: 43a05b2c (button) folded on the Flop
Seat 2: fedfe7c6 (small blind) folded before Flop
Seat 3: d92ddef8 (big blind) folded before Flop
Seat 4: 5ef88743 won ($0.32)
Seat 5: 9a69a3a0 folded before Flop (didn't bet)
Seat 6: Hero folded before Flop (didn't bet)


Poker Hand #RC3334484205: Hold'em No Limit ($0.02/$0.05) - 2025/02/17 21:12:36
Table 'RushAndCash619465' 6-max Seat #1 is the button
Seat 1: 35016d48 ($5.62 in chips)
Seat 2: Hero ($7.3 in chips)
Seat 3: 66be2112 ($5.13 in chips)
Seat 4: c8e72d1e ($4.95 in chips)
Seat 5: 8ec32764 ($5.67 in chips)
Seat 6: 92855848 ($4.87 in chips)
Hero: posts small blind $0.02
66be2112: posts big blind $0.05
*** HOLE CARDS ***
Dealt to 35016d48 
Dealt to Hero [6d Qd]
Dealt to 66be2112 
Dealt to c8e72d1e 
Dealt to 8ec32764 
Dealt to 92855848 
c8e72d1e: folds
8ec32764: folds
92855848: folds
35016d48: folds
Hero: folds
Uncalled bet ($0.03) returned to 66be2112
*** SHOWDOWN ***
66be2112 collected $0.04 from pot
*** SUMMARY ***
Total pot $0.04 | Rake $0 | Jackpot $0 | Bingo $0 | Fortune $0 | Tax $0
Seat 1: 35016d48 (button) folded before Flop (didn't bet)
Seat 2: Hero (small blind) folded before Flop
Seat 3: 66be2112 (big blind) collected ($0.04)
Seat 4: c8e72d1e folded before Flop (didn't bet)
Seat 5: 8ec32764 folded before Flop (didn't bet)
Seat 6: 92855848 folded before Flop (didn't bet)


Poker Hand #RC3334483846: Hold'em No Limit ($0.02/$0.05) - 2025/02/17 21:11:49
Table 'RushAndCash619106' 6-max Seat #1 is the button
Seat 1: Hero ($6.98 in chips)
Seat 2: 1e290a15 ($12.38 in chips)
Seat 3: d2fb1cd9 ($8.91 in chips)
Seat 4: 90fb5891 ($5.17 in chips)
Seat 5: f9d64f1a ($6.27 in chips)
Seat 6: 8ec32764 ($5.95 in chips)
1e290a15: posts small blind $0.02
d2fb1cd9: posts big blind $0.05
*** HOLE CARDS ***
Dealt to Hero [8s 8h]
Dealt to 1e290a15 
Dealt to d2fb1cd9 
Dealt to 90fb5891 
Dealt to f9d64f1a 
Dealt to 8ec32764 
90fb5891: folds
f9d64f1a: folds
8ec32764: raises $0.07 to $0.12
Hero: calls $0.12
1e290a15: folds
d2fb1cd9: folds
*** FLOP *** [8d 2h 5c]
8ec32764: checks
Hero: checks
*** TURN *** [8d 2h 5c] [3c]
8ec32764: checks
Hero: bets $0.16
8ec32764: calls $0.16
*** RIVER *** [8d 2h 5c 3c] [Kc]
8ec32764: checks
Hero: bets $0.32
8ec32764: folds
Uncalled bet ($0.32) returned to Hero
*** SHOWDOWN ***
Hero collected $0.6 from pot
*** SUMMARY ***
Total pot $0.63 | Rake $0.03 | Jackpot $0 | Bingo $0 | Fortune $0 | Tax $0
Board [8d 2h 5c 3c Kc]
Seat 1: Hero (button) won ($0.6)
Seat 2: 1e290a15 (small blind) folded before Flop
Seat 3: d2fb1cd9 (big blind) folded before Flop
Seat 4: 90fb5891 folded before Flop (didn't bet)
Seat 5: f9d64f1a folded before Flop (didn't bet)
Seat 6: 8ec32764 folded on the River


Poker Hand #RC3334483744: Hold'em No Limit ($0.02/$0.05) - 2025/02/17 21:11:36
Table 'RushAndCash619004' 6-max Seat #1 is the button
Seat 1: 7da7ba8a ($5 in chips)
Seat 2: 9dba8a1e ($5.4 in chips)
Seat 3: 52f43d28 ($9.14 in chips)
Seat 4: 90c3e611 ($5.46 in chips)
Seat 5: Hero ($6.98 in chips)
Seat 6: fe9dbb50 ($5.32 in chips)
9dba8a1e: posts small blind $0.02
52f43d28: posts big blind $0.05
*** HOLE CARDS ***
Dealt to 7da7ba8a 
Dealt to 9dba8a1e 
Dealt to 52f43d28 
Dealt to 90c3e611 
Dealt to Hero [9h Ad]
Dealt to fe9dbb50 
90c3e611: folds
Hero: folds
fe9dbb50: folds
7da7ba8a: folds
9dba8a1e: folds
Uncalled bet ($0.03) returned to 52f43d28
*** SHOWDOWN ***
52f43d28 collected $0.04 from pot
*** SUMMARY ***
Total pot $0.04 | Rake $0 | Jackpot $0 | Bingo $0 | Fortune $0 | Tax $0
Seat 1: 7da7ba8a (button) folded before Flop (didn't bet)
Seat 2: 9dba8a1e (small blind) folded before Flop
Seat 3: 52f43d28 (big blind) collected ($0.04)
Seat 4: 90c3e611 folded before Flop (didn't bet)
Seat 5: Hero folded before Flop (didn't bet)
Seat 6: fe9dbb50 folded before Flop (didn't bet)


Poker Hand #RC3334483597: Hold'em No Limit ($0.02/$0.05) - 2025/02/17 21:11:19
Table 'RushAndCash618857' 6-max Seat #1 is the button
Seat 1: 42065dde ($5.46 in chips)
Seat 2: 53a8c2fd ($5 in chips)
Seat 3: ee3fdfd8 ($6.64 in chips)
Seat 4: ae2aee6e ($5.79 in chips)
Seat 5: 4e5ae3cb ($5.33 in chips)
Seat 6: Hero ($7.08 in chips)
53a8c2fd: posts small blind $0.02
ee3fdfd8: posts big blind $0.05
*** HOLE CARDS ***
Dealt to 42065dde 
Dealt to 53a8c2fd 
Dealt to ee3fdfd8 
Dealt to ae2aee6e 
Dealt to 4e5ae3cb 
Dealt to Hero [7s 8s]
ae2aee6e: folds
4e5ae3cb: folds
Hero: raises $0.05 to $0.1
42065dde: raises $0.21 to $0.31
53a8c2fd: folds
ee3fdfd8: folds
Hero: folds
Uncalled bet ($0.21) returned to 42065dde
*** SHOWDOWN ***
42065dde collected $0.26 from pot
*** SUMMARY ***
Total pot $0.27 | Rake $0.01 | Jackpot $0 | Bingo $0 | Fortune $0 | Tax $0
Seat 1: 42065dde (button) collected ($0.26)
Seat 2: 53a8c2fd (small blind) folded before Flop
Seat 3: ee3fdfd8 (big blind) folded before Flop
Seat 4: ae2aee6e folded before Flop (didn't bet)
Seat 5: 4e5ae3cb folded before Flop (didn't bet)
Seat 6: Hero folded before Flop


Poker Hand #RC3334483570: Hold'em No Limit ($0.02/$0.05) - 2025/02/17 21:11:16
Table 'RushAndCash618830' 6-max Seat #1 is the button
Seat 1: e5e6041b ($6.16 in chips)
Seat 2: Hero ($7.1 in chips)
Seat 3: 1f187ba0 ($6.4 in chips)
Seat 4: 27baaa05 ($6.93 in chips)
Seat 5: 4c783157 ($5 in chips)
Seat 6: d11ba472 ($6.2 in chips)
Hero: posts small blind $0.02
1f187ba0: posts big blind $0.05
*** HOLE CARDS ***
Dealt to e5e6041b 
Dealt to Hero [Tc 8d]
Dealt to 1f187ba0 
Dealt to 27baaa05 
Dealt to 4c783157 
Dealt to d11ba472 
27baaa05: raises $0.05 to $0.1
4c783157: folds
d11ba472: folds
e5e6041b: folds
Hero: folds
1f187ba0: folds
Uncalled bet ($0.05) returned to 27baaa05
*** SHOWDOWN ***
27baaa05 collected $0.12 from pot
*** SUMMARY ***
Total pot $0.12 | Rake $0 | Jackpot $0 | Bingo $0 | Fortune $0 | Tax $0
Seat 1: e5e6041b (button) folded before Flop (didn't bet)
Seat 2: Hero (small blind) folded before Flop
Seat 3: 1f187ba0 (big blind) folded before Flop
Seat 4: 27baaa05 collected ($0.12)
Seat 5: 4c783157 folded before Flop (didn't bet)
Seat 6: d11ba472 folded before Flop (didn't bet)


Poker Hand #RC3334483547: Hold'em No Limit ($0.02/$0.05) - 2025/02/17 21:11:13
Table 'RushAndCash618807' 6-max Seat #1 is the button
Seat 1: 5db2c2b1 ($2.48 in chips)
Seat 2: 1b6c31ec ($6.79 in chips)
Seat 3: Hero ($7.15 in chips)
Seat 4: 19259657 ($5 in chips)
Seat 5: 2e8ab509 ($5 in chips)
Seat 6: c806dd25 ($10.87 in chips)
1b6c31ec: posts small blind $0.02
Hero: posts big blind $0.05
*** HOLE CARDS ***
Dealt to 5db2c2b1 
Dealt to 1b6c31ec 
Dealt to Hero [Kh 4c]
Dealt to 19259657 
Dealt to 2e8ab509 
Dealt to c806dd25 
19259657: folds
2e8ab509: folds
c806dd25: folds
5db2c2b1: raises $0.05 to $0.1
1b6c31ec: folds
Hero: folds
Uncalled bet ($0.05) returned to 5db2c2b1
*** SHOWDOWN ***
5db2c2b1 collected $0.12 from pot
*** SUMMARY ***
Total pot $0.12 | Rake $0 | Jackpot $0 | Bingo $0 | Fortune $0 | Tax $0
Seat 1: 5db2c2b1 (button) collected ($0.12)
Seat 2: 1b6c31ec (small blind) folded before Flop
Seat 3: Hero (big blind) folded before Flop
Seat 4: 19259657 folded before Flop (didn't bet)
Seat 5: 2e8ab509 folded before Flop (didn't bet)
Seat 6: c806dd25 folded before Flop (didn't bet)


Poker Hand #RC3334483523: Hold'em No Limit ($0.02/$0.05) - 2025/02/17 21:11:09
Table 'RushAndCash618783' 6-max Seat #1 is the button
Seat 1: 1d0217bc ($9.83 in chips)
Seat 2: 23258e5f ($4.87 in chips)
Seat 3: 8507bdad ($5.03 in chips)
Seat 4: de024677 ($4.76 in chips)
Seat 5: e14d48fa ($4.03 in chips)
Seat 6: Hero ($7.15 in chips)
23258e5f: posts small blind $0.02
8507bdad: posts big blind $0.05
*** HOLE CARDS ***
Dealt to 1d0217bc 
Dealt to 23258e5f 
Dealt to 8507bdad 
Dealt to de024677 
Dealt to e14d48fa 
Dealt to Hero [Qc 6d]
de024677: folds
e14d48fa: folds
Hero: folds
1d0217bc: raises $0.08 to $0.13
23258e5f: calls $0.11
8507bdad: folds
*** FLOP *** [Qh Jh 5h]
23258e5f: checks
1d0217bc: checks
*** TURN *** [Qh Jh 5h] [Jc]
23258e5f: bets $0.11
1d0217bc: calls $0.11
*** RIVER *** [Qh Jh 5h Jc] [5s]
23258e5f: checks
1d0217bc: bets $0.35
23258e5f: folds
Uncalled bet ($0.35) returned to 1d0217bc
*** SHOWDOWN ***
1d0217bc collected $0.51 from pot
*** SUMMARY ***
Total pot $0.53 | Rake $0.02 | Jackpot $0 | Bingo $0 | Fortune $0 | Tax $0
Board [Qh Jh 5h Jc 5s]
Seat 1: 1d0217bc (button) won ($0.51)
Seat 2: 23258e5f (small blind) folded on the River
Seat 3: 8507bdad (big blind) folded before Flop
Seat 4: de024677 folded before Flop (didn't bet)
Seat 5: e14d48fa folded before Flop (didn't bet)
Seat 6: Hero folded before Flop (didn't bet)


Poker Hand #RC3334483497: Hold'em No Limit ($0.02/$0.05) - 2025/02/17 21:11:06
Table 'RushAndCash618757' 6-max Seat #1 is the button
Seat 1: 70521b8f ($5.18 in chips)
Seat 2: 23a65ab7 ($5.17 in chips)
Seat 3: ec3424f5 ($5 in chips)
Seat 4: Hero ($7.15 in chips)
Seat 5: d691d846 ($2.78 in chips)
Seat 6: 87d5083b ($23.14 in chips)
23a65ab7: posts small blind $0.02
ec3424f5: posts big blind $0.05
*** HOLE CARDS ***
Dealt to 70521b8f 
Dealt to 23a65ab7 
Dealt to ec3424f5 
Dealt to Hero [6c Td]
Dealt to d691d846 
Dealt to 87d5083b 
Hero: folds
d691d846: raises $0.05 to $0.1
87d5083b: folds
70521b8f: folds
23a65ab7: folds
ec3424f5: folds
Uncalled bet ($0.05) returned to d691d846
*** SHOWDOWN ***
d691d846 collected $0.12 from pot
*** SUMMARY ***
Total pot $0.12 | Rake $0 | Jackpot $0 | Bingo $0 | Fortune $0 | Tax $0
Seat 1: 70521b8f (button) folded before Flop (didn't bet)
Seat 2: 23a65ab7 (small blind) folded before Flop
Seat 3: ec3424f5 (big blind) folded before Flop
Seat 4: Hero folded before Flop (didn't bet)
Seat 5: d691d846 collected ($0.12)
Seat 6: 87d5083b folded before Flop (didn't bet)


Poker Hand #RC3334483471: Hold'em No Limit ($0.02/$0.05) - 2025/02/17 21:11:02
Table 'RushAndCash618731' 6-max Seat #1 is the button
Seat 1: 14d03752 ($5.5 in chips)
Seat 2: 84a1bb5f ($12.64 in chips)
Seat 3: Hero ($7.2 in chips)
Seat 4: a5be70d9 ($5 in chips)
Seat 5: ec1214a6 ($5.1 in chips)
Seat 6: 70521b8f ($5.18 in chips)
84a1bb5f: posts small blind $0.02
Hero: posts big blind $0.05
*** HOLE CARDS ***
Dealt to 14d03752 
Dealt to 84a1bb5f 
Dealt to Hero [Qd 3d]
Dealt to a5be70d9 
Dealt to ec1214a6 
Dealt to 70521b8f 
a5be70d9: raises $0.08 to $0.13
ec1214a6: folds
70521b8f: folds
14d03752: folds
84a1bb5f: folds
Hero: folds
Uncalled bet ($0.08) returned to a5be70d9
*** SHOWDOWN ***
a5be70d9 collected $0.12 from pot
*** SUMMARY ***
Total pot $0.12 | Rake $0 | Jackpot $0 | Bingo $0 | Fortune $0 | Tax $0
Seat 1: 14d03752 (button) folded before Flop (didn't bet)
Seat 2: 84a1bb5f (small blind) folded before Flop
Seat 3: Hero (big blind) folded before Flop
Seat 4: a5be70d9 collected ($0.12)
Seat 5: ec1214a6 folded before Flop (didn't bet)
Seat 6: 70521b8f folded before Flop (didn't bet)


Poker Hand #RC3334483432: Hold'em No Limit ($0.02/$0.05) - 2025/02/17 21:10:57
Table 'RushAndCash618692' 6-max Seat #1 is the button
Seat 1: bbace944 ($3.95 in chips)
Seat 2: 8ed17f8c ($8.28 in chips)
Seat 3: d75cab93 ($6.26 in chips)
Seat 4: Hero ($7.2 in chips)
Seat 5: 73d087f7 ($5.51 in chips)
Seat 6: cda83b9b ($7.43 in chips)
8ed17f8c: posts small blind $0.02
d75cab93: posts big blind $0.05
*** HOLE CARDS ***
Dealt to bbace944 
Dealt to 8ed17f8c 
Dealt to d75cab93 
Dealt to Hero [2c 3c]
Dealt to 73d087f7 
Dealt to cda83b9b 
Hero: folds
73d087f7: folds
cda83b9b: folds
bbace944: folds
8ed17f8c: folds
Uncalled bet ($0.03) returned to d75cab93
*** SHOWDOWN ***
d75cab93 collected $0.04 from pot
*** SUMMARY ***
Total pot $0.04 | Rake $0 | Jackpot $0 | Bingo $0 | Fortune $0 | Tax $0
Seat 1: bbace944 (button) folded before Flop (didn't bet)
Seat 2: 8ed17f8c (small blind) folded before Flop
Seat 3: d75cab93 (big blind) collected ($0.04)
Seat 4: Hero folded before Flop (didn't bet)
Seat 5: 73d087f7 folded before Flop (didn't bet)
Seat 6: cda83b9b folded before Flop (didn't bet)


Poker Hand #RC3334483408: Hold'em No Limit ($0.02/$0.05) - 2025/02/17 21:10:54
Table 'RushAndCash618668' 6-max Seat #1 is the button
Seat 1: 3bfcd529 ($5.24 in chips)
Seat 2: bda9ba33 ($5.14 in chips)
Seat 3: 1ac52efc ($5.07 in chips)
Seat 4: f72bf77b ($5 in chips)
Seat 5: a3b43a4c ($5.38 in chips)
Seat 6: Hero ($7.2 in chips)
bda9ba33: posts small blind $0.02
1ac52efc: posts big blind $0.05
*** HOLE CARDS ***
Dealt to 3bfcd529 
Dealt to bda9ba33 
Dealt to 1ac52efc 
Dealt to f72bf77b 
Dealt to a3b43a4c 
Dealt to Hero [6s 9d]
f72bf77b: folds
a3b43a4c: raises $0.05 to $0.1
Hero: folds
3bfcd529: folds
bda9ba33: folds
1ac52efc: calls $0.05
*** FLOP *** [Kh 6h Kc]
1ac52efc: checks
a3b43a4c: bets $0.08
1ac52efc: calls $0.08
*** TURN *** [Kh 6h Kc] [Ah]
1ac52efc: checks
a3b43a4c: checks
*** RIVER *** [Kh 6h Kc Ah] [Td]
1ac52efc: checks
a3b43a4c: checks
1ac52efc: shows [6c 3c] (Pair of Kings and Pair of Sixes)
a3b43a4c: shows [2c Ac] (Pair of Aces and Pair of Kings)
*** SHOWDOWN ***
a3b43a4c collected $0.37 from pot
*** SUMMARY ***
Total pot $0.38 | Rake $0.01 | Jackpot $0 | Bingo $0 | Fortune $0 | Tax $0
Board [Kh 6h Kc Ah Td]
Seat 1: 3bfcd529 (button) folded before Flop (didn't bet)
Seat 2: bda9ba33 (small blind) folded before Flop
Seat 3: 1ac52efc (big blind) showed [6c 3c] and lost with Pair of Kings and Pair of Sixes
Seat 4: f72bf77b folded before Flop (didn't bet)
Seat 5: a3b43a4c showed [2c Ac] and won ($0.37) with Pair of Aces and Pair of Kings
Seat 6: Hero folded before Flop (didn't bet)


Poker Hand #RC3334483371: Hold'em No Limit ($0.02/$0.05) - 2025/02/17 21:10:49
Table 'RushAndCash618631' 6-max Seat #1 is the button
Seat 1: 1095926a ($5.18 in chips)
Seat 2: Hero ($7.22 in chips)
Seat 3: 675a7b76 ($4.83 in chips)
Seat 4: 42fca4f9 ($10.49 in chips)
Seat 5: 157631a0 ($5 in chips)
Seat 6: 4ab3f3bc ($5.93 in chips)
Hero: posts small blind $0.02
675a7b76: posts big blind $0.05
*** HOLE CARDS ***
Dealt to 1095926a 
Dealt to Hero [Qd 6h]
Dealt to 675a7b76 
Dealt to 42fca4f9 
Dealt to 157631a0 
Dealt to 4ab3f3bc 
42fca4f9: folds
157631a0: folds
4ab3f3bc: raises $0.1 to $0.15
1095926a: folds
Hero: folds
675a7b76: folds
Uncalled bet ($0.1) returned to 4ab3f3bc
*** SHOWDOWN ***
4ab3f3bc collected $0.12 from pot
*** SUMMARY ***
Total pot $0.12 | Rake $0 | Jackpot $0 | Bingo $0 | Fortune $0 | Tax $0
Seat 1: 1095926a (button) folded before Flop (didn't bet)
Seat 2: Hero (small blind) folded before Flop
Seat 3: 675a7b76 (big blind) folded before Flop
Seat 4: 42fca4f9 folded before Flop (didn't bet)
Seat 5: 157631a0 folded before Flop (didn't bet)
Seat 6: 4ab3f3bc collected ($0.12)


Poker Hand #RC3334483348: Hold'em No Limit ($0.02/$0.05) - 2025/02/17 21:10:46
Table 'RushAndCash618608' 6-max Seat #1 is the button
Seat 1: 4f7979c7 ($4.74 in chips)
Seat 2: 3565018d ($4.95 in chips)
Seat 3: eed867f5 ($8.99 in chips)
Seat 4: 266a98da ($1.72 in chips)
Seat 5: Hero ($7.22 in chips)
Seat 6: 9b331463 ($4.83 in chips)
3565018d: posts small blind $0.02
eed867f5: posts big blind $0.05
*** HOLE CARDS ***
Dealt to 4f7979c7 
Dealt to 3565018d 
Dealt to eed867f5 
Dealt to 266a98da 
Dealt to Hero [4h 9s]
Dealt to 9b331463 
266a98da: folds
Hero: folds
9b331463: raises $0.08 to $0.13
4f7979c7: folds
3565018d: folds
eed867f5: folds
Uncalled bet ($0.08) returned to 9b331463
*** SHOWDOWN ***
9b331463 collected $0.12 from pot
*** SUMMARY ***
Total pot $0.12 | Rake $0 | Jackpot $0 | Bingo $0 | Fortune $0 | Tax $0
Seat 1: 4f7979c7 (button) folded before Flop (didn't bet)
Seat 2: 3565018d (small blind) folded before Flop
Seat 3: eed867f5 (big blind) folded before Flop
Seat 4: 266a98da folded before Flop (didn't bet)
Seat 5: Hero folded before Flop (didn't bet)
Seat 6: 9b331463 collected ($0.12)


Poker Hand #RC3334483325: Hold'em No Limit ($0.02/$0.05) - 2025/02/17 21:10:43
Table 'RushAndCash618585' 6-max Seat #1 is the button
Seat 1: Hero ($7.22 in chips)
Seat 2: 38a4c833 ($6.57 in chips)
Seat 3: 8dbd0a2d ($9.4 in chips)
Seat 4: 692417ff ($5.74 in chips)
Seat 5: 84667b37 ($3.16 in chips)
Seat 6: fc99599f ($2.52 in chips)
38a4c833: posts small blind $0.02
8dbd0a2d: posts big blind $0.05
*** HOLE CARDS ***
Dealt to Hero [Kd 9s]
Dealt to 38a4c833 
Dealt to 8dbd0a2d 
Dealt to 692417ff 
Dealt to 84667b37 
Dealt to fc99599f 
692417ff: raises $0.05 to $0.1
84667b37: folds
fc99599f: calls $0.1
Hero: folds
38a4c833: calls $0.08
8dbd0a2d: calls $0.05
*** FLOP *** [Ks Ah Kh]
38a4c833: checks
8dbd0a2d: checks
692417ff: checks
fc99599f: bets $0.05
38a4c833: calls $0.05
8dbd0a2d: folds
692417ff: folds
*** TURN *** [Ks Ah Kh] [4d]
38a4c833: checks
fc99599f: bets $0.2
38a4c833: calls $0.2
*** RIVER *** [Ks Ah Kh 4d] [3d]
38a4c833: checks
fc99599f: checks
38a4c833: shows [5s 3s] (Pair of Kings and Pair of Treys)
fc99599f: shows [2h 2c] (Pair of Kings and Pair of Twos)
*** SHOWDOWN ***
38a4c833 collected $0.86 from pot
*** SUMMARY ***
Total pot $0.9 | Rake $0.04 | Jackpot $0 | Bingo $0 | Fortune $0 | Tax $0
Board [Ks Ah Kh 4d 3d]
Seat 1: Hero (button) folded before Flop (didn't bet)
Seat 2: 38a4c833 (small blind) showed [5s 3s] and won ($0.86) with Pair of Kings and Pair of Treys
Seat 3: 8dbd0a2d (big blind) folded on the Flop
Seat 4: 692417ff folded on the Flop
Seat 5: 84667b37 folded before Flop (didn't bet)
Seat 6: fc99599f showed [2h 2c] and lost with Pair of Kings and Pair of Twos


Poker Hand #RC3334483294: Hold'em No Limit ($0.02/$0.05) - 2025/02/17 21:10:39
Table 'RushAndCash618554' 6-max Seat #1 is the button
Seat 1: 87256f31 ($6.13 in chips)
Seat 2: 77d1364f ($5.13 in chips)
Seat 3: Hero ($7.27 in chips)
Seat 4: e72c7748 ($12.89 in chips)
Seat 5: 52f43d28 ($9.14 in chips)
Seat 6: 450ff502 ($5.09 in chips)
77d1364f: posts small blind $0.02
Hero: posts big blind $0.05
*** HOLE CARDS ***
Dealt to 87256f31 
Dealt to 77d1364f 
Dealt to Hero [7c 6d]
Dealt to e72c7748 
Dealt to 52f43d28 
Dealt to 450ff502 
e72c7748: folds
52f43d28: folds
450ff502: folds
87256f31: folds
77d1364f: raises $0.1 to $0.15
Hero: folds
Uncalled bet ($0.1) returned to 77d1364f
*** SHOWDOWN ***
77d1364f collected $0.1 from pot
*** SUMMARY ***
Total pot $0.1 | Rake $0 | Jackpot $0 | Bingo $0 | Fortune $0 | Tax $0
Seat 1: 87256f31 (button) folded before Flop (didn't bet)
Seat 2: 77d1364f (small blind) collected ($0.1)
Seat 3: Hero (big blind) folded before Flop
Seat 4: e72c7748 folded before Flop (didn't bet)
Seat 5: 52f43d28 folded before Flop (didn't bet)
Seat 6: 450ff502 folded before Flop (didn't bet)


Poker Hand #RC3334483266: Hold'em No Limit ($0.02/$0.05) - 2025/02/17 21:10:36
Table 'RushAndCash618526' 6-max Seat #1 is the button
Seat 1: 76135c78 ($11.49 in chips)
Seat 2: 820e1571 ($5.27 in chips)
Seat 3: 73d087f7 ($5.37 in chips)
Seat 4: a2a0f00 ($5.16 in chips)
Seat 5: Hero ($7.27 in chips)
Seat 6: 95096c6a ($6.6 in chips)
820e1571: posts small blind $0.02
73d087f7: posts big blind $0.05
*** HOLE CARDS ***
Dealt to 76135c78 
Dealt to 820e1571 
Dealt to 73d087f7 
Dealt to a2a0f00 
Dealt to Hero [7d 2h]
Dealt to 95096c6a 
a2a0f00: folds
Hero: folds
95096c6a: folds
76135c78: folds
820e1571: raises $0.1 to $0.15
73d087f7: raises $0.4 to $0.55
820e1571: folds
Uncalled bet ($0.4) returned to 73d087f7
*** SHOWDOWN ***
73d087f7 collected $0.29 from pot
*** SUMMARY ***
Total pot $0.3 | Rake $0.01 | Jackpot $0 | Bingo $0 | Fortune $0 | Tax $0
Seat 1: 76135c78 (button) folded before Flop (didn't bet)
Seat 2: 820e1571 (small blind) folded before Flop
Seat 3: 73d087f7 (big blind) collected ($0.29)
Seat 4: a2a0f00 folded before Flop (didn't bet)
Seat 5: Hero folded before Flop (didn't bet)
Seat 6: 95096c6a folded before Flop (didn't bet)


Poker Hand #RC3334483233: Hold'em No Limit ($0.02/$0.05) - 2025/02/17 21:10:32
Table 'RushAndCash618493' 6-max Seat #1 is the button
Seat 1: e644e026 ($5.1 in chips)
Seat 2: Hero ($7.29 in chips)
Seat 3: c59158f3 ($6.09 in chips)
Seat 4: 90fb5891 ($4.56 in chips)
Seat 5: 4f7979c7 ($4.81 in chips)
Seat 6: 7fc44808 ($12.08 in chips)
Hero: posts small blind $0.02
c59158f3: posts big blind $0.05
*** HOLE CARDS ***
Dealt to e644e026 
Dealt to Hero [Ts 2s]
Dealt to c59158f3 
Dealt to 90fb5891 
Dealt to 4f7979c7 
Dealt to 7fc44808 
90fb5891: raises $0.05 to $0.1
4f7979c7: folds
7fc44808: folds
e644e026: folds
Hero: folds
c59158f3: calls $0.05
*** FLOP *** [7c Js Ad]
c59158f3: checks
90fb5891: bets $0.1
c59158f3: folds
Uncalled bet ($0.1) returned to 90fb5891
*** SHOWDOWN ***
90fb5891 collected $0.21 from pot
*** SUMMARY ***
Total pot $0.22 | Rake $0.01 | Jackpot $0 | Bingo $0 | Fortune $0 | Tax $0
Board [7c Js Ad]
Seat 1: e644e026 (button) folded before Flop (didn't bet)
Seat 2: Hero (small blind) folded before Flop
Seat 3: c59158f3 (big blind) folded on the Flop
Seat 4: 90fb5891 won ($0.21)
Seat 5: 4f7979c7 folded before Flop (didn't bet)
Seat 6: 7fc44808 folded before Flop (didn't bet)


Poker Hand #RC3334483208: Hold'em No Limit ($0.02/$0.05) - 2025/02/17 21:10:29
Table 'RushAndCash618468' 6-max Seat #1 is the button
Seat 1: 8f9fd8b1 ($13.37 in chips)
Seat 2: ccabd9d2 ($5 in chips)
Seat 3: 64526212 ($5.26 in chips)
Seat 4: Hero ($7.29 in chips)
Seat 5: c1784884 ($5 in chips)
Seat 6: d47cb19 ($5.14 in chips)
ccabd9d2: posts small blind $0.02
64526212: posts big blind $0.05
*** HOLE CARDS ***
Dealt to 8f9fd8b1 
Dealt to ccabd9d2 
Dealt to 64526212 
Dealt to Hero [Kh 5c]
Dealt to c1784884 
Dealt to d47cb19 
Hero: folds
c1784884: folds
d47cb19: raises $0.08 to $0.13
8f9fd8b1: folds
ccabd9d2: folds
64526212: folds
Uncalled bet ($0.08) returned to d47cb19
*** SHOWDOWN ***
d47cb19 collected $0.12 from pot
*** SUMMARY ***
Total pot $0.12 | Rake $0 | Jackpot $0 | Bingo $0 | Fortune $0 | Tax $0
Seat 1: 8f9fd8b1 (button) folded before Flop (didn't bet)
Seat 2: ccabd9d2 (small blind) folded before Flop
Seat 3: 64526212 (big blind) folded before Flop
Seat 4: Hero folded before Flop (didn't bet)
Seat 5: c1784884 folded before Flop (didn't bet)
Seat 6: d47cb19 collected ($0.12)


Poker Hand #RC3334483135: Hold'em No Limit ($0.02/$0.05) - 2025/02/17 21:10:21
Table 'RushAndCash618395' 6-max Seat #1 is the button
Seat 1: 6a5a3ab6 ($4.21 in chips)
Seat 2: a2123cbe ($12.01 in chips)
Seat 3: 66be2112 ($5.19 in chips)
Seat 4: 31bef4 ($6.5 in chips)
Seat 5: Hero ($7.29 in chips)
Seat 6: 688d08ef ($5.39 in chips)
a2123cbe: posts small blind $0.02
66be2112: posts big blind $0.05
*** HOLE CARDS ***
Dealt to 6a5a3ab6 
Dealt to a2123cbe 
Dealt to 66be2112 
Dealt to 31bef4 
Dealt to Hero [8d Ac]
Dealt to 688d08ef 
31bef4: folds
Hero: folds
688d08ef: folds
6a5a3ab6: folds
a2123cbe: folds
Uncalled bet ($0.03) returned to 66be2112
*** SHOWDOWN ***
66be2112 collected $0.04 from pot
*** SUMMARY ***
Total pot $0.04 | Rake $0 | Jackpot $0 | Bingo $0 | Fortune $0 | Tax $0
Seat 1: 6a5a3ab6 (button) folded before Flop (didn't bet)
Seat 2: a2123cbe (small blind) folded before Flop
Seat 3: 66be2112 (big blind) collected ($0.04)
Seat 4: 31bef4 folded before Flop (didn't bet)
Seat 5: Hero folded before Flop (didn't bet)
Seat 6: 688d08ef folded before Flop (didn't bet)


Poker Hand #RC3334483094: Hold'em No Limit ($0.02/$0.05) - 2025/02/17 21:10:16
Table 'RushAndCash618354' 6-max Seat #1 is the button
Seat 1: Hero ($7.29 in chips)
Seat 2: ec1214a6 ($5.18 in chips)
Seat 3: 7a24974a ($5.31 in chips)
Seat 4: 54c506e4 ($5 in chips)
Seat 5: 1e76a4d8 ($6.42 in chips)
Seat 6: e7868a11 ($10.01 in chips)
ec1214a6: posts small blind $0.02
7a24974a: posts big blind $0.05
*** HOLE CARDS ***
Dealt to Hero [9c Qs]
Dealt to ec1214a6 
Dealt to 7a24974a 
Dealt to 54c506e4 
Dealt to 1e76a4d8 
Dealt to e7868a11 
54c506e4: folds
1e76a4d8: folds
e7868a11: folds
Hero: folds
ec1214a6: folds
Uncalled bet ($0.03) returned to 7a24974a
*** SHOWDOWN ***
7a24974a collected $0.04 from pot
*** SUMMARY ***
Total pot $0.04 | Rake $0 | Jackpot $0 | Bingo $0 | Fortune $0 | Tax $0
Seat 1: Hero (button) folded before Flop (didn't bet)
Seat 2: ec1214a6 (small blind) folded before Flop
Seat 3: 7a24974a (big blind) collected ($0.04)
Seat 4: 54c506e4 folded before Flop (didn't bet)
Seat 5: 1e76a4d8 folded before Flop (didn't bet)
Seat 6: e7868a11 folded before Flop (didn't bet)


Poker Hand #RC3334483058: Hold'em No Limit ($0.02/$0.05) - 2025/02/17 21:10:12
Table 'RushAndCash618318' 6-max Seat #1 is the button
Seat 1: e0a9129e ($3.44 in chips)
Seat 2: 6dc21e6a ($5.08 in chips)
Seat 3: 62156df3 ($5.27 in chips)
Seat 4: 22e7e468 ($5.32 in chips)
Seat 5: e74a324 ($15.53 in chips)
Seat 6: Hero ($7.29 in chips)
6dc21e6a: posts small blind $0.02
62156df3: posts big blind $0.05
*** HOLE CARDS ***
Dealt to e0a9129e 
Dealt to 6dc21e6a 
Dealt to 62156df3 
Dealt to 22e7e468 
Dealt to e74a324 
Dealt to Hero [Jh Ts]
22e7e468: raises $0.05 to $0.1
e74a324: folds
Hero: folds
e0a9129e: folds
6dc21e6a: raises $0.34 to $0.44
62156df3: folds
22e7e468: folds
Uncalled bet ($0.34) returned to 6dc21e6a
*** SHOWDOWN ***
6dc21e6a collected $0.24 from pot
*** SUMMARY ***
Total pot $0.25 | Rake $0.01 | Jackpot $0 | Bingo $0 | Fortune $0 | Tax $0
Seat 1: e0a9129e (button) folded before Flop (didn't bet)
Seat 2: 6dc21e6a (small blind) collected ($0.24)
Seat 3: 62156df3 (big blind) folded before Flop
Seat 4: 22e7e468 folded before Flop
Seat 5: e74a324 folded before Flop (didn't bet)
Seat 6: Hero folded before Flop (didn't bet)


Poker Hand #RC3334482693: Hold'em No Limit ($0.02/$0.05) - 2025/02/17 21:09:28
Table 'RushAndCash617953' 6-max Seat #1 is the button
Seat 1: 6dc21e6a ($5.18 in chips)
Seat 2: 757f29d9 ($5.29 in chips)
Seat 3: Hero ($7.08 in chips)
Seat 4: 9013f95e ($13.11 in chips)
Seat 5: b59fc0b9 ($5.37 in chips)
Seat 6: bda9ba33 ($5.02 in chips)
757f29d9: posts small blind $0.02
Hero: posts big blind $0.05
*** HOLE CARDS ***
Dealt to 6dc21e6a 
Dealt to 757f29d9 
Dealt to Hero [Qd Ts]
Dealt to 9013f95e 
Dealt to b59fc0b9 
Dealt to bda9ba33 
9013f95e: calls $0.05
b59fc0b9: folds
bda9ba33: folds
6dc21e6a: calls $0.05
757f29d9: folds
Hero: checks
*** FLOP *** [Qh 4d Qs]
Hero: checks
9013f95e: checks
6dc21e6a: checks
*** TURN *** [Qh 4d Qs] [Th]
Hero: bets $0.05
9013f95e: calls $0.05
6dc21e6a: calls $0.05
*** RIVER *** [Qh 4d Qs Th] [Tc]
Hero: bets $0.16
9013f95e: folds
6dc21e6a: folds
Uncalled bet ($0.16) returned to Hero
*** SHOWDOWN ***
Hero collected $0.31 from pot
*** SUMMARY ***
Total pot $0.32 | Rake $0.01 | Jackpot $0 | Bingo $0 | Fortune $0 | Tax $0
Board [Qh 4d Qs Th Tc]
Seat 1: 6dc21e6a (button) folded on the River
Seat 2: 757f29d9 (small blind) folded before Flop
Seat 3: Hero (big blind) won ($0.31)
Seat 4: 9013f95e folded on the River
Seat 5: b59fc0b9 folded before Flop (didn't bet)
Seat 6: bda9ba33 folded before Flop (didn't bet)


Poker Hand #RC3334482660: Hold'em No Limit ($0.02/$0.05) - 2025/02/17 21:09:25
Table 'RushAndCash617920' 6-max Seat #1 is the button
Seat 1: b3aefb75 ($9.55 in chips)
Seat 2: Hero ($7.1 in chips)
Seat 3: 3bfcd529 ($5.23 in chips)
Seat 4: f6abc1da ($4.65 in chips)
Seat 5: 8c3789e ($5.39 in chips)
Seat 6: 9864109b ($6.74 in chips)
Hero: posts small blind $0.02
3bfcd529: posts big blind $0.05
*** HOLE CARDS ***
Dealt to b3aefb75 
Dealt to Hero [Jd 2h]
Dealt to 3bfcd529 
Dealt to f6abc1da 
Dealt to 8c3789e 
Dealt to 9864109b 
f6abc1da: folds
8c3789e: folds
9864109b: folds
b3aefb75: folds
Hero: folds
Uncalled bet ($0.03) returned to 3bfcd529
*** SHOWDOWN ***
3bfcd529 collected $0.04 from pot
*** SUMMARY ***
Total pot $0.04 | Rake $0 | Jackpot $0 | Bingo $0 | Fortune $0 | Tax $0
Seat 1: b3aefb75 (button) folded before Flop (didn't bet)
Seat 2: Hero (small blind) folded before Flop
Seat 3: 3bfcd529 (big blind) collected ($0.04)
Seat 4: f6abc1da folded before Flop (didn't bet)
Seat 5: 8c3789e folded before Flop (didn't bet)
Seat 6: 9864109b folded before Flop (didn't bet)


Poker Hand #RC3334482615: Hold'em No Limit ($0.02/$0.05) - 2025/02/17 21:09:20
Table 'RushAndCash617875' 6-max Seat #1 is the button
Seat 1: 7c8b3964 ($5 in chips)
Seat 2: e3cc36cb ($5.79 in chips)
Seat 3: Hero ($7.15 in chips)
Seat 4: baaf0b0d ($5 in chips)
Seat 5: c8e834fc ($5 in chips)
Seat 6: 9f9e1094 ($6.16 in chips)
e3cc36cb: posts small blind $0.02
Hero: posts big blind $0.05
*** HOLE CARDS ***
Dealt to 7c8b3964 
Dealt to e3cc36cb 
Dealt to Hero [7c Kh]
Dealt to baaf0b0d 
Dealt to c8e834fc 
Dealt to 9f9e1094 
baaf0b0d: folds
c8e834fc: folds
9f9e1094: raises $0.06 to $0.11
7c8b3964: calls $0.11
e3cc36cb: folds
Hero: folds
*** FLOP *** [3s Td As]
9f9e1094: bets $0.1
7c8b3964: calls $0.1
*** TURN *** [3s Td As] [8d]
9f9e1094: bets $0.25
7c8b3964: calls $0.25
*** RIVER *** [3s Td As 8d] [Jd]
9f9e1094: bets $0.85
7c8b3964: folds
Uncalled bet ($0.85) returned to 9f9e1094
*** SHOWDOWN ***
9f9e1094 collected $0.94 from pot
*** SUMMARY ***
Total pot $0.99 | Rake $0.05 | Jackpot $0 | Bingo $0 | Fortune $0 | Tax $0
Board [3s Td As 8d Jd]
Seat 1: 7c8b3964 (button) folded on the River
Seat 2: e3cc36cb (small blind) folded before Flop
Seat 3: Hero (big blind) folded before Flop
Seat 4: baaf0b0d folded before Flop (didn't bet)
Seat 5: c8e834fc folded before Flop (didn't bet)
Seat 6: 9f9e1094 won ($0.94)


Poker Hand #RC3334482316: Hold'em No Limit ($0.02/$0.05) - 2025/02/17 21:08:42
Table 'RushAndCash617576' 6-max Seat #1 is the button
Seat 1: Hero ($7.08 in chips)
Seat 2: cedf4726 ($12.67 in chips)
Seat 3: b3aefb75 ($9.6 in chips)
Seat 4: 692e3a83 ($10.1 in chips)
Seat 5: 38a4c833 ($7.53 in chips)
Seat 6: 6008538 ($3.57 in chips)
cedf4726: posts small blind $0.02
b3aefb75: posts big blind $0.05
*** HOLE CARDS ***
Dealt to Hero [Qs 8s]
Dealt to cedf4726 
Dealt to b3aefb75 
Dealt to 692e3a83 
Dealt to 38a4c833 
Dealt to 6008538 
692e3a83: folds
38a4c833: folds
6008538: folds
Hero: raises $0.05 to $0.1
cedf4726: folds
b3aefb75: folds
Uncalled bet ($0.05) returned to Hero
*** SHOWDOWN ***
Hero collected $0.12 from pot
*** SUMMARY ***
Total pot $0.12 | Rake $0 | Jackpot $0 | Bingo $0 | Fortune $0 | Tax $0
Seat 1: Hero (button) collected ($0.12)
Seat 2: cedf4726 (small blind) folded before Flop
Seat 3: b3aefb75 (big blind) folded before Flop
Seat 4: 692e3a83 folded before Flop (didn't bet)
Seat 5: 38a4c833 folded before Flop (didn't bet)
Seat 6: 6008538 folded before Flop (didn't bet)


Poker Hand #RC3334482292: Hold'em No Limit ($0.02/$0.05) - 2025/02/17 21:08:39
Table 'RushAndCash617552' 6-max Seat #1 is the button
Seat 1: 5f1cdd27 ($5.02 in chips)
Seat 2: 71f2556b ($2.76 in chips)
Seat 3: 42c7d5a0 ($5 in chips)
Seat 4: 7f0fed0a ($10.15 in chips)
Seat 5: d92ddef8 ($4.46 in chips)
Seat 6: Hero ($7.08 in chips)
71f2556b: posts small blind $0.02
42c7d5a0: posts big blind $0.05
*** HOLE CARDS ***
Dealt to 5f1cdd27 
Dealt to 71f2556b 
Dealt to 42c7d5a0 
Dealt to 7f0fed0a 
Dealt to d92ddef8 
Dealt to Hero [Qc 9s]
7f0fed0a: folds
d92ddef8: folds
Hero: folds
5f1cdd27: calls $0.05
71f2556b: folds
42c7d5a0: checks
*** FLOP *** [Jh 7c 5s]
42c7d5a0: checks
5f1cdd27: bets $0.05
42c7d5a0: calls $0.05
*** TURN *** [Jh 7c 5s] [Kh]
42c7d5a0: checks
5f1cdd27: checks
*** RIVER *** [Jh 7c 5s Kh] [7d]
42c7d5a0: checks
5f1cdd27: bets $0.11
42c7d5a0: folds
Uncalled bet ($0.11) returned to 5f1cdd27
*** SHOWDOWN ***
5f1cdd27 collected $0.21 from pot
*** SUMMARY ***
Total pot $0.22 | Rake $0.01 | Jackpot $0 | Bingo $0 | Fortune $0 | Tax $0
Board [Jh 7c 5s Kh 7d]
Seat 1: 5f1cdd27 (button) won ($0.21)
Seat 2: 71f2556b (small blind) folded before Flop
Seat 3: 42c7d5a0 (big blind) folded on the River
Seat 4: 7f0fed0a folded before Flop (didn't bet)
Seat 5: d92ddef8 folded before Flop (didn't bet)
Seat 6: Hero folded before Flop (didn't bet)


Poker Hand #RC3334482241: Hold'em No Limit ($0.02/$0.05) - 2025/02/17 21:08:32
Table 'RushAndCash617501' 6-max Seat #1 is the button
Seat 1: fedfe7c6 ($14.05 in chips)
Seat 2: f6abc1da ($4.9 in chips)
Seat 3: a86de18f ($1.5 in chips)
Seat 4: Hero ($7.08 in chips)
Seat 5: ccabd9d2 ($4.93 in chips)
Seat 6: 15346d36 ($5.29 in chips)
f6abc1da: posts small blind $0.02
a86de18f: posts big blind $0.05
*** HOLE CARDS ***
Dealt to fedfe7c6 
Dealt to f6abc1da 
Dealt to a86de18f 
Dealt to Hero [6c Ac]
Dealt to ccabd9d2 
Dealt to 15346d36 
Hero: folds
ccabd9d2: folds
15346d36: folds
fedfe7c6: folds
f6abc1da: raises $0.05 to $0.1
a86de18f: calls $0.05
*** FLOP *** [Ts Tc 5s]
f6abc1da: checks
a86de18f: checks
*** TURN *** [Ts Tc 5s] [7s]
f6abc1da: checks
a86de18f: bets $0.15
f6abc1da: calls $0.15
*** RIVER *** [Ts Tc 5s 7s] [6d]
f6abc1da: checks
a86de18f: bets $0.38
f6abc1da: folds
Uncalled bet ($0.38) returned to a86de18f
*** SHOWDOWN ***
a86de18f collected $0.48 from pot
*** SUMMARY ***
Total pot $0.5 | Rake $0.02 | Jackpot $0 | Bingo $0 | Fortune $0 | Tax $0
Board [Ts Tc 5s 7s 6d]
Seat 1: fedfe7c6 (button) folded before Flop (didn't bet)
Seat 2: f6abc1da (small blind) folded on the River
Seat 3: a86de18f (big blind) won ($0.48)
Seat 4: Hero folded before Flop (didn't bet)
Seat 5: ccabd9d2 folded before Flop (didn't bet)
Seat 6: 15346d36 folded before Flop (didn't bet)


Poker Hand #RC3334482211: Hold'em No Limit ($0.02/$0.05) - 2025/02/17 21:08:28
Table 'RushAndCash617471' 6-max Seat #1 is the button
Seat 1: f3614ba1 ($10.67 in chips)
Seat 2: f56d4922 ($5 in chips)
Seat 3: ff1d8df1 ($6.63 in chips)
Seat 4: 9143d0b0 ($5.05 in chips)
Seat 5: 6dcd0788 ($9.52 in chips)
Seat 6: Hero ($7.08 in chips)
f56d4922: posts small blind $0.02
ff1d8df1: posts big blind $0.05
*** HOLE CARDS ***
Dealt to f3614ba1 
Dealt to f56d4922 
Dealt to ff1d8df1 
Dealt to 9143d0b0 
Dealt to 6dcd0788 
Dealt to Hero [2h 9h]
9143d0b0: raises $0.06 to $0.11
6dcd0788: folds
Hero: folds
f3614ba1: raises $0.22 to $0.33
f56d4922: folds
ff1d8df1: folds
9143d0b0: raises $0.69 to $1.02
f3614ba1: folds
Uncalled bet ($0.69) returned to 9143d0b0
*** SHOWDOWN ***
9143d0b0 collected $0.7 from pot
*** SUMMARY ***
Total pot $0.73 | Rake $0.03 | Jackpot $0 | Bingo $0 | Fortune $0 | Tax $0
Seat 1: f3614ba1 (button) folded before Flop
Seat 2: f56d4922 (small blind) folded before Flop
Seat 3: ff1d8df1 (big blind) folded before Flop
Seat 4: 9143d0b0 collected ($0.7)
Seat 5: 6dcd0788 folded before Flop (didn't bet)
Seat 6: Hero folded before Flop (didn't bet)


Poker Hand #RC3334482178: Hold'em No Limit ($0.02/$0.05) - 2025/02/17 21:08:24
Table 'RushAndCash617438' 6-max Seat #1 is the button
Seat 1: 19bb03b5 ($11.84 in chips)
Seat 2: Hero ($7.1 in chips)
Seat 3: b9ae439d ($4.32 in chips)
Seat 4: f1821143 ($6.82 in chips)
Seat 5: 650e9dc7 ($7.72 in chips)
Seat 6: a57ff8a7 ($5.09 in chips)
Hero: posts small blind $0.02
b9ae439d: posts big blind $0.05
*** HOLE CARDS ***
Dealt to 19bb03b5 
Dealt to Hero [9d 3d]
Dealt to b9ae439d 
Dealt to f1821143 
Dealt to 650e9dc7 
Dealt to a57ff8a7 
f1821143: folds
650e9dc7: folds
a57ff8a7: folds
19bb03b5: folds
Hero: folds
Uncalled bet ($0.03) returned to b9ae439d
*** SHOWDOWN ***
b9ae439d collected $0.04 from pot
*** SUMMARY ***
Total pot $0.04 | Rake $0 | Jackpot $0 | Bingo $0 | Fortune $0 | Tax $0
Seat 1: 19bb03b5 (button) folded before Flop (didn't bet)
Seat 2: Hero (small blind) folded before Flop
Seat 3: b9ae439d (big blind) collected ($0.04)
Seat 4: f1821143 folded before Flop (didn't bet)
Seat 5: 650e9dc7 folded before Flop (didn't bet)
Seat 6: a57ff8a7 folded before Flop (didn't bet)


Poker Hand #RC3334482137: Hold'em No Limit ($0.02/$0.05) - 2025/02/17 21:08:19
Table 'RushAndCash617397' 6-max Seat #1 is the button
Seat 1: 1ac52efc ($5.07 in chips)
Seat 2: bfef046a ($24.03 in chips)
Seat 3: 3b701823 ($6.59 in chips)
Seat 4: 65ca9276 ($5.58 in chips)
Seat 5: Hero ($7.1 in chips)
Seat 6: 42fca4f9 ($10.57 in chips)
bfef046a: posts small blind $0.02
3b701823: posts big blind $0.05
*** HOLE CARDS ***
Dealt to 1ac52efc 
Dealt to bfef046a 
Dealt to 3b701823 
Dealt to 65ca9276 
Dealt to Hero [5c 2h]
Dealt to 42fca4f9 
65ca9276: raises $0.08 to $0.13
Hero: folds
42fca4f9: folds
1ac52efc: folds
bfef046a: calls $0.11
3b701823: calls $0.08
*** FLOP *** [Ts 6c Td]
bfef046a: checks
3b701823: checks
65ca9276: bets $0.16
bfef046a: calls $0.16
3b701823: calls $0.16
*** TURN *** [Ts 6c Td] [Jc]
bfef046a: checks
3b701823: checks
65ca9276: bets $0.66
bfef046a: folds
3b701823: raises $1.71 to $2.37
65ca9276: calls $1.71
*** RIVER *** [Ts 6c Td Jc] [Jd]
3b701823: checks
65ca9276: checks
3b701823: shows [9s 8h] (Pair of Jacks and Pair of Tens)
65ca9276: shows [Ah As] (Pair of Aces and Pair of Jacks)
*** SHOWDOWN ***
65ca9276 collected $5.39 from pot
*** SUMMARY ***
Total pot $5.61 | Rake $0.15 | Jackpot $0.07 | Bingo $0 | Fortune $0 | Tax $0
Board [Ts 6c Td Jc Jd]
Seat 1: 1ac52efc (button) folded before Flop (didn't bet)
Seat 2: bfef046a (small blind) folded on the Turn
Seat 3: 3b701823 (big blind) showed [9s 8h] and lost with Pair of Jacks and Pair of Tens
Seat 4: 65ca9276 showed [Ah As] and won ($5.39) with Pair of Aces and Pair of Jacks
Seat 5: Hero folded before Flop (didn't bet)
Seat 6: 42fca4f9 folded before Flop (didn't bet)


Poker Hand #RC3334482075: Hold'em No Limit ($0.02/$0.05) - 2025/02/17 21:08:11
Table 'RushAndCash617335' 6-max Seat #1 is the button
Seat 1: Hero ($7.1 in chips)
Seat 2: 7c8d7172 ($7.53 in chips)
Seat 3: a5be70d9 ($5.32 in chips)
Seat 4: 577aa3d3 ($6.01 in chips)
Seat 5: af9df96 ($8.86 in chips)
Seat 6: b258f9f9 ($5 in chips)
7c8d7172: posts small blind $0.02
a5be70d9: posts big blind $0.05
*** HOLE CARDS ***
Dealt to Hero [4h Qc]
Dealt to 7c8d7172 
Dealt to a5be70d9 
Dealt to 577aa3d3 
Dealt to af9df96 
Dealt to b258f9f9 
577aa3d3: folds
af9df96: raises $0.05 to $0.1
b258f9f9: folds
Hero: folds
7c8d7172: raises $0.3 to $0.4
a5be70d9: folds
af9df96: calls $0.3
*** FLOP *** [2d Kc 4d]
7c8d7172: checks
af9df96: bets $0.29
7c8d7172: calls $0.29
*** TURN *** [2d Kc 4d] [5c]
7c8d7172: checks
af9df96: bets $0.48
7c8d7172: calls $0.48
*** RIVER *** [2d Kc 4d 5c] [Jd]
7c8d7172: checks
af9df96: checks
7c8d7172: shows [Qd Qs] (Pair of Queens)
af9df96: shows [Ks Ad] (Pair of Kings)
*** SHOWDOWN ***
af9df96 collected $2.21 from pot
*** SUMMARY ***
Total pot $2.39 | Rake $0.11 | Jackpot $0.07 | Bingo $0 | Fortune $0 | Tax $0
Board [2d Kc 4d 5c Jd]
Seat 1: Hero (button) folded before Flop (didn't bet)
Seat 2: 7c8d7172 (small blind) showed [Qd Qs] and lost with Pair of Queens
Seat 3: a5be70d9 (big blind) folded before Flop
Seat 4: 577aa3d3 folded before Flop (didn't bet)
Seat 5: af9df96 showed [Ks Ad] and won ($2.21) with Pair of Kings
Seat 6: b258f9f9 folded before Flop (didn't bet)


Poker Hand #RC3334482049: Hold'em No Limit ($0.02/$0.05) - 2025/02/17 21:08:08
Table 'RushAndCash617309' 6-max Seat #1 is the button
Seat 1: Hero ($7.1 in chips)
Seat 2: 3723bfd4 ($4.98 in chips)
Seat 3: cf593991 ($10.72 in chips)
Seat 4: b258f9f9 ($5 in chips)
Seat 5: 577aa3d3 ($6.01 in chips)
Seat 6: ac083cf2 ($4.03 in chips)
3723bfd4: posts small blind $0.02
cf593991: posts big blind $0.05
*** HOLE CARDS ***
Dealt to Hero [Kd 2d]
Dealt to 3723bfd4 
Dealt to cf593991 
Dealt to b258f9f9 
Dealt to 577aa3d3 
Dealt to ac083cf2 
b258f9f9: folds
577aa3d3: folds
ac083cf2: folds
Hero: folds
3723bfd4: raises $0.1 to $0.15
cf593991: raises $0.45 to $0.6
3723bfd4: calls $0.45
*** FLOP *** [Th 5d Td]
3723bfd4: checks
cf593991: bets $0.4
3723bfd4: calls $0.4
*** TURN *** [Th 5d Td] [2c]
3723bfd4: checks
cf593991: bets $0.9
3723bfd4: folds
Uncalled bet ($0.9) returned to cf593991
*** SHOWDOWN ***
cf593991 collected $1.84 from pot
*** SUMMARY ***
Total pot $2 | Rake $0.09 | Jackpot $0.07 | Bingo $0 | Fortune $0 | Tax $0
Board [Th 5d Td 2c]
Seat 1: Hero (button) folded before Flop (didn't bet)
Seat 2: 3723bfd4 (small blind) folded on the Turn
Seat 3: cf593991 (big blind) won ($1.84)
Seat 4: b258f9f9 folded before Flop (didn't bet)
Seat 5: 577aa3d3 folded before Flop (didn't bet)
Seat 6: ac083cf2 folded before Flop (didn't bet)


Poker Hand #RC3334482008: Hold'em No Limit ($0.02/$0.05) - 2025/02/17 21:08:03
Table 'RushAndCash617268' 6-max Seat #1 is the button
Seat 1: bacb67c8 ($4.49 in chips)
Seat 2: 1f85219b ($5.48 in chips)
Seat 3: 3208c594 ($4.77 in chips)
Seat 4: 92fa3d91 ($4.9 in chips)
Seat 5: Hero ($7.1 in chips)
Seat 6: 1fa8537 ($6.76 in chips)
1f85219b: posts small blind $0.02
3208c594: posts big blind $0.05
*** HOLE CARDS ***
Dealt to bacb67c8 
Dealt to 1f85219b 
Dealt to 3208c594 
Dealt to 92fa3d91 
Dealt to Hero [Qd 8c]
Dealt to 1fa8537 
92fa3d91: folds
Hero: folds
1fa8537: raises $0.06 to $0.11
bacb67c8: folds
1f85219b: folds
3208c594: folds
Uncalled bet ($0.06) returned to 1fa8537
*** SHOWDOWN ***
1fa8537 collected $0.12 from pot
*** SUMMARY ***
Total pot $0.12 | Rake $0 | Jackpot $0 | Bingo $0 | Fortune $0 | Tax $0
Seat 1: bacb67c8 (button) folded before Flop (didn't bet)
Seat 2: 1f85219b (small blind) folded before Flop
Seat 3: 3208c594 (big blind) folded before Flop
Seat 4: 92fa3d91 folded before Flop (didn't bet)
Seat 5: Hero folded before Flop (didn't bet)
Seat 6: 1fa8537 collected ($0.12)


Poker Hand #RC3334481976: Hold'em No Limit ($0.02/$0.05) - 2025/02/17 21:07:59
Table 'RushAndCash617236' 6-max Seat #1 is the button
Seat 1: 77936ad9 ($6.24 in chips)
Seat 2: 9864109b ($6.89 in chips)
Seat 3: ab43c8b8 ($5.75 in chips)
Seat 4: e6ee1d7f ($7.68 in chips)
Seat 5: Hero ($7.1 in chips)
Seat 6: 7df4712d ($12.79 in chips)
9864109b: posts small blind $0.02
ab43c8b8: posts big blind $0.05
*** HOLE CARDS ***
Dealt to 77936ad9 
Dealt to 9864109b 
Dealt to ab43c8b8 
Dealt to e6ee1d7f 
Dealt to Hero [5h Qh]
Dealt to 7df4712d 
e6ee1d7f: raises $0.06 to $0.11
Hero: folds
7df4712d: folds
77936ad9: folds
9864109b: folds
ab43c8b8: folds
Uncalled bet ($0.06) returned to e6ee1d7f
*** SHOWDOWN ***
e6ee1d7f collected $0.12 from pot
*** SUMMARY ***
Total pot $0.12 | Rake $0 | Jackpot $0 | Bingo $0 | Fortune $0 | Tax $0
Seat 1: 77936ad9 (button) folded before Flop (didn't bet)
Seat 2: 9864109b (small blind) folded before Flop
Seat 3: ab43c8b8 (big blind) folded before Flop
Seat 4: e6ee1d7f collected ($0.12)
Seat 5: Hero folded before Flop (didn't bet)
Seat 6: 7df4712d folded before Flop (didn't bet)


Poker Hand #RC3334481952: Hold'em No Limit ($0.02/$0.05) - 2025/02/17 21:07:55
Table 'RushAndCash617212' 6-max Seat #1 is the button
Seat 1: db6b60a1 ($5.5 in chips)
Seat 2: 902b47de ($5.61 in chips)
Seat 3: 1e290a15 ($12.32 in chips)
Seat 4: Hero ($7.1 in chips)
Seat 5: db0f0c64 ($7.09 in chips)
Seat 6: 8a5a4b28 ($1.8 in chips)
902b47de: posts small blind $0.02
1e290a15: posts big blind $0.05
*** HOLE CARDS ***
Dealt to db6b60a1 
Dealt to 902b47de 
Dealt to 1e290a15 
Dealt to Hero [5s Qh]
Dealt to db0f0c64 
Dealt to 8a5a4b28 
Hero: folds
db0f0c64: folds
8a5a4b28: raises $0.07 to $0.12
db6b60a1: folds
902b47de: calls $0.1
1e290a15: calls $0.07
*** FLOP *** [5c 4c 9h]
902b47de: checks
1e290a15: checks
8a5a4b28: checks
*** TURN *** [5c 4c 9h] [2s]
902b47de: bets $0.36
1e290a15: folds
8a5a4b28: folds
Uncalled bet ($0.36) returned to 902b47de
*** SHOWDOWN ***
902b47de collected $0.35 from pot
*** SUMMARY ***
Total pot $0.36 | Rake $0.01 | Jackpot $0 | Bingo $0 | Fortune $0 | Tax $0
Board [5c 4c 9h 2s]
Seat 1: db6b60a1 (button) folded before Flop (didn't bet)
Seat 2: 902b47de (small blind) won ($0.35)
Seat 3: 1e290a15 (big blind) folded on the Turn
Seat 4: Hero folded before Flop (didn't bet)
Seat 5: db0f0c64 folded before Flop (didn't bet)
Seat 6: 8a5a4b28 folded on the Turn


Poker Hand #RC3334481922: Hold'em No Limit ($0.02/$0.05) - 2025/02/17 21:07:52
Table 'RushAndCash617182' 6-max Seat #1 is the button
Seat 1: 5c8c19b7 ($15.02 in chips)
Seat 2: db6b60a1 ($5.45 in chips)
Seat 3: 27baaa05 ($6.87 in chips)
Seat 4: 21c758a ($5.54 in chips)
Seat 5: Hero ($7.1 in chips)
Seat 6: 92e1348d ($8.24 in chips)
db6b60a1: posts small blind $0.02
27baaa05: posts big blind $0.05
*** HOLE CARDS ***
Dealt to 5c8c19b7 
Dealt to db6b60a1 
Dealt to 27baaa05 
Dealt to 21c758a 
Dealt to Hero [4h Ks]
Dealt to 92e1348d 
21c758a: folds
Hero: folds
92e1348d: folds
5c8c19b7: folds
db6b60a1: folds
Uncalled bet ($0.03) returned to 27baaa05
*** SHOWDOWN ***
27baaa05 collected $0.04 from pot
*** SUMMARY ***
Total pot $0.04 | Rake $0 | Jackpot $0 | Bingo $0 | Fortune $0 | Tax $0
Seat 1: 5c8c19b7 (button) folded before Flop (didn't bet)
Seat 2: db6b60a1 (small blind) folded before Flop
Seat 3: 27baaa05 (big blind) collected ($0.04)
Seat 4: 21c758a folded before Flop (didn't bet)
Seat 5: Hero folded before Flop (didn't bet)
Seat 6: 92e1348d folded before Flop (didn't bet)


Poker Hand #RC3334481536: Hold'em No Limit ($0.02/$0.05) - 2025/02/17 21:07:04
Table 'RushAndCash616796' 6-max Seat #1 is the button
Seat 1: 4190d158 ($8.42 in chips)
Seat 2: 688b40f9 ($5.91 in chips)
Seat 3: Hero ($7.48 in chips)
Seat 4: 9b7148f5 ($9.44 in chips)
Seat 5: f6e684ae ($18.67 in chips)
Seat 6: fa36f7b1 ($4.93 in chips)
688b40f9: posts small blind $0.02
Hero: posts big blind $0.05
*** HOLE CARDS ***
Dealt to 4190d158 
Dealt to 688b40f9 
Dealt to Hero [Ad Kd]
Dealt to 9b7148f5 
Dealt to f6e684ae 
Dealt to fa36f7b1 
9b7148f5: folds
f6e684ae: folds
fa36f7b1: raises $0.05 to $0.1
4190d158: folds
688b40f9: folds
Hero: raises $0.28 to $0.38
fa36f7b1: calls $0.28
*** FLOP *** [9c 7d 3s]
Hero: checks
fa36f7b1: checks
*** TURN *** [9c 7d 3s] [3h]
Hero: checks
fa36f7b1: bets $0.42
Hero: folds
Uncalled bet ($0.42) returned to fa36f7b1
*** SHOWDOWN ***
fa36f7b1 collected $0.75 from pot
*** SUMMARY ***
Total pot $0.78 | Rake $0.03 | Jackpot $0 | Bingo $0 | Fortune $0 | Tax $0
Board [9c 7d 3s 3h]
Seat 1: 4190d158 (button) folded before Flop (didn't bet)
Seat 2: 688b40f9 (small blind) folded before Flop
Seat 3: Hero (big blind) folded on the Turn
Seat 4: 9b7148f5 folded before Flop (didn't bet)
Seat 5: f6e684ae folded before Flop (didn't bet)
Seat 6: fa36f7b1 won ($0.75)


Poker Hand #RC3334481255: Hold'em No Limit ($0.02/$0.05) - 2025/02/17 21:06:31
Table 'RushAndCash616515' 6-max Seat #1 is the button
Seat 1: f6013c83 ($15.85 in chips)
Seat 2: Hero ($7.43 in chips)
Seat 3: 621c3c07 ($6.04 in chips)
Seat 4: 534f7ad0 ($2.54 in chips)
Seat 5: 6614dc4b ($5.07 in chips)
Seat 6: 6c641898 ($5.25 in chips)
Hero: posts small blind $0.02
621c3c07: posts big blind $0.05
*** HOLE CARDS ***
Dealt to f6013c83 
Dealt to Hero [9h Kh]
Dealt to 621c3c07 
Dealt to 534f7ad0 
Dealt to 6614dc4b 
Dealt to 6c641898 
534f7ad0: folds
6614dc4b: folds
6c641898: folds
f6013c83: folds
Hero: calls $0.03
621c3c07: checks
*** FLOP *** [Jd 4d 5c]
Hero: checks
621c3c07: checks
*** TURN *** [Jd 4d 5c] [2d]
Hero: checks
621c3c07: checks
*** RIVER *** [Jd 4d 5c 2d] [Js]
Hero: checks
621c3c07: checks
Hero: shows [9h Kh] (Pair of Jacks)
621c3c07: shows [Qc 7c] (Pair of Jacks)
*** SHOWDOWN ***
Hero collected $0.1 from pot
*** SUMMARY ***
Total pot $0.1 | Rake $0 | Jackpot $0 | Bingo $0 | Fortune $0 | Tax $0
Board [Jd 4d 5c 2d Js]
Seat 1: f6013c83 (button) folded before Flop (didn't bet)
Seat 2: Hero (small blind) showed [9h Kh] and won ($0.1) with Pair of Jacks
Seat 3: 621c3c07 (big blind) showed [Qc 7c] and lost with Pair of Jacks
Seat 4: 534f7ad0 folded before Flop (didn't bet)
Seat 5: 6614dc4b folded before Flop (didn't bet)
Seat 6: 6c641898 folded before Flop (didn't bet)


Poker Hand #RC3334481106: Hold'em No Limit ($0.02/$0.05) - 2025/02/17 21:06:13
Table 'RushAndCash616366' 6-max Seat #1 is the button
Seat 1: ab43c8b8 ($5.85 in chips)
Seat 2: afceb40a ($2.15 in chips)
Seat 3: a708a98a ($18.36 in chips)
Seat 4: Hero ($7.53 in chips)
Seat 5: 15125d65 ($13.97 in chips)
Seat 6: d201e5fe ($9.34 in chips)
afceb40a: posts small blind $0.02
a708a98a: posts big blind $0.05
*** HOLE CARDS ***
Dealt to ab43c8b8 
Dealt to afceb40a 
Dealt to a708a98a 
Dealt to Hero [Th Jh]
Dealt to 15125d65 
Dealt to d201e5fe 
Hero: raises $0.05 to $0.1
15125d65: folds
d201e5fe: folds
ab43c8b8: raises $0.42 to $0.52
afceb40a: folds
a708a98a: folds
Hero: folds
Uncalled bet ($0.42) returned to ab43c8b8
*** SHOWDOWN ***
ab43c8b8 collected $0.26 from pot
*** SUMMARY ***
Total pot $0.27 | Rake $0.01 | Jackpot $0 | Bingo $0 | Fortune $0 | Tax $0
Seat 1: ab43c8b8 (button) collected ($0.26)
Seat 2: afceb40a (small blind) folded before Flop
Seat 3: a708a98a (big blind) folded before Flop
Seat 4: Hero folded before Flop
Seat 5: 15125d65 folded before Flop (didn't bet)
Seat 6: d201e5fe folded before Flop (didn't bet)


Poker Hand #RC3334481060: Hold'em No Limit ($0.02/$0.05) - 2025/02/17 21:06:08
Table 'RushAndCash616320' 6-max Seat #1 is the button
Seat 1: c24b20b9 ($19.25 in chips)
Seat 2: 84667b37 ($4.28 in chips)
Seat 3: 8c3789e ($5 in chips)
Seat 4: 9babc997 ($4.77 in chips)
Seat 5: Hero ($7.53 in chips)
Seat 6: 9b152430 ($5.53 in chips)
84667b37: posts small blind $0.02
8c3789e: posts big blind $0.05
*** HOLE CARDS ***
Dealt to c24b20b9 
Dealt to 84667b37 
Dealt to 8c3789e 
Dealt to 9babc997 
Dealt to Hero [As 7s]
Dealt to 9b152430 
9babc997: raises $0.07 to $0.12
Hero: folds
9b152430: folds
c24b20b9: folds
84667b37: folds
8c3789e: folds
Uncalled bet ($0.07) returned to 9babc997
*** SHOWDOWN ***
9babc997 collected $0.12 from pot
*** SUMMARY ***
Total pot $0.12 | Rake $0 | Jackpot $0 | Bingo $0 | Fortune $0 | Tax $0
Seat 1: c24b20b9 (button) folded before Flop (didn't bet)
Seat 2: 84667b37 (small blind) folded before Flop
Seat 3: 8c3789e (big blind) folded before Flop
Seat 4: 9babc997 collected ($0.12)
Seat 5: Hero folded before Flop (didn't bet)
Seat 6: 9b152430 folded before Flop (didn't bet)


Poker Hand #RC3334481035: Hold'em No Limit ($0.02/$0.05) - 2025/02/17 21:06:05
Table 'RushAndCash616295' 6-max Seat #1 is the button
Seat 1: 17d82e36 ($3.2 in chips)
Seat 2: 4812f5c8 ($5 in chips)
Seat 3: 9e5a32b5 ($5.21 in chips)
Seat 4: Hero ($7.53 in chips)
Seat 5: 62156df3 ($5.14 in chips)
Seat 6: 48dc6454 ($2.66 in chips)
4812f5c8: posts small blind $0.02
9e5a32b5: posts big blind $0.05
*** HOLE CARDS ***
Dealt to 17d82e36 
Dealt to 4812f5c8 
Dealt to 9e5a32b5 
Dealt to Hero [5c Ad]
Dealt to 62156df3 
Dealt to 48dc6454 
Hero: folds
62156df3: folds
48dc6454: folds
17d82e36: folds
4812f5c8: folds
Uncalled bet ($0.03) returned to 9e5a32b5
*** SHOWDOWN ***
9e5a32b5 collected $0.04 from pot
*** SUMMARY ***
Total pot $0.04 | Rake $0 | Jackpot $0 | Bingo $0 | Fortune $0 | Tax $0
Seat 1: 17d82e36 (button) folded before Flop (didn't bet)
Seat 2: 4812f5c8 (small blind) folded before Flop
Seat 3: 9e5a32b5 (big blind) collected ($0.04)
Seat 4: Hero folded before Flop (didn't bet)
Seat 5: 62156df3 folded before Flop (didn't bet)
Seat 6: 48dc6454 folded before Flop (didn't bet)


Poker Hand #RC3334480951: Hold'em No Limit ($0.02/$0.05) - 2025/02/17 21:05:54
Table 'RushAndCash616211' 6-max Seat #1 is the button
Seat 1: 54c506e4 ($5 in chips)
Seat 2: a61c94e4 ($5 in chips)
Seat 3: 4238ab48 ($7.03 in chips)
Seat 4: 8c3789e ($5 in chips)
Seat 5: d201e5fe ($9.34 in chips)
Seat 6: Hero ($7.46 in chips)
a61c94e4: posts small blind $0.02
4238ab48: posts big blind $0.05
*** HOLE CARDS ***
Dealt to 54c506e4 
Dealt to a61c94e4 
Dealt to 4238ab48 
Dealt to 8c3789e 
Dealt to d201e5fe 
Dealt to Hero [8d Td]
8c3789e: folds
d201e5fe: folds
Hero: raises $0.05 to $0.1
54c506e4: folds
a61c94e4: folds
4238ab48: folds
Uncalled bet ($0.05) returned to Hero
*** SHOWDOWN ***
Hero collected $0.12 from pot
*** SUMMARY ***
Total pot $0.12 | Rake $0 | Jackpot $0 | Bingo $0 | Fortune $0 | Tax $0
Seat 1: 54c506e4 (button) folded before Flop (didn't bet)
Seat 2: a61c94e4 (small blind) folded before Flop
Seat 3: 4238ab48 (big blind) folded before Flop
Seat 4: 8c3789e folded before Flop (didn't bet)
Seat 5: d201e5fe folded before Flop (didn't bet)
Seat 6: Hero collected ($0.12)


Poker Hand #RC3334480910: Hold'em No Limit ($0.02/$0.05) - 2025/02/17 21:05:48
Table 'RushAndCash616170' 6-max Seat #1 is the button
Seat 1: Hero ($7.46 in chips)
Seat 2: c75b2ba0 ($5.48 in chips)
Seat 3: ef7b5599 ($32.68 in chips)
Seat 4: f23e7bad ($8.68 in chips)
Seat 5: 23c23672 ($5.06 in chips)
Seat 6: ca601b39 ($5.19 in chips)
c75b2ba0: posts small blind $0.02
ef7b5599: posts big blind $0.05
*** HOLE CARDS ***
Dealt to Hero [7h 9h]
Dealt to c75b2ba0 
Dealt to ef7b5599 
Dealt to f23e7bad 
Dealt to 23c23672 
Dealt to ca601b39 
f23e7bad: folds
23c23672: folds
ca601b39: folds
Hero: folds
c75b2ba0: folds
Uncalled bet ($0.03) returned to ef7b5599
*** SHOWDOWN ***
ef7b5599 collected $0.04 from pot
*** SUMMARY ***
Total pot $0.04 | Rake $0 | Jackpot $0 | Bingo $0 | Fortune $0 | Tax $0
Seat 1: Hero (button) folded before Flop (didn't bet)
Seat 2: c75b2ba0 (small blind) folded before Flop
Seat 3: ef7b5599 (big blind) collected ($0.04)
Seat 4: f23e7bad folded before Flop (didn't bet)
Seat 5: 23c23672 folded before Flop (didn't bet)
Seat 6: ca601b39 folded before Flop (didn't bet)


Poker Hand #RC3334480886: Hold'em No Limit ($0.02/$0.05) - 2025/02/17 21:05:45
Table 'RushAndCash616146' 6-max Seat #1 is the button
Seat 1: 42c7d5a0 ($5 in chips)
Seat 2: 54c506e4 ($5 in chips)
Seat 3: Hero ($7.51 in chips)
Seat 4: d00f991c ($10.46 in chips)
Seat 5: cf593991 ($9.85 in chips)
Seat 6: 123dc5ea ($5 in chips)
54c506e4: posts small blind $0.02
Hero: posts big blind $0.05
*** HOLE CARDS ***
Dealt to 42c7d5a0 
Dealt to 54c506e4 
Dealt to Hero [9h 3s]
Dealt to d00f991c 
Dealt to cf593991 
Dealt to 123dc5ea 
d00f991c: folds
cf593991: raises $0.05 to $0.1
123dc5ea: folds
42c7d5a0: calls $0.1
54c506e4: folds
Hero: folds
*** FLOP *** [8d 9c 7d]
cf593991: checks
42c7d5a0: checks
*** TURN *** [8d 9c 7d] [Qc]
cf593991: bets $0.18
42c7d5a0: calls $0.18
*** RIVER *** [8d 9c 7d Qc] [3d]
cf593991: checks
42c7d5a0: bets $0.48
cf593991: raises $1.2 to $1.68
42c7d5a0: folds
Uncalled bet ($1.2) returned to cf593991
*** SHOWDOWN ***
cf593991 collected $1.45 from pot
*** SUMMARY ***
Total pot $1.59 | Rake $0.07 | Jackpot $0.07 | Bingo $0 | Fortune $0 | Tax $0
Board [8d 9c 7d Qc 3d]
Seat 1: 42c7d5a0 (button) folded on the River
Seat 2: 54c506e4 (small blind) folded before Flop
Seat 3: Hero (big blind) folded before Flop
Seat 4: d00f991c folded before Flop (didn't bet)
Seat 5: cf593991 won ($1.45)
Seat 6: 123dc5ea folded before Flop (didn't bet)


Poker Hand #RC3334480426: Hold'em No Limit ($0.02/$0.05) - 2025/02/17 21:04:46
Table 'RushAndCash615686' 6-max Seat #1 is the button
Seat 1: bacb67c8 ($4.81 in chips)
Seat 2: ec767863 ($5.75 in chips)
Seat 3: a8e12c85 ($5.74 in chips)
Seat 4: 87d5083b ($23.08 in chips)
Seat 5: 123dc5ea ($5 in chips)
Seat 6: Hero ($5.29 in chips)
ec767863: posts small blind $0.02
a8e12c85: posts big blind $0.05
*** HOLE CARDS ***
Dealt to bacb67c8 
Dealt to ec767863 
Dealt to a8e12c85 
Dealt to 87d5083b 
Dealt to 123dc5ea 
Dealt to Hero [Kc Kd]
87d5083b: folds
123dc5ea: raises $0.07 to $0.12
Hero: raises $0.24 to $0.36
bacb67c8: folds
ec767863: folds
a8e12c85: folds
123dc5ea: calls $0.24
*** FLOP *** [5c 7h 7c]
123dc5ea: checks
Hero: bets $0.28
123dc5ea: raises $0.5 to $0.78
Hero: calls $0.5
*** TURN *** [5c 7h 7c] [Ks]
123dc5ea: checks
Hero: checks
*** RIVER *** [5c 7h 7c Ks] [2d]
123dc5ea: bets $1.23
Hero: raises $2.92 to $4.15 and is all-in
123dc5ea: folds
Uncalled bet ($2.92) returned to Hero
*** SHOWDOWN ***
Hero collected $4.59 from pot
*** SUMMARY ***
Total pot $4.81 | Rake $0.15 | Jackpot $0.07 | Bingo $0 | Fortune $0 | Tax $0
Board [5c 7h 7c Ks 2d]
Seat 1: bacb67c8 (button) folded before Flop (didn't bet)
Seat 2: ec767863 (small blind) folded before Flop
Seat 3: a8e12c85 (big blind) folded before Flop
Seat 4: 87d5083b folded before Flop (didn't bet)
Seat 5: 123dc5ea folded on the River
Seat 6: Hero won ($4.59)


Poker Hand #RC3334480402: Hold'em No Limit ($0.02/$0.05) - 2025/02/17 21:04:42
Table 'RushAndCash615662' 6-max Seat #1 is the button
Seat 1: 278194f ($5.11 in chips)
Seat 2: Hero ($5.31 in chips)
Seat 3: 3747d311 ($5 in chips)
Seat 4: d2fb1cd9 ($9.04 in chips)
Seat 5: b258f9f9 ($5.22 in chips)
Seat 6: 3db4c32a ($5.43 in chips)
Hero: posts small blind $0.02
3747d311: posts big blind $0.05
*** HOLE CARDS ***
Dealt to 278194f 
Dealt to Hero [9c 2c]
Dealt to 3747d311 
Dealt to d2fb1cd9 
Dealt to b258f9f9 
Dealt to 3db4c32a 
d2fb1cd9: folds
b258f9f9: folds
3db4c32a: folds
278194f: raises $0.06 to $0.11
Hero: folds
3747d311: folds
Uncalled bet ($0.06) returned to 278194f
*** SHOWDOWN ***
278194f collected $0.12 from pot
*** SUMMARY ***
Total pot $0.12 | Rake $0 | Jackpot $0 | Bingo $0 | Fortune $0 | Tax $0
Seat 1: 278194f (button) collected ($0.12)
Seat 2: Hero (small blind) folded before Flop
Seat 3: 3747d311 (big blind) folded before Flop
Seat 4: d2fb1cd9 folded before Flop (didn't bet)
Seat 5: b258f9f9 folded before Flop (didn't bet)
Seat 6: 3db4c32a folded before Flop (didn't bet)


Poker Hand #RC3334480371: Hold'em No Limit ($0.02/$0.05) - 2025/02/17 21:04:38
Table 'RushAndCash615631' 6-max Seat #1 is the button
Seat 1: f43eaf15 ($8.16 in chips)
Seat 2: ca462b6a ($4.97 in chips)
Seat 3: 8f3a3c0a ($9.74 in chips)
Seat 4: 6aa0c391 ($5.47 in chips)
Seat 5: b9ae439d ($4.93 in chips)
Seat 6: Hero ($5.31 in chips)
ca462b6a: posts small blind $0.02
8f3a3c0a: posts big blind $0.05
*** HOLE CARDS ***
Dealt to f43eaf15 
Dealt to ca462b6a 
Dealt to 8f3a3c0a 
Dealt to 6aa0c391 
Dealt to b9ae439d 
Dealt to Hero [8h Kd]
6aa0c391: folds
b9ae439d: folds
Hero: folds
f43eaf15: folds
ca462b6a: folds
Uncalled bet ($0.03) returned to 8f3a3c0a
*** SHOWDOWN ***
8f3a3c0a collected $0.04 from pot
*** SUMMARY ***
Total pot $0.04 | Rake $0 | Jackpot $0 | Bingo $0 | Fortune $0 | Tax $0
Seat 1: f43eaf15 (button) folded before Flop (didn't bet)
Seat 2: ca462b6a (small blind) folded before Flop
Seat 3: 8f3a3c0a (big blind) collected ($0.04)
Seat 4: 6aa0c391 folded before Flop (didn't bet)
Seat 5: b9ae439d folded before Flop (didn't bet)
Seat 6: Hero folded before Flop (didn't bet)


Poker Hand #RC3334480345: Hold'em No Limit ($0.02/$0.05) - 2025/02/17 21:04:35
Table 'RushAndCash615605' 6-max Seat #1 is the button
Seat 1: 826a79b4 ($7.02 in chips)
Seat 2: e14d48fa ($3.76 in chips)
Seat 3: 1e76a4d8 ($5.47 in chips)
Seat 4: Hero ($5.31 in chips)
Seat 5: f6e684ae ($18.8 in chips)
Seat 6: 4e3e8f0e ($5.43 in chips)
e14d48fa: posts small blind $0.02
1e76a4d8: posts big blind $0.05
*** HOLE CARDS ***
Dealt to 826a79b4 
Dealt to e14d48fa 
Dealt to 1e76a4d8 
Dealt to Hero [Qd 8s]
Dealt to f6e684ae 
Dealt to 4e3e8f0e 
Hero: folds
f6e684ae: folds
4e3e8f0e: raises $0.05 to $0.1
826a79b4: folds
e14d48fa: folds
1e76a4d8: folds
Uncalled bet ($0.05) returned to 4e3e8f0e
*** SHOWDOWN ***
4e3e8f0e collected $0.12 from pot
*** SUMMARY ***
Total pot $0.12 | Rake $0 | Jackpot $0 | Bingo $0 | Fortune $0 | Tax $0
Seat 1: 826a79b4 (button) folded before Flop (didn't bet)
Seat 2: e14d48fa (small blind) folded before Flop
Seat 3: 1e76a4d8 (big blind) folded before Flop
Seat 4: Hero folded before Flop (didn't bet)
Seat 5: f6e684ae folded before Flop (didn't bet)
Seat 6: 4e3e8f0e collected ($0.12)


Poker Hand #RC3334480319: Hold'em No Limit ($0.02/$0.05) - 2025/02/17 21:04:32
Table 'RushAndCash615579' 6-max Seat #1 is the button
Seat 1: 711af4a4 ($12.17 in chips)
Seat 2: 35016d48 ($5.89 in chips)
Seat 3: 3d537b07 ($3.14 in chips)
Seat 4: 81e1b438 ($6.32 in chips)
Seat 5: Hero ($5.31 in chips)
Seat 6: e74a324 ($5.4 in chips)
35016d48: posts small blind $0.02
3d537b07: posts big blind $0.05
*** HOLE CARDS ***
Dealt to 711af4a4 
Dealt to 35016d48 
Dealt to 3d537b07 
Dealt to 81e1b438 
Dealt to Hero [Jd 8c]
Dealt to e74a324 
81e1b438: raises $0.05 to $0.1
Hero: folds
e74a324: folds
711af4a4: folds
35016d48: folds
3d537b07: folds
Uncalled bet ($0.05) returned to 81e1b438
*** SHOWDOWN ***
81e1b438 collected $0.12 from pot
*** SUMMARY ***
Total pot $0.12 | Rake $0 | Jackpot $0 | Bingo $0 | Fortune $0 | Tax $0
Seat 1: 711af4a4 (button) folded before Flop (didn't bet)
Seat 2: 35016d48 (small blind) folded before Flop
Seat 3: 3d537b07 (big blind) folded before Flop
Seat 4: 81e1b438 collected ($0.12)
Seat 5: Hero folded before Flop (didn't bet)
Seat 6: e74a324 folded before Flop (didn't bet)


Poker Hand #RC3334480297: Hold'em No Limit ($0.02/$0.05) - 2025/02/17 21:04:29
Table 'RushAndCash615557' 6-max Seat #1 is the button
Seat 1: Hero ($5.31 in chips)
Seat 2: 42065dde ($5.09 in chips)
Seat 3: 19bb03b5 ($11.74 in chips)
Seat 4: 711af4a4 ($12.17 in chips)
Seat 5: c4bb930b ($0.99 in chips)
Seat 6: 54a16a21 ($6.66 in chips)
42065dde: posts small blind $0.02
19bb03b5: posts big blind $0.05
*** HOLE CARDS ***
Dealt to Hero [8s 3d]
Dealt to 42065dde 
Dealt to 19bb03b5 
Dealt to 711af4a4 
Dealt to c4bb930b 
Dealt to 54a16a21 
711af4a4: folds
c4bb930b: raises $0.05 to $0.1
54a16a21: folds
Hero: folds
42065dde: folds
19bb03b5: folds
Uncalled bet ($0.05) returned to c4bb930b
*** SHOWDOWN ***
c4bb930b collected $0.12 from pot
*** SUMMARY ***
Total pot $0.12 | Rake $0 | Jackpot $0 | Bingo $0 | Fortune $0 | Tax $0
Seat 1: Hero (button) folded before Flop (didn't bet)
Seat 2: 42065dde (small blind) folded before Flop
Seat 3: 19bb03b5 (big blind) folded before Flop
Seat 4: 711af4a4 folded before Flop (didn't bet)
Seat 5: c4bb930b collected ($0.12)
Seat 6: 54a16a21 folded before Flop (didn't bet)


Poker Hand #RC3334479986: Hold'em No Limit ($0.02/$0.05) - 2025/02/17 21:03:50
Table 'RushAndCash615246' 6-max Seat #1 is the button
Seat 1: 43c437e9 ($13.84 in chips)
Seat 2: Hero ($5.41 in chips)
Seat 3: 42065dde ($5 in chips)
Seat 4: 6bc74d1d ($6.05 in chips)
Seat 5: b19e7101 ($5.44 in chips)
Seat 6: 688b40f9 ($6.1 in chips)
Hero: posts small blind $0.02
42065dde: posts big blind $0.05
*** HOLE CARDS ***
Dealt to 43c437e9 
Dealt to Hero [5c 5s]
Dealt to 42065dde 
Dealt to 6bc74d1d 
Dealt to b19e7101 
Dealt to 688b40f9 
6bc74d1d: folds
b19e7101: folds
688b40f9: folds
43c437e9: folds
Hero: calls $0.03
42065dde: checks
*** FLOP *** [4d 2d 6s]
Hero: bets $0.05
42065dde: calls $0.05
*** TURN *** [4d 2d 6s] [8d]
Hero: checks
42065dde: bets $0.12
Hero: folds
Uncalled bet ($0.12) returned to 42065dde
*** SHOWDOWN ***
42065dde collected $0.19 from pot
*** SUMMARY ***
Total pot $0.2 | Rake $0.01 | Jackpot $0 | Bingo $0 | Fortune $0 | Tax $0
Board [4d 2d 6s 8d]
Seat 1: 43c437e9 (button) folded before Flop (didn't bet)
Seat 2: Hero (small blind) folded on the Turn
Seat 3: 42065dde (big blind) won ($0.19)
Seat 4: 6bc74d1d folded before Flop (didn't bet)
Seat 5: b19e7101 folded before Flop (didn't bet)
Seat 6: 688b40f9 folded before Flop (didn't bet)


Poker Hand #RC3334479955: Hold'em No Limit ($0.02/$0.05) - 2025/02/17 21:03:46
Table 'RushAndCash615215' 6-max Seat #1 is the button
Seat 1: d0df8653 ($1.7 in chips)
Seat 2: 4d398f88 ($4.88 in chips)
Seat 3: Hero ($5.46 in chips)
Seat 4: 7dd18ea7 ($7.92 in chips)
Seat 5: ae4e82ab ($6.12 in chips)
Seat 6: 2b9f39df ($5.88 in chips)
4d398f88: posts small blind $0.02
Hero: posts big blind $0.05
*** HOLE CARDS ***
Dealt to d0df8653 
Dealt to 4d398f88 
Dealt to Hero [4s Jc]
Dealt to 7dd18ea7 
Dealt to ae4e82ab 
Dealt to 2b9f39df 
7dd18ea7: folds
ae4e82ab: folds
2b9f39df: folds
d0df8653: folds
4d398f88: raises $0.06 to $0.11
Hero: folds
Uncalled bet ($0.06) returned to 4d398f88
*** SHOWDOWN ***
4d398f88 collected $0.1 from pot
*** SUMMARY ***
Total pot $0.1 | Rake $0 | Jackpot $0 | Bingo $0 | Fortune $0 | Tax $0
Seat 1: d0df8653 (button) folded before Flop (didn't bet)
Seat 2: 4d398f88 (small blind) collected ($0.1)
Seat 3: Hero (big blind) folded before Flop
Seat 4: 7dd18ea7 folded before Flop (didn't bet)
Seat 5: ae4e82ab folded before Flop (didn't bet)
Seat 6: 2b9f39df folded before Flop (didn't bet)


Poker Hand #RC3334479926: Hold'em No Limit ($0.02/$0.05) - 2025/02/17 21:03:42
Table 'RushAndCash615186' 6-max Seat #1 is the button
Seat 1: 6d2abfa5 ($6.79 in chips)
Seat 2: 70521b8f ($5.58 in chips)
Seat 3: Hero ($5.51 in chips)
Seat 4: 6c6b017a ($5.02 in chips)
Seat 5: 757f29d9 ($5 in chips)
Seat 6: c4bb930b ($1.35 in chips)
70521b8f: posts small blind $0.02
Hero: posts big blind $0.05
*** HOLE CARDS ***
Dealt to 6d2abfa5 
Dealt to 70521b8f 
Dealt to Hero [3d 2h]
Dealt to 6c6b017a 
Dealt to 757f29d9 
Dealt to c4bb930b 
6c6b017a: folds
757f29d9: raises $0.05 to $0.1
c4bb930b: folds
6d2abfa5: raises $0.26 to $0.36
70521b8f: folds
Hero: folds
757f29d9: calls $0.26
*** FLOP *** [Jc As 4h]
757f29d9: checks
6d2abfa5: checks
*** TURN *** [Jc As 4h] [5c]
757f29d9: bets $0.6
6d2abfa5: folds
Uncalled bet ($0.6) returned to 757f29d9
*** SHOWDOWN ***
757f29d9 collected $0.75 from pot
*** SUMMARY ***
Total pot $0.79 | Rake $0.04 | Jackpot $0 | Bingo $0 | Fortune $0 | Tax $0
Board [Jc As 4h 5c]
Seat 1: 6d2abfa5 (button) folded on the Turn
Seat 2: 70521b8f (small blind) folded before Flop
Seat 3: Hero (big blind) folded before Flop
Seat 4: 6c6b017a folded before Flop (didn't bet)
Seat 5: 757f29d9 won ($0.75)
Seat 6: c4bb930b folded before Flop (didn't bet)


Poker Hand #RC3334479596: Hold'em No Limit ($0.02/$0.05) - 2025/02/17 21:03:00
Table 'RushAndCash614856' 6-max Seat #1 is the button
Seat 1: 8ed17f8c ($6.48 in chips)
Seat 2: 38f4cc4d ($4.88 in chips)
Seat 3: ead9d64d ($8.77 in chips)
Seat 4: f6abc1da ($5 in chips)
Seat 5: Hero ($5.43 in chips)
Seat 6: 97ae2208 ($5.24 in chips)
38f4cc4d: posts small blind $0.02
ead9d64d: posts big blind $0.05
*** HOLE CARDS ***
Dealt to 8ed17f8c 
Dealt to 38f4cc4d 
Dealt to ead9d64d 
Dealt to f6abc1da 
Dealt to Hero [Kh Ks]
Dealt to 97ae2208 
f6abc1da: folds
Hero: raises $0.05 to $0.1
97ae2208: folds
8ed17f8c: raises $0.22 to $0.32
38f4cc4d: calls $0.3
ead9d64d: folds
Hero: raises $5.11 to $5.43 and is all-in
8ed17f8c: folds
38f4cc4d: calls $4.56 and is all-in
Uncalled bet ($0.55) returned to Hero
Hero: shows [Kh Ks]
38f4cc4d: shows [Qs Qh]
*** FIRST FLOP *** [8s 4d Jd]
*** FIRST TURN *** [8s 4d Jd] [2h]
*** FIRST RIVER *** [8s 4d Jd 2h] [3h]
*** SECOND FLOP *** [Qd 7h 6h]
*** SECOND TURN *** [Qd 7h 6h] [Js]
*** SECOND RIVER *** [Qd 7h 6h Js] [As]
*** FIRST SHOWDOWN ***
Hero collected $4.96 from pot
*** SECOND SHOWDOWN ***
38f4cc4d collected $4.96 from pot
*** SUMMARY ***
Total pot $10.13 | Rake $0.14 | Jackpot $0.07 | Bingo $0 | Fortune $0 | Tax $0
Hand was run two times
FIRST Board [8s 4d Jd 2h 3h]
SECOND Board [Qd 7h 6h Js As]
Seat 1: 8ed17f8c (button) folded before Flop
Seat 2: 38f4cc4d (small blind) showed [Qs Qh] and lost with Pair of Queens, and won ($4.96) with Three Queens
Seat 3: ead9d64d (big blind) folded before Flop
Seat 4: f6abc1da folded before Flop (didn't bet)
Seat 5: Hero showed [Kh Ks] and won ($4.96) with Pair of Kings, and lost with Pair of Kings
Seat 6: 97ae2208 folded before Flop (didn't bet)


Poker Hand #RC3334479417: Hold'em No Limit ($0.02/$0.05) - 2025/02/17 21:02:38
Table 'RushAndCash614677' 6-max Seat #1 is the button
Seat 1: Hero ($5.32 in chips)
Seat 2: c579f93c ($9.79 in chips)
Seat 3: 38f4cc4d ($4.98 in chips)
Seat 4: 1b63280e ($6.21 in chips)
Seat 5: faba3abb ($15.86 in chips)
Seat 6: 656af102 ($5.14 in chips)
c579f93c: posts small blind $0.02
38f4cc4d: posts big blind $0.05
*** HOLE CARDS ***
Dealt to Hero [Jh Ks]
Dealt to c579f93c 
Dealt to 38f4cc4d 
Dealt to 1b63280e 
Dealt to faba3abb 
Dealt to 656af102 
1b63280e: folds
faba3abb: folds
656af102: folds
Hero: raises $0.05 to $0.1
c579f93c: folds
38f4cc4d: calls $0.05
*** FLOP *** [4d 3c Kd]
38f4cc4d: checks
Hero: bets $0.08
38f4cc4d: folds
Uncalled bet ($0.08) returned to Hero
*** SHOWDOWN ***
Hero collected $0.21 from pot
*** SUMMARY ***
Total pot $0.22 | Rake $0.01 | Jackpot $0 | Bingo $0 | Fortune $0 | Tax $0
Board [4d 3c Kd]
Seat 1: Hero (button) won ($0.21)
Seat 2: c579f93c (small blind) folded before Flop
Seat 3: 38f4cc4d (big blind) folded on the Flop
Seat 4: 1b63280e folded before Flop (didn't bet)
Seat 5: faba3abb folded before Flop (didn't bet)
Seat 6: 656af102 folded before Flop (didn't bet)


Poker Hand #RC3334479391: Hold'em No Limit ($0.02/$0.05) - 2025/02/17 21:02:35
Table 'RushAndCash614651' 6-max Seat #1 is the button
Seat 1: c3b473c1 ($5.14 in chips)
Seat 2: 860b5247 ($8.17 in chips)
Seat 3: 9891f05e ($5 in chips)
Seat 4: a598408a ($5.07 in chips)
Seat 5: Hero ($5.32 in chips)
Seat 6: 3c76a91d ($5.56 in chips)
860b5247: posts small blind $0.02
9891f05e: posts big blind $0.05
*** HOLE CARDS ***
Dealt to c3b473c1 
Dealt to 860b5247 
Dealt to 9891f05e 
Dealt to a598408a 
Dealt to Hero [Td Js]
Dealt to 3c76a91d 
a598408a: folds
Hero: folds
3c76a91d: folds
c3b473c1: raises $0.05 to $0.1
860b5247: folds
9891f05e: folds
Uncalled bet ($0.05) returned to c3b473c1
*** SHOWDOWN ***
c3b473c1 collected $0.12 from pot
*** SUMMARY ***
Total pot $0.12 | Rake $0 | Jackpot $0 | Bingo $0 | Fortune $0 | Tax $0
Seat 1: c3b473c1 (button) collected ($0.12)
Seat 2: 860b5247 (small blind) folded before Flop
Seat 3: 9891f05e (big blind) folded before Flop
Seat 4: a598408a folded before Flop (didn't bet)
Seat 5: Hero folded before Flop (didn't bet)
Seat 6: 3c76a91d folded before Flop (didn't bet)


Poker Hand #RC3334479149: Hold'em No Limit ($0.02/$0.05) - 2025/02/17 21:02:03
Table 'RushAndCash614409' 6-max Seat #1 is the button
Seat 1: 7df4712d ($8.45 in chips)
Seat 2: c585480d ($8.78 in chips)
Seat 3: e2c99c94 ($7.61 in chips)
Seat 4: 1e2c3e8b ($5 in chips)
Seat 5: Hero ($5.42 in chips)
Seat 6: 92e1348d ($6.67 in chips)
c585480d: posts small blind $0.02
e2c99c94: posts big blind $0.05
*** HOLE CARDS ***
Dealt to 7df4712d 
Dealt to c585480d 
Dealt to e2c99c94 
Dealt to 1e2c3e8b 
Dealt to Hero [Jd Ks]
Dealt to 92e1348d 
1e2c3e8b: folds
Hero: raises $0.05 to $0.1
92e1348d: folds
7df4712d: folds
c585480d: calls $0.08
e2c99c94: folds
*** FLOP *** [8h Qh 6h]
c585480d: checks
Hero: checks
*** TURN *** [8h Qh 6h] [5h]
c585480d: checks
Hero: checks
*** RIVER *** [8h Qh 6h 5h] [6s]
c585480d: bets $0.13
Hero: folds
Uncalled bet ($0.13) returned to c585480d
*** SHOWDOWN ***
c585480d collected $0.24 from pot
*** SUMMARY ***
Total pot $0.25 | Rake $0.01 | Jackpot $0 | Bingo $0 | Fortune $0 | Tax $0
Board [8h Qh 6h 5h 6s]
Seat 1: 7df4712d (button) folded before Flop (didn't bet)
Seat 2: c585480d (small blind) won ($0.24)
Seat 3: e2c99c94 (big blind) folded before Flop
Seat 4: 1e2c3e8b folded before Flop (didn't bet)
Seat 5: Hero folded on the River
Seat 6: 92e1348d folded before Flop (didn't bet)


Poker Hand #RC3334479069: Hold'em No Limit ($0.02/$0.05) - 2025/02/17 21:01:54
Table 'RushAndCash614329' 6-max Seat #1 is the button
Seat 1: 39109629 ($5 in chips)
Seat 2: Hero ($5.44 in chips)
Seat 3: 98b7c00d ($5 in chips)
Seat 4: e7a0ba42 ($10.95 in chips)
Seat 5: 3dd0afef ($5.34 in chips)
Seat 6: 3b1b6d04 ($6.77 in chips)
Hero: posts small blind $0.02
98b7c00d: posts big blind $0.05
*** HOLE CARDS ***
Dealt to 39109629 
Dealt to Hero [6s 9c]
Dealt to 98b7c00d 
Dealt to e7a0ba42 
Dealt to 3dd0afef 
Dealt to 3b1b6d04 
e7a0ba42: raises $0.06 to $0.11
3dd0afef: folds
3b1b6d04: folds
39109629: folds
Hero: folds
98b7c00d: folds
Uncalled bet ($0.06) returned to e7a0ba42
*** SHOWDOWN ***
e7a0ba42 collected $0.12 from pot
*** SUMMARY ***
Total pot $0.12 | Rake $0 | Jackpot $0 | Bingo $0 | Fortune $0 | Tax $0
Seat 1: 39109629 (button) folded before Flop (didn't bet)
Seat 2: Hero (small blind) folded before Flop
Seat 3: 98b7c00d (big blind) folded before Flop
Seat 4: e7a0ba42 collected ($0.12)
Seat 5: 3dd0afef folded before Flop (didn't bet)
Seat 6: 3b1b6d04 folded before Flop (didn't bet)


Poker Hand #RC3334479037: Hold'em No Limit ($0.02/$0.05) - 2025/02/17 21:01:50
Table 'RushAndCash614297' 6-max Seat #1 is the button
Seat 1: edb41254 ($5.72 in chips)
Seat 2: Hero ($5.46 in chips)
Seat 3: 653af57c ($5.19 in chips)
Seat 4: 8e5db286 ($11.05 in chips)
Seat 5: 143ede8b ($6.16 in chips)
Seat 6: f994138c ($6.62 in chips)
Hero: posts small blind $0.02
653af57c: posts big blind $0.05
*** HOLE CARDS ***
Dealt to edb41254 
Dealt to Hero [3s 2s]
Dealt to 653af57c 
Dealt to 8e5db286 
Dealt to 143ede8b 
Dealt to f994138c 
8e5db286: raises $0.07 to $0.12
143ede8b: folds
f994138c: folds
edb41254: folds
Hero: folds
653af57c: calls $0.07
*** FLOP *** [7c 7d Qh]
653af57c: checks
8e5db286: checks
*** TURN *** [7c 7d Qh] [9c]
653af57c: checks
8e5db286: checks
*** RIVER *** [7c 7d Qh 9c] [7s]
653af57c: checks
8e5db286: bets $0.14
653af57c: folds
Uncalled bet ($0.14) returned to 8e5db286
*** SHOWDOWN ***
8e5db286 collected $0.25 from pot
*** SUMMARY ***
Total pot $0.26 | Rake $0.01 | Jackpot $0 | Bingo $0 | Fortune $0 | Tax $0
Board [7c 7d Qh 9c 7s]
Seat 1: edb41254 (button) folded before Flop (didn't bet)
Seat 2: Hero (small blind) folded before Flop
Seat 3: 653af57c (big blind) folded on the River
Seat 4: 8e5db286 won ($0.25)
Seat 5: 143ede8b folded before Flop (didn't bet)
Seat 6: f994138c folded before Flop (didn't bet)


Poker Hand #RC3334478988: Hold'em No Limit ($0.02/$0.05) - 2025/02/17 21:01:44
Table 'RushAndCash614248' 6-max Seat #1 is the button
Seat 1: 87d5083b ($23.73 in chips)
Seat 2: d86379c5 ($7.01 in chips)
Seat 3: bc8371cb ($5.51 in chips)
Seat 4: 8bfa05cc ($5.07 in chips)
Seat 5: Hero ($5.46 in chips)
Seat 6: c826a560 ($13.75 in chips)
d86379c5: posts small blind $0.02
bc8371cb: posts big blind $0.05
*** HOLE CARDS ***
Dealt to 87d5083b 
Dealt to d86379c5 
Dealt to bc8371cb 
Dealt to 8bfa05cc 
Dealt to Hero [9d Tc]
Dealt to c826a560 
8bfa05cc: raises $0.08 to $0.13
Hero: folds
c826a560: calls $0.13
87d5083b: calls $0.13
d86379c5: folds
bc8371cb: folds
*** FLOP *** [3h 3d 3c]
8bfa05cc: checks
c826a560: checks
87d5083b: bets $0.33
8bfa05cc: folds
c826a560: folds
Uncalled bet ($0.33) returned to 87d5083b
*** SHOWDOWN ***
87d5083b collected $0.44 from pot
*** SUMMARY ***
Total pot $0.46 | Rake $0.02 | Jackpot $0 | Bingo $0 | Fortune $0 | Tax $0
Board [3h 3d 3c]
Seat 1: 87d5083b (button) won ($0.44)
Seat 2: d86379c5 (small blind) folded before Flop
Seat 3: bc8371cb (big blind) folded before Flop
Seat 4: 8bfa05cc folded on the Flop
Seat 5: Hero folded before Flop (didn't bet)
Seat 6: c826a560 folded on the Flop


Poker Hand #RC3334478961: Hold'em No Limit ($0.02/$0.05) - 2025/02/17 21:01:40
Table 'RushAndCash614221' 6-max Seat #1 is the button
Seat 1: 18767060 ($10.75 in chips)
Seat 2: 229ec9a7 ($5.31 in chips)
Seat 3: Hero ($5.51 in chips)
Seat 4: 9dd1ff39 ($7.21 in chips)
Seat 5: 945593bf ($16.05 in chips)
Seat 6: d47cb19 ($5 in chips)
229ec9a7: posts small blind $0.02
Hero: posts big blind $0.05
*** HOLE CARDS ***
Dealt to 18767060 
Dealt to 229ec9a7 
Dealt to Hero [6c 3h]
Dealt to 9dd1ff39 
Dealt to 945593bf 
Dealt to d47cb19 
9dd1ff39: folds
945593bf: folds
d47cb19: folds
18767060: folds
229ec9a7: raises $0.13 to $0.18
Hero: folds
Uncalled bet ($0.13) returned to 229ec9a7
*** SHOWDOWN ***
229ec9a7 collected $0.1 from pot
*** SUMMARY ***
Total pot $0.1 | Rake $0 | Jackpot $0 | Bingo $0 | Fortune $0 | Tax $0
Seat 1: 18767060 (button) folded before Flop (didn't bet)
Seat 2: 229ec9a7 (small blind) collected ($0.1)
Seat 3: Hero (big blind) folded before Flop
Seat 4: 9dd1ff39 folded before Flop (didn't bet)
Seat 5: 945593bf folded before Flop (didn't bet)
Seat 6: d47cb19 folded before Flop (didn't bet)


Poker Hand #RC3334478941: Hold'em No Limit ($0.02/$0.05) - 2025/02/17 21:01:38
Table 'RushAndCash614201' 6-max Seat #1 is the button
Seat 1: Hero ($5.51 in chips)
Seat 2: db0f0c64 ($6.25 in chips)
Seat 3: 9788125b ($5 in chips)
Seat 4: e0a9129e ($2.8 in chips)
Seat 5: f4cb4fd0 ($5.16 in chips)
Seat 6: 27baaa05 ($6.35 in chips)
db0f0c64: posts small blind $0.02
9788125b: posts big blind $0.05
*** HOLE CARDS ***
Dealt to Hero [4h 5d]
Dealt to db0f0c64 
Dealt to 9788125b 
Dealt to e0a9129e 
Dealt to f4cb4fd0 
Dealt to 27baaa05 
e0a9129e: folds
f4cb4fd0: folds
27baaa05: folds
Hero: folds
db0f0c64: folds
Uncalled bet ($0.03) returned to 9788125b
*** SHOWDOWN ***
9788125b collected $0.04 from pot
*** SUMMARY ***
Total pot $0.04 | Rake $0 | Jackpot $0 | Bingo $0 | Fortune $0 | Tax $0
Seat 1: Hero (button) folded before Flop (didn't bet)
Seat 2: db0f0c64 (small blind) folded before Flop
Seat 3: 9788125b (big blind) collected ($0.04)
Seat 4: e0a9129e folded before Flop (didn't bet)
Seat 5: f4cb4fd0 folded before Flop (didn't bet)
Seat 6: 27baaa05 folded before Flop (didn't bet)


Poker Hand #RC3334478917: Hold'em No Limit ($0.02/$0.05) - 2025/02/17 21:01:35
Table 'RushAndCash614177' 6-max Seat #1 is the button
Seat 1: 3b1b6d04 ($6.7 in chips)
Seat 2: ead9d64d ($8.79 in chips)
Seat 3: f56d4922 ($5 in chips)
Seat 4: Hero ($5.51 in chips)
Seat 5: 6dcd0788 ($8.39 in chips)
Seat 6: c4bb930b ($1.54 in chips)
ead9d64d: posts small blind $0.02
f56d4922: posts big blind $0.05
*** HOLE CARDS ***
Dealt to 3b1b6d04 
Dealt to ead9d64d 
Dealt to f56d4922 
Dealt to Hero [4s Th]
Dealt to 6dcd0788 
Dealt to c4bb930b 
Hero: folds
6dcd0788: folds
c4bb930b: folds
3b1b6d04: raises $0.08 to $0.13
ead9d64d: folds
f56d4922: folds
Uncalled bet ($0.08) returned to 3b1b6d04
*** SHOWDOWN ***
3b1b6d04 collected $0.12 from pot
*** SUMMARY ***
Total pot $0.12 | Rake $0 | Jackpot $0 | Bingo $0 | Fortune $0 | Tax $0
Seat 1: 3b1b6d04 (button) collected ($0.12)
Seat 2: ead9d64d (small blind) folded before Flop
Seat 3: f56d4922 (big blind) folded before Flop
Seat 4: Hero folded before Flop (didn't bet)
Seat 5: 6dcd0788 folded before Flop (didn't bet)
Seat 6: c4bb930b folded before Flop (didn't bet)


Poker Hand #RC3334475676: Hold'em No Limit ($0.02/$0.05) - 2025/02/17 20:54:14
Table 'RushAndCash610936' 6-max Seat #1 is the button
Seat 1: d916afa1 ($7.38 in chips)
Seat 2: 3100dcf0 ($5 in chips)
Seat 3: 2b9f39df ($7.99 in chips)
Seat 4: Hero ($5.44 in chips)
Seat 5: a92346b2 ($5.07 in chips)
Seat 6: e3b51b04 ($7.85 in chips)
3100dcf0: posts small blind $0.02
2b9f39df: posts big blind $0.05
*** HOLE CARDS ***
Dealt to d916afa1 
Dealt to 3100dcf0 
Dealt to 2b9f39df 
Dealt to Hero [Tc 4c]
Dealt to a92346b2 
Dealt to e3b51b04 
Hero: folds
a92346b2: raises $0.05 to $0.1
e3b51b04: folds
d916afa1: folds
3100dcf0: folds
2b9f39df: folds
Uncalled bet ($0.05) returned to a92346b2
*** SHOWDOWN ***
a92346b2 collected $0.12 from pot
*** SUMMARY ***
Total pot $0.12 | Rake $0 | Jackpot $0 | Bingo $0 | Fortune $0 | Tax $0
Seat 1: d916afa1 (button) folded before Flop (didn't bet)
Seat 2: 3100dcf0 (small blind) folded before Flop
Seat 3: 2b9f39df (big blind) folded before Flop
Seat 4: Hero folded before Flop (didn't bet)
Seat 5: a92346b2 collected ($0.12)
Seat 6: e3b51b04 folded before Flop (didn't bet)


Poker Hand #RC3334475630: Hold'em No Limit ($0.02/$0.05) - 2025/02/17 20:54:08
Table 'RushAndCash610890' 6-max Seat #1 is the button
Seat 1: 93a6c244 ($8.47 in chips)
Seat 2: 76135c78 ($12 in chips)
Seat 3: Hero ($5.49 in chips)
Seat 4: 100d4f9e ($5.93 in chips)
Seat 5: f2e82cf4 ($5.1 in chips)
Seat 6: a5be70d9 ($5 in chips)
76135c78: posts small blind $0.02
Hero: posts big blind $0.05
*** HOLE CARDS ***
Dealt to 93a6c244 
Dealt to 76135c78 
Dealt to Hero [5d Ah]
Dealt to 100d4f9e 
Dealt to f2e82cf4 
Dealt to a5be70d9 
100d4f9e: folds
f2e82cf4: folds
a5be70d9: folds
93a6c244: folds
76135c78: folds
Uncalled bet ($0.03) returned to Hero
*** SHOWDOWN ***
Hero collected $0.04 from pot
*** SUMMARY ***
Total pot $0.04 | Rake $0 | Jackpot $0 | Bingo $0 | Fortune $0 | Tax $0
Seat 1: 93a6c244 (button) folded before Flop (didn't bet)
Seat 2: 76135c78 (small blind) folded before Flop
Seat 3: Hero (big blind) collected ($0.04)
Seat 4: 100d4f9e folded before Flop (didn't bet)
Seat 5: f2e82cf4 folded before Flop (didn't bet)
Seat 6: a5be70d9 folded before Flop (didn't bet)


Poker Hand #RC3334475584: Hold'em No Limit ($0.02/$0.05) - 2025/02/17 20:54:03
Table 'RushAndCash610844' 6-max Seat #1 is the button
Seat 1: 95096c6a ($7.66 in chips)
Seat 2: 887ed1a2 ($4.95 in chips)
Seat 3: 62156df3 ($5.55 in chips)
Seat 4: e2c99c94 ($6.21 in chips)
Seat 5: Hero ($5.49 in chips)
Seat 6: c59158f3 ($9.38 in chips)
887ed1a2: posts small blind $0.02
62156df3: posts big blind $0.05
*** HOLE CARDS ***
Dealt to 95096c6a 
Dealt to 887ed1a2 
Dealt to 62156df3 
Dealt to e2c99c94 
Dealt to Hero [3s 8c]
Dealt to c59158f3 
e2c99c94: raises $0.05 to $0.1
Hero: folds
c59158f3: folds
95096c6a: calls $0.1
887ed1a2: folds
62156df3: calls $0.05
*** FLOP *** [8d Ad Ks]
62156df3: checks
e2c99c94: checks
95096c6a: checks
*** TURN *** [8d Ad Ks] [Td]
62156df3: bets $0.24
e2c99c94: folds
95096c6a: calls $0.24
*** RIVER *** [8d Ad Ks Td] [8h]
62156df3: bets $0.6
95096c6a: folds
Uncalled bet ($0.6) returned to 62156df3
*** SHOWDOWN ***
62156df3 collected $0.76 from pot
*** SUMMARY ***
Total pot $0.8 | Rake $0.04 | Jackpot $0 | Bingo $0 | Fortune $0 | Tax $0
Board [8d Ad Ks Td 8h]
Seat 1: 95096c6a (button) folded on the River
Seat 2: 887ed1a2 (small blind) folded before Flop
Seat 3: 62156df3 (big blind) won ($0.76)
Seat 4: e2c99c94 folded on the Turn
Seat 5: Hero folded before Flop (didn't bet)
Seat 6: c59158f3 folded before Flop (didn't bet)


Poker Hand #RC3334475559: Hold'em No Limit ($0.02/$0.05) - 2025/02/17 20:54:00
Table 'RushAndCash610819' 6-max Seat #1 is the button
Seat 1: 8c3789e ($6.55 in chips)
Seat 2: e5903036 ($16.72 in chips)
Seat 3: 3c1ddc3a ($7.64 in chips)
Seat 4: c7e9103c ($17.44 in chips)
Seat 5: 5e166e9a ($5.12 in chips)
Seat 6: Hero ($5.49 in chips)
e5903036: posts small blind $0.02
3c1ddc3a: posts big blind $0.05
*** HOLE CARDS ***
Dealt to 8c3789e 
Dealt to e5903036 
Dealt to 3c1ddc3a 
Dealt to c7e9103c 
Dealt to 5e166e9a 
Dealt to Hero [2h 3d]
c7e9103c: folds
5e166e9a: folds
Hero: folds
8c3789e: folds
e5903036: raises $0.1 to $0.15
3c1ddc3a: folds
Uncalled bet ($0.1) returned to e5903036
*** SHOWDOWN ***
e5903036 collected $0.1 from pot
*** SUMMARY ***
Total pot $0.1 | Rake $0 | Jackpot $0 | Bingo $0 | Fortune $0 | Tax $0
Seat 1: 8c3789e (button) folded before Flop (didn't bet)
Seat 2: e5903036 (small blind) collected ($0.1)
Seat 3: 3c1ddc3a (big blind) folded before Flop
Seat 4: c7e9103c folded before Flop (didn't bet)
Seat 5: 5e166e9a folded before Flop (didn't bet)
Seat 6: Hero folded before Flop (didn't bet)


Poker Hand #RC3334475512: Hold'em No Limit ($0.02/$0.05) - 2025/02/17 20:53:54
Table 'RushAndCash610772' 6-max Seat #1 is the button
Seat 1: Hero ($5.49 in chips)
Seat 2: 3ed1e77f ($5.18 in chips)
Seat 3: da41ab59 ($9.51 in chips)
Seat 4: a3538261 ($5.92 in chips)
Seat 5: 21e0e4ee ($5.07 in chips)
Seat 6: 9f70f94d ($7.03 in chips)
3ed1e77f: posts small blind $0.02
da41ab59: posts big blind $0.05
*** HOLE CARDS ***
Dealt to Hero [4c 5h]
Dealt to 3ed1e77f 
Dealt to da41ab59 
Dealt to a3538261 
Dealt to 21e0e4ee 
Dealt to 9f70f94d 
a3538261: folds
21e0e4ee: folds
9f70f94d: raises $0.05 to $0.1
Hero: folds
3ed1e77f: folds
da41ab59: calls $0.05
*** FLOP *** [5d 6h 6s]
da41ab59: checks
9f70f94d: checks
*** TURN *** [5d 6h 6s] [4d]
da41ab59: bets $0.08
9f70f94d: calls $0.08
*** RIVER *** [5d 6h 6s 4d] [Qc]
da41ab59: checks
9f70f94d: checks
da41ab59: shows [5c 2c] (Pair of Sixes and Pair of Fives)
9f70f94d: shows [Ah Jd] (Pair of Sixes)
*** SHOWDOWN ***
da41ab59 collected $0.37 from pot
*** SUMMARY ***
Total pot $0.38 | Rake $0.01 | Jackpot $0 | Bingo $0 | Fortune $0 | Tax $0
Board [5d 6h 6s 4d Qc]
Seat 1: Hero (button) folded before Flop (didn't bet)
Seat 2: 3ed1e77f (small blind) folded before Flop
Seat 3: da41ab59 (big blind) showed [5c 2c] and won ($0.37) with Pair of Sixes and Pair of Fives
Seat 4: a3538261 folded before Flop (didn't bet)
Seat 5: 21e0e4ee folded before Flop (didn't bet)
Seat 6: 9f70f94d showed [Ah Jd] and lost with Pair of Sixes


Poker Hand #RC3334475481: Hold'em No Limit ($0.02/$0.05) - 2025/02/17 20:53:51
Table 'RushAndCash610741' 6-max Seat #1 is the button
Seat 1: 5fe62400 ($6.08 in chips)
Seat 2: Hero ($5.51 in chips)
Seat 3: 5e166e9a ($5.1 in chips)
Seat 4: 887ed1a2 ($4.95 in chips)
Seat 5: 3747d311 ($5 in chips)
Seat 6: 99af2b58 ($13.78 in chips)
Hero: posts small blind $0.02
5e166e9a: posts big blind $0.05
*** HOLE CARDS ***
Dealt to 5fe62400 
Dealt to Hero [6h Ac]
Dealt to 5e166e9a 
Dealt to 887ed1a2 
Dealt to 3747d311 
Dealt to 99af2b58 
887ed1a2: folds
3747d311: folds
99af2b58: folds
5fe62400: folds
Hero: folds
Uncalled bet ($0.03) returned to 5e166e9a
*** SHOWDOWN ***
5e166e9a collected $0.04 from pot
*** SUMMARY ***
Total pot $0.04 | Rake $0 | Jackpot $0 | Bingo $0 | Fortune $0 | Tax $0
Seat 1: 5fe62400 (button) folded before Flop (didn't bet)
Seat 2: Hero (small blind) folded before Flop
Seat 3: 5e166e9a (big blind) collected ($0.04)
Seat 4: 887ed1a2 folded before Flop (didn't bet)
Seat 5: 3747d311 folded before Flop (didn't bet)
Seat 6: 99af2b58 folded before Flop (didn't bet)


Poker Hand #RC3334475452: Hold'em No Limit ($0.02/$0.05) - 2025/02/17 20:53:47
Table 'RushAndCash610712' 6-max Seat #1 is the button
Seat 1: 945593bf ($16.23 in chips)
Seat 2: dc62c87d ($5 in chips)
Seat 3: ef7e6107 ($5 in chips)
Seat 4: 1e76a4d8 ($6.65 in chips)
Seat 5: Hero ($5.51 in chips)
Seat 6: 83cc7f46 ($3.02 in chips)
dc62c87d: posts small blind $0.02
ef7e6107: posts big blind $0.05
*** HOLE CARDS ***
Dealt to 945593bf 
Dealt to dc62c87d 
Dealt to ef7e6107 
Dealt to 1e76a4d8 
Dealt to Hero [6d 8d]
Dealt to 83cc7f46 
1e76a4d8: folds
Hero: folds
83cc7f46: raises $0.1 to $0.15
945593bf: folds
dc62c87d: folds
ef7e6107: folds
Uncalled bet ($0.1) returned to 83cc7f46
*** SHOWDOWN ***
83cc7f46 collected $0.12 from pot
*** SUMMARY ***
Total pot $0.12 | Rake $0 | Jackpot $0 | Bingo $0 | Fortune $0 | Tax $0
Seat 1: 945593bf (button) folded before Flop (didn't bet)
Seat 2: dc62c87d (small blind) folded before Flop
Seat 3: ef7e6107 (big blind) folded before Flop
Seat 4: 1e76a4d8 folded before Flop (didn't bet)
Seat 5: Hero folded before Flop (didn't bet)
Seat 6: 83cc7f46 collected ($0.12)


Poker Hand #RC3334475069: Hold'em No Limit ($0.02/$0.05) - 2025/02/17 20:53:00
Table 'RushAndCash610329' 6-max Seat #1 is the button
Seat 1: Hero ($5.32 in chips)
Seat 2: dc00ecae ($5.15 in chips)
Seat 3: 1e76a4d8 ($6.83 in chips)
Seat 4: 8e07c53 ($5 in chips)
Seat 5: 717e9861 ($5.07 in chips)
Seat 6: cf593991 ($5 in chips)
dc00ecae: posts small blind $0.02
1e76a4d8: posts big blind $0.05
*** HOLE CARDS ***
Dealt to Hero [9h 9s]
Dealt to dc00ecae 
Dealt to 1e76a4d8 
Dealt to 8e07c53 
Dealt to 717e9861 
Dealt to cf593991 
8e07c53: folds
717e9861: folds
cf593991: folds
Hero: raises $0.05 to $0.1
dc00ecae: folds
1e76a4d8: calls $0.05
*** FLOP *** [9c 5c 6s]
1e76a4d8: checks
Hero: bets $0.08
1e76a4d8: calls $0.08
*** TURN *** [9c 5c 6s] [7s]
1e76a4d8: checks
Hero: checks
*** RIVER *** [9c 5c 6s 7s] [6c]
1e76a4d8: checks
Hero: bets $0.3
1e76a4d8: folds
Uncalled bet ($0.3) returned to Hero
*** SHOWDOWN ***
Hero collected $0.37 from pot
*** SUMMARY ***
Total pot $0.38 | Rake $0.01 | Jackpot $0 | Bingo $0 | Fortune $0 | Tax $0
Board [9c 5c 6s 7s 6c]
Seat 1: Hero (button) won ($0.37)
Seat 2: dc00ecae (small blind) folded before Flop
Seat 3: 1e76a4d8 (big blind) folded on the River
Seat 4: 8e07c53 folded before Flop (didn't bet)
Seat 5: 717e9861 folded before Flop (didn't bet)
Seat 6: cf593991 folded before Flop (didn't bet)


Poker Hand #RC3334475043: Hold'em No Limit ($0.02/$0.05) - 2025/02/17 20:52:56
Table 'RushAndCash610303' 6-max Seat #1 is the button
Seat 1: 97fe2676 ($7.46 in chips)
Seat 2: b9ba5363 ($8.91 in chips)
Seat 3: Hero ($5.37 in chips)
Seat 4: a5be70d9 ($5 in chips)
Seat 5: f50925e7 ($5.02 in chips)
Seat 6: 4c783157 ($5.25 in chips)
b9ba5363: posts small blind $0.02
Hero: posts big blind $0.05
*** HOLE CARDS ***
Dealt to 97fe2676 
Dealt to b9ba5363 
Dealt to Hero [8s 4h]
Dealt to a5be70d9 
Dealt to f50925e7 
Dealt to 4c783157 
a5be70d9: folds
f50925e7: folds
4c783157: folds
97fe2676: folds
b9ba5363: raises $0.1 to $0.15
Hero: folds
Uncalled bet ($0.1) returned to b9ba5363
*** SHOWDOWN ***
b9ba5363 collected $0.1 from pot
*** SUMMARY ***
Total pot $0.1 | Rake $0 | Jackpot $0 | Bingo $0 | Fortune $0 | Tax $0
Seat 1: 97fe2676 (button) folded before Flop (didn't bet)
Seat 2: b9ba5363 (small blind) collected ($0.1)
Seat 3: Hero (big blind) folded before Flop
Seat 4: a5be70d9 folded before Flop (didn't bet)
Seat 5: f50925e7 folded before Flop (didn't bet)
Seat 6: 4c783157 folded before Flop (didn't bet)


Poker Hand #RC3334475018: Hold'em No Limit ($0.02/$0.05) - 2025/02/17 20:52:53
Table 'RushAndCash610278' 6-max Seat #1 is the button
Seat 1: 4c7728b5 ($5.73 in chips)
Seat 2: Hero ($5.39 in chips)
Seat 3: f3614ba1 ($5.1 in chips)
Seat 4: c24b20b9 ($19.94 in chips)
Seat 5: 825e110f ($6.17 in chips)
Seat 6: 4abcea5e ($5.81 in chips)
Hero: posts small blind $0.02
f3614ba1: posts big blind $0.05
*** HOLE CARDS ***
Dealt to 4c7728b5 
Dealt to Hero [5h 8c]
Dealt to f3614ba1 
Dealt to c24b20b9 
Dealt to 825e110f 
Dealt to 4abcea5e 
c24b20b9: folds
825e110f: folds
4abcea5e: raises $0.1 to $0.15
4c7728b5: folds
Hero: folds
f3614ba1: folds
Uncalled bet ($0.1) returned to 4abcea5e
*** SHOWDOWN ***
4abcea5e collected $0.12 from pot
*** SUMMARY ***
Total pot $0.12 | Rake $0 | Jackpot $0 | Bingo $0 | Fortune $0 | Tax $0
Seat 1: 4c7728b5 (button) folded before Flop (didn't bet)
Seat 2: Hero (small blind) folded before Flop
Seat 3: f3614ba1 (big blind) folded before Flop
Seat 4: c24b20b9 folded before Flop (didn't bet)
Seat 5: 825e110f folded before Flop (didn't bet)
Seat 6: 4abcea5e collected ($0.12)


Poker Hand #RC3334474743: Hold'em No Limit ($0.02/$0.05) - 2025/02/17 20:52:16
Table 'RushAndCash610003' 6-max Seat #1 is the button
Seat 1: 26e655d0 ($6.49 in chips)
Seat 2: d949b23d ($5 in chips)
Seat 3: c7e9103c ($17.67 in chips)
Seat 4: 7dd18ea7 ($8.49 in chips)
Seat 5: 20e2d62 ($5.54 in chips)
Seat 6: Hero ($5.28 in chips)
d949b23d: posts small blind $0.02
c7e9103c: posts big blind $0.05
*** HOLE CARDS ***
Dealt to 26e655d0 
Dealt to d949b23d 
Dealt to c7e9103c 
Dealt to 7dd18ea7 
Dealt to 20e2d62 
Dealt to Hero [6c 7c]
7dd18ea7: folds
20e2d62: folds
Hero: raises $0.05 to $0.1
26e655d0: folds
d949b23d: folds
c7e9103c: calls $0.05
*** FLOP *** [Jh 6h Js]
c7e9103c: checks
Hero: checks
*** TURN *** [Jh 6h Js] [Qc]
c7e9103c: checks
Hero: checks
*** RIVER *** [Jh 6h Js Qc] [4c]
c7e9103c: checks
Hero: checks
c7e9103c: shows [9s 8c] (Pair of Jacks)
Hero: shows [6c 7c] (Pair of Jacks and Pair of Sixes)
*** SHOWDOWN ***
Hero collected $0.21 from pot
*** SUMMARY ***
Total pot $0.22 | Rake $0.01 | Jackpot $0 | Bingo $0 | Fortune $0 | Tax $0
Board [Jh 6h Js Qc 4c]
Seat 1: 26e655d0 (button) folded before Flop (didn't bet)
Seat 2: d949b23d (small blind) folded before Flop
Seat 3: c7e9103c (big blind) showed [9s 8c] and lost with Pair of Jacks
Seat 4: 7dd18ea7 folded before Flop (didn't bet)
Seat 5: 20e2d62 folded before Flop (didn't bet)
Seat 6: Hero showed [6c 7c] and won ($0.21) with Pair of Jacks and Pair of Sixes


Poker Hand #RC3334444675: Hold'em No Limit ($0.02/$0.05) - 2025/02/17 20:52:07
Table 'RushAndCash609935' 6-max Seat #1 is the button
Seat 1: 835df346 ($14.79 in chips)
Seat 2: cd4f83b6 ($5.23 in chips)
Seat 3: 3d2a56c8 ($5.11 in chips)
Seat 4: Hero ($5.28 in chips)
Seat 5: e8992002 ($5.31 in chips)
Seat 6: 9f70f94d ($6.84 in chips)
cd4f83b6: posts small blind $0.02
3d2a56c8: posts big blind $0.05
*** HOLE CARDS ***
Dealt to 835df346 
Dealt to cd4f83b6 
Dealt to 3d2a56c8 
Dealt to Hero [6h Qd]
Dealt to e8992002 
Dealt to 9f70f94d 
Hero: folds
e8992002: folds
9f70f94d: raises $0.05 to $0.1
835df346: folds
cd4f83b6: folds
3d2a56c8: folds
Uncalled bet ($0.05) returned to 9f70f94d
*** SHOWDOWN ***
9f70f94d collected $0.12 from pot
*** SUMMARY ***
Total pot $0.12 | Rake $0 | Jackpot $0 | Bingo $0 | Fortune $0 | Tax $0
Seat 1: 835df346 (button) folded before Flop (didn't bet)
Seat 2: cd4f83b6 (small blind) folded before Flop
Seat 3: 3d2a56c8 (big blind) folded before Flop
Seat 4: Hero folded before Flop (didn't bet)
Seat 5: e8992002 folded before Flop (didn't bet)
Seat 6: 9f70f94d collected ($0.12)


Poker Hand #RC3334444488: Hold'em No Limit ($0.02/$0.05) - 2025/02/17 20:51:43
Table 'RushAndCash609748' 6-max Seat #1 is the button
Seat 1: 188c8947 ($11.82 in chips)
Seat 2: 1b8b89c1 ($6.43 in chips)
Seat 3: 1095926a ($5.69 in chips)
Seat 4: ab5e89b2 ($5.54 in chips)
Seat 5: Hero ($5.78 in chips)
Seat 6: 2e8ab509 ($5 in chips)
1b8b89c1: posts small blind $0.02
1095926a: posts big blind $0.05
*** HOLE CARDS ***
Dealt to 188c8947 
Dealt to 1b8b89c1 
Dealt to 1095926a 
Dealt to ab5e89b2 
Dealt to Hero [7s 6s]
Dealt to 2e8ab509 
ab5e89b2: folds
Hero: raises $0.05 to $0.1
2e8ab509: folds
188c8947: folds
1b8b89c1: folds
1095926a: raises $0.4 to $0.5
Hero: calls $0.4
*** FLOP *** [3c 3h Qs]
1095926a: bets $0.34
Hero: folds
Uncalled bet ($0.34) returned to 1095926a
*** SHOWDOWN ***
1095926a collected $0.97 from pot
*** SUMMARY ***
Total pot $1.02 | Rake $0.05 | Jackpot $0 | Bingo $0 | Fortune $0 | Tax $0
Board [3c 3h Qs]
Seat 1: 188c8947 (button) folded before Flop (didn't bet)
Seat 2: 1b8b89c1 (small blind) folded before Flop
Seat 3: 1095926a (big blind) won ($0.97)
Seat 4: ab5e89b2 folded before Flop (didn't bet)
Seat 5: Hero folded on the Flop
Seat 6: 2e8ab509 folded before Flop (didn't bet)


Poker Hand #RC3334444465: Hold'em No Limit ($0.02/$0.05) - 2025/02/17 20:51:40
Table 'RushAndCash609725' 6-max Seat #1 is the button
Seat 1: 6662e866 ($17.59 in chips)
Seat 2: 688b40f9 ($7.15 in chips)
Seat 3: 18cb11a ($5.17 in chips)
Seat 4: Hero ($5.78 in chips)
Seat 5: 6ac4af54 ($13.16 in chips)
Seat 6: 9fbe68d1 ($4.15 in chips)
688b40f9: posts small blind $0.02
18cb11a: posts big blind $0.05
*** HOLE CARDS ***
Dealt to 6662e866 
Dealt to 688b40f9 
Dealt to 18cb11a 
Dealt to Hero [Th 6c]
Dealt to 6ac4af54 
Dealt to 9fbe68d1 
Hero: folds
6ac4af54: folds
9fbe68d1: folds
6662e866: folds
688b40f9: folds
Uncalled bet ($0.03) returned to 18cb11a
*** SHOWDOWN ***
18cb11a collected $0.04 from pot
*** SUMMARY ***
Total pot $0.04 | Rake $0 | Jackpot $0 | Bingo $0 | Fortune $0 | Tax $0
Seat 1: 6662e866 (button) folded before Flop (didn't bet)
Seat 2: 688b40f9 (small blind) folded before Flop
Seat 3: 18cb11a (big blind) collected ($0.04)
Seat 4: Hero folded before Flop (didn't bet)
Seat 5: 6ac4af54 folded before Flop (didn't bet)
Seat 6: 9fbe68d1 folded before Flop (didn't bet)


Poker Hand #RC3334443975: Hold'em No Limit ($0.02/$0.05) - 2025/02/17 20:50:32
Table 'RushAndCash609235' 6-max Seat #1 is the button
Seat 1: 84fb210c ($14.26 in chips)
Seat 2: Hero ($5 in chips)
Seat 3: ee368e2c ($5.95 in chips)
Seat 4: 8ed17f8c ($5.05 in chips)
Seat 5: 9fbe68d1 ($5.03 in chips)
Seat 6: 7a5bf293 ($8.55 in chips)
Hero: posts small blind $0.02
ee368e2c: posts big blind $0.05
*** HOLE CARDS ***
Dealt to 84fb210c 
Dealt to Hero [Td Jc]
Dealt to ee368e2c 
Dealt to 8ed17f8c 
Dealt to 9fbe68d1 
Dealt to 7a5bf293 
8ed17f8c: folds
9fbe68d1: raises $0.05 to $0.1
7a5bf293: folds
84fb210c: folds
Hero: calls $0.08
ee368e2c: folds
*** FLOP *** [5d 2d 3s]
Hero: checks
9fbe68d1: checks
*** TURN *** [5d 2d 3s] [Jd]
Hero: bets $0.14
9fbe68d1: calls $0.14
*** RIVER *** [5d 2d 3s Jd] [Ts]
Hero: bets $0.28
9fbe68d1: raises $0.36 to $0.64
Hero: calls $0.36
9fbe68d1: shows [Kc 5c] (Pair of Fives)
Hero: shows [Td Jc] (Pair of Jacks and Pair of Tens)
*** SHOWDOWN ***
Hero collected $1.66 from pot
*** SUMMARY ***
Total pot $1.81 | Rake $0.08 | Jackpot $0.07 | Bingo $0 | Fortune $0 | Tax $0
Board [5d 2d 3s Jd Ts]
Seat 1: 84fb210c (button) folded before Flop (didn't bet)
Seat 2: Hero (small blind) showed [Td Jc] and won ($1.66) with Pair of Jacks and Pair of Tens
Seat 3: ee368e2c (big blind) folded before Flop
Seat 4: 8ed17f8c folded before Flop (didn't bet)
Seat 5: 9fbe68d1 showed [Kc 5c] and lost with Pair of Fives
Seat 6: 7a5bf293 folded before Flop (didn't bet)


Poker Hand #RC3334443951: Hold'em No Limit ($0.02/$0.05) - 2025/02/17 20:50:29
Table 'RushAndCash609211' 6-max Seat #1 is the button
Seat 1: e2777133 ($9.13 in chips)
Seat 2: Hero ($5 in chips)
Seat 3: e877c9db ($6.26 in chips)
Seat 4: e4d8df1d ($6.65 in chips)
Seat 5: 5197516b ($5 in chips)
Seat 6: 66981141 ($11.29 in chips)
Hero: posts small blind $0.02
e877c9db: posts big blind $0.05
*** HOLE CARDS ***
Dealt to e2777133 
Dealt to Hero [8d 9c]
Dealt to e877c9db 
Dealt to e4d8df1d 
Dealt to 5197516b 
Dealt to 66981141 
e4d8df1d: folds
5197516b: folds
66981141: folds
e2777133: raises $0.06 to $0.11
Hero: folds
e877c9db: folds
Uncalled bet ($0.06) returned to e2777133
*** SHOWDOWN ***
e2777133 collected $0.12 from pot
*** SUMMARY ***
Total pot $0.12 | Rake $0 | Jackpot $0 | Bingo $0 | Fortune $0 | Tax $0
Seat 1: e2777133 (button) collected ($0.12)
Seat 2: Hero (small blind) folded before Flop
Seat 3: e877c9db (big blind) folded before Flop
Seat 4: e4d8df1d folded before Flop (didn't bet)
Seat 5: 5197516b folded before Flop (didn't bet)
Seat 6: 66981141 folded before Flop (didn't bet)


Poker Hand #RC3334443925: Hold'em No Limit ($0.02/$0.05) - 2025/02/17 20:50:26
Table 'RushAndCash609185' 6-max Seat #1 is the button
Seat 1: Hero ($5 in chips)
Seat 2: 81e1b438 ($3.88 in chips)
Seat 3: 11778018 ($4.67 in chips)
Seat 4: af8ce89c ($3.33 in chips)
Seat 5: f6efd55a ($5.64 in chips)
Seat 6: 1e4e1a58 ($6.02 in chips)
81e1b438: posts small blind $0.02
11778018: posts big blind $0.05
*** HOLE CARDS ***
Dealt to Hero [3s Jc]
Dealt to 81e1b438 
Dealt to 11778018 
Dealt to af8ce89c 
Dealt to f6efd55a 
Dealt to 1e4e1a58 
af8ce89c: folds
f6efd55a: folds
1e4e1a58: raises $0.05 to $0.1
Hero: folds
81e1b438: folds
11778018: raises $0.3 to $0.4
1e4e1a58: calls $0.3
*** FLOP *** [Ah Kc Kh]
11778018: bets $1.03
1e4e1a58: folds
Uncalled bet ($1.03) returned to 11778018
*** SHOWDOWN ***
11778018 collected $0.78 from pot
*** SUMMARY ***
Total pot $0.82 | Rake $0.04 | Jackpot $0 | Bingo $0 | Fortune $0 | Tax $0
Board [Ah Kc Kh]
Seat 1: Hero (button) folded before Flop (didn't bet)
Seat 2: 81e1b438 (small blind) folded before Flop
Seat 3: 11778018 (big blind) won ($0.78)
Seat 4: af8ce89c folded before Flop (didn't bet)
Seat 5: f6efd55a folded before Flop (didn't bet)
Seat 6: 1e4e1a58 folded on the Flop


Poker Hand #RC3334443669: Hold'em No Limit ($0.02/$0.05) - 2025/02/17 20:49:50
Table 'RushAndCash608929' 6-max Seat #1 is the button
Seat 1: fbb9d8f2 ($3.63 in chips)
Seat 2: 9604af2 ($6.49 in chips)
Seat 3: Hero ($5 in chips)
Seat 4: d25efca ($5 in chips)
Seat 5: 97fe2676 ($9.69 in chips)
Seat 6: 2509f499 ($4.72 in chips)
9604af2: posts small blind $0.02
Hero: posts big blind $0.05
*** HOLE CARDS ***
Dealt to fbb9d8f2 
Dealt to 9604af2 
Dealt to Hero [2s 2d]
Dealt to d25efca 
Dealt to 97fe2676 
Dealt to 2509f499 
d25efca: folds
97fe2676: folds
2509f499: raises $0.08 to $0.13
fbb9d8f2: calls $0.13
9604af2: folds
Hero: calls $0.08
*** FLOP *** [5d 3s 4s]
Hero: checks
2509f499: bets $0.23
fbb9d8f2: folds
Hero: calls $0.23
*** TURN *** [5d 3s 4s] [4h]
Hero: checks
2509f499: bets $0.81
Hero: folds
Uncalled bet ($0.81) returned to 2509f499
*** SHOWDOWN ***
2509f499 collected $0.83 from pot
*** SUMMARY ***
Total pot $0.87 | Rake $0.04 | Jackpot $0 | Bingo $0 | Fortune $0 | Tax $0
Board [5d 3s 4s 4h]
Seat 1: fbb9d8f2 (button) folded on the Flop
Seat 2: 9604af2 (small blind) folded before Flop
Seat 3: Hero (big blind) folded on the Turn
Seat 4: d25efca folded before Flop (didn't bet)
Seat 5: 97fe2676 folded before Flop (didn't bet)
Seat 6: 2509f499 won ($0.83)


Poker Hand #RC3334443639: Hold'em No Limit ($0.02/$0.05) - 2025/02/17 20:49:46
Table 'RushAndCash608899' 6-max Seat #1 is the button
Seat 1: b4b34357 ($5 in chips)
Seat 2: 8d17f774 ($5.38 in chips)
Seat 3: 9885e0a0 ($12.91 in chips)
Seat 4: 751b451c ($2.09 in chips)
Seat 5: Hero ($5 in chips)
Seat 6: a8e12c85 ($5.56 in chips)
8d17f774: posts small blind $0.02
9885e0a0: posts big blind $0.05
*** HOLE CARDS ***
Dealt to b4b34357 
Dealt to 8d17f774 
Dealt to 9885e0a0 
Dealt to 751b451c 
Dealt to Hero [4h 5s]
Dealt to a8e12c85 
751b451c: folds
Hero: folds
a8e12c85: folds
b4b34357: folds
8d17f774: raises $0.08 to $0.13
9885e0a0: folds
Uncalled bet ($0.08) returned to 8d17f774
*** SHOWDOWN ***
8d17f774 collected $0.1 from pot
*** SUMMARY ***
Total pot $0.1 | Rake $0 | Jackpot $0 | Bingo $0 | Fortune $0 | Tax $0
Seat 1: b4b34357 (button) folded before Flop (didn't bet)
Seat 2: 8d17f774 (small blind) collected ($0.1)
Seat 3: 9885e0a0 (big blind) folded before Flop
Seat 4: 751b451c folded before Flop (didn't bet)
Seat 5: Hero folded before Flop (didn't bet)
Seat 6: a8e12c85 folded before Flop (didn't bet)


Poker Hand #RC3334443614: Hold'em No Limit ($0.02/$0.05) - 2025/02/17 20:49:43
Table 'RushAndCash608874' 6-max Seat #1 is the button
Seat 1: 91e92de9 ($6.22 in chips)
Seat 2: f4cb4fd0 ($5.47 in chips)
Seat 3: 1bc9d557 ($5.25 in chips)
Seat 4: 868c7021 ($3.79 in chips)
Seat 5: e2c99c94 ($5.07 in chips)
Seat 6: Hero ($5 in chips)
f4cb4fd0: posts small blind $0.02
1bc9d557: posts big blind $0.05
*** HOLE CARDS ***
Dealt to 91e92de9 
Dealt to f4cb4fd0 
Dealt to 1bc9d557 
Dealt to 868c7021 
Dealt to e2c99c94 
Dealt to Hero [Ac 2d]
868c7021: folds
e2c99c94: folds
Hero: folds
91e92de9: folds
f4cb4fd0: folds
Uncalled bet ($0.03) returned to 1bc9d557
*** SHOWDOWN ***
1bc9d557 collected $0.04 from pot
*** SUMMARY ***
Total pot $0.04 | Rake $0 | Jackpot $0 | Bingo $0 | Fortune $0 | Tax $0
Seat 1: 91e92de9 (button) folded before Flop (didn't bet)
Seat 2: f4cb4fd0 (small blind) folded before Flop
Seat 3: 1bc9d557 (big blind) collected ($0.04)
Seat 4: 868c7021 folded before Flop (didn't bet)
Seat 5: e2c99c94 folded before Flop (didn't bet)
Seat 6: Hero folded before Flop (didn't bet)


Poker Hand #RC3334443566: Hold'em No Limit ($0.02/$0.05) - 2025/02/17 20:49:37
Table 'RushAndCash608826' 6-max Seat #1 is the button
Seat 1: cbe02d98 ($5.5 in chips)
Seat 2: 868521d5 ($5.2 in chips)
Seat 3: Hero ($5 in chips)
Seat 4: cb0795b5 ($6.24 in chips)
Seat 5: 9604af2 ($6.49 in chips)
Seat 6: fbb9d8f2 ($3.7 in chips)
868521d5: posts small blind $0.02
Hero: posts big blind $0.05
*** HOLE CARDS ***
Dealt to cbe02d98 
Dealt to 868521d5 
Dealt to Hero [2h Kh]
Dealt to cb0795b5 
Dealt to 9604af2 
Dealt to fbb9d8f2 
cb0795b5: raises $0.08 to $0.13
9604af2: folds
fbb9d8f2: folds
cbe02d98: folds
868521d5: folds
Hero: folds
Uncalled bet ($0.08) returned to cb0795b5
*** SHOWDOWN ***
cb0795b5 collected $0.12 from pot
*** SUMMARY ***
Total pot $0.12 | Rake $0 | Jackpot $0 | Bingo $0 | Fortune $0 | Tax $0
Seat 1: cbe02d98 (button) folded before Flop (didn't bet)
Seat 2: 868521d5 (small blind) folded before Flop
Seat 3: Hero (big blind) folded before Flop
Seat 4: cb0795b5 collected ($0.12)
Seat 5: 9604af2 folded before Flop (didn't bet)
Seat 6: fbb9d8f2 folded before Flop (didn't bet)


Poker Hand #RC3334443540: Hold'em No Limit ($0.02/$0.05) - 2025/02/17 20:49:34
Table 'RushAndCash608800' 6-max Seat #1 is the button
Seat 1: 4c9f897a ($5.02 in chips)
Seat 2: 94c257a9 ($5.98 in chips)
Seat 3: c24b20b9 ($18.81 in chips)
Seat 4: 48fa5407 ($5.69 in chips)
Seat 5: Hero ($5 in chips)
Seat 6: 570c97fe ($8.1 in chips)
94c257a9: posts small blind $0.02
c24b20b9: posts big blind $0.05
*** HOLE CARDS ***
Dealt to 4c9f897a 
Dealt to 94c257a9 
Dealt to c24b20b9 
Dealt to 48fa5407 
Dealt to Hero [2s 4s]
Dealt to 570c97fe 
48fa5407: raises $0.05 to $0.1
Hero: folds
570c97fe: folds
4c9f897a: folds
94c257a9: calls $0.08
c24b20b9: folds
*** FLOP *** [9c Jc As]
94c257a9: checks
48fa5407: checks
*** TURN *** [9c Jc As] [5s]
94c257a9: checks
48fa5407: checks
*** RIVER *** [9c Jc As 5s] [2d]
94c257a9: checks
48fa5407: checks
94c257a9: shows [6c 6h] (Pair of Sixes)
48fa5407: shows [Ks Js] (Pair of Jacks)
*** SHOWDOWN ***
48fa5407 collected $0.24 from pot
*** SUMMARY ***
Total pot $0.25 | Rake $0.01 | Jackpot $0 | Bingo $0 | Fortune $0 | Tax $0
Board [9c Jc As 5s 2d]
Seat 1: 4c9f897a (button) folded before Flop (didn't bet)
Seat 2: 94c257a9 (small blind) showed [6c 6h] and lost with Pair of Sixes
Seat 3: c24b20b9 (big blind) folded before Flop
Seat 4: 48fa5407 showed [Ks Js] and won ($0.24) with Pair of Jacks
Seat 5: Hero folded before Flop (didn't bet)
Seat 6: 570c97fe folded before Flop (didn't bet)


Poker Hand #RC3334443513: Hold'em No Limit ($0.02/$0.05) - 2025/02/17 20:49:30
Table 'RushAndCash608773' 6-max Seat #1 is the button
Seat 1: ee368e2c ($6.22 in chips)
Seat 2: 31c8057a ($4.95 in chips)
Seat 3: 86cb159 ($5 in chips)
Seat 4: 6662e866 ($17.2 in chips)
Seat 5: bce71d0e ($5.2 in chips)
Seat 6: Hero ($5 in chips)
31c8057a: posts small blind $0.02
86cb159: posts big blind $0.05
*** HOLE CARDS ***
Dealt to ee368e2c 
Dealt to 31c8057a 
Dealt to 86cb159 
Dealt to 6662e866 
Dealt to bce71d0e 
Dealt to Hero [2h 9c]
6662e866: raises $0.05 to $0.1
bce71d0e: folds
Hero: folds
ee368e2c: folds
31c8057a: folds
86cb159: folds
Uncalled bet ($0.05) returned to 6662e866
*** SHOWDOWN ***
6662e866 collected $0.12 from pot
*** SUMMARY ***
Total pot $0.12 | Rake $0 | Jackpot $0 | Bingo $0 | Fortune $0 | Tax $0
Seat 1: ee368e2c (button) folded before Flop (didn't bet)
Seat 2: 31c8057a (small blind) folded before Flop
Seat 3: 86cb159 (big blind) folded before Flop
Seat 4: 6662e866 collected ($0.12)
Seat 5: bce71d0e folded before Flop (didn't bet)
Seat 6: Hero folded before Flop (didn't bet)


Poker Hand #RC3334443489: Hold'em No Limit ($0.02/$0.05) - 2025/02/17 20:49:28
Table 'RushAndCash608749' 6-max Seat #1 is the button
Seat 1: 4c5ef89 ($3.91 in chips)
Seat 2: a28ca95c ($20.26 in chips)
Seat 3: d949b23d ($5 in chips)
Seat 4: Hero ($5 in chips)
Seat 5: e2c99c94 ($5 in chips)
Seat 6: fb6c913 ($11.48 in chips)
a28ca95c: posts small blind $0.02
d949b23d: posts big blind $0.05
*** HOLE CARDS ***
Dealt to 4c5ef89 
Dealt to a28ca95c 
Dealt to d949b23d 
Dealt to Hero [9s 4s]
Dealt to e2c99c94 
Dealt to fb6c913 
Hero: folds
e2c99c94: raises $0.05 to $0.1
fb6c913: folds
4c5ef89: folds
a28ca95c: folds
d949b23d: folds
Uncalled bet ($0.05) returned to e2c99c94
*** SHOWDOWN ***
e2c99c94 collected $0.12 from pot
*** SUMMARY ***
Total pot $0.12 | Rake $0 | Jackpot $0 | Bingo $0 | Fortune $0 | Tax $0
Seat 1: 4c5ef89 (button) folded before Flop (didn't bet)
Seat 2: a28ca95c (small blind) folded before Flop
Seat 3: d949b23d (big blind) folded before Flop
Seat 4: Hero folded before Flop (didn't bet)
Seat 5: e2c99c94 collected ($0.12)
Seat 6: fb6c913 folded before Flop (didn't bet)


Poker Hand #RC3334443464: Hold'em No Limit ($0.02/$0.05) - 2025/02/17 20:49:24
Table 'RushAndCash608724' 6-max Seat #1 is the button
Seat 1: Hero ($5 in chips)
Seat 2: c607d475 ($8.82 in chips)
Seat 3: 5ef88743 ($6.25 in chips)
Seat 4: cbfd6c92 ($11.26 in chips)
Seat 5: 9135e49d ($5.38 in chips)
Seat 6: 1ea0f381 ($4.24 in chips)
c607d475: posts small blind $0.02
5ef88743: posts big blind $0.05
*** HOLE CARDS ***
Dealt to Hero [Ac 5d]
Dealt to c607d475 
Dealt to 5ef88743 
Dealt to cbfd6c92 
Dealt to 9135e49d 
Dealt to 1ea0f381 
cbfd6c92: folds
9135e49d: folds
1ea0f381: folds
Hero: folds
c607d475: calls $0.03
5ef88743: raises $0.1 to $0.15
c607d475: calls $0.1
*** FLOP *** [4h Jc Ts]
c607d475: checks
5ef88743: bets $0.15
c607d475: folds
Uncalled bet ($0.15) returned to 5ef88743
*** SHOWDOWN ***
5ef88743 collected $0.29 from pot
*** SUMMARY ***
Total pot $0.3 | Rake $0.01 | Jackpot $0 | Bingo $0 | Fortune $0 | Tax $0
Board [4h Jc Ts]
Seat 1: Hero (button) folded before Flop (didn't bet)
Seat 2: c607d475 (small blind) folded on the Flop
Seat 3: 5ef88743 (big blind) won ($0.29)
Seat 4: cbfd6c92 folded before Flop (didn't bet)
Seat 5: 9135e49d folded before Flop (didn't bet)
Seat 6: 1ea0f381 folded before Flop (didn't bet)


Poker Hand #RC3334443423: Hold'em No Limit ($0.02/$0.05) - 2025/02/17 20:49:19
Table 'RushAndCash608683' 6-max Seat #1 is the button
Seat 1: 1063406 ($10.23 in chips)
Seat 2: a8e12c85 ($5.44 in chips)
Seat 3: 9f70f94d ($5 in chips)
Seat 4: c806dd25 ($5 in chips)
Seat 5: Hero ($5 in chips)
Seat 6: 1f85219b ($7 in chips)
a8e12c85: posts small blind $0.02
9f70f94d: posts big blind $0.05
*** HOLE CARDS ***
Dealt to 1063406 
Dealt to a8e12c85 
Dealt to 9f70f94d 
Dealt to c806dd25 
Dealt to Hero [9s Ah]
Dealt to 1f85219b 
c806dd25: folds
Hero: folds
1f85219b: folds
1063406: raises $0.1 to $0.15
a8e12c85: folds
9f70f94d: calls $0.1
*** FLOP *** [7c 3c Jd]
9f70f94d: checks
1063406: bets $0.24
9f70f94d: raises $0.61 to $0.85
1063406: folds
Uncalled bet ($0.61) returned to 9f70f94d
*** SHOWDOWN ***
9f70f94d collected $0.76 from pot
*** SUMMARY ***
Total pot $0.8 | Rake $0.04 | Jackpot $0 | Bingo $0 | Fortune $0 | Tax $0
Board [7c 3c Jd]
Seat 1: 1063406 (button) folded on the Flop
Seat 2: a8e12c85 (small blind) folded before Flop
Seat 3: 9f70f94d (big blind) won ($0.76)
Seat 4: c806dd25 folded before Flop (didn't bet)
Seat 5: Hero folded before Flop (didn't bet)
Seat 6: 1f85219b folded before Flop (didn't bet)


Poker Hand #RC3334443221: Hold'em No Limit ($0.02/$0.05) - 2025/02/17 20:48:52
Table 'RushAndCash608481' 6-max Seat #1 is the button
Seat 1: 3b2a8270 ($5.02 in chips)
Seat 2: Hero ($5.01 in chips)
Seat 3: 6aafda73 ($5 in chips)
Seat 4: fb6c4072 ($6.16 in chips)
Seat 5: 4e3c3196 ($28.54 in chips)
Seat 6: e4fd2097 ($22.86 in chips)
Hero: posts small blind $0.02
6aafda73: posts big blind $0.05
*** HOLE CARDS ***
Dealt to 3b2a8270 
Dealt to Hero [Ts Kh]
Dealt to 6aafda73 
Dealt to fb6c4072 
Dealt to 4e3c3196 
Dealt to e4fd2097 
fb6c4072: folds
4e3c3196: folds
e4fd2097: folds
3b2a8270: raises $0.05 to $0.1
Hero: calls $0.08
6aafda73: folds
*** FLOP *** [5s 4c 7h]
Hero: checks
3b2a8270: checks
*** TURN *** [5s 4c 7h] [8c]
Hero: checks
3b2a8270: checks
*** RIVER *** [5s 4c 7h 8c] [Ad]
Hero: checks
3b2a8270: checks
Hero: shows [Ts Kh] (Ace-High)
3b2a8270: shows [2c 2h] (Pair of Twos)
*** SHOWDOWN ***
3b2a8270 collected $0.24 from pot
*** SUMMARY ***
Total pot $0.25 | Rake $0.01 | Jackpot $0 | Bingo $0 | Fortune $0 | Tax $0
Board [5s 4c 7h 8c Ad]
Seat 1: 3b2a8270 (button) showed [2c 2h] and won ($0.24) with Pair of Twos
Seat 2: Hero (small blind) showed [Ts Kh] and lost with Ace-High
Seat 3: 6aafda73 (big blind) folded before Flop
Seat 4: fb6c4072 folded before Flop (didn't bet)
Seat 5: 4e3c3196 folded before Flop (didn't bet)
Seat 6: e4fd2097 folded before Flop (didn't bet)


Poker Hand #RC3334442965: Hold'em No Limit ($0.02/$0.05) - 2025/02/17 20:48:15
Table 'RushAndCash608225' 6-max Seat #1 is the button
Seat 1: e4fd2097 ($22.72 in chips)
Seat 2: c24b20b9 ($18.83 in chips)
Seat 3: Hero ($5.14 in chips)
Seat 4: 76135c78 ($5.78 in chips)
Seat 5: 70521b8f ($6.58 in chips)
Seat 6: 123dc5ea ($9.5 in chips)
c24b20b9: posts small blind $0.02
Hero: posts big blind $0.05
*** HOLE CARDS ***
Dealt to e4fd2097 
Dealt to c24b20b9 
Dealt to Hero [5s As]
Dealt to 76135c78 
Dealt to 70521b8f 
Dealt to 123dc5ea 
76135c78: folds
70521b8f: folds
123dc5ea: folds
e4fd2097: raises $0.08 to $0.13
c24b20b9: folds
Hero: calls $0.08
*** FLOP *** [3s Jh 7d]
Hero: checks
e4fd2097: checks
*** TURN *** [3s Jh 7d] [Kh]
Hero: checks
e4fd2097: bets $0.22
Hero: folds
Uncalled bet ($0.22) returned to e4fd2097
*** SHOWDOWN ***
e4fd2097 collected $0.27 from pot
*** SUMMARY ***
Total pot $0.28 | Rake $0.01 | Jackpot $0 | Bingo $0 | Fortune $0 | Tax $0
Board [3s Jh 7d Kh]
Seat 1: e4fd2097 (button) won ($0.27)
Seat 2: c24b20b9 (small blind) folded before Flop
Seat 3: Hero (big blind) folded on the Turn
Seat 4: 76135c78 folded before Flop (didn't bet)
Seat 5: 70521b8f folded before Flop (didn't bet)
Seat 6: 123dc5ea folded before Flop (didn't bet)


Poker Hand #RC3334442912: Hold'em No Limit ($0.02/$0.05) - 2025/02/17 20:48:08
Table 'RushAndCash608172' 6-max Seat #1 is the button
Seat 1: e20e5cfc ($5.08 in chips)
Seat 2: 573eb753 ($6.97 in chips)
Seat 3: f6013c83 ($8.05 in chips)
Seat 4: Hero ($5.14 in chips)
Seat 5: 3b2a8270 ($5.19 in chips)
Seat 6: b144f063 ($13.11 in chips)
573eb753: posts small blind $0.02
f6013c83: posts big blind $0.05
*** HOLE CARDS ***
Dealt to e20e5cfc 
Dealt to 573eb753 
Dealt to f6013c83 
Dealt to Hero [4d 9d]
Dealt to 3b2a8270 
Dealt to b144f063 
Hero: folds
3b2a8270: folds
b144f063: raises $0.05 to $0.1
e20e5cfc: folds
573eb753: folds
f6013c83: calls $0.05
*** FLOP *** [3s 5s Jc]
f6013c83: bets $0.08
b144f063: folds
Uncalled bet ($0.08) returned to f6013c83
*** SHOWDOWN ***
f6013c83 collected $0.21 from pot
*** SUMMARY ***
Total pot $0.22 | Rake $0.01 | Jackpot $0 | Bingo $0 | Fortune $0 | Tax $0
Board [3s 5s Jc]
Seat 1: e20e5cfc (button) folded before Flop (didn't bet)
Seat 2: 573eb753 (small blind) folded before Flop
Seat 3: f6013c83 (big blind) won ($0.21)
Seat 4: Hero folded before Flop (didn't bet)
Seat 5: 3b2a8270 folded before Flop (didn't bet)
Seat 6: b144f063 folded on the Flop


Poker Hand #RC3334442891: Hold'em No Limit ($0.02/$0.05) - 2025/02/17 20:48:05
Table 'RushAndCash608151' 6-max Seat #1 is the button
Seat 1: Hero ($5.14 in chips)
Seat 2: 2b8b2921 ($8.27 in chips)
Seat 3: 34a123ac ($5.98 in chips)
Seat 4: 1ce64dd8 ($7.08 in chips)
Seat 5: af9df96 ($5.14 in chips)
Seat 6: 1a54a2fc ($9.98 in chips)
2b8b2921: posts small blind $0.02
34a123ac: posts big blind $0.05
*** HOLE CARDS ***
Dealt to Hero [7h 2d]
Dealt to 2b8b2921 
Dealt to 34a123ac 
Dealt to 1ce64dd8 
Dealt to af9df96 
Dealt to 1a54a2fc 
1ce64dd8: folds
af9df96: folds
1a54a2fc: folds
Hero: folds
2b8b2921: folds
Uncalled bet ($0.03) returned to 34a123ac
*** SHOWDOWN ***
34a123ac collected $0.04 from pot
*** SUMMARY ***
Total pot $0.04 | Rake $0 | Jackpot $0 | Bingo $0 | Fortune $0 | Tax $0
Seat 1: Hero (button) folded before Flop (didn't bet)
Seat 2: 2b8b2921 (small blind) folded before Flop
Seat 3: 34a123ac (big blind) collected ($0.04)
Seat 4: 1ce64dd8 folded before Flop (didn't bet)
Seat 5: af9df96 folded before Flop (didn't bet)
Seat 6: 1a54a2fc folded before Flop (didn't bet)


Poker Hand #RC3334442682: Hold'em No Limit ($0.02/$0.05) - 2025/02/17 20:47:33
Table 'RushAndCash607942' 6-max Seat #1 is the button
Seat 1: d58b99ca ($22.12 in chips)
Seat 2: 711af4a4 ($11.27 in chips)
Seat 3: 16f2e5ce ($5.71 in chips)
Seat 4: ead6cfaf ($5 in chips)
Seat 5: Hero ($5 in chips)
Seat 6: 5fd404ad ($5.25 in chips)
711af4a4: posts small blind $0.02
16f2e5ce: posts big blind $0.05
*** HOLE CARDS ***
Dealt to d58b99ca 
Dealt to 711af4a4 
Dealt to 16f2e5ce 
Dealt to ead6cfaf 
Dealt to Hero [Js Ks]
Dealt to 5fd404ad 
ead6cfaf: folds
Hero: raises $0.05 to $0.1
5fd404ad: folds
d58b99ca: folds
711af4a4: calls $0.08
16f2e5ce: folds
*** FLOP *** [Tc 3c 4h]
711af4a4: checks
Hero: checks
*** TURN *** [Tc 3c 4h] [5d]
711af4a4: checks
Hero: checks
*** RIVER *** [Tc 3c 4h 5d] [Ac]
711af4a4: checks
Hero: checks
711af4a4: shows [Qh 9h] (Ace-High)
Hero: shows [Js Ks] (Ace-High)
*** SHOWDOWN ***
Hero collected $0.24 from pot
*** SUMMARY ***
Total pot $0.25 | Rake $0.01 | Jackpot $0 | Bingo $0 | Fortune $0 | Tax $0
Board [Tc 3c 4h 5d Ac]
Seat 1: d58b99ca (button) folded before Flop (didn't bet)
Seat 2: 711af4a4 (small blind) showed [Qh 9h] and lost with Ace-High
Seat 3: 16f2e5ce (big blind) folded before Flop
Seat 4: ead6cfaf folded before Flop (didn't bet)
Seat 5: Hero showed [Js Ks] and won ($0.24) with Ace-High
Seat 6: 5fd404ad folded before Flop (didn't bet)


Poker Hand #RC3334442654: Hold'em No Limit ($0.02/$0.05) - 2025/02/17 20:47:29
Table 'RushAndCash607914' 6-max Seat #1 is the button
Seat 1: faba3abb ($6.06 in chips)
Seat 2: 717e9861 ($5.07 in chips)
Seat 3: Hero ($5 in chips)
Seat 4: a7365f1c ($6.69 in chips)
Seat 5: 842d7655 ($8.19 in chips)
Seat 6: 1ac52efc ($5.32 in chips)
717e9861: posts small blind $0.02
Hero: posts big blind $0.05
*** HOLE CARDS ***
Dealt to faba3abb 
Dealt to 717e9861 
Dealt to Hero [7c Kd]
Dealt to a7365f1c 
Dealt to 842d7655 
Dealt to 1ac52efc 
a7365f1c: folds
842d7655: folds
1ac52efc: folds
faba3abb: raises $0.08 to $0.13
717e9861: raises $0.48 to $0.61
Hero: folds
faba3abb: folds
Uncalled bet ($0.48) returned to 717e9861
*** SHOWDOWN ***
717e9861 collected $0.3 from pot
*** SUMMARY ***
Total pot $0.31 | Rake $0.01 | Jackpot $0 | Bingo $0 | Fortune $0 | Tax $0
Seat 1: faba3abb (button) folded before Flop
Seat 2: 717e9861 (small blind) collected ($0.3)
Seat 3: Hero (big blind) folded before Flop
Seat 4: a7365f1c folded before Flop (didn't bet)
Seat 5: 842d7655 folded before Flop (didn't bet)
Seat 6: 1ac52efc folded before Flop (didn't bet)


Poker Hand #RC3334442632: Hold'em No Limit ($0.02/$0.05) - 2025/02/17 20:47:25
Table 'RushAndCash607892' 6-max Seat #1 is the button
Seat 1: 41720de0 ($19.61 in chips)
Seat 2: 1095926a ($5.07 in chips)
Seat 3: f0600331 ($5.26 in chips)
Seat 4: Hero ($5 in chips)
Seat 5: 886c894a ($9.8 in chips)
Seat 6: 21bff972 ($5.09 in chips)
1095926a: posts small blind $0.02
f0600331: posts big blind $0.05
*** HOLE CARDS ***
Dealt to 41720de0 
Dealt to 1095926a 
Dealt to f0600331 
Dealt to Hero [3d 4c]
Dealt to 886c894a 
Dealt to 21bff972 
Hero: folds
886c894a: folds
21bff972: raises $0.08 to $0.13
41720de0: folds
1095926a: folds
f0600331: folds
Uncalled bet ($0.08) returned to 21bff972
*** SHOWDOWN ***
21bff972 collected $0.12 from pot
*** SUMMARY ***
Total pot $0.12 | Rake $0 | Jackpot $0 | Bingo $0 | Fortune $0 | Tax $0
Seat 1: 41720de0 (button) folded before Flop (didn't bet)
Seat 2: 1095926a (small blind) folded before Flop
Seat 3: f0600331 (big blind) folded before Flop
Seat 4: Hero folded before Flop (didn't bet)
Seat 5: 886c894a folded before Flop (didn't bet)
Seat 6: 21bff972 collected ($0.12)


Poker Hand #RC3334442602: Hold'em No Limit ($0.02/$0.05) - 2025/02/17 20:47:21
Table 'RushAndCash607862' 6-max Seat #1 is the button
Seat 1: 32d40ce0 ($5.83 in chips)
Seat 2: Hero ($5 in chips)
Seat 3: 98ea32b ($4.19 in chips)
Seat 4: 35fb946f ($5.9 in chips)
Seat 5: 1f187ba0 ($4.49 in chips)
Seat 6: 6d5fa70b ($6.1 in chips)
Hero: posts small blind $0.02
98ea32b: posts big blind $0.05
*** HOLE CARDS ***
Dealt to 32d40ce0 
Dealt to Hero [Th 3h]
Dealt to 98ea32b 
Dealt to 35fb946f 
Dealt to 1f187ba0 
Dealt to 6d5fa70b 
35fb946f: folds
1f187ba0: folds
6d5fa70b: folds
32d40ce0: folds
Hero: folds
Uncalled bet ($0.03) returned to 98ea32b
*** SHOWDOWN ***
98ea32b collected $0.04 from pot
*** SUMMARY ***
Total pot $0.04 | Rake $0 | Jackpot $0 | Bingo $0 | Fortune $0 | Tax $0
Seat 1: 32d40ce0 (button) folded before Flop (didn't bet)
Seat 2: Hero (small blind) folded before Flop
Seat 3: 98ea32b (big blind) collected ($0.04)
Seat 4: 35fb946f folded before Flop (didn't bet)
Seat 5: 1f187ba0 folded before Flop (didn't bet)
Seat 6: 6d5fa70b folded before Flop (didn't bet)


Poker Hand #RC3334442582: Hold'em No Limit ($0.02/$0.05) - 2025/02/17 20:47:18
Table 'RushAndCash607842' 6-max Seat #1 is the button
Seat 1: Hero ($5 in chips)
Seat 2: b940aa44 ($10.54 in chips)
Seat 3: 5c980949 ($6.31 in chips)
Seat 4: 144ea2b0 ($11.53 in chips)
Seat 5: 1f85219b ($6.8 in chips)
Seat 6: a28ca95c ($20.8 in chips)
b940aa44: posts small blind $0.02
5c980949: posts big blind $0.05
*** HOLE CARDS ***
Dealt to Hero [9d 2s]
Dealt to b940aa44 
Dealt to 5c980949 
Dealt to 144ea2b0 
Dealt to 1f85219b 
Dealt to a28ca95c 
144ea2b0: folds
1f85219b: folds
a28ca95c: folds
Hero: folds
b940aa44: folds
Uncalled bet ($0.03) returned to 5c980949
*** SHOWDOWN ***
5c980949 collected $0.04 from pot
*** SUMMARY ***
Total pot $0.04 | Rake $0 | Jackpot $0 | Bingo $0 | Fortune $0 | Tax $0
Seat 1: Hero (button) folded before Flop (didn't bet)
Seat 2: b940aa44 (small blind) folded before Flop
Seat 3: 5c980949 (big blind) collected ($0.04)
Seat 4: 144ea2b0 folded before Flop (didn't bet)
Seat 5: 1f85219b folded before Flop (didn't bet)
Seat 6: a28ca95c folded before Flop (didn't bet)


Poker Hand #RC3334442557: Hold'em No Limit ($0.02/$0.05) - 2025/02/17 20:47:14
Table 'RushAndCash607817' 6-max Seat #1 is the button
Seat 1: c607d475 ($7.67 in chips)
Seat 2: 8b76c8c6 ($5.47 in chips)
Seat 3: 81e8e5cc ($5.32 in chips)
Seat 4: Hero ($5 in chips)
Seat 5: 79df293 ($5 in chips)
Seat 6: 1e76a4d8 ($6.13 in chips)
8b76c8c6: posts small blind $0.02
81e8e5cc: posts big blind $0.05
*** HOLE CARDS ***
Dealt to c607d475 
Dealt to 8b76c8c6 
Dealt to 81e8e5cc 
Dealt to Hero [2s Kc]
Dealt to 79df293 
Dealt to 1e76a4d8 
Hero: folds
79df293: folds
1e76a4d8: folds
c607d475: raises $0.1 to $0.15
8b76c8c6: raises $0.27 to $0.42
81e8e5cc: folds
c607d475: calls $0.27
*** FLOP *** [4s 9d 7s]
8b76c8c6: checks
c607d475: checks
*** TURN *** [4s 9d 7s] [2d]
8b76c8c6: checks
c607d475: checks
*** RIVER *** [4s 9d 7s 2d] [9c]
8b76c8c6: checks
c607d475: bets $0.67
8b76c8c6: folds
Uncalled bet ($0.67) returned to c607d475
*** SHOWDOWN ***
c607d475 collected $0.85 from pot
*** SUMMARY ***
Total pot $0.89 | Rake $0.04 | Jackpot $0 | Bingo $0 | Fortune $0 | Tax $0
Board [4s 9d 7s 2d 9c]
Seat 1: c607d475 (button) won ($0.85)
Seat 2: 8b76c8c6 (small blind) folded on the River
Seat 3: 81e8e5cc (big blind) folded before Flop
Seat 4: Hero folded before Flop (didn't bet)
Seat 5: 79df293 folded before Flop (didn't bet)
Seat 6: 1e76a4d8 folded before Flop (didn't bet)


Poker Hand #RC3334442535: Hold'em No Limit ($0.02/$0.05) - 2025/02/17 20:47:11
Table 'RushAndCash607795' 6-max Seat #1 is the button
Seat 1: c607d475 ($7.67 in chips)
Seat 2: c7d7e6aa ($18.16 in chips)
Seat 3: 8cd59d43 ($5 in chips)
Seat 4: Hero ($5 in chips)
Seat 5: cea9730b ($5 in chips)
Seat 6: bf2195f6 ($4.99 in chips)
c7d7e6aa: posts small blind $0.02
8cd59d43: posts big blind $0.05
*** HOLE CARDS ***
Dealt to c607d475 
Dealt to c7d7e6aa 
Dealt to 8cd59d43 
Dealt to Hero [6c Qd]
Dealt to cea9730b 
Dealt to bf2195f6 
Hero: folds
cea9730b: raises $0.06 to $0.11
bf2195f6: folds
c607d475: folds
c7d7e6aa: folds
8cd59d43: calls $0.06
*** FLOP *** [Tc 8s 6h]
8cd59d43: checks
cea9730b: checks
*** TURN *** [Tc 8s 6h] [6s]
8cd59d43: bets $0.12
cea9730b: raises $0.37 to $0.49
8cd59d43: calls $0.37
*** RIVER *** [Tc 8s 6h 6s] [Jc]
8cd59d43: checks
cea9730b: bets $1.17
8cd59d43: calls $1.17
cea9730b: shows [8h 8c] (Eights Full over Sixes)
8cd59d43: shows [As Th] (Pair of Tens and Pair of Sixes)
*** SHOWDOWN ***
cea9730b collected $3.34 from pot
*** SUMMARY ***
Total pot $3.56 | Rake $0.15 | Jackpot $0.07 | Bingo $0 | Fortune $0 | Tax $0
Board [Tc 8s 6h 6s Jc]
Seat 1: c607d475 (button) folded before Flop (didn't bet)
Seat 2: c7d7e6aa (small blind) folded before Flop
Seat 3: 8cd59d43 (big blind) showed [As Th] and lost with Pair of Tens and Pair of Sixes
Seat 4: Hero folded before Flop (didn't bet)
Seat 5: cea9730b showed [8h 8c] and won ($3.34) with Eights Full over Sixes
Seat 6: bf2195f6 folded before Flop (didn't bet)


Poker Hand #RC3334442506: Hold'em No Limit ($0.02/$0.05) - 2025/02/17 20:47:07
Table 'RushAndCash607766' 6-max Seat #1 is the button
Seat 1: c3b473c1 ($5.14 in chips)
Seat 2: 4b15f54e ($5 in chips)
Seat 3: 1ea0f381 ($4.61 in chips)
Seat 4: 9604af2 ($6.2 in chips)
Seat 5: 98ea32b ($4.12 in chips)
Seat 6: Hero ($5 in chips)
4b15f54e: posts small blind $0.02
1ea0f381: posts big blind $0.05
*** HOLE CARDS ***
Dealt to c3b473c1 
Dealt to 4b15f54e 
Dealt to 1ea0f381 
Dealt to 9604af2 
Dealt to 98ea32b 
Dealt to Hero [Kh 9d]
9604af2: folds
98ea32b: folds
Hero: folds
c3b473c1: folds
4b15f54e: folds
Uncalled bet ($0.03) returned to 1ea0f381
*** SHOWDOWN ***
1ea0f381 collected $0.04 from pot
*** SUMMARY ***
Total pot $0.04 | Rake $0 | Jackpot $0 | Bingo $0 | Fortune $0 | Tax $0
Seat 1: c3b473c1 (button) folded before Flop (didn't bet)
Seat 2: 4b15f54e (small blind) folded before Flop
Seat 3: 1ea0f381 (big blind) collected ($0.04)
Seat 4: 9604af2 folded before Flop (didn't bet)
Seat 5: 98ea32b folded before Flop (didn't bet)
Seat 6: Hero folded before Flop (didn't bet)


Poker Hand #RC3334442482: Hold'em No Limit ($0.02/$0.05) - 2025/02/17 20:47:03
Table 'RushAndCash607742' 6-max Seat #1 is the button
Seat 1: 78b1f985 ($5.12 in chips)
Seat 2: Hero ($5 in chips)
Seat 3: db83c16e ($6.47 in chips)
Seat 4: fdbac393 ($5.5 in chips)
Seat 5: 7e8993bd ($4.39 in chips)
Seat 6: 71e00d83 ($6.82 in chips)
Hero: posts small blind $0.02
db83c16e: posts big blind $0.05
*** HOLE CARDS ***
Dealt to 78b1f985 
Dealt to Hero [3s Ah]
Dealt to db83c16e 
Dealt to fdbac393 
Dealt to 7e8993bd 
Dealt to 71e00d83 
fdbac393: folds
7e8993bd: folds
71e00d83: raises $0.05 to $0.1
78b1f985: folds
Hero: folds
db83c16e: raises $0.17 to $0.27
71e00d83: calls $0.17
*** FLOP *** [4s Qc 9c]
db83c16e: bets $0.28
71e00d83: calls $0.28
*** TURN *** [4s Qc 9c] [Ad]
db83c16e: checks
71e00d83: bets $0.84
db83c16e: folds
Uncalled bet ($0.84) returned to 71e00d83
*** SHOWDOWN ***
71e00d83 collected $1.07 from pot
*** SUMMARY ***
Total pot $1.12 | Rake $0.05 | Jackpot $0 | Bingo $0 | Fortune $0 | Tax $0
Board [4s Qc 9c Ad]
Seat 1: 78b1f985 (button) folded before Flop (didn't bet)
Seat 2: Hero (small blind) folded before Flop
Seat 3: db83c16e (big blind) folded on the Turn
Seat 4: fdbac393 folded before Flop (didn't bet)
Seat 5: 7e8993bd folded before Flop (didn't bet)
Seat 6: 71e00d83 showed [Qd] and won ($1.07)


Poker Hand #RC3334442307: Hold'em No Limit ($0.02/$0.05) - 2025/02/17 20:46:38
Table 'RushAndCash607567' 6-max Seat #1 is the button
Seat 1: Hero ($5 in chips)
Seat 2: 84667b37 ($5 in chips)
Seat 3: 32c94dea ($5 in chips)
Seat 4: 651cc52f ($2.79 in chips)
Seat 5: 25f30dbe ($7.22 in chips)
Seat 6: 123dc5ea ($9.96 in chips)
84667b37: posts small blind $0.02
32c94dea: posts big blind $0.05
*** HOLE CARDS ***
Dealt to Hero [Tc Qh]
Dealt to 84667b37 
Dealt to 32c94dea 
Dealt to 651cc52f 
Dealt to 25f30dbe 
Dealt to 123dc5ea 
651cc52f: folds
25f30dbe: folds
123dc5ea: folds
Hero: raises $0.05 to $0.1
84667b37: calls $0.08
32c94dea: calls $0.05
*** FLOP *** [7d Jc 7s]
84667b37: checks
32c94dea: checks
Hero: checks
*** TURN *** [7d Jc 7s] [6c]
84667b37: bets $0.15
32c94dea: folds
Hero: folds
Uncalled bet ($0.15) returned to 84667b37
*** SHOWDOWN ***
84667b37 collected $0.29 from pot
*** SUMMARY ***
Total pot $0.3 | Rake $0.01 | Jackpot $0 | Bingo $0 | Fortune $0 | Tax $0
Board [7d Jc 7s 6c]
Seat 1: Hero (button) folded on the Turn
Seat 2: 84667b37 (small blind) won ($0.29)
Seat 3: 32c94dea (big blind) folded on the Turn
Seat 4: 651cc52f folded before Flop (didn't bet)
Seat 5: 25f30dbe folded before Flop (didn't bet)
Seat 6: 123dc5ea folded before Flop (didn't bet)


Poker Hand #RC3334442287: Hold'em No Limit ($0.02/$0.05) - 2025/02/17 20:46:35
Table 'RushAndCash607547' 6-max Seat #1 is the button
Seat 1: 6ac4af54 ($13.12 in chips)
Seat 2: a1fd9df7 ($5 in chips)
Seat 3: Hero ($5 in chips)
Seat 4: 9013f95e ($12.32 in chips)
Seat 5: 2eb4439f ($11.37 in chips)
Seat 6: e20e5cfc ($5.22 in chips)
a1fd9df7: posts small blind $0.02
Hero: posts big blind $0.05
*** HOLE CARDS ***
Dealt to 6ac4af54 
Dealt to a1fd9df7 
Dealt to Hero [4h Qs]
Dealt to 9013f95e 
Dealt to 2eb4439f 
Dealt to e20e5cfc 
9013f95e: folds
2eb4439f: folds
e20e5cfc: folds
6ac4af54: raises $0.05 to $0.1
a1fd9df7: folds
Hero: folds
Uncalled bet ($0.05) returned to 6ac4af54
*** SHOWDOWN ***
6ac4af54 collected $0.12 from pot
*** SUMMARY ***
Total pot $0.12 | Rake $0 | Jackpot $0 | Bingo $0 | Fortune $0 | Tax $0
Seat 1: 6ac4af54 (button) collected ($0.12)
Seat 2: a1fd9df7 (small blind) folded before Flop
Seat 3: Hero (big blind) folded before Flop
Seat 4: 9013f95e folded before Flop (didn't bet)
Seat 5: 2eb4439f folded before Flop (didn't bet)
Seat 6: e20e5cfc folded before Flop (didn't bet)


Poker Hand #RC3334442265: Hold'em No Limit ($0.02/$0.05) - 2025/02/17 20:46:32
Table 'RushAndCash607525' 6-max Seat #1 is the button
Seat 1: 1f187ba0 ($4.55 in chips)
Seat 2: 2f9e8867 ($5.66 in chips)
Seat 3: 4c783157 ($5 in chips)
Seat 4: Hero ($5 in chips)
Seat 5: 825e110f ($5.95 in chips)
Seat 6: b7bd1225 ($5.25 in chips)
2f9e8867: posts small blind $0.02
4c783157: posts big blind $0.05
*** HOLE CARDS ***
Dealt to 1f187ba0 
Dealt to 2f9e8867 
Dealt to 4c783157 
Dealt to Hero [2c 8d]
Dealt to 825e110f 
Dealt to b7bd1225 
Hero: folds
825e110f: raises $0.08 to $0.13
b7bd1225: folds
1f187ba0: folds
2f9e8867: folds
4c783157: folds
Uncalled bet ($0.08) returned to 825e110f
*** SHOWDOWN ***
825e110f collected $0.12 from pot
*** SUMMARY ***
Total pot $0.12 | Rake $0 | Jackpot $0 | Bingo $0 | Fortune $0 | Tax $0
Seat 1: 1f187ba0 (button) folded before Flop (didn't bet)
Seat 2: 2f9e8867 (small blind) folded before Flop
Seat 3: 4c783157 (big blind) folded before Flop
Seat 4: Hero folded before Flop (didn't bet)
Seat 5: 825e110f collected ($0.12)
Seat 6: b7bd1225 folded before Flop (didn't bet)


Poker Hand #RC3334442248: Hold'em No Limit ($0.02/$0.05) - 2025/02/17 20:46:29
Table 'RushAndCash607508' 6-max Seat #1 is the button
Seat 1: 656af102 ($6.44 in chips)
Seat 2: 9f09d482 ($7.01 in chips)
Seat 3: 287f8174 ($6.17 in chips)
Seat 4: Hero ($5 in chips)
Seat 5: 9dd1ff39 ($6.9 in chips)
Seat 6: eed867f5 ($4.98 in chips)
9f09d482: posts small blind $0.02
287f8174: posts big blind $0.05
*** HOLE CARDS ***
Dealt to 656af102 
Dealt to 9f09d482 
Dealt to 287f8174 
Dealt to Hero [Jc 7h]
Dealt to 9dd1ff39 
Dealt to eed867f5 
Hero: folds
9dd1ff39: folds
eed867f5: folds
656af102: folds
9f09d482: raises $0.06 to $0.11
287f8174: folds
Uncalled bet ($0.06) returned to 9f09d482
*** SHOWDOWN ***
9f09d482 collected $0.1 from pot
*** SUMMARY ***
Total pot $0.1 | Rake $0 | Jackpot $0 | Bingo $0 | Fortune $0 | Tax $0
Seat 1: 656af102 (button) folded before Flop (didn't bet)
Seat 2: 9f09d482 (small blind) collected ($0.1)
Seat 3: 287f8174 (big blind) folded before Flop
Seat 4: Hero folded before Flop (didn't bet)
Seat 5: 9dd1ff39 folded before Flop (didn't bet)
Seat 6: eed867f5 folded before Flop (didn't bet)


Poker Hand #RC3334442212: Hold'em No Limit ($0.02/$0.05) - 2025/02/17 20:46:22
Table 'RushAndCash607472' 6-max Seat #1 is the button
Seat 1: e8e95c39 ($7.62 in chips)
Seat 2: Hero ($5.02 in chips)
Seat 3: 803e9f05 ($6.98 in chips)
Seat 4: 3fe67f8 ($6.42 in chips)
Seat 5: f6e684ae ($16.66 in chips)
Seat 6: 8f9fd8b1 ($6.5 in chips)
Hero: posts small blind $0.02
803e9f05: posts big blind $0.05
*** HOLE CARDS ***
Dealt to e8e95c39 
Dealt to Hero [3d Ad]
Dealt to 803e9f05 
Dealt to 3fe67f8 
Dealt to f6e684ae 
Dealt to 8f9fd8b1 
3fe67f8: raises $0.05 to $0.1
f6e684ae: folds
8f9fd8b1: folds
e8e95c39: folds
Hero: folds
803e9f05: calls $0.05
*** FLOP *** [7h 4h Qd]
803e9f05: checks
3fe67f8: bets $0.06
803e9f05: folds
Uncalled bet ($0.06) returned to 3fe67f8
*** SHOWDOWN ***
3fe67f8 collected $0.21 from pot
*** SUMMARY ***
Total pot $0.22 | Rake $0.01 | Jackpot $0 | Bingo $0 | Fortune $0 | Tax $0
Board [7h 4h Qd]
Seat 1: e8e95c39 (button) folded before Flop (didn't bet)
Seat 2: Hero (small blind) folded before Flop
Seat 3: 803e9f05 (big blind) folded on the Flop
Seat 4: 3fe67f8 won ($0.21)
Seat 5: f6e684ae folded before Flop (didn't bet)
Seat 6: 8f9fd8b1 folded before Flop (didn't bet)


Poker Hand #RC3334442193: Hold'em No Limit ($0.02/$0.05) - 2025/02/17 20:46:19
Table 'RushAndCash607453' 6-max Seat #1 is the button
Seat 1: 6339ee1d ($5.21 in chips)
Seat 2: 7e677a64 ($2.43 in chips)
Seat 3: f9d64f1a ($5.23 in chips)
Seat 4: 6bc74d1d ($7.38 in chips)
Seat 5: Hero ($5.02 in chips)
Seat 6: 4f7979c7 ($6.35 in chips)
7e677a64: posts small blind $0.02
f9d64f1a: posts big blind $0.05
*** HOLE CARDS ***
Dealt to 6339ee1d 
Dealt to 7e677a64 
Dealt to f9d64f1a 
Dealt to 6bc74d1d 
Dealt to Hero [6d 3s]
Dealt to 4f7979c7 
6bc74d1d: folds
Hero: folds
4f7979c7: folds
6339ee1d: folds
7e677a64: folds
Uncalled bet ($0.03) returned to f9d64f1a
*** SHOWDOWN ***
f9d64f1a collected $0.04 from pot
*** SUMMARY ***
Total pot $0.04 | Rake $0 | Jackpot $0 | Bingo $0 | Fortune $0 | Tax $0
Seat 1: 6339ee1d (button) folded before Flop (didn't bet)
Seat 2: 7e677a64 (small blind) folded before Flop
Seat 3: f9d64f1a (big blind) collected ($0.04)
Seat 4: 6bc74d1d folded before Flop (didn't bet)
Seat 5: Hero folded before Flop (didn't bet)
Seat 6: 4f7979c7 folded before Flop (didn't bet)


Poker Hand #RC3334442165: Hold'em No Limit ($0.02/$0.05) - 2025/02/17 20:46:15
Table 'RushAndCash607425' 6-max Seat #1 is the button
Seat 1: 8f9fd8b1 ($6.5 in chips)
Seat 2: f4cb4fd0 ($5.41 in chips)
Seat 3: cf593991 ($5 in chips)
Seat 4: f6e684ae ($16.66 in chips)
Seat 5: d25efca ($5.07 in chips)
Seat 6: Hero ($5.02 in chips)
f4cb4fd0: posts small blind $0.02
cf593991: posts big blind $0.05
*** HOLE CARDS ***
Dealt to 8f9fd8b1 
Dealt to f4cb4fd0 
Dealt to cf593991 
Dealt to f6e684ae 
Dealt to d25efca 
Dealt to Hero [5d Jd]
f6e684ae: folds
d25efca: folds
Hero: folds
8f9fd8b1: folds
f4cb4fd0: raises $0.07 to $0.12
cf593991: folds
Uncalled bet ($0.07) returned to f4cb4fd0
*** SHOWDOWN ***
f4cb4fd0 collected $0.1 from pot
*** SUMMARY ***
Total pot $0.1 | Rake $0 | Jackpot $0 | Bingo $0 | Fortune $0 | Tax $0
Seat 1: 8f9fd8b1 (button) folded before Flop (didn't bet)
Seat 2: f4cb4fd0 (small blind) collected ($0.1)
Seat 3: cf593991 (big blind) folded before Flop
Seat 4: f6e684ae folded before Flop (didn't bet)
Seat 5: d25efca folded before Flop (didn't bet)
Seat 6: Hero folded before Flop (didn't bet)


Poker Hand #RC3334442076: Hold'em No Limit ($0.02/$0.05) - 2025/02/17 20:46:01
Table 'RushAndCash607336' 6-max Seat #1 is the button
Seat 1: ec31f77 ($5.14 in chips)
Seat 2: 46cf35ec ($4.97 in chips)
Seat 3: Hero ($5 in chips)
Seat 4: 510f8c9f ($5.15 in chips)
Seat 5: f3fc119a ($7.15 in chips)
Seat 6: a86de18f ($2.21 in chips)
46cf35ec: posts small blind $0.02
Hero: posts big blind $0.05
*** HOLE CARDS ***
Dealt to ec31f77 
Dealt to 46cf35ec 
Dealt to Hero [6d Kd]
Dealt to 510f8c9f 
Dealt to f3fc119a 
Dealt to a86de18f 
510f8c9f: folds
f3fc119a: folds
a86de18f: folds
ec31f77: folds
46cf35ec: folds
Uncalled bet ($0.03) returned to Hero
*** SHOWDOWN ***
Hero collected $0.04 from pot
*** SUMMARY ***
Total pot $0.04 | Rake $0 | Jackpot $0 | Bingo $0 | Fortune $0 | Tax $0
Seat 1: ec31f77 (button) folded before Flop (didn't bet)
Seat 2: 46cf35ec (small blind) folded before Flop
Seat 3: Hero (big blind) collected ($0.04)
Seat 4: 510f8c9f folded before Flop (didn't bet)
Seat 5: f3fc119a folded before Flop (didn't bet)
Seat 6: a86de18f folded before Flop (didn't bet)


Poker Hand #RC3334441774: Hold'em No Limit ($0.02/$0.05) - 2025/02/17 20:45:15
Table 'RushAndCash607034' 6-max Seat #1 is the button
Seat 1: Hero ($5 in chips)
Seat 2: 54ca1f06 ($6.19 in chips)
Seat 3: 81e1b438 ($5.37 in chips)
Seat 4: c7d7e6aa ($12.13 in chips)
Seat 5: 91e92de9 ($5 in chips)
Seat 6: 84667b37 ($4.49 in chips)
54ca1f06: posts small blind $0.02
81e1b438: posts big blind $0.05
*** HOLE CARDS ***
Dealt to Hero [Ac Ah]
Dealt to 54ca1f06 
Dealt to 81e1b438 
Dealt to c7d7e6aa 
Dealt to 91e92de9 
Dealt to 84667b37 
c7d7e6aa: raises $0.05 to $0.1
91e92de9: folds
84667b37: folds
Hero: raises $0.22 to $0.32
54ca1f06: folds
81e1b438: folds
c7d7e6aa: calls $0.22
*** FLOP *** [Qs Ts Ks]
c7d7e6aa: checks
Hero: bets $0.24
c7d7e6aa: calls $0.24
*** TURN *** [Qs Ts Ks] [7s]
c7d7e6aa: checks
Hero: checks
*** RIVER *** [Qs Ts Ks 7s] [5d]
c7d7e6aa: checks
Hero: checks
c7d7e6aa: shows [8s 8h] (King High Flush)
Hero: shows [Ac Ah] (Pair of Aces)
*** SHOWDOWN ***
c7d7e6aa collected $1.13 from pot
*** SUMMARY ***
Total pot $1.19 | Rake $0.06 | Jackpot $0 | Bingo $0 | Fortune $0 | Tax $0
Board [Qs Ts Ks 7s 5d]
Seat 1: Hero (button) showed [Ac Ah] and lost with Pair of Aces
Seat 2: 54ca1f06 (small blind) folded before Flop
Seat 3: 81e1b438 (big blind) folded before Flop
Seat 4: c7d7e6aa showed [8s 8h] and won ($1.13) with King High Flush
Seat 5: 91e92de9 folded before Flop (didn't bet)
Seat 6: 84667b37 folded before Flop (didn't bet)


Poker Hand #RC3334441745: Hold'em No Limit ($0.02/$0.05) - 2025/02/17 20:45:11
Table 'RushAndCash607005' 6-max Seat #1 is the button
Seat 1: 99af2b58 ($13.38 in chips)
Seat 2: 753b3d59 ($5 in chips)
Seat 3: Hero ($5.01 in chips)
Seat 4: 21657810 ($6.6 in chips)
Seat 5: dea8bb2e ($5 in chips)
Seat 6: 742ccfee ($3.73 in chips)
753b3d59: posts small blind $0.02
Hero: posts big blind $0.05
*** HOLE CARDS ***
Dealt to 99af2b58 
Dealt to 753b3d59 
Dealt to Hero [Qd 9s]
Dealt to 21657810 
Dealt to dea8bb2e 
Dealt to 742ccfee 
21657810: folds
dea8bb2e: folds
742ccfee: raises $0.05 to $0.1
99af2b58: raises $0.2 to $0.3
753b3d59: folds
Hero: folds
742ccfee: folds
Uncalled bet ($0.2) returned to 99af2b58
*** SHOWDOWN ***
99af2b58 collected $0.26 from pot
*** SUMMARY ***
Total pot $0.27 | Rake $0.01 | Jackpot $0 | Bingo $0 | Fortune $0 | Tax $0
Seat 1: 99af2b58 (button) collected ($0.26)
Seat 2: 753b3d59 (small blind) folded before Flop
Seat 3: Hero (big blind) folded before Flop
Seat 4: 21657810 folded before Flop (didn't bet)
Seat 5: dea8bb2e folded before Flop (didn't bet)
Seat 6: 742ccfee folded before Flop


Poker Hand #RC3334441721: Hold'em No Limit ($0.02/$0.05) - 2025/02/17 20:45:07
Table 'RushAndCash606981' 6-max Seat #1 is the button
Seat 1: 8e5db286 ($7.29 in chips)
Seat 2: 1df270b6 ($8.71 in chips)
Seat 3: 697412e ($5 in chips)
Seat 4: 18cb11a ($6.53 in chips)
Seat 5: 8b7f9932 ($4.81 in chips)
Seat 6: Hero ($5.01 in chips)
1df270b6: posts small blind $0.02
697412e: posts big blind $0.05
*** HOLE CARDS ***
Dealt to 8e5db286 
Dealt to 1df270b6 
Dealt to 697412e 
Dealt to 18cb11a 
Dealt to 8b7f9932 
Dealt to Hero [2d 3s]
18cb11a: folds
8b7f9932: raises $0.06 to $0.11
Hero: folds
8e5db286: folds
1df270b6: folds
697412e: folds
Uncalled bet ($0.06) returned to 8b7f9932
*** SHOWDOWN ***
8b7f9932 collected $0.12 from pot
*** SUMMARY ***
Total pot $0.12 | Rake $0 | Jackpot $0 | Bingo $0 | Fortune $0 | Tax $0
Seat 1: 8e5db286 (button) folded before Flop (didn't bet)
Seat 2: 1df270b6 (small blind) folded before Flop
Seat 3: 697412e (big blind) folded before Flop
Seat 4: 18cb11a folded before Flop (didn't bet)
Seat 5: 8b7f9932 collected ($0.12)
Seat 6: Hero folded before Flop (didn't bet)


Poker Hand #RC3334441482: Hold'em No Limit ($0.02/$0.05) - 2025/02/17 20:44:33
Table 'RushAndCash606742' 6-max Seat #1 is the button
Seat 1: Hero ($5.11 in chips)
Seat 2: 18cb11a ($6.39 in chips)
Seat 3: 651cc52f ($2.67 in chips)
Seat 4: 7a5bf293 ($10.28 in chips)
Seat 5: 20e2d62 ($5 in chips)
Seat 6: a6ca20e7 ($35.8 in chips)
18cb11a: posts small blind $0.02
651cc52f: posts big blind $0.05
*** HOLE CARDS ***
Dealt to Hero [4d Ad]
Dealt to 18cb11a 
Dealt to 651cc52f 
Dealt to 7a5bf293 
Dealt to 20e2d62 
Dealt to a6ca20e7 
7a5bf293: folds
20e2d62: folds
a6ca20e7: folds
Hero: raises $0.05 to $0.1
18cb11a: calls $0.08
651cc52f: folds
*** FLOP *** [2s Kc Kh]
18cb11a: checks
Hero: checks
*** TURN *** [2s Kc Kh] [Jh]
18cb11a: checks
Hero: checks
*** RIVER *** [2s Kc Kh Jh] [Qc]
18cb11a: checks
Hero: checks
18cb11a: shows [Js Ts] (Pair of Kings and Pair of Jacks)
Hero: shows [4d Ad] (Pair of Kings)
*** SHOWDOWN ***
18cb11a collected $0.24 from pot
*** SUMMARY ***
Total pot $0.25 | Rake $0.01 | Jackpot $0 | Bingo $0 | Fortune $0 | Tax $0
Board [2s Kc Kh Jh Qc]
Seat 1: Hero (button) showed [4d Ad] and lost with Pair of Kings
Seat 2: 18cb11a (small blind) showed [Js Ts] and won ($0.24) with Pair of Kings and Pair of Jacks
Seat 3: 651cc52f (big blind) folded before Flop
Seat 4: 7a5bf293 folded before Flop (didn't bet)
Seat 5: 20e2d62 folded before Flop (didn't bet)
Seat 6: a6ca20e7 folded before Flop (didn't bet)


Poker Hand #RC3334441454: Hold'em No Limit ($0.02/$0.05) - 2025/02/17 20:44:29
Table 'RushAndCash606714' 6-max Seat #1 is the button
Seat 1: Hero ($5.11 in chips)
Seat 2: 64b39229 ($5.07 in chips)
Seat 3: 85ef1c62 ($7.28 in chips)
Seat 4: e72c7748 ($9.33 in chips)
Seat 5: 18cb11a ($6.39 in chips)
Seat 6: 7a5bf293 ($10.28 in chips)
64b39229: posts small blind $0.02
85ef1c62: posts big blind $0.05
*** HOLE CARDS ***
Dealt to Hero [4c 6s]
Dealt to 64b39229 
Dealt to 85ef1c62 
Dealt to e72c7748 
Dealt to 18cb11a 
Dealt to 7a5bf293 
e72c7748: folds
18cb11a: folds
7a5bf293: folds
Hero: folds
64b39229: folds
Uncalled bet ($0.03) returned to 85ef1c62
*** SHOWDOWN ***
85ef1c62 collected $0.04 from pot
*** SUMMARY ***
Total pot $0.04 | Rake $0 | Jackpot $0 | Bingo $0 | Fortune $0 | Tax $0
Seat 1: Hero (button) folded before Flop (didn't bet)
Seat 2: 64b39229 (small blind) folded before Flop
Seat 3: 85ef1c62 (big blind) collected ($0.04)
Seat 4: e72c7748 folded before Flop (didn't bet)
Seat 5: 18cb11a folded before Flop (didn't bet)
Seat 6: 7a5bf293 folded before Flop (didn't bet)


Poker Hand #RC3334441429: Hold'em No Limit ($0.02/$0.05) - 2025/02/17 20:44:26
Table 'RushAndCash606689' 6-max Seat #1 is the button
Seat 1: ef7b5599 ($15.33 in chips)
Seat 2: Hero ($5.13 in chips)
Seat 3: 25f30dbe ($7.57 in chips)
Seat 4: 130fc8d7 ($16.76 in chips)
Seat 5: 64e5de41 ($5.34 in chips)
Seat 6: 6ad9ee5e ($7.18 in chips)
Hero: posts small blind $0.02
25f30dbe: posts big blind $0.05
*** HOLE CARDS ***
Dealt to ef7b5599 
Dealt to Hero [4s 9c]
Dealt to 25f30dbe 
Dealt to 130fc8d7 
Dealt to 64e5de41 
Dealt to 6ad9ee5e 
130fc8d7: folds
64e5de41: folds
6ad9ee5e: folds
ef7b5599: raises $0.08 to $0.13
Hero: folds
25f30dbe: folds
Uncalled bet ($0.08) returned to ef7b5599
*** SHOWDOWN ***
ef7b5599 collected $0.12 from pot
*** SUMMARY ***
Total pot $0.12 | Rake $0 | Jackpot $0 | Bingo $0 | Fortune $0 | Tax $0
Seat 1: ef7b5599 (button) collected ($0.12)
Seat 2: Hero (small blind) folded before Flop
Seat 3: 25f30dbe (big blind) folded before Flop
Seat 4: 130fc8d7 folded before Flop (didn't bet)
Seat 5: 64e5de41 folded before Flop (didn't bet)
Seat 6: 6ad9ee5e folded before Flop (didn't bet)


Poker Hand #RC3334441386: Hold'em No Limit ($0.02/$0.05) - 2025/02/17 20:44:20
Table 'RushAndCash606646' 6-max Seat #1 is the button
Seat 1: f4cb4fd0 ($5.18 in chips)
Seat 2: edbb0bb6 ($5.74 in chips)
Seat 3: 1ac52efc ($5 in chips)
Seat 4: c11c2441 ($5 in chips)
Seat 5: 9b99e93a ($11.41 in chips)
Seat 6: Hero ($5.13 in chips)
edbb0bb6: posts small blind $0.02
1ac52efc: posts big blind $0.05
*** HOLE CARDS ***
Dealt to f4cb4fd0 
Dealt to edbb0bb6 
Dealt to 1ac52efc 
Dealt to c11c2441 
Dealt to 9b99e93a 
Dealt to Hero [7s 4d]
c11c2441: folds
9b99e93a: raises $0.05 to $0.1
Hero: folds
f4cb4fd0: folds
edbb0bb6: folds
1ac52efc: calls $0.05
*** FLOP *** [Jc 7h Th]
1ac52efc: checks
9b99e93a: bets $0.08
1ac52efc: folds
Uncalled bet ($0.08) returned to 9b99e93a
*** SHOWDOWN ***
9b99e93a collected $0.21 from pot
*** SUMMARY ***
Total pot $0.22 | Rake $0.01 | Jackpot $0 | Bingo $0 | Fortune $0 | Tax $0
Board [Jc 7h Th]
Seat 1: f4cb4fd0 (button) folded before Flop (didn't bet)
Seat 2: edbb0bb6 (small blind) folded before Flop
Seat 3: 1ac52efc (big blind) folded on the Flop
Seat 4: c11c2441 folded before Flop (didn't bet)
Seat 5: 9b99e93a won ($0.21)
Seat 6: Hero folded before Flop (didn't bet)


Poker Hand #RC3334441361: Hold'em No Limit ($0.02/$0.05) - 2025/02/17 20:44:17
Table 'RushAndCash606621' 6-max Seat #1 is the button
Seat 1: 3b85f8e6 ($15.14 in chips)
Seat 2: Hero ($5.15 in chips)
Seat 3: ab5e89b2 ($5.32 in chips)
Seat 4: e4a1f2d2 ($6.06 in chips)
Seat 5: 6d5fa70b ($5.53 in chips)
Seat 6: 127f997c ($8.22 in chips)
Hero: posts small blind $0.02
ab5e89b2: posts big blind $0.05
*** HOLE CARDS ***
Dealt to 3b85f8e6 
Dealt to Hero [7d Qs]
Dealt to ab5e89b2 
Dealt to e4a1f2d2 
Dealt to 6d5fa70b 
Dealt to 127f997c 
e4a1f2d2: folds
6d5fa70b: folds
127f997c: folds
3b85f8e6: folds
Hero: folds
Uncalled bet ($0.03) returned to ab5e89b2
*** SHOWDOWN ***
ab5e89b2 collected $0.04 from pot
*** SUMMARY ***
Total pot $0.04 | Rake $0 | Jackpot $0 | Bingo $0 | Fortune $0 | Tax $0
Seat 1: 3b85f8e6 (button) folded before Flop (didn't bet)
Seat 2: Hero (small blind) folded before Flop
Seat 3: ab5e89b2 (big blind) collected ($0.04)
Seat 4: e4a1f2d2 folded before Flop (didn't bet)
Seat 5: 6d5fa70b folded before Flop (didn't bet)
Seat 6: 127f997c folded before Flop (didn't bet)


Poker Hand #RC3334441337: Hold'em No Limit ($0.02/$0.05) - 2025/02/17 20:44:14
Table 'RushAndCash606597' 6-max Seat #1 is the button
Seat 1: 842d7655 ($5.5 in chips)
Seat 2: 6de2662f ($6.04 in chips)
Seat 3: ee368e2c ($5 in chips)
Seat 4: 6878e82a ($5.26 in chips)
Seat 5: 7f3dcda7 ($10.93 in chips)
Seat 6: Hero ($5.15 in chips)
6de2662f: posts small blind $0.02
ee368e2c: posts big blind $0.05
*** HOLE CARDS ***
Dealt to 842d7655 
Dealt to 6de2662f 
Dealt to ee368e2c 
Dealt to 6878e82a 
Dealt to 7f3dcda7 
Dealt to Hero [8d Ah]
6878e82a: folds
7f3dcda7: raises $0.06 to $0.11
Hero: folds
842d7655: folds
6de2662f: folds
ee368e2c: calls $0.06
*** FLOP *** [5h 9s 8h]
ee368e2c: checks
7f3dcda7: bets $0.08
ee368e2c: folds
Uncalled bet ($0.08) returned to 7f3dcda7
*** SHOWDOWN ***
7f3dcda7 collected $0.23 from pot
*** SUMMARY ***
Total pot $0.24 | Rake $0.01 | Jackpot $0 | Bingo $0 | Fortune $0 | Tax $0
Board [5h 9s 8h]
Seat 1: 842d7655 (button) folded before Flop (didn't bet)
Seat 2: 6de2662f (small blind) folded before Flop
Seat 3: ee368e2c (big blind) folded on the Flop
Seat 4: 6878e82a folded before Flop (didn't bet)
Seat 5: 7f3dcda7 won ($0.23)
Seat 6: Hero folded before Flop (didn't bet)


Poker Hand #RC3334441235: Hold'em No Limit ($0.02/$0.05) - 2025/02/17 20:44:00
Table 'RushAndCash606495' 6-max Seat #1 is the button
Seat 1: 1f85219b ($6.49 in chips)
Seat 2: eabdba88 ($5.11 in chips)
Seat 3: ef82d036 ($22.3 in chips)
Seat 4: 28e11496 ($14.26 in chips)
Seat 5: Hero ($5.15 in chips)
Seat 6: ab5e89b2 ($5.34 in chips)
eabdba88: posts small blind $0.02
ef82d036: posts big blind $0.05
*** HOLE CARDS ***
Dealt to 1f85219b 
Dealt to eabdba88 
Dealt to ef82d036 
Dealt to 28e11496 
Dealt to Hero [Ts 8s]
Dealt to ab5e89b2 
28e11496: raises $0.05 to $0.1
Hero: folds
ab5e89b2: folds
1f85219b: folds
eabdba88: folds
ef82d036: folds
Uncalled bet ($0.05) returned to 28e11496
*** SHOWDOWN ***
28e11496 collected $0.12 from pot
*** SUMMARY ***
Total pot $0.12 | Rake $0 | Jackpot $0 | Bingo $0 | Fortune $0 | Tax $0
Seat 1: 1f85219b (button) folded before Flop (didn't bet)
Seat 2: eabdba88 (small blind) folded before Flop
Seat 3: ef82d036 (big blind) folded before Flop
Seat 4: 28e11496 collected ($0.12)
Seat 5: Hero folded before Flop (didn't bet)
Seat 6: ab5e89b2 folded before Flop (didn't bet)


Poker Hand #RC3334440942: Hold'em No Limit ($0.02/$0.05) - 2025/02/17 20:43:22
Table 'RushAndCash606202' 6-max Seat #1 is the button
Seat 1: 95fac4b9 ($8.31 in chips)
Seat 2: 95003d9e ($4.95 in chips)
Seat 3: eabdba88 ($5 in chips)
Seat 4: 8a5a4b28 ($4.89 in chips)
Seat 5: ead6cfaf ($5 in chips)
Seat 6: Hero ($5.25 in chips)
95003d9e: posts small blind $0.02
eabdba88: posts big blind $0.05
*** HOLE CARDS ***
Dealt to 95fac4b9 
Dealt to 95003d9e 
Dealt to eabdba88 
Dealt to 8a5a4b28 
Dealt to ead6cfaf 
Dealt to Hero [Ks As]
8a5a4b28: folds
ead6cfaf: folds
Hero: raises $0.05 to $0.1
95fac4b9: folds
95003d9e: folds
eabdba88: calls $0.05
*** FLOP *** [7d Th 9c]
eabdba88: checks
Hero: checks
*** TURN *** [7d Th 9c] [Td]
eabdba88: bets $0.11
Hero: folds
Uncalled bet ($0.11) returned to eabdba88
*** SHOWDOWN ***
eabdba88 collected $0.21 from pot
*** SUMMARY ***
Total pot $0.22 | Rake $0.01 | Jackpot $0 | Bingo $0 | Fortune $0 | Tax $0
Board [7d Th 9c Td]
Seat 1: 95fac4b9 (button) folded before Flop (didn't bet)
Seat 2: 95003d9e (small blind) folded before Flop
Seat 3: eabdba88 (big blind) won ($0.21)
Seat 4: 8a5a4b28 folded before Flop (didn't bet)
Seat 5: ead6cfaf folded before Flop (didn't bet)
Seat 6: Hero folded on the Turn


Poker Hand #RC3334440883: Hold'em No Limit ($0.02/$0.05) - 2025/02/17 20:43:14
Table 'RushAndCash606143' 6-max Seat #1 is the button
Seat 1: 8c1b0cdf ($2.46 in chips)
Seat 2: e3a10bfa ($5.82 in chips)
Seat 3: Hero ($5.3 in chips)
Seat 4: 4d9372d1 ($5 in chips)
Seat 5: 719071b8 ($5.24 in chips)
Seat 6: 7fc44808 ($11.47 in chips)
e3a10bfa: posts small blind $0.02
Hero: posts big blind $0.05
*** HOLE CARDS ***
Dealt to 8c1b0cdf 
Dealt to e3a10bfa 
Dealt to Hero [3h 8c]
Dealt to 4d9372d1 
Dealt to 719071b8 
Dealt to 7fc44808 
4d9372d1: folds
719071b8: folds
7fc44808: folds
8c1b0cdf: raises $0.08 to $0.13
e3a10bfa: folds
Hero: folds
Uncalled bet ($0.08) returned to 8c1b0cdf
*** SHOWDOWN ***
8c1b0cdf collected $0.12 from pot
*** SUMMARY ***
Total pot $0.12 | Rake $0 | Jackpot $0 | Bingo $0 | Fortune $0 | Tax $0
Seat 1: 8c1b0cdf (button) collected ($0.12)
Seat 2: e3a10bfa (small blind) folded before Flop
Seat 3: Hero (big blind) folded before Flop
Seat 4: 4d9372d1 folded before Flop (didn't bet)
Seat 5: 719071b8 folded before Flop (didn't bet)
Seat 6: 7fc44808 folded before Flop (didn't bet)


Poker Hand #RC3334440857: Hold'em No Limit ($0.02/$0.05) - 2025/02/17 20:43:10
Table 'RushAndCash606117' 6-max Seat #1 is the button
Seat 1: 52f43d28 ($7.81 in chips)
Seat 2: fe374609 ($5.33 in chips)
Seat 3: 8c1b0cdf ($2.51 in chips)
Seat 4: Hero ($5.3 in chips)
Seat 5: 1c01f5f5 ($3.85 in chips)
Seat 6: c3b473c1 ($5.11 in chips)
fe374609: posts small blind $0.02
8c1b0cdf: posts big blind $0.05
*** HOLE CARDS ***
Dealt to 52f43d28 
Dealt to fe374609 
Dealt to 8c1b0cdf 
Dealt to Hero [5s 9h]
Dealt to 1c01f5f5 
Dealt to c3b473c1 
Hero: folds
1c01f5f5: folds
c3b473c1: folds
52f43d28: raises $0.05 to $0.1
fe374609: folds
8c1b0cdf: folds
Uncalled bet ($0.05) returned to 52f43d28
*** SHOWDOWN ***
52f43d28 collected $0.12 from pot
*** SUMMARY ***
Total pot $0.12 | Rake $0 | Jackpot $0 | Bingo $0 | Fortune $0 | Tax $0
Seat 1: 52f43d28 (button) collected ($0.12)
Seat 2: fe374609 (small blind) folded before Flop
Seat 3: 8c1b0cdf (big blind) folded before Flop
Seat 4: Hero folded before Flop (didn't bet)
Seat 5: 1c01f5f5 folded before Flop (didn't bet)
Seat 6: c3b473c1 folded before Flop (didn't bet)


Poker Hand #RC3334440832: Hold'em No Limit ($0.02/$0.05) - 2025/02/17 20:43:07
Table 'RushAndCash606092' 6-max Seat #1 is the button
Seat 1: 860fa4c9 ($10.14 in chips)
Seat 2: 945593bf ($16.68 in chips)
Seat 3: 2f12456d ($5.96 in chips)
Seat 4: 1c01f5f5 ($3.85 in chips)
Seat 5: Hero ($5.3 in chips)
Seat 6: c3b473c1 ($5.11 in chips)
945593bf: posts small blind $0.02
2f12456d: posts big blind $0.05
*** HOLE CARDS ***
Dealt to 860fa4c9 
Dealt to 945593bf 
Dealt to 2f12456d 
Dealt to 1c01f5f5 
Dealt to Hero [9h 4d]
Dealt to c3b473c1 
1c01f5f5: folds
Hero: folds
c3b473c1: folds
860fa4c9: folds
945593bf: raises $0.1 to $0.15
2f12456d: folds
Uncalled bet ($0.1) returned to 945593bf
*** SHOWDOWN ***
945593bf collected $0.1 from pot
*** SUMMARY ***
Total pot $0.1 | Rake $0 | Jackpot $0 | Bingo $0 | Fortune $0 | Tax $0
Seat 1: 860fa4c9 (button) folded before Flop (didn't bet)
Seat 2: 945593bf (small blind) collected ($0.1)
Seat 3: 2f12456d (big blind) folded before Flop
Seat 4: 1c01f5f5 folded before Flop (didn't bet)
Seat 5: Hero folded before Flop (didn't bet)
Seat 6: c3b473c1 folded before Flop (didn't bet)


Poker Hand #RC3334440784: Hold'em No Limit ($0.02/$0.05) - 2025/02/17 20:43:01
Table 'RushAndCash606044' 6-max Seat #1 is the button
Seat 1: Hero ($5.3 in chips)
Seat 2: 6650c8cb ($5.07 in chips)
Seat 3: 942cbe70 ($5.73 in chips)
Seat 4: 56624886 ($5.09 in chips)
Seat 5: 16f2e5ce ($5.96 in chips)
Seat 6: b9d877b0 ($5.58 in chips)
6650c8cb: posts small blind $0.02
942cbe70: posts big blind $0.05
*** HOLE CARDS ***
Dealt to Hero [Kc 3d]
Dealt to 6650c8cb 
Dealt to 942cbe70 
Dealt to 56624886 
Dealt to 16f2e5ce 
Dealt to b9d877b0 
56624886: folds
16f2e5ce: folds
b9d877b0: folds
Hero: folds
6650c8cb: raises $0.05 to $0.1
942cbe70: raises $0.29 to $0.39
6650c8cb: calls $0.29
*** FLOP *** [3h 5h Qd]
6650c8cb: checks
942cbe70: bets $0.39
6650c8cb: raises $0.52 to $0.91
942cbe70: calls $0.52
*** TURN *** [3h 5h Qd] [Qc]
6650c8cb: checks
942cbe70: bets $0.86
6650c8cb: raises $2.91 to $3.77 and is all-in
942cbe70: calls $2.91
6650c8cb: shows [Td Qs] (Three Queens)
942cbe70: shows [Ah As] (Pair of Aces and Pair of Queens)
*** RIVER *** [3h 5h Qd Qc] [Jc]
*** SHOWDOWN ***
6650c8cb collected $9.92 from pot
*** SUMMARY ***
Total pot $10.14 | Rake $0.15 | Jackpot $0.07 | Bingo $0 | Fortune $0 | Tax $0
Board [3h 5h Qd Qc Jc]
Seat 1: Hero (button) folded before Flop (didn't bet)
Seat 2: 6650c8cb (small blind) showed [Td Qs] and won ($9.92) with Three Queens
Seat 3: 942cbe70 (big blind) showed [Ah As] and lost with Pair of Aces and Pair of Queens
Seat 4: 56624886 folded before Flop (didn't bet)
Seat 5: 16f2e5ce folded before Flop (didn't bet)
Seat 6: b9d877b0 folded before Flop (didn't bet)


Poker Hand #RC3334440711: Hold'em No Limit ($0.02/$0.05) - 2025/02/17 20:42:52
Table 'RushAndCash605971' 6-max Seat #1 is the button
Seat 1: 1e290a15 ($9.91 in chips)
Seat 2: 1df270b6 ($8.66 in chips)
Seat 3: Hero ($5.28 in chips)
Seat 4: 5a37a767 ($5.6 in chips)
Seat 5: e4a1f2d2 ($5.99 in chips)
Seat 6: fc78a9a4 ($4.8 in chips)
1df270b6: posts small blind $0.02
Hero: posts big blind $0.05
*** HOLE CARDS ***
Dealt to 1e290a15 
Dealt to 1df270b6 
Dealt to Hero [7c Tc]
Dealt to 5a37a767 
Dealt to e4a1f2d2 
Dealt to fc78a9a4 
5a37a767: folds
e4a1f2d2: folds
fc78a9a4: folds
1e290a15: folds
1df270b6: folds
Uncalled bet ($0.03) returned to Hero
*** SHOWDOWN ***
Hero collected $0.04 from pot
*** SUMMARY ***
Total pot $0.04 | Rake $0 | Jackpot $0 | Bingo $0 | Fortune $0 | Tax $0
Seat 1: 1e290a15 (button) folded before Flop (didn't bet)
Seat 2: 1df270b6 (small blind) folded before Flop
Seat 3: Hero (big blind) collected ($0.04)
Seat 4: 5a37a767 folded before Flop (didn't bet)
Seat 5: e4a1f2d2 folded before Flop (didn't bet)
Seat 6: fc78a9a4 folded before Flop (didn't bet)


Poker Hand #RC3334440689: Hold'em No Limit ($0.02/$0.05) - 2025/02/17 20:42:49
Table 'RushAndCash605949' 6-max Seat #1 is the button
Seat 1: 23619adf ($5 in chips)
Seat 2: 95096c6a ($5 in chips)
Seat 3: bfef046a ($17.51 in chips)
Seat 4: 742ccfee ($4.11 in chips)
Seat 5: b59fc0b9 ($5.59 in chips)
Seat 6: Hero ($5.28 in chips)
95096c6a: posts small blind $0.02
bfef046a: posts big blind $0.05
*** HOLE CARDS ***
Dealt to 23619adf 
Dealt to 95096c6a 
Dealt to bfef046a 
Dealt to 742ccfee 
Dealt to b59fc0b9 
Dealt to Hero [Jc 6s]
742ccfee: folds
b59fc0b9: folds
Hero: folds
23619adf: folds
95096c6a: folds
Uncalled bet ($0.03) returned to bfef046a
*** SHOWDOWN ***
bfef046a collected $0.04 from pot
*** SUMMARY ***
Total pot $0.04 | Rake $0 | Jackpot $0 | Bingo $0 | Fortune $0 | Tax $0
Seat 1: 23619adf (button) folded before Flop (didn't bet)
Seat 2: 95096c6a (small blind) folded before Flop
Seat 3: bfef046a (big blind) collected ($0.04)
Seat 4: 742ccfee folded before Flop (didn't bet)
Seat 5: b59fc0b9 folded before Flop (didn't bet)
Seat 6: Hero folded before Flop (didn't bet)


Poker Hand #RC3334440663: Hold'em No Limit ($0.02/$0.05) - 2025/02/17 20:42:46
Table 'RushAndCash605923' 6-max Seat #1 is the button
Seat 1: bda9ba33 ($5.38 in chips)
Seat 2: 8023de0f ($5.23 in chips)
Seat 3: 9cbf2041 ($2 in chips)
Seat 4: Hero ($5.28 in chips)
Seat 5: f898e827 ($5.62 in chips)
Seat 6: e390e48e ($6.65 in chips)
8023de0f: posts small blind $0.02
9cbf2041: posts big blind $0.05
*** HOLE CARDS ***
Dealt to bda9ba33 
Dealt to 8023de0f 
Dealt to 9cbf2041 
Dealt to Hero [6h Ts]
Dealt to f898e827 
Dealt to e390e48e 
Hero: folds
f898e827: folds
e390e48e: folds
bda9ba33: raises $0.06 to $0.11
8023de0f: folds
9cbf2041: calls $0.06
*** FLOP *** [Td 2h Jd]
9cbf2041: bets $0.13
bda9ba33: calls $0.13
*** TURN *** [Td 2h Jd] [8h]
9cbf2041: checks
bda9ba33: checks
*** RIVER *** [Td 2h Jd 8h] [4c]
9cbf2041: bets $0.5
bda9ba33: folds
Uncalled bet ($0.5) returned to 9cbf2041
*** SHOWDOWN ***
9cbf2041 collected $0.48 from pot
*** SUMMARY ***
Total pot $0.5 | Rake $0.02 | Jackpot $0 | Bingo $0 | Fortune $0 | Tax $0
Board [Td 2h Jd 8h 4c]
Seat 1: bda9ba33 (button) folded on the River
Seat 2: 8023de0f (small blind) folded before Flop
Seat 3: 9cbf2041 (big blind) won ($0.48)
Seat 4: Hero folded before Flop (didn't bet)
Seat 5: f898e827 folded before Flop (didn't bet)
Seat 6: e390e48e folded before Flop (didn't bet)


Poker Hand #RC3334440641: Hold'em No Limit ($0.02/$0.05) - 2025/02/17 20:42:43
Table 'RushAndCash605901' 6-max Seat #1 is the button
Seat 1: 78b1f985 ($4.4 in chips)
Seat 2: Hero ($5.3 in chips)
Seat 3: 75091df4 ($8.08 in chips)
Seat 4: 4264790d ($5.03 in chips)
Seat 5: 1ea0f381 ($5.11 in chips)
Seat 6: 127f997c ($7.99 in chips)
Hero: posts small blind $0.02
75091df4: posts big blind $0.05
*** HOLE CARDS ***
Dealt to 78b1f985 
Dealt to Hero [6d Qh]
Dealt to 75091df4 
Dealt to 4264790d 
Dealt to 1ea0f381 
Dealt to 127f997c 
4264790d: folds
1ea0f381: folds
127f997c: folds
78b1f985: raises $0.07 to $0.12
Hero: folds
75091df4: folds
Uncalled bet ($0.07) returned to 78b1f985
*** SHOWDOWN ***
78b1f985 collected $0.12 from pot
*** SUMMARY ***
Total pot $0.12 | Rake $0 | Jackpot $0 | Bingo $0 | Fortune $0 | Tax $0
Seat 1: 78b1f985 (button) collected ($0.12)
Seat 2: Hero (small blind) folded before Flop
Seat 3: 75091df4 (big blind) folded before Flop
Seat 4: 4264790d folded before Flop (didn't bet)
Seat 5: 1ea0f381 folded before Flop (didn't bet)
Seat 6: 127f997c folded before Flop (didn't bet)


Poker Hand #RC3334440530: Hold'em No Limit ($0.02/$0.05) - 2025/02/17 20:42:27
Table 'RushAndCash605790' 6-max Seat #1 is the button
Seat 1: f171b990 ($5 in chips)
Seat 2: 56cefdc9 ($8.17 in chips)
Seat 3: 28e11496 ($14.37 in chips)
Seat 4: d25efca ($5.3 in chips)
Seat 5: Hero ($5.23 in chips)
Seat 6: f6efd55a ($5 in chips)
56cefdc9: posts small blind $0.02
28e11496: posts big blind $0.05
*** HOLE CARDS ***
Dealt to f171b990 
Dealt to 56cefdc9 
Dealt to 28e11496 
Dealt to d25efca 
Dealt to Hero [Ts Qd]
Dealt to f6efd55a 
d25efca: folds
Hero: raises $0.05 to $0.1
f6efd55a: folds
f171b990: folds
56cefdc9: folds
28e11496: folds
Uncalled bet ($0.05) returned to Hero
*** SHOWDOWN ***
Hero collected $0.12 from pot
*** SUMMARY ***
Total pot $0.12 | Rake $0 | Jackpot $0 | Bingo $0 | Fortune $0 | Tax $0
Seat 1: f171b990 (button) folded before Flop (didn't bet)
Seat 2: 56cefdc9 (small blind) folded before Flop
Seat 3: 28e11496 (big blind) folded before Flop
Seat 4: d25efca folded before Flop (didn't bet)
Seat 5: Hero collected ($0.12)
Seat 6: f6efd55a folded before Flop (didn't bet)


Poker Hand #RC3334440508: Hold'em No Limit ($0.02/$0.05) - 2025/02/17 20:42:24
Table 'RushAndCash605768' 6-max Seat #1 is the button
Seat 1: 1095926a ($5.35 in chips)
Seat 2: c11c2441 ($5.09 in chips)
Seat 3: 25f30dbe ($7.62 in chips)
Seat 4: d916afa1 ($6.74 in chips)
Seat 5: Hero ($5.23 in chips)
Seat 6: 19bb03b5 ($12.27 in chips)
c11c2441: posts small blind $0.02
25f30dbe: posts big blind $0.05
*** HOLE CARDS ***
Dealt to 1095926a 
Dealt to c11c2441 
Dealt to 25f30dbe 
Dealt to d916afa1 
Dealt to Hero [Qs 5h]
Dealt to 19bb03b5 
d916afa1: raises $0.1 to $0.15
Hero: folds
19bb03b5: folds
1095926a: folds
c11c2441: folds
25f30dbe: folds
Uncalled bet ($0.1) returned to d916afa1
*** SHOWDOWN ***
d916afa1 collected $0.12 from pot
*** SUMMARY ***
Total pot $0.12 | Rake $0 | Jackpot $0 | Bingo $0 | Fortune $0 | Tax $0
Seat 1: 1095926a (button) folded before Flop (didn't bet)
Seat 2: c11c2441 (small blind) folded before Flop
Seat 3: 25f30dbe (big blind) folded before Flop
Seat 4: d916afa1 collected ($0.12)
Seat 5: Hero folded before Flop (didn't bet)
Seat 6: 19bb03b5 folded before Flop (didn't bet)


Poker Hand #RC3334440488: Hold'em No Limit ($0.02/$0.05) - 2025/02/17 20:42:21
Table 'RushAndCash605748' 6-max Seat #1 is the button
Seat 1: 6dcd0788 ($7.68 in chips)
Seat 2: 1fa8537 ($5 in chips)
Seat 3: 187f2194 ($11.32 in chips)
Seat 4: 34a123ac ($5 in chips)
Seat 5: 773fdf96 ($5.37 in chips)
Seat 6: Hero ($5.23 in chips)
1fa8537: posts small blind $0.02
187f2194: posts big blind $0.05
*** HOLE CARDS ***
Dealt to 6dcd0788 
Dealt to 1fa8537 
Dealt to 187f2194 
Dealt to 34a123ac 
Dealt to 773fdf96 
Dealt to Hero [4s 5c]
34a123ac: folds
773fdf96: folds
Hero: folds
6dcd0788: raises $0.08 to $0.13
1fa8537: folds
187f2194: folds
Uncalled bet ($0.08) returned to 6dcd0788
*** SHOWDOWN ***
6dcd0788 collected $0.12 from pot
*** SUMMARY ***
Total pot $0.12 | Rake $0 | Jackpot $0 | Bingo $0 | Fortune $0 | Tax $0
Seat 1: 6dcd0788 (button) collected ($0.12)
Seat 2: 1fa8537 (small blind) folded before Flop
Seat 3: 187f2194 (big blind) folded before Flop
Seat 4: 34a123ac folded before Flop (didn't bet)
Seat 5: 773fdf96 folded before Flop (didn't bet)
Seat 6: Hero folded before Flop (didn't bet)


Poker Hand #RC3334440467: Hold'em No Limit ($0.02/$0.05) - 2025/02/17 20:42:17
Table 'RushAndCash605727' 6-max Seat #1 is the button
Seat 1: Hero ($5.23 in chips)
Seat 2: 1d0217bc ($14.32 in chips)
Seat 3: fbb9d8f2 ($3.56 in chips)
Seat 4: f1821143 ($5.51 in chips)
Seat 5: 6be17d4e ($5.89 in chips)
Seat 6: 918d412c ($3.65 in chips)
1d0217bc: posts small blind $0.02
fbb9d8f2: posts big blind $0.05
*** HOLE CARDS ***
Dealt to Hero [Kh 2h]
Dealt to 1d0217bc 
Dealt to fbb9d8f2 
Dealt to f1821143 
Dealt to 6be17d4e 
Dealt to 918d412c 
f1821143: folds
6be17d4e: folds
918d412c: raises $0.05 to $0.1
Hero: folds
1d0217bc: folds
fbb9d8f2: folds
Uncalled bet ($0.05) returned to 918d412c
*** SHOWDOWN ***
918d412c collected $0.12 from pot
*** SUMMARY ***
Total pot $0.12 | Rake $0 | Jackpot $0 | Bingo $0 | Fortune $0 | Tax $0
Seat 1: Hero (button) folded before Flop (didn't bet)
Seat 2: 1d0217bc (small blind) folded before Flop
Seat 3: fbb9d8f2 (big blind) folded before Flop
Seat 4: f1821143 folded before Flop (didn't bet)
Seat 5: 6be17d4e folded before Flop (didn't bet)
Seat 6: 918d412c collected ($0.12)


Poker Hand #RC3334440160: Hold'em No Limit ($0.02/$0.05) - 2025/02/17 20:41:36
Table 'RushAndCash605420' 6-max Seat #1 is the button
Seat 1: d25efca ($5.3 in chips)
Seat 2: Hero ($5 in chips)
Seat 3: 1d0217bc ($14.57 in chips)
Seat 4: a3e1ffe ($5 in chips)
Seat 5: 38f4cc4d ($4.02 in chips)
Seat 6: 192a8fb5 ($5.67 in chips)
Hero: posts small blind $0.02
1d0217bc: posts big blind $0.05
*** HOLE CARDS ***
Dealt to d25efca 
Dealt to Hero [Ad Ts]
Dealt to 1d0217bc 
Dealt to a3e1ffe 
Dealt to 38f4cc4d 
Dealt to 192a8fb5 
a3e1ffe: folds
38f4cc4d: folds
192a8fb5: folds
d25efca: folds
Hero: raises $0.1 to $0.15
1d0217bc: calls $0.1
*** FLOP *** [Qd 6d Ah]
Hero: bets $0.1
1d0217bc: calls $0.1
*** TURN *** [Qd 6d Ah] [4h]
Hero: checks
1d0217bc: checks
*** RIVER *** [Qd 6d Ah 4h] [5s]
Hero: checks
1d0217bc: checks
Hero: shows [Ad Ts] (Pair of Aces)
1d0217bc: shows [7d Td] (Ace-High)
*** SHOWDOWN ***
Hero collected $0.48 from pot
*** SUMMARY ***
Total pot $0.5 | Rake $0.02 | Jackpot $0 | Bingo $0 | Fortune $0 | Tax $0
Board [Qd 6d Ah 4h 5s]
Seat 1: d25efca (button) folded before Flop (didn't bet)
Seat 2: Hero (small blind) showed [Ad Ts] and won ($0.48) with Pair of Aces
Seat 3: 1d0217bc (big blind) showed [7d Td] and lost with Ace-High
Seat 4: a3e1ffe folded before Flop (didn't bet)
Seat 5: 38f4cc4d folded before Flop (didn't bet)
Seat 6: 192a8fb5 folded before Flop (didn't bet)


Poker Hand #RC3334440134: Hold'em No Limit ($0.02/$0.05) - 2025/02/17 20:41:32
Table 'RushAndCash605394' 6-max Seat #1 is the button
Seat 1: 1754e33c ($5.8 in chips)
Seat 2: 7b6a3077 ($6.84 in chips)
Seat 3: 9d7d4a76 ($5.54 in chips)
Seat 4: f6655046 ($5.53 in chips)
Seat 5: Hero ($5 in chips)
Seat 6: 6aa0c391 ($5.05 in chips)
7b6a3077: posts small blind $0.02
9d7d4a76: posts big blind $0.05
*** HOLE CARDS ***
Dealt to 1754e33c 
Dealt to 7b6a3077 
Dealt to 9d7d4a76 
Dealt to f6655046 
Dealt to Hero [7c As]
Dealt to 6aa0c391 
f6655046: folds
Hero: folds
6aa0c391: folds
1754e33c: folds
7b6a3077: folds
Uncalled bet ($0.03) returned to 9d7d4a76
*** SHOWDOWN ***
9d7d4a76 collected $0.04 from pot
*** SUMMARY ***
Total pot $0.04 | Rake $0 | Jackpot $0 | Bingo $0 | Fortune $0 | Tax $0
Seat 1: 1754e33c (button) folded before Flop (didn't bet)
Seat 2: 7b6a3077 (small blind) folded before Flop
Seat 3: 9d7d4a76 (big blind) collected ($0.04)
Seat 4: f6655046 folded before Flop (didn't bet)
Seat 5: Hero folded before Flop (didn't bet)
Seat 6: 6aa0c391 folded before Flop (didn't bet)


Poker Hand #RC3334439931: Hold'em No Limit ($0.02/$0.05) - 2025/02/17 20:41:01
Table 'RushAndCash605191' 6-max Seat #1 is the button
Seat 1: 1e4e1a58 ($6.56 in chips)
Seat 2: 1640de52 ($15.16 in chips)
Seat 3: Hero ($5 in chips)
Seat 4: e72c7748 ($9.54 in chips)
Seat 5: a17718eb ($2.07 in chips)
Seat 6: 15125d65 ($9.03 in chips)
1640de52: posts small blind $0.02
Hero: posts big blind $0.05
*** HOLE CARDS ***
Dealt to 1e4e1a58 
Dealt to 1640de52 
Dealt to Hero [Js 9s]
Dealt to e72c7748 
Dealt to a17718eb 
Dealt to 15125d65 
e72c7748: folds
a17718eb: raises $0.05 to $0.1
15125d65: folds
1e4e1a58: folds
1640de52: folds
Hero: calls $0.05
*** FLOP *** [8c 6h 6d]
Hero: checks
a17718eb: checks
*** TURN *** [8c 6h 6d] [3c]
Hero: checks
a17718eb: bets $0.11
Hero: folds
Uncalled bet ($0.11) returned to a17718eb
*** SHOWDOWN ***
a17718eb collected $0.21 from pot
*** SUMMARY ***
Total pot $0.22 | Rake $0.01 | Jackpot $0 | Bingo $0 | Fortune $0 | Tax $0
Board [8c 6h 6d 3c]
Seat 1: 1e4e1a58 (button) folded before Flop (didn't bet)
Seat 2: 1640de52 (small blind) folded before Flop
Seat 3: Hero (big blind) folded on the Turn
Seat 4: e72c7748 folded before Flop (didn't bet)
Seat 5: a17718eb won ($0.21)
Seat 6: 15125d65 folded before Flop (didn't bet)


Poker Hand #RC3334439826: Hold'em No Limit ($0.02/$0.05) - 2025/02/17 20:40:46
Table 'RushAndCash605086' 6-max Seat #1 is the button
Seat 1: 6af54020 ($6.89 in chips)
Seat 2: 1e76a4d8 ($6 in chips)
Seat 3: 54ca1f06 ($7.06 in chips)
Seat 4: f18b40b7 ($5.45 in chips)
Seat 5: Hero ($5 in chips)
Seat 6: b45daa8e ($2.17 in chips)
1e76a4d8: posts small blind $0.02
54ca1f06: posts big blind $0.05
*** HOLE CARDS ***
Dealt to 6af54020 
Dealt to 1e76a4d8 
Dealt to 54ca1f06 
Dealt to f18b40b7 
Dealt to Hero [Jh Ad]
Dealt to b45daa8e 
f18b40b7: raises $0.05 to $0.1
Hero: calls $0.1
b45daa8e: folds
6af54020: folds
1e76a4d8: raises $0.6 to $0.7
54ca1f06: folds
f18b40b7: folds
Hero: folds
Uncalled bet ($0.6) returned to 1e76a4d8
*** SHOWDOWN ***
1e76a4d8 collected $0.34 from pot
*** SUMMARY ***
Total pot $0.35 | Rake $0.01 | Jackpot $0 | Bingo $0 | Fortune $0 | Tax $0
Seat 1: 6af54020 (button) folded before Flop (didn't bet)
Seat 2: 1e76a4d8 (small blind) collected ($0.34)
Seat 3: 54ca1f06 (big blind) folded before Flop
Seat 4: f18b40b7 folded before Flop
Seat 5: Hero folded before Flop
Seat 6: b45daa8e folded before Flop (didn't bet)


Poker Hand #RC3334439788: Hold'em No Limit ($0.02/$0.05) - 2025/02/17 20:40:42
Table 'RushAndCash605048' 6-max Seat #1 is the button
Seat 1: 5bf5cd50 ($5 in chips)
Seat 2: 1ce64dd8 ($4.44 in chips)
Seat 3: Hero ($5 in chips)
Seat 4: dc00ecae ($5 in chips)
Seat 5: f1f26d78 ($9.1 in chips)
Seat 6: 57d6169c ($5.65 in chips)
1ce64dd8: posts small blind $0.02
Hero: posts big blind $0.05
*** HOLE CARDS ***
Dealt to 5bf5cd50 
Dealt to 1ce64dd8 
Dealt to Hero [Th 7s]
Dealt to dc00ecae 
Dealt to f1f26d78 
Dealt to 57d6169c 
dc00ecae: folds
f1f26d78: folds
57d6169c: raises $0.08 to $0.13
5bf5cd50: calls $0.13
1ce64dd8: folds
Hero: folds
*** FLOP *** [Kc Ac 4d]
57d6169c: bets $0.1
5bf5cd50: calls $0.1
*** TURN *** [Kc Ac 4d] [4c]
57d6169c: checks
5bf5cd50: bets $0.32
57d6169c: folds
Uncalled bet ($0.32) returned to 5bf5cd50
*** SHOWDOWN ***
5bf5cd50 collected $0.51 from pot
*** SUMMARY ***
Total pot $0.53 | Rake $0.02 | Jackpot $0 | Bingo $0 | Fortune $0 | Tax $0
Board [Kc Ac 4d 4c]
Seat 1: 5bf5cd50 (button) won ($0.51)
Seat 2: 1ce64dd8 (small blind) folded before Flop
Seat 3: Hero (big blind) folded before Flop
Seat 4: dc00ecae folded before Flop (didn't bet)
Seat 5: f1f26d78 folded before Flop (didn't bet)
Seat 6: 57d6169c folded on the Turn


Poker Hand #RC3334439756: Hold'em No Limit ($0.02/$0.05) - 2025/02/17 20:40:38
Table 'RushAndCash605016' 6-max Seat #1 is the button
Seat 1: f83d0c9c ($6.79 in chips)
Seat 2: Hero ($5 in chips)
Seat 3: 91e92de9 ($9.16 in chips)
Seat 4: e813a51e ($2.59 in chips)
Seat 5: d1f305bd ($4.99 in chips)
Seat 6: d793d8f ($9.8 in chips)
Hero: posts small blind $0.02
91e92de9: posts big blind $0.05
*** HOLE CARDS ***
Dealt to f83d0c9c 
Dealt to Hero [4s Ac]
Dealt to 91e92de9 
Dealt to e813a51e 
Dealt to d1f305bd 
Dealt to d793d8f 
e813a51e: folds
d1f305bd: folds
d793d8f: folds
f83d0c9c: folds
Hero: folds
Uncalled bet ($0.03) returned to 91e92de9
*** SHOWDOWN ***
91e92de9 collected $0.04 from pot
*** SUMMARY ***
Total pot $0.04 | Rake $0 | Jackpot $0 | Bingo $0 | Fortune $0 | Tax $0
Seat 1: f83d0c9c (button) folded before Flop (didn't bet)
Seat 2: Hero (small blind) folded before Flop
Seat 3: 91e92de9 (big blind) collected ($0.04)
Seat 4: e813a51e folded before Flop (didn't bet)
Seat 5: d1f305bd folded before Flop (didn't bet)
Seat 6: d793d8f folded before Flop (didn't bet)


Poker Hand #RC3334439735: Hold'em No Limit ($0.02/$0.05) - 2025/02/17 20:40:35
Table 'RushAndCash604995' 6-max Seat #1 is the button
Seat 1: Hero ($5 in chips)
Seat 2: 64b39229 ($5.16 in chips)
Seat 3: 71e00d83 ($10.46 in chips)
Seat 4: 6f8bb9d1 ($5.45 in chips)
Seat 5: 1937cebf ($5 in chips)
Seat 6: 15125d65 ($9.1 in chips)
64b39229: posts small blind $0.02
71e00d83: posts big blind $0.05
*** HOLE CARDS ***
Dealt to Hero [5c 6h]
Dealt to 64b39229 
Dealt to 71e00d83 
Dealt to 6f8bb9d1 
Dealt to 1937cebf 
Dealt to 15125d65 
6f8bb9d1: folds
1937cebf: folds
15125d65: folds
Hero: folds
64b39229: raises $0.05 to $0.1
71e00d83: calls $0.05
*** FLOP *** [5h 3c 7c]
64b39229: bets $0.1
71e00d83: calls $0.1
*** TURN *** [5h 3c 7c] [5s]
64b39229: bets $0.2
71e00d83: folds
Uncalled bet ($0.2) returned to 64b39229
*** SHOWDOWN ***
64b39229 collected $0.38 from pot
*** SUMMARY ***
Total pot $0.4 | Rake $0.02 | Jackpot $0 | Bingo $0 | Fortune $0 | Tax $0
Board [5h 3c 7c 5s]
Seat 1: Hero (button) folded before Flop (didn't bet)
Seat 2: 64b39229 (small blind) won ($0.38)
Seat 3: 71e00d83 (big blind) folded on the Turn
Seat 4: 6f8bb9d1 folded before Flop (didn't bet)
Seat 5: 1937cebf folded before Flop (didn't bet)
Seat 6: 15125d65 folded before Flop (didn't bet)


Poker Hand #RC3334439713: Hold'em No Limit ($0.02/$0.05) - 2025/02/17 20:40:32
Table 'RushAndCash604973' 6-max Seat #1 is the button
Seat 1: 2c7878da ($4.8 in chips)
Seat 2: 38ef00 ($1.3 in chips)
Seat 3: e56ac911 ($3.37 in chips)
Seat 4: Hero ($5 in chips)
Seat 5: e74a324 ($5.15 in chips)
Seat 6: e3a10bfa ($5 in chips)
38ef00: posts small blind $0.02
e56ac911: posts big blind $0.05
*** HOLE CARDS ***
Dealt to 2c7878da 
Dealt to 38ef00 
Dealt to e56ac911 
Dealt to Hero [5c Ks]
Dealt to e74a324 
Dealt to e3a10bfa 
Hero: folds
e74a324: raises $0.05 to $0.1
e3a10bfa: folds
2c7878da: folds
38ef00: folds
e56ac911: folds
Uncalled bet ($0.05) returned to e74a324
*** SHOWDOWN ***
e74a324 collected $0.12 from pot
*** SUMMARY ***
Total pot $0.12 | Rake $0 | Jackpot $0 | Bingo $0 | Fortune $0 | Tax $0
Seat 1: 2c7878da (button) folded before Flop (didn't bet)
Seat 2: 38ef00 (small blind) folded before Flop
Seat 3: e56ac911 (big blind) folded before Flop
Seat 4: Hero folded before Flop (didn't bet)
Seat 5: e74a324 collected ($0.12)
Seat 6: e3a10bfa folded before Flop (didn't bet)


Poker Hand #RC3334439690: Hold'em No Limit ($0.02/$0.05) - 2025/02/17 20:40:29
Table 'RushAndCash604950' 6-max Seat #1 is the button
Seat 1: f2e82cf4 ($5.55 in chips)
Seat 2: 16081ce9 ($15.21 in chips)
Seat 3: c7e9103c ($20.37 in chips)
Seat 4: 2dba12ed ($5.07 in chips)
Seat 5: 194ee370 ($6.65 in chips)
Seat 6: Hero ($5 in chips)
16081ce9: posts small blind $0.02
c7e9103c: posts big blind $0.05
*** HOLE CARDS ***
Dealt to f2e82cf4 
Dealt to 16081ce9 
Dealt to c7e9103c 
Dealt to 2dba12ed 
Dealt to 194ee370 
Dealt to Hero [8h 5d]
2dba12ed: folds
194ee370: folds
Hero: folds
f2e82cf4: folds
16081ce9: folds
Uncalled bet ($0.03) returned to c7e9103c
*** SHOWDOWN ***
c7e9103c collected $0.04 from pot
*** SUMMARY ***
Total pot $0.04 | Rake $0 | Jackpot $0 | Bingo $0 | Fortune $0 | Tax $0
Seat 1: f2e82cf4 (button) folded before Flop (didn't bet)
Seat 2: 16081ce9 (small blind) folded before Flop
Seat 3: c7e9103c (big blind) collected ($0.04)
Seat 4: 2dba12ed folded before Flop (didn't bet)
Seat 5: 194ee370 folded before Flop (didn't bet)
Seat 6: Hero folded before Flop (didn't bet)


Poker Hand #RC3334439665: Hold'em No Limit ($0.02/$0.05) - 2025/02/17 20:40:26
Table 'RushAndCash604925' 6-max Seat #1 is the button
Seat 1: 711af4a4 ($5.77 in chips)
Seat 2: d0475ba7 ($7.36 in chips)
Seat 3: f16cf89a ($5.12 in chips)
Seat 4: Hero ($5 in chips)
Seat 5: 52f43d28 ($7.51 in chips)
Seat 6: e95b4a35 ($4.12 in chips)
d0475ba7: posts small blind $0.02
f16cf89a: posts big blind $0.05
*** HOLE CARDS ***
Dealt to 711af4a4 
Dealt to d0475ba7 
Dealt to f16cf89a 
Dealt to Hero [8h 2s]
Dealt to 52f43d28 
Dealt to e95b4a35 
Hero: folds
52f43d28: folds
e95b4a35: folds
711af4a4: raises $0.09 to $0.14
d0475ba7: calls $0.12
f16cf89a: folds
*** FLOP *** [Js Kh 6c]
d0475ba7: checks
711af4a4: checks
*** TURN *** [Js Kh 6c] [7s]
d0475ba7: bets $0.05
711af4a4: calls $0.05
*** RIVER *** [Js Kh 6c 7s] [Qc]
d0475ba7: checks
711af4a4: bets $0.1
d0475ba7: folds
Uncalled bet ($0.1) returned to 711af4a4
*** SHOWDOWN ***
711af4a4 collected $0.41 from pot
*** SUMMARY ***
Total pot $0.43 | Rake $0.02 | Jackpot $0 | Bingo $0 | Fortune $0 | Tax $0
Board [Js Kh 6c 7s Qc]
Seat 1: 711af4a4 (button) won ($0.41)
Seat 2: d0475ba7 (small blind) folded on the River
Seat 3: f16cf89a (big blind) folded before Flop
Seat 4: Hero folded before Flop (didn't bet)
Seat 5: 52f43d28 folded before Flop (didn't bet)
Seat 6: e95b4a35 folded before Flop (didn't bet)


Poker Hand #RC3334439642: Hold'em No Limit ($0.02/$0.05) - 2025/02/17 20:40:23
Table 'RushAndCash604902' 6-max Seat #1 is the button
Seat 1: 7b6a3077 ($7.26 in chips)
Seat 2: f43eaf15 ($8.07 in chips)
Seat 3: 54884390 ($5.31 in chips)
Seat 4: 929700a0 ($8.58 in chips)
Seat 5: 14d966a6 ($5.01 in chips)
Seat 6: Hero ($5 in chips)
f43eaf15: posts small blind $0.02
54884390: posts big blind $0.05
*** HOLE CARDS ***
Dealt to 7b6a3077 
Dealt to f43eaf15 
Dealt to 54884390 
Dealt to 929700a0 
Dealt to 14d966a6 
Dealt to Hero [3d Qh]
929700a0: folds
14d966a6: folds
Hero: folds
7b6a3077: folds
f43eaf15: folds
Uncalled bet ($0.03) returned to 54884390
*** SHOWDOWN ***
54884390 collected $0.04 from pot
*** SUMMARY ***
Total pot $0.04 | Rake $0 | Jackpot $0 | Bingo $0 | Fortune $0 | Tax $0
Seat 1: 7b6a3077 (button) folded before Flop (didn't bet)
Seat 2: f43eaf15 (small blind) folded before Flop
Seat 3: 54884390 (big blind) collected ($0.04)
Seat 4: 929700a0 folded before Flop (didn't bet)
Seat 5: 14d966a6 folded before Flop (didn't bet)
Seat 6: Hero folded before Flop (didn't bet)


Poker Hand #RC3334439620: Hold'em No Limit ($0.02/$0.05) - 2025/02/17 20:40:20
Table 'RushAndCash604880' 6-max Seat #1 is the button
Seat 1: Hero ($5 in chips)
Seat 2: 84b68722 ($18.32 in chips)
Seat 3: ded3640 ($5.07 in chips)
Seat 4: 43a6133a ($4.98 in chips)
Seat 5: 6339ee1d ($5.43 in chips)
Seat 6: a223d3ca ($5.35 in chips)
84b68722: posts small blind $0.02
ded3640: posts big blind $0.05
*** HOLE CARDS ***
Dealt to Hero [Qh 3c]
Dealt to 84b68722 
Dealt to ded3640 
Dealt to 43a6133a 
Dealt to 6339ee1d 
Dealt to a223d3ca 
43a6133a: folds
6339ee1d: folds
a223d3ca: folds
Hero: folds
84b68722: calls $0.03
ded3640: checks
*** FLOP *** [2c 8h 8d]
84b68722: bets $0.05
ded3640: calls $0.05
*** TURN *** [2c 8h 8d] [Tc]
84b68722: bets $0.12
ded3640: calls $0.12
*** RIVER *** [2c 8h 8d Tc] [Jh]
84b68722: bets $0.25
ded3640: raises $0.53 to $0.78
84b68722: raises $2.5 to $3.28
ded3640: folds
Uncalled bet ($2.5) returned to 84b68722
*** SHOWDOWN ***
84b68722 collected $1.84 from pot
*** SUMMARY ***
Total pot $2 | Rake $0.09 | Jackpot $0.07 | Bingo $0 | Fortune $0 | Tax $0
Board [2c 8h 8d Tc Jh]
Seat 1: Hero (button) folded before Flop (didn't bet)
Seat 2: 84b68722 (small blind) won ($1.84)
Seat 3: ded3640 (big blind) folded on the River
Seat 4: 43a6133a folded before Flop (didn't bet)
Seat 5: 6339ee1d folded before Flop (didn't bet)
Seat 6: a223d3ca folded before Flop (didn't bet)


Poker Hand #RC3334439593: Hold'em No Limit ($0.02/$0.05) - 2025/02/17 20:40:16
Table 'RushAndCash604853' 6-max Seat #1 is the button
Seat 1: 1f187ba0 ($4.9 in chips)
Seat 2: c6158c9d ($7.03 in chips)
Seat 3: Hero ($5.05 in chips)
Seat 4: dbf5f543 ($5.02 in chips)
Seat 5: 23619adf ($5.07 in chips)
Seat 6: c5f53436 ($7.58 in chips)
c6158c9d: posts small blind $0.02
Hero: posts big blind $0.05
*** HOLE CARDS ***
Dealt to 1f187ba0 
Dealt to c6158c9d 
Dealt to Hero [3c As]
Dealt to dbf5f543 
Dealt to 23619adf 
Dealt to c5f53436 
dbf5f543: folds
23619adf: folds
c5f53436: folds
1f187ba0: folds
c6158c9d: calls $0.03
Hero: checks
*** FLOP *** [9s 4d Jc]
c6158c9d: bets $0.05
Hero: folds
Uncalled bet ($0.05) returned to c6158c9d
*** SHOWDOWN ***
c6158c9d collected $0.1 from pot
*** SUMMARY ***
Total pot $0.1 | Rake $0 | Jackpot $0 | Bingo $0 | Fortune $0 | Tax $0
Board [9s 4d Jc]
Seat 1: 1f187ba0 (button) folded before Flop (didn't bet)
Seat 2: c6158c9d (small blind) won ($0.1)
Seat 3: Hero (big blind) folded on the Flop
Seat 4: dbf5f543 folded before Flop (didn't bet)
Seat 5: 23619adf folded before Flop (didn't bet)
Seat 6: c5f53436 folded before Flop (didn't bet)


Poker Hand #RC3334439564: Hold'em No Limit ($0.02/$0.05) - 2025/02/17 20:40:12
Table 'RushAndCash604824' 6-max Seat #1 is the button
Seat 1: 94706c35 ($14.76 in chips)
Seat 2: Hero ($5.07 in chips)
Seat 3: 9135e49d ($5.93 in chips)
Seat 4: 902b47de ($5 in chips)
Seat 5: 23619adf ($5.07 in chips)
Seat 6: b64a83d ($7.45 in chips)
Hero: posts small blind $0.02
9135e49d: posts big blind $0.05
*** HOLE CARDS ***
Dealt to 94706c35 
Dealt to Hero [Jc 6s]
Dealt to 9135e49d 
Dealt to 902b47de 
Dealt to 23619adf 
Dealt to b64a83d 
902b47de: folds
23619adf: folds
b64a83d: raises $0.05 to $0.1
94706c35: folds
Hero: folds
9135e49d: calls $0.05
*** FLOP *** [Ah 9d 2d]
9135e49d: checks
b64a83d: bets $0.05
9135e49d: folds
Uncalled bet ($0.05) returned to b64a83d
*** SHOWDOWN ***
b64a83d collected $0.21 from pot
*** SUMMARY ***
Total pot $0.22 | Rake $0.01 | Jackpot $0 | Bingo $0 | Fortune $0 | Tax $0
Board [Ah 9d 2d]
Seat 1: 94706c35 (button) folded before Flop (didn't bet)
Seat 2: Hero (small blind) folded before Flop
Seat 3: 9135e49d (big blind) folded on the Flop
Seat 4: 902b47de folded before Flop (didn't bet)
Seat 5: 23619adf folded before Flop (didn't bet)
Seat 6: b64a83d won ($0.21)


Poker Hand #RC3334439523: Hold'em No Limit ($0.02/$0.05) - 2025/02/17 20:40:06
Table 'RushAndCash604783' 6-max Seat #1 is the button
Seat 1: 1ce64dd8 ($4.49 in chips)
Seat 2: 84667b37 ($4.76 in chips)
Seat 3: 14620cce ($16.26 in chips)
Seat 4: e813a51e ($2.54 in chips)
Seat 5: Hero ($5.07 in chips)
Seat 6: 677c4b25 ($5.64 in chips)
84667b37: posts small blind $0.02
14620cce: posts big blind $0.05
*** HOLE CARDS ***
Dealt to 1ce64dd8 
Dealt to 84667b37 
Dealt to 14620cce 
Dealt to e813a51e 
Dealt to Hero [6d Ks]
Dealt to 677c4b25 
e813a51e: folds
Hero: folds
677c4b25: folds
1ce64dd8: folds
84667b37: raises $0.05 to $0.1
14620cce: folds
Uncalled bet ($0.05) returned to 84667b37
*** SHOWDOWN ***
84667b37 collected $0.1 from pot
*** SUMMARY ***
Total pot $0.1 | Rake $0 | Jackpot $0 | Bingo $0 | Fortune $0 | Tax $0
Seat 1: 1ce64dd8 (button) folded before Flop (didn't bet)
Seat 2: 84667b37 (small blind) collected ($0.1)
Seat 3: 14620cce (big blind) folded before Flop
Seat 4: e813a51e folded before Flop (didn't bet)
Seat 5: Hero folded before Flop (didn't bet)
Seat 6: 677c4b25 folded before Flop (didn't bet)


Poker Hand #RC3334439424: Hold'em No Limit ($0.02/$0.05) - 2025/02/17 20:39:51
Table 'RushAndCash604684' 6-max Seat #1 is the button
Seat 1: 4e55fa29 ($4.25 in chips)
Seat 2: 868521d5 ($5 in chips)
Seat 3: 16081ce9 ($15.33 in chips)
Seat 4: d58b99ca ($13.56 in chips)
Seat 5: b3de874e ($5.11 in chips)
Seat 6: Hero ($5.07 in chips)
868521d5: posts small blind $0.02
16081ce9: posts big blind $0.05
*** HOLE CARDS ***
Dealt to 4e55fa29 
Dealt to 868521d5 
Dealt to 16081ce9 
Dealt to d58b99ca 
Dealt to b3de874e 
Dealt to Hero [Jc 9h]
d58b99ca: folds
b3de874e: raises $0.05 to $0.1
Hero: folds
4e55fa29: folds
868521d5: folds
16081ce9: folds
Uncalled bet ($0.05) returned to b3de874e
*** SHOWDOWN ***
b3de874e collected $0.12 from pot
*** SUMMARY ***
Total pot $0.12 | Rake $0 | Jackpot $0 | Bingo $0 | Fortune $0 | Tax $0
Seat 1: 4e55fa29 (button) folded before Flop (didn't bet)
Seat 2: 868521d5 (small blind) folded before Flop
Seat 3: 16081ce9 (big blind) folded before Flop
Seat 4: d58b99ca folded before Flop (didn't bet)
Seat 5: b3de874e collected ($0.12)
Seat 6: Hero folded before Flop (didn't bet)


Poker Hand #RC3334439401: Hold'em No Limit ($0.02/$0.05) - 2025/02/17 20:39:48
Table 'RushAndCash604661' 6-max Seat #1 is the button
Seat 1: 86768906 ($9.95 in chips)
Seat 2: 929700a0 ($8.65 in chips)
Seat 3: 98fa8579 ($5.26 in chips)
Seat 4: Hero ($5.07 in chips)
Seat 5: 8dbd0a2d ($5.12 in chips)
Seat 6: 4190d158 ($11.21 in chips)
929700a0: posts small blind $0.02
98fa8579: posts big blind $0.05
*** HOLE CARDS ***
Dealt to 86768906 
Dealt to 929700a0 
Dealt to 98fa8579 
Dealt to Hero [Ts Qd]
Dealt to 8dbd0a2d 
Dealt to 4190d158 
Hero: folds
8dbd0a2d: folds
4190d158: folds
86768906: folds
929700a0: folds
Uncalled bet ($0.03) returned to 98fa8579
*** SHOWDOWN ***
98fa8579 collected $0.04 from pot
*** SUMMARY ***
Total pot $0.04 | Rake $0 | Jackpot $0 | Bingo $0 | Fortune $0 | Tax $0
Seat 1: 86768906 (button) folded before Flop (didn't bet)
Seat 2: 929700a0 (small blind) folded before Flop
Seat 3: 98fa8579 (big blind) collected ($0.04)
Seat 4: Hero folded before Flop (didn't bet)
Seat 5: 8dbd0a2d folded before Flop (didn't bet)
Seat 6: 4190d158 folded before Flop (didn't bet)


Poker Hand #RC3334439233: Hold'em No Limit ($0.02/$0.05) - 2025/02/17 20:39:24
Table 'RushAndCash604493' 6-max Seat #1 is the button
Seat 1: a28ca95c ($19.61 in chips)
Seat 2: 6c8cb957 ($5.39 in chips)
Seat 3: 229ec9a7 ($5.17 in chips)
Seat 4: c59158f3 ($9.72 in chips)
Seat 5: e72c7748 ($9.27 in chips)
Seat 6: Hero ($5 in chips)
6c8cb957: posts small blind $0.02
229ec9a7: posts big blind $0.05
*** HOLE CARDS ***
Dealt to a28ca95c 
Dealt to 6c8cb957 
Dealt to 229ec9a7 
Dealt to c59158f3 
Dealt to e72c7748 
Dealt to Hero [Ad 3d]
c59158f3: folds
e72c7748: folds
Hero: raises $0.05 to $0.1
a28ca95c: folds
6c8cb957: folds
229ec9a7: folds
Uncalled bet ($0.05) returned to Hero
*** SHOWDOWN ***
Hero collected $0.12 from pot
*** SUMMARY ***
Total pot $0.12 | Rake $0 | Jackpot $0 | Bingo $0 | Fortune $0 | Tax $0
Seat 1: a28ca95c (button) folded before Flop (didn't bet)
Seat 2: 6c8cb957 (small blind) folded before Flop
Seat 3: 229ec9a7 (big blind) folded before Flop
Seat 4: c59158f3 folded before Flop (didn't bet)
Seat 5: e72c7748 folded before Flop (didn't bet)
Seat 6: Hero collected ($0.12)


Poker Hand #RC3334439205: Hold'em No Limit ($0.02/$0.05) - 2025/02/17 20:39:21
Table 'RushAndCash604465' 6-max Seat #1 is the button
Seat 1: 5b91a195 ($12.02 in chips)
Seat 2: c11c2441 ($5.09 in chips)
Seat 3: Hero ($5 in chips)
Seat 4: c59158f3 ($9.72 in chips)
Seat 5: fa40c39c ($5.42 in chips)
Seat 6: e72c7748 ($9.27 in chips)
c11c2441: posts small blind $0.02
Hero: posts big blind $0.05
*** HOLE CARDS ***
Dealt to 5b91a195 
Dealt to c11c2441 
Dealt to Hero [7h 8c]
Dealt to c59158f3 
Dealt to fa40c39c 
Dealt to e72c7748 
c59158f3: folds
fa40c39c: raises $0.06 to $0.11
e72c7748: folds
5b91a195: folds
c11c2441: folds
Hero: folds
Uncalled bet ($0.06) returned to fa40c39c
*** SHOWDOWN ***
fa40c39c collected $0.12 from pot
*** SUMMARY ***
Total pot $0.12 | Rake $0 | Jackpot $0 | Bingo $0 | Fortune $0 | Tax $0
Seat 1: 5b91a195 (button) folded before Flop (didn't bet)
Seat 2: c11c2441 (small blind) folded before Flop
Seat 3: Hero (big blind) folded before Flop
Seat 4: c59158f3 folded before Flop (didn't bet)
Seat 5: fa40c39c collected ($0.12)
Seat 6: e72c7748 folded before Flop (didn't bet)


Poker Hand #RC3334439179: Hold'em No Limit ($0.02/$0.05) - 2025/02/17 20:39:17
Table 'RushAndCash604439' 6-max Seat #1 is the button
Seat 1: 1095926a ($5 in chips)
Seat 2: Hero ($5 in chips)
Seat 3: f71501ed ($5.49 in chips)
Seat 4: 8c1b0cdf ($2.39 in chips)
Seat 5: db6d28b7 ($5 in chips)
Seat 6: daaf4280 ($4.99 in chips)
Hero: posts small blind $0.02
f71501ed: posts big blind $0.05
*** HOLE CARDS ***
Dealt to 1095926a 
Dealt to Hero [Kc 9c]
Dealt to f71501ed 
Dealt to 8c1b0cdf 
Dealt to db6d28b7 
Dealt to daaf4280 
8c1b0cdf: folds
db6d28b7: raises $0.05 to $0.1
daaf4280: folds
1095926a: folds
Hero: folds
f71501ed: calls $0.05
*** FLOP *** [3d 7d 2h]
f71501ed: checks
db6d28b7: checks
*** TURN *** [3d 7d 2h] [Jh]
f71501ed: bets $0.11
db6d28b7: raises $0.22 to $0.33
f71501ed: folds
Uncalled bet ($0.22) returned to db6d28b7
*** SHOWDOWN ***
db6d28b7 collected $0.42 from pot
*** SUMMARY ***
Total pot $0.44 | Rake $0.02 | Jackpot $0 | Bingo $0 | Fortune $0 | Tax $0
Board [3d 7d 2h Jh]
Seat 1: 1095926a (button) folded before Flop (didn't bet)
Seat 2: Hero (small blind) folded before Flop
Seat 3: f71501ed (big blind) folded on the Turn
Seat 4: 8c1b0cdf folded before Flop (didn't bet)
Seat 5: db6d28b7 won ($0.42)
Seat 6: daaf4280 folded before Flop (didn't bet)


Poker Hand #RC3334439150: Hold'em No Limit ($0.02/$0.05) - 2025/02/17 20:39:14
Table 'RushAndCash604410' 6-max Seat #1 is the button
Seat 1: 6a231779 ($8.89 in chips)
Seat 2: 99af2b58 ($15.13 in chips)
Seat 3: 570c97fe ($6.8 in chips)
Seat 4: 491e0e63 ($5 in chips)
Seat 5: 4264790d ($5.17 in chips)
Seat 6: Hero ($5 in chips)
99af2b58: posts small blind $0.02
570c97fe: posts big blind $0.05
*** HOLE CARDS ***
Dealt to 6a231779 
Dealt to 99af2b58 
Dealt to 570c97fe 
Dealt to 491e0e63 
Dealt to 4264790d 
Dealt to Hero [3h 4s]
491e0e63: folds
4264790d: folds
Hero: folds
6a231779: raises $0.05 to $0.1
99af2b58: folds
570c97fe: folds
Uncalled bet ($0.05) returned to 6a231779
*** SHOWDOWN ***
6a231779 collected $0.12 from pot
*** SUMMARY ***
Total pot $0.12 | Rake $0 | Jackpot $0 | Bingo $0 | Fortune $0 | Tax $0
Seat 1: 6a231779 (button) collected ($0.12)
Seat 2: 99af2b58 (small blind) folded before Flop
Seat 3: 570c97fe (big blind) folded before Flop
Seat 4: 491e0e63 folded before Flop (didn't bet)
Seat 5: 4264790d folded before Flop (didn't bet)
Seat 6: Hero folded before Flop (didn't bet)


Poker Hand #RC3334439114: Hold'em No Limit ($0.02/$0.05) - 2025/02/17 20:39:09
Table 'RushAndCash604374' 6-max Seat #1 is the button
Seat 1: f83d0c9c ($6.88 in chips)
Seat 2: Hero ($5 in chips)
Seat 3: 157631a0 ($6.36 in chips)
Seat 4: cbfd6c92 ($4.48 in chips)
Seat 5: 2c7878da ($4.9 in chips)
Seat 6: c607d475 ($9.18 in chips)
Hero: posts small blind $0.02
157631a0: posts big blind $0.05
*** HOLE CARDS ***
Dealt to f83d0c9c 
Dealt to Hero [6h 8h]
Dealt to 157631a0 
Dealt to cbfd6c92 
Dealt to 2c7878da 
Dealt to c607d475 
cbfd6c92: folds
2c7878da: folds
c607d475: folds
f83d0c9c: folds
Hero: folds
Uncalled bet ($0.03) returned to 157631a0
*** SHOWDOWN ***
157631a0 collected $0.04 from pot
*** SUMMARY ***
Total pot $0.04 | Rake $0 | Jackpot $0 | Bingo $0 | Fortune $0 | Tax $0
Seat 1: f83d0c9c (button) folded before Flop (didn't bet)
Seat 2: Hero (small blind) folded before Flop
Seat 3: 157631a0 (big blind) collected ($0.04)
Seat 4: cbfd6c92 folded before Flop (didn't bet)
Seat 5: 2c7878da folded before Flop (didn't bet)
Seat 6: c607d475 folded before Flop (didn't bet)


Poker Hand #RC3334439082: Hold'em No Limit ($0.02/$0.05) - 2025/02/17 20:39:06
Table 'RushAndCash604342' 6-max Seat #1 is the button
Seat 1: 7da8a368 ($5 in chips)
Seat 2: 929700a0 ($8.6 in chips)
Seat 3: Hero ($5 in chips)
Seat 4: 773fdf96 ($5.4 in chips)
Seat 5: cd1f87c8 ($4.07 in chips)
Seat 6: 717e9861 ($5 in chips)
929700a0: posts small blind $0.02
Hero: posts big blind $0.05
*** HOLE CARDS ***
Dealt to 7da8a368 
Dealt to 929700a0 
Dealt to Hero [Jd 3d]
Dealt to 773fdf96 
Dealt to cd1f87c8 
Dealt to 717e9861 
773fdf96: folds
cd1f87c8: folds
717e9861: folds
7da8a368: folds
929700a0: calls $0.03
Hero: checks
*** FLOP *** [4s 2s 9s]
929700a0: checks
Hero: checks
*** TURN *** [4s 2s 9s] [6h]
929700a0: checks
Hero: checks
*** RIVER *** [4s 2s 9s 6h] [2h]
929700a0: checks
Hero: checks
929700a0: shows [7h 4d] (Pair of Fours and Pair of Twos)
Hero: shows [Jd 3d] (Pair of Twos)
*** SHOWDOWN ***
929700a0 collected $0.1 from pot
*** SUMMARY ***
Total pot $0.1 | Rake $0 | Jackpot $0 | Bingo $0 | Fortune $0 | Tax $0
Board [4s 2s 9s 6h 2h]
Seat 1: 7da8a368 (button) folded before Flop (didn't bet)
Seat 2: 929700a0 (small blind) showed [7h 4d] and won ($0.1) with Pair of Fours and Pair of Twos
Seat 3: Hero (big blind) showed [Jd 3d] and lost with Pair of Twos
Seat 4: 773fdf96 folded before Flop (didn't bet)
Seat 5: cd1f87c8 folded before Flop (didn't bet)
Seat 6: 717e9861 folded before Flop (didn't bet)


Poker Hand #RC3334439050: Hold'em No Limit ($0.02/$0.05) - 2025/02/17 20:39:01
Table 'RushAndCash604310' 6-max Seat #1 is the button
Seat 1: 86768906 ($10.05 in chips)
Seat 2: d75cab93 ($5 in chips)
Seat 3: 6191b99d ($2.7 in chips)
Seat 4: c096c24 ($5 in chips)
Seat 5: Hero ($5 in chips)
Seat 6: 1696890b ($4.28 in chips)
d75cab93: posts small blind $0.02
6191b99d: posts big blind $0.05
*** HOLE CARDS ***
Dealt to 86768906 
Dealt to d75cab93 
Dealt to 6191b99d 
Dealt to c096c24 
Dealt to Hero [9d 5c]
Dealt to 1696890b 
c096c24: folds
Hero: folds
1696890b: folds
86768906: raises $0.05 to $0.1
d75cab93: folds
6191b99d: raises $2.6 to $2.7 and is all-in
86768906: folds
Uncalled bet ($2.6) returned to 6191b99d
*** SHOWDOWN ***
6191b99d collected $0.21 from pot
*** SUMMARY ***
Total pot $0.22 | Rake $0.01 | Jackpot $0 | Bingo $0 | Fortune $0 | Tax $0
Seat 1: 86768906 (button) folded before Flop
Seat 2: d75cab93 (small blind) folded before Flop
Seat 3: 6191b99d (big blind) collected ($0.21)
Seat 4: c096c24 folded before Flop (didn't bet)
Seat 5: Hero folded before Flop (didn't bet)
Seat 6: 1696890b folded before Flop (didn't bet)


Poker Hand #RC3334439014: Hold'em No Limit ($0.02/$0.05) - 2025/02/17 20:38:57
Table 'RushAndCash604274' 6-max Seat #1 is the button
Seat 1: Hero ($5 in chips)
Seat 2: 4264790d ($5.19 in chips)
Seat 3: cd1f87c8 ($4.12 in chips)
Seat 4: dc257e7 ($4.94 in chips)
Seat 5: aac5b60f ($4.54 in chips)
Seat 6: c1784884 ($8.57 in chips)
4264790d: posts small blind $0.02
cd1f87c8: posts big blind $0.05
*** HOLE CARDS ***
Dealt to Hero [Td 7s]
Dealt to 4264790d 
Dealt to cd1f87c8 
Dealt to dc257e7 
Dealt to aac5b60f 
Dealt to c1784884 
dc257e7: folds
aac5b60f: folds
c1784884: raises $0.1 to $0.15
Hero: folds
4264790d: folds
cd1f87c8: folds
Uncalled bet ($0.1) returned to c1784884
*** SHOWDOWN ***
c1784884 collected $0.12 from pot
*** SUMMARY ***
Total pot $0.12 | Rake $0 | Jackpot $0 | Bingo $0 | Fortune $0 | Tax $0
Seat 1: Hero (button) folded before Flop (didn't bet)
Seat 2: 4264790d (small blind) folded before Flop
Seat 3: cd1f87c8 (big blind) folded before Flop
Seat 4: dc257e7 folded before Flop (didn't bet)
Seat 5: aac5b60f folded before Flop (didn't bet)
Seat 6: c1784884 collected ($0.12)


Poker Hand #RC3334438988: Hold'em No Limit ($0.02/$0.05) - 2025/02/17 20:38:54
Table 'RushAndCash604248' 6-max Seat #1 is the button
Seat 1: Hero ($5 in chips)
Seat 2: b45daa8e ($3.52 in chips)
Seat 3: f8db84a ($6.2 in chips)
Seat 4: b4b34357 ($5 in chips)
Seat 5: fcc3c3cc ($8.35 in chips)
Seat 6: f108945f ($5.26 in chips)
b45daa8e: posts small blind $0.02
f8db84a: posts big blind $0.05
*** HOLE CARDS ***
Dealt to Hero [Ks 5d]
Dealt to b45daa8e 
Dealt to f8db84a 
Dealt to b4b34357 
Dealt to fcc3c3cc 
Dealt to f108945f 
b4b34357: folds
fcc3c3cc: folds
f108945f: folds
Hero: folds
b45daa8e: raises $0.07 to $0.12
f8db84a: folds
Uncalled bet ($0.07) returned to b45daa8e
*** SHOWDOWN ***
b45daa8e collected $0.1 from pot
*** SUMMARY ***
Total pot $0.1 | Rake $0 | Jackpot $0 | Bingo $0 | Fortune $0 | Tax $0
Seat 1: Hero (button) folded before Flop (didn't bet)
Seat 2: b45daa8e (small blind) collected ($0.1)
Seat 3: f8db84a (big blind) folded before Flop
Seat 4: b4b34357 folded before Flop (didn't bet)
Seat 5: fcc3c3cc folded before Flop (didn't bet)
Seat 6: f108945f folded before Flop (didn't bet)


Poker Hand #RC3334438959: Hold'em No Limit ($0.02/$0.05) - 2025/02/17 20:38:51
Table 'RushAndCash604219' 6-max Seat #1 is the button
Seat 1: fbb9d8f2 ($4.86 in chips)
Seat 2: ead6cfaf ($5.14 in chips)
Seat 3: f02d4645 ($10.12 in chips)
Seat 4: 38d2fc1e ($5.65 in chips)
Seat 5: 38ef00 ($1.55 in chips)
Seat 6: Hero ($5 in chips)
ead6cfaf: posts small blind $0.02
f02d4645: posts big blind $0.05
*** HOLE CARDS ***
Dealt to fbb9d8f2 
Dealt to ead6cfaf 
Dealt to f02d4645 
Dealt to 38d2fc1e 
Dealt to 38ef00 
Dealt to Hero [3c Kh]
38d2fc1e: folds
38ef00: folds
Hero: folds
fbb9d8f2: folds
ead6cfaf: folds
Uncalled bet ($0.03) returned to f02d4645
*** SHOWDOWN ***
f02d4645 collected $0.04 from pot
*** SUMMARY ***
Total pot $0.04 | Rake $0 | Jackpot $0 | Bingo $0 | Fortune $0 | Tax $0
Seat 1: fbb9d8f2 (button) folded before Flop (didn't bet)
Seat 2: ead6cfaf (small blind) folded before Flop
Seat 3: f02d4645 (big blind) collected ($0.04)
Seat 4: 38d2fc1e folded before Flop (didn't bet)
Seat 5: 38ef00 folded before Flop (didn't bet)
Seat 6: Hero folded before Flop (didn't bet)


Poker Hand #RC3334438935: Hold'em No Limit ($0.02/$0.05) - 2025/02/17 20:38:47
Table 'RushAndCash604195' 6-max Seat #1 is the button
Seat 1: 4db54282 ($5 in chips)
Seat 2: 675a7b76 ($7.7 in chips)
Seat 3: 64b39229 ($5.19 in chips)
Seat 4: 38ef00 ($1.55 in chips)
Seat 5: Hero ($5 in chips)
Seat 6: 65ca9276 ($7.61 in chips)
675a7b76: posts small blind $0.02
64b39229: posts big blind $0.05
*** HOLE CARDS ***
Dealt to 4db54282 
Dealt to 675a7b76 
Dealt to 64b39229 
Dealt to 38ef00 
Dealt to Hero [4h 7c]
Dealt to 65ca9276 
38ef00: folds
Hero: folds
65ca9276: folds
4db54282: raises $0.05 to $0.1
675a7b76: folds
64b39229: calls $0.05
*** FLOP *** [As Qs Ac]
64b39229: checks
4db54282: bets $0.05
64b39229: folds
Uncalled bet ($0.05) returned to 4db54282
*** SHOWDOWN ***
4db54282 collected $0.21 from pot
*** SUMMARY ***
Total pot $0.22 | Rake $0.01 | Jackpot $0 | Bingo $0 | Fortune $0 | Tax $0
Board [As Qs Ac]
Seat 1: 4db54282 (button) won ($0.21)
Seat 2: 675a7b76 (small blind) folded before Flop
Seat 3: 64b39229 (big blind) folded on the Flop
Seat 4: 38ef00 folded before Flop (didn't bet)
Seat 5: Hero folded before Flop (didn't bet)
Seat 6: 65ca9276 folded before Flop (didn't bet)


Poker Hand #RC3334438897: Hold'em No Limit ($0.02/$0.05) - 2025/02/17 20:38:43
Table 'RushAndCash604157' 6-max Seat #1 is the button
Seat 1: c3c40ffa ($5.38 in chips)
Seat 2: 5fe62400 ($5 in chips)
Seat 3: 650e9dc7 ($5.65 in chips)
Seat 4: 9f70f94d ($5.48 in chips)
Seat 5: 14d966a6 ($5 in chips)
Seat 6: Hero ($5 in chips)
5fe62400: posts small blind $0.02
650e9dc7: posts big blind $0.05
*** HOLE CARDS ***
Dealt to c3c40ffa 
Dealt to 5fe62400 
Dealt to 650e9dc7 
Dealt to 9f70f94d 
Dealt to 14d966a6 
Dealt to Hero [9c 6h]
9f70f94d: folds
14d966a6: folds
Hero: folds
c3c40ffa: folds
5fe62400: folds
Uncalled bet ($0.03) returned to 650e9dc7
*** SHOWDOWN ***
650e9dc7 collected $0.04 from pot
*** SUMMARY ***
Total pot $0.04 | Rake $0 | Jackpot $0 | Bingo $0 | Fortune $0 | Tax $0
Seat 1: c3c40ffa (button) folded before Flop (didn't bet)
Seat 2: 5fe62400 (small blind) folded before Flop
Seat 3: 650e9dc7 (big blind) collected ($0.04)
Seat 4: 9f70f94d folded before Flop (didn't bet)
Seat 5: 14d966a6 folded before Flop (didn't bet)
Seat 6: Hero folded before Flop (didn't bet)


Poker Hand #RC3334438640: Hold'em No Limit ($0.02/$0.05) - 2025/02/17 20:38:08
Table 'RushAndCash603900' 6-max Seat #1 is the button
Seat 1: 868c7021 ($3.69 in chips)
Seat 2: b0ee20aa ($21.78 in chips)
Seat 3: Hero ($5.05 in chips)
Seat 4: 66be2112 ($5.58 in chips)
Seat 5: 38d2fc1e ($5.65 in chips)
Seat 6: 7b0e5cb2 ($5.32 in chips)
b0ee20aa: posts small blind $0.02
Hero: posts big blind $0.05
*** HOLE CARDS ***
Dealt to 868c7021 
Dealt to b0ee20aa 
Dealt to Hero [5d 3d]
Dealt to 66be2112 
Dealt to 38d2fc1e 
Dealt to 7b0e5cb2 
66be2112: folds
38d2fc1e: folds
7b0e5cb2: raises $0.07 to $0.12
868c7021: folds
b0ee20aa: folds
Hero: calls $0.07
*** FLOP *** [Qd Js 3s]
Hero: checks
7b0e5cb2: bets $0.13
Hero: calls $0.13
*** TURN *** [Qd Js 3s] [9h]
Hero: checks
7b0e5cb2: bets $0.39
Hero: folds
Uncalled bet ($0.39) returned to 7b0e5cb2
*** SHOWDOWN ***
7b0e5cb2 collected $0.5 from pot
*** SUMMARY ***
Total pot $0.52 | Rake $0.02 | Jackpot $0 | Bingo $0 | Fortune $0 | Tax $0
Board [Qd Js 3s 9h]
Seat 1: 868c7021 (button) folded before Flop (didn't bet)
Seat 2: b0ee20aa (small blind) folded before Flop
Seat 3: Hero (big blind) folded on the Turn
Seat 4: 66be2112 folded before Flop (didn't bet)
Seat 5: 38d2fc1e folded before Flop (didn't bet)
Seat 6: 7b0e5cb2 won ($0.5)


Poker Hand #RC3334438618: Hold'em No Limit ($0.02/$0.05) - 2025/02/17 20:38:05
Table 'RushAndCash603878' 6-max Seat #1 is the button
Seat 1: ec1d0d44 ($11.19 in chips)
Seat 2: Hero ($5.07 in chips)
Seat 3: 64542a04 ($5 in chips)
Seat 4: fd5d7bbe ($2.33 in chips)
Seat 5: 9931beba ($4.97 in chips)
Seat 6: 130fc8d7 ($16.52 in chips)
Hero: posts small blind $0.02
64542a04: posts big blind $0.05
*** HOLE CARDS ***
Dealt to ec1d0d44 
Dealt to Hero [3s 8h]
Dealt to 64542a04 
Dealt to fd5d7bbe 
Dealt to 9931beba 
Dealt to 130fc8d7 
fd5d7bbe: folds
9931beba: folds
130fc8d7: folds
ec1d0d44: folds
Hero: folds
Uncalled bet ($0.03) returned to 64542a04
*** SHOWDOWN ***
64542a04 collected $0.04 from pot
*** SUMMARY ***
Total pot $0.04 | Rake $0 | Jackpot $0 | Bingo $0 | Fortune $0 | Tax $0
Seat 1: ec1d0d44 (button) folded before Flop (didn't bet)
Seat 2: Hero (small blind) folded before Flop
Seat 3: 64542a04 (big blind) collected ($0.04)
Seat 4: fd5d7bbe folded before Flop (didn't bet)
Seat 5: 9931beba folded before Flop (didn't bet)
Seat 6: 130fc8d7 folded before Flop (didn't bet)


Poker Hand #RC3334438594: Hold'em No Limit ($0.02/$0.05) - 2025/02/17 20:38:02
Table 'RushAndCash603854' 6-max Seat #1 is the button
Seat 1: Hero ($5.07 in chips)
Seat 2: b21ced79 ($5 in chips)
Seat 3: 577aa3d3 ($4.46 in chips)
Seat 4: 2c7878da ($4.92 in chips)
Seat 5: 194ee370 ($4.95 in chips)
Seat 6: 71e00d83 ($11.74 in chips)
b21ced79: posts small blind $0.02
577aa3d3: posts big blind $0.05
*** HOLE CARDS ***
Dealt to Hero [2c Td]
Dealt to b21ced79 
Dealt to 577aa3d3 
Dealt to 2c7878da 
Dealt to 194ee370 
Dealt to 71e00d83 
2c7878da: folds
194ee370: raises $0.1 to $0.15
71e00d83: calls $0.15
Hero: folds
b21ced79: folds
577aa3d3: folds
*** FLOP *** [6h Jd 7d]
194ee370: checks
71e00d83: bets $0.13
194ee370: folds
Uncalled bet ($0.13) returned to 71e00d83
*** SHOWDOWN ***
71e00d83 collected $0.36 from pot
*** SUMMARY ***
Total pot $0.37 | Rake $0.01 | Jackpot $0 | Bingo $0 | Fortune $0 | Tax $0
Board [6h Jd 7d]
Seat 1: Hero (button) folded before Flop (didn't bet)
Seat 2: b21ced79 (small blind) folded before Flop
Seat 3: 577aa3d3 (big blind) folded before Flop
Seat 4: 2c7878da folded before Flop (didn't bet)
Seat 5: 194ee370 folded on the Flop
Seat 6: 71e00d83 won ($0.36)


Poker Hand #RC3334438568: Hold'em No Limit ($0.02/$0.05) - 2025/02/17 20:37:59
Table 'RushAndCash603828' 6-max Seat #1 is the button
Seat 1: 200ba768 ($4.03 in chips)
Seat 2: 717e9861 ($5 in chips)
Seat 3: 735c4afd ($5 in chips)
Seat 4: ee368e2c ($5 in chips)
Seat 5: Hero ($5.07 in chips)
Seat 6: f71f9fc0 ($4.3 in chips)
717e9861: posts small blind $0.02
735c4afd: posts big blind $0.05
*** HOLE CARDS ***
Dealt to 200ba768 
Dealt to 717e9861 
Dealt to 735c4afd 
Dealt to ee368e2c 
Dealt to Hero [7d Jh]
Dealt to f71f9fc0 
ee368e2c: raises $0.06 to $0.11
Hero: folds
f71f9fc0: folds
200ba768: folds
717e9861: folds
735c4afd: folds
Uncalled bet ($0.06) returned to ee368e2c
*** SHOWDOWN ***
ee368e2c collected $0.12 from pot
*** SUMMARY ***
Total pot $0.12 | Rake $0 | Jackpot $0 | Bingo $0 | Fortune $0 | Tax $0
Seat 1: 200ba768 (button) folded before Flop (didn't bet)
Seat 2: 717e9861 (small blind) folded before Flop
Seat 3: 735c4afd (big blind) folded before Flop
Seat 4: ee368e2c collected ($0.12)
Seat 5: Hero folded before Flop (didn't bet)
Seat 6: f71f9fc0 folded before Flop (didn't bet)


Poker Hand #RC3334438541: Hold'em No Limit ($0.02/$0.05) - 2025/02/17 20:37:55
Table 'RushAndCash603801' 6-max Seat #1 is the button
Seat 1: Hero ($5 in chips)
Seat 2: da25c79c ($5.11 in chips)
Seat 3: e95b4a35 ($4.87 in chips)
Seat 4: 3f138d48 ($5.17 in chips)
Seat 5: c92a5ecb ($6.53 in chips)
Seat 6: 9b4fbe63 ($8.88 in chips)
da25c79c: posts small blind $0.02
e95b4a35: posts big blind $0.05
*** HOLE CARDS ***
Dealt to Hero [2d 8h]
Dealt to da25c79c 
Dealt to e95b4a35 
Dealt to 3f138d48 
Dealt to c92a5ecb 
Dealt to 9b4fbe63 
3f138d48: folds
c92a5ecb: raises $0.05 to $0.1
9b4fbe63: folds
Hero: folds
da25c79c: folds
e95b4a35: calls $0.05
*** FLOP *** [9h Ks 2c]
e95b4a35: checks
c92a5ecb: bets $0.11
e95b4a35: folds
Uncalled bet ($0.11) returned to c92a5ecb
*** SHOWDOWN ***
c92a5ecb collected $0.21 from pot
*** SUMMARY ***
Total pot $0.22 | Rake $0.01 | Jackpot $0 | Bingo $0 | Fortune $0 | Tax $0
Board [9h Ks 2c]
Seat 1: Hero (button) folded before Flop (didn't bet)
Seat 2: da25c79c (small blind) folded before Flop
Seat 3: e95b4a35 (big blind) folded on the Flop
Seat 4: 3f138d48 folded before Flop (didn't bet)
Seat 5: c92a5ecb won ($0.21)
Seat 6: 9b4fbe63 folded before Flop (didn't bet)


Poker Hand #RC3334438519: Hold'em No Limit ($0.02/$0.05) - 2025/02/17 20:37:52
Table 'RushAndCash603779' 6-max Seat #1 is the button
Seat 1: 79df293 ($5.41 in chips)
Seat 2: 32d40ce0 ($8.1 in chips)
Seat 3: Hero ($5.05 in chips)
Seat 4: 41926fd ($5.32 in chips)
Seat 5: f2e82cf4 ($5.25 in chips)
Seat 6: 6a5a3ab6 ($4.5 in chips)
32d40ce0: posts small blind $0.02
Hero: posts big blind $0.05
*** HOLE CARDS ***
Dealt to 79df293 
Dealt to 32d40ce0 
Dealt to Hero [4c Js]
Dealt to 41926fd 
Dealt to f2e82cf4 
Dealt to 6a5a3ab6 
41926fd: folds
f2e82cf4: folds
6a5a3ab6: folds
79df293: folds
32d40ce0: folds
Uncalled bet ($0.03) returned to Hero
*** SHOWDOWN ***
Hero collected $0.04 from pot
*** SUMMARY ***
Total pot $0.04 | Rake $0 | Jackpot $0 | Bingo $0 | Fortune $0 | Tax $0
Seat 1: 79df293 (button) folded before Flop (didn't bet)
Seat 2: 32d40ce0 (small blind) folded before Flop
Seat 3: Hero (big blind) collected ($0.04)
Seat 4: 41926fd folded before Flop (didn't bet)
Seat 5: f2e82cf4 folded before Flop (didn't bet)
Seat 6: 6a5a3ab6 folded before Flop (didn't bet)


Poker Hand #RC3334438497: Hold'em No Limit ($0.02/$0.05) - 2025/02/17 20:37:48
Table 'RushAndCash603757' 6-max Seat #1 is the button
Seat 1: 860fa4c9 ($5.31 in chips)
Seat 2: a482bd3 ($6.37 in chips)
Seat 3: 6878e82a ($5.27 in chips)
Seat 4: 92099542 ($8.68 in chips)
Seat 5: Hero ($5.05 in chips)
Seat 6: 99af2b58 ($14.75 in chips)
a482bd3: posts small blind $0.02
6878e82a: posts big blind $0.05
*** HOLE CARDS ***
Dealt to 860fa4c9 
Dealt to a482bd3 
Dealt to 6878e82a 
Dealt to 92099542 
Dealt to Hero [7d 2d]
Dealt to 99af2b58 
92099542: folds
Hero: folds
99af2b58: raises $0.05 to $0.1
860fa4c9: calls $0.1
a482bd3: calls $0.08
6878e82a: calls $0.05
*** FLOP *** [Kh 5d Jd]
a482bd3: checks
6878e82a: checks
99af2b58: bets $0.2
860fa4c9: folds
a482bd3: folds
6878e82a: folds
Uncalled bet ($0.2) returned to 99af2b58
*** SHOWDOWN ***
99af2b58 collected $0.38 from pot
*** SUMMARY ***
Total pot $0.4 | Rake $0.02 | Jackpot $0 | Bingo $0 | Fortune $0 | Tax $0
Board [Kh 5d Jd]
Seat 1: 860fa4c9 (button) folded on the Flop
Seat 2: a482bd3 (small blind) folded on the Flop
Seat 3: 6878e82a (big blind) folded on the Flop
Seat 4: 92099542 folded before Flop (didn't bet)
Seat 5: Hero folded before Flop (didn't bet)
Seat 6: 99af2b58 won ($0.38)


Poker Hand #RC3334438355: Hold'em No Limit ($0.02/$0.05) - 2025/02/17 20:37:28
Table 'RushAndCash603615' 6-max Seat #1 is the button
Seat 1: fd5d7bbe ($2.33 in chips)
Seat 2: Hero ($5 in chips)
Seat 3: f83d0c9c ($5.83 in chips)
Seat 4: a17718eb ($1.94 in chips)
Seat 5: 7da1f29c ($6.87 in chips)
Seat 6: af9df96 ($5.13 in chips)
Hero: posts small blind $0.02
f83d0c9c: posts big blind $0.05
*** HOLE CARDS ***
Dealt to fd5d7bbe 
Dealt to Hero [Qs Kc]
Dealt to f83d0c9c 
Dealt to a17718eb 
Dealt to 7da1f29c 
Dealt to af9df96 
a17718eb: folds
7da1f29c: folds
af9df96: folds
fd5d7bbe: folds
Hero: raises $0.1 to $0.15
f83d0c9c: folds
Uncalled bet ($0.1) returned to Hero
*** SHOWDOWN ***
Hero collected $0.1 from pot
*** SUMMARY ***
Total pot $0.1 | Rake $0 | Jackpot $0 | Bingo $0 | Fortune $0 | Tax $0
Seat 1: fd5d7bbe (button) folded before Flop (didn't bet)
Seat 2: Hero (small blind) collected ($0.1)
Seat 3: f83d0c9c (big blind) folded before Flop
Seat 4: a17718eb folded before Flop (didn't bet)
Seat 5: 7da1f29c folded before Flop (didn't bet)
Seat 6: af9df96 folded before Flop (didn't bet)


Poker Hand #RC3334438333: Hold'em No Limit ($0.02/$0.05) - 2025/02/17 20:37:24
Table 'RushAndCash603593' 6-max Seat #1 is the button
Seat 1: 1640de52 ($14.95 in chips)
Seat 2: 6be17d4e ($5.23 in chips)
Seat 3: e2777133 ($7.64 in chips)
Seat 4: 803e9f05 ($6.61 in chips)
Seat 5: Hero ($5 in chips)
Seat 6: 42eefc11 ($11.17 in chips)
6be17d4e: posts small blind $0.02
e2777133: posts big blind $0.05
*** HOLE CARDS ***
Dealt to 1640de52 
Dealt to 6be17d4e 
Dealt to e2777133 
Dealt to 803e9f05 
Dealt to Hero [6h 4d]
Dealt to 42eefc11 
803e9f05: raises $0.05 to $0.1
Hero: folds
42eefc11: folds
1640de52: calls $0.1
6be17d4e: folds
e2777133: calls $0.05
*** FLOP *** [Kh 2d 6s]
e2777133: checks
803e9f05: checks
1640de52: checks
*** TURN *** [Kh 2d 6s] [7d]
e2777133: checks
803e9f05: checks
1640de52: checks
*** RIVER *** [Kh 2d 6s 7d] [6c]
e2777133: checks
803e9f05: checks
1640de52: checks
e2777133: shows [2s 4s] (Pair of Sixes and Pair of Twos)
803e9f05: shows [Qd Ad] (Pair of Sixes)
1640de52: shows [8h 9h] (Pair of Sixes)
*** SHOWDOWN ***
e2777133 collected $0.31 from pot
*** SUMMARY ***
Total pot $0.32 | Rake $0.01 | Jackpot $0 | Bingo $0 | Fortune $0 | Tax $0
Board [Kh 2d 6s 7d 6c]
Seat 1: 1640de52 (button) showed [8h 9h] and lost with Pair of Sixes
Seat 2: 6be17d4e (small blind) folded before Flop
Seat 3: e2777133 (big blind) showed [2s 4s] and won ($0.31) with Pair of Sixes and Pair of Twos
Seat 4: 803e9f05 showed [Qd Ad] and lost with Pair of Sixes
Seat 5: Hero folded before Flop (didn't bet)
Seat 6: 42eefc11 folded before Flop (didn't bet)


Poker Hand #RC3334438306: Hold'em No Limit ($0.02/$0.05) - 2025/02/17 20:37:21
Table 'RushAndCash603566' 6-max Seat #1 is the button
Seat 1: Hero ($5 in chips)
Seat 2: 1d0217bc ($7.88 in chips)
Seat 3: 31bef4 ($2.55 in chips)
Seat 4: 9dd1ff39 ($8.1 in chips)
Seat 5: 99af2b58 ($14.85 in chips)
Seat 6: 5db4cca ($4.42 in chips)
1d0217bc: posts small blind $0.02
31bef4: posts big blind $0.05
*** HOLE CARDS ***
Dealt to Hero [7c Ks]
Dealt to 1d0217bc 
Dealt to 31bef4 
Dealt to 9dd1ff39 
Dealt to 99af2b58 
Dealt to 5db4cca 
9dd1ff39: folds
99af2b58: folds
5db4cca: folds
Hero: folds
1d0217bc: raises $0.1 to $0.15
31bef4: folds
Uncalled bet ($0.1) returned to 1d0217bc
*** SHOWDOWN ***
1d0217bc collected $0.1 from pot
*** SUMMARY ***
Total pot $0.1 | Rake $0 | Jackpot $0 | Bingo $0 | Fortune $0 | Tax $0
Seat 1: Hero (button) folded before Flop (didn't bet)
Seat 2: 1d0217bc (small blind) collected ($0.1)
Seat 3: 31bef4 (big blind) folded before Flop
Seat 4: 9dd1ff39 folded before Flop (didn't bet)
Seat 5: 99af2b58 folded before Flop (didn't bet)
Seat 6: 5db4cca folded before Flop (didn't bet)


Poker Hand #RC3334438273: Hold'em No Limit ($0.02/$0.05) - 2025/02/17 20:37:17
Table 'RushAndCash603533' 6-max Seat #1 is the button
Seat 1: d0316f8a ($5.07 in chips)
Seat 2: f20f94d9 ($5 in chips)
Seat 3: 4f7979c7 ($5.34 in chips)
Seat 4: e26361cd ($4.88 in chips)
Seat 5: c35a9a18 ($5.39 in chips)
Seat 6: Hero ($5 in chips)
f20f94d9: posts small blind $0.02
4f7979c7: posts big blind $0.05
*** HOLE CARDS ***
Dealt to d0316f8a 
Dealt to f20f94d9 
Dealt to 4f7979c7 
Dealt to e26361cd 
Dealt to c35a9a18 
Dealt to Hero [Js 7h]
e26361cd: folds
c35a9a18: folds
Hero: folds
d0316f8a: folds
f20f94d9: folds
Uncalled bet ($0.03) returned to 4f7979c7
*** SHOWDOWN ***
4f7979c7 collected $0.04 from pot
*** SUMMARY ***
Total pot $0.04 | Rake $0 | Jackpot $0 | Bingo $0 | Fortune $0 | Tax $0
Seat 1: d0316f8a (button) folded before Flop (didn't bet)
Seat 2: f20f94d9 (small blind) folded before Flop
Seat 3: 4f7979c7 (big blind) collected ($0.04)
Seat 4: e26361cd folded before Flop (didn't bet)
Seat 5: c35a9a18 folded before Flop (didn't bet)
Seat 6: Hero folded before Flop (didn't bet)


Poker Hand #RC3334438241: Hold'em No Limit ($0.02/$0.05) - 2025/02/17 20:37:13
Table 'RushAndCash603501' 6-max Seat #1 is the button
Seat 1: fbb9d8f2 ($4.77 in chips)
Seat 2: 1ea0f381 ($4.83 in chips)
Seat 3: 1df270b6 ($8.86 in chips)
Seat 4: Hero ($5 in chips)
Seat 5: f20f94d9 ($5 in chips)
Seat 6: b86c29aa ($5 in chips)
1ea0f381: posts small blind $0.02
1df270b6: posts big blind $0.05
*** HOLE CARDS ***
Dealt to fbb9d8f2 
Dealt to 1ea0f381 
Dealt to 1df270b6 
Dealt to Hero [6d Jc]
Dealt to f20f94d9 
Dealt to b86c29aa 
Hero: folds
f20f94d9: folds
b86c29aa: folds
fbb9d8f2: raises $0.08 to $0.13
1ea0f381: folds
1df270b6: calls $0.08
*** FLOP *** [7h Tc Ad]
1df270b6: checks
fbb9d8f2: bets $0.1
1df270b6: calls $0.1
*** TURN *** [7h Tc Ad] [7d]
1df270b6: checks
fbb9d8f2: bets $0.24
1df270b6: folds
Uncalled bet ($0.24) returned to fbb9d8f2
*** SHOWDOWN ***
fbb9d8f2 collected $0.46 from pot
*** SUMMARY ***
Total pot $0.48 | Rake $0.02 | Jackpot $0 | Bingo $0 | Fortune $0 | Tax $0
Board [7h Tc Ad 7d]
Seat 1: fbb9d8f2 (button) won ($0.46)
Seat 2: 1ea0f381 (small blind) folded before Flop
Seat 3: 1df270b6 (big blind) folded on the Turn
Seat 4: Hero folded before Flop (didn't bet)
Seat 5: f20f94d9 folded before Flop (didn't bet)
Seat 6: b86c29aa folded before Flop (didn't bet)


Poker Hand #RC3334438216: Hold'em No Limit ($0.02/$0.05) - 2025/02/17 20:37:10
Table 'RushAndCash603476' 6-max Seat #1 is the button
Seat 1: f108945f ($5 in chips)
Seat 2: c95c6ae6 ($14.04 in chips)
Seat 3: 6c0f6dbf ($14.38 in chips)
Seat 4: 29471264 ($5.33 in chips)
Seat 5: fcad3124 ($11.39 in chips)
Seat 6: Hero ($5 in chips)
c95c6ae6: posts small blind $0.02
6c0f6dbf: posts big blind $0.05
*** HOLE CARDS ***
Dealt to f108945f 
Dealt to c95c6ae6 
Dealt to 6c0f6dbf 
Dealt to 29471264 
Dealt to fcad3124 
Dealt to Hero [7c 2c]
29471264: folds
fcad3124: folds
Hero: folds
f108945f: folds
c95c6ae6: raises $0.05 to $0.1
6c0f6dbf: folds
Uncalled bet ($0.05) returned to c95c6ae6
*** SHOWDOWN ***
c95c6ae6 collected $0.1 from pot
*** SUMMARY ***
Total pot $0.1 | Rake $0 | Jackpot $0 | Bingo $0 | Fortune $0 | Tax $0
Seat 1: f108945f (button) folded before Flop (didn't bet)
Seat 2: c95c6ae6 (small blind) collected ($0.1)
Seat 3: 6c0f6dbf (big blind) folded before Flop
Seat 4: 29471264 folded before Flop (didn't bet)
Seat 5: fcad3124 folded before Flop (didn't bet)
Seat 6: Hero folded before Flop (didn't bet)


Poker Hand #RC3334438185: Hold'em No Limit ($0.02/$0.05) - 2025/02/17 20:37:05
Table 'RushAndCash603445' 6-max Seat #1 is the button
Seat 1: Hero ($5 in chips)
Seat 2: f5fcc522 ($10.37 in chips)
Seat 3: 3dbbdac8 ($5.19 in chips)
Seat 4: ef1a0dc2 ($5 in chips)
Seat 5: b86c29aa ($5 in chips)
Seat 6: 773fdf96 ($5.48 in chips)
f5fcc522: posts small blind $0.02
3dbbdac8: posts big blind $0.05
*** HOLE CARDS ***
Dealt to Hero [5s Ac]
Dealt to f5fcc522 
Dealt to 3dbbdac8 
Dealt to ef1a0dc2 
Dealt to b86c29aa 
Dealt to 773fdf96 
ef1a0dc2: folds
b86c29aa: folds
773fdf96: folds
Hero: folds
f5fcc522: calls $0.03
3dbbdac8: checks
*** FLOP *** [3s 4d 4h]
f5fcc522: checks
3dbbdac8: checks
*** TURN *** [3s 4d 4h] [Kd]
f5fcc522: checks
3dbbdac8: checks
*** RIVER *** [3s 4d 4h Kd] [8s]
f5fcc522: checks
3dbbdac8: checks
f5fcc522: shows [Qd 9c] (Pair of Fours)
3dbbdac8: shows [9d Qs] (Pair of Fours)
*** SHOWDOWN ***
f5fcc522 collected $0.05 from pot
3dbbdac8 collected $0.05 from pot
*** SUMMARY ***
Total pot $0.1 | Rake $0 | Jackpot $0 | Bingo $0 | Fortune $0 | Tax $0
Board [3s 4d 4h Kd 8s]
Seat 1: Hero (button) folded before Flop (didn't bet)
Seat 2: f5fcc522 (small blind) showed [Qd 9c] and won ($0.05) with Pair of Fours
Seat 3: 3dbbdac8 (big blind) showed [9d Qs] and won ($0.05) with Pair of Fours
Seat 4: ef1a0dc2 folded before Flop (didn't bet)
Seat 5: b86c29aa folded before Flop (didn't bet)
Seat 6: 773fdf96 folded before Flop (didn't bet)


Poker Hand #RC3334438154: Hold'em No Limit ($0.02/$0.05) - 2025/02/17 20:37:01
Table 'RushAndCash603414' 6-max Seat #1 is the button
Seat 1: d1cd1071 ($15.08 in chips)
Seat 2: ee3fdfd8 ($6.12 in chips)
Seat 3: Hero ($5 in chips)
Seat 4: 1095926a ($5 in chips)
Seat 5: 5a53cba2 ($5.21 in chips)
Seat 6: c2f5c77 ($4.59 in chips)
ee3fdfd8: posts small blind $0.02
Hero: posts big blind $0.05
*** HOLE CARDS ***
Dealt to d1cd1071 
Dealt to ee3fdfd8 
Dealt to Hero [3h 8c]
Dealt to 1095926a 
Dealt to 5a53cba2 
Dealt to c2f5c77 
1095926a: raises $0.08 to $0.13
5a53cba2: folds
c2f5c77: folds
d1cd1071: folds
ee3fdfd8: folds
Hero: folds
Uncalled bet ($0.08) returned to 1095926a
*** SHOWDOWN ***
1095926a collected $0.12 from pot
*** SUMMARY ***
Total pot $0.12 | Rake $0 | Jackpot $0 | Bingo $0 | Fortune $0 | Tax $0
Seat 1: d1cd1071 (button) folded before Flop (didn't bet)
Seat 2: ee3fdfd8 (small blind) folded before Flop
Seat 3: Hero (big blind) folded before Flop
Seat 4: 1095926a collected ($0.12)
Seat 5: 5a53cba2 folded before Flop (didn't bet)
Seat 6: c2f5c77 folded before Flop (didn't bet)


Poker Hand #RC3334438129: Hold'em No Limit ($0.02/$0.05) - 2025/02/17 20:36:58
Table 'RushAndCash603389' 6-max Seat #1 is the button
Seat 1: 42fca4f9 ($9.73 in chips)
Seat 2: Hero ($5 in chips)
Seat 3: fd5d7bbe ($2.4 in chips)
Seat 4: c5f53436 ($7.89 in chips)
Seat 5: 387e4951 ($5 in chips)
Seat 6: edbb0bb6 ($5.08 in chips)
Hero: posts small blind $0.02
fd5d7bbe: posts big blind $0.05
*** HOLE CARDS ***
Dealt to 42fca4f9 
Dealt to Hero [Th 2c]
Dealt to fd5d7bbe 
Dealt to c5f53436 
Dealt to 387e4951 
Dealt to edbb0bb6 
c5f53436: calls $0.05
387e4951: folds
edbb0bb6: raises $0.05 to $0.1
42fca4f9: folds
Hero: folds
fd5d7bbe: folds
c5f53436: calls $0.05
*** FLOP *** [6h Ks 8d]
c5f53436: checks
edbb0bb6: bets $0.18
c5f53436: calls $0.18
*** TURN *** [6h Ks 8d] [6s]
c5f53436: checks
edbb0bb6: bets $0.42
c5f53436: folds
Uncalled bet ($0.42) returned to edbb0bb6
*** SHOWDOWN ***
edbb0bb6 collected $0.6 from pot
*** SUMMARY ***
Total pot $0.63 | Rake $0.03 | Jackpot $0 | Bingo $0 | Fortune $0 | Tax $0
Board [6h Ks 8d 6s]
Seat 1: 42fca4f9 (button) folded before Flop (didn't bet)
Seat 2: Hero (small blind) folded before Flop
Seat 3: fd5d7bbe (big blind) folded before Flop
Seat 4: c5f53436 folded on the Turn
Seat 5: 387e4951 folded before Flop (didn't bet)
Seat 6: edbb0bb6 won ($0.6)


Poker Hand #RC3334438102: Hold'em No Limit ($0.02/$0.05) - 2025/02/17 20:36:54
Table 'RushAndCash603362' 6-max Seat #1 is the button
Seat 1: 42eefc11 ($11.24 in chips)
Seat 2: Hero ($5 in chips)
Seat 3: 6c122cb5 ($7.17 in chips)
Seat 4: 6662e866 ($15.68 in chips)
Seat 5: e74a324 ($5 in chips)
Seat 6: 651cc52f ($3.97 in chips)
Hero: posts small blind $0.02
6c122cb5: posts big blind $0.05
*** HOLE CARDS ***
Dealt to 42eefc11 
Dealt to Hero [8s 3d]
Dealt to 6c122cb5 
Dealt to 6662e866 
Dealt to e74a324 
Dealt to 651cc52f 
6662e866: raises $0.05 to $0.1
e74a324: folds
651cc52f: calls $0.1
42eefc11: folds
Hero: folds
6c122cb5: calls $0.05
*** FLOP *** [9c Kd 4c]
6c122cb5: checks
6662e866: checks
651cc52f: checks
*** TURN *** [9c Kd 4c] [Jh]
6c122cb5: checks
6662e866: bets $0.15
651cc52f: folds
6c122cb5: calls $0.15
*** RIVER *** [9c Kd 4c Jh] [5s]
6c122cb5: checks
6662e866: bets $0.36
6c122cb5: folds
Uncalled bet ($0.36) returned to 6662e866
*** SHOWDOWN ***
6662e866 collected $0.59 from pot
*** SUMMARY ***
Total pot $0.62 | Rake $0.03 | Jackpot $0 | Bingo $0 | Fortune $0 | Tax $0
Board [9c Kd 4c Jh 5s]
Seat 1: 42eefc11 (button) folded before Flop (didn't bet)
Seat 2: Hero (small blind) folded before Flop
Seat 3: 6c122cb5 (big blind) folded on the River
Seat 4: 6662e866 won ($0.59)
Seat 5: e74a324 folded before Flop (didn't bet)
Seat 6: 651cc52f folded on the Turn


Poker Hand #RC3334438067: Hold'em No Limit ($0.02/$0.05) - 2025/02/17 20:36:49
Table 'RushAndCash603327' 6-max Seat #1 is the button
Seat 1: 9a69a3a0 ($5.88 in chips)
Seat 2: b86c29aa ($5 in chips)
Seat 3: 4264790d ($5.43 in chips)
Seat 4: 1ce64dd8 ($4.46 in chips)
Seat 5: Hero ($5 in chips)
Seat 6: 3c1ddc3a ($7.12 in chips)
b86c29aa: posts small blind $0.02
4264790d: posts big blind $0.05
*** HOLE CARDS ***
Dealt to 9a69a3a0 
Dealt to b86c29aa 
Dealt to 4264790d 
Dealt to 1ce64dd8 
Dealt to Hero [Kd 2c]
Dealt to 3c1ddc3a 
1ce64dd8: folds
Hero: folds
3c1ddc3a: folds
9a69a3a0: folds
b86c29aa: folds
Uncalled bet ($0.03) returned to 4264790d
*** SHOWDOWN ***
4264790d collected $0.04 from pot
*** SUMMARY ***
Total pot $0.04 | Rake $0 | Jackpot $0 | Bingo $0 | Fortune $0 | Tax $0
Seat 1: 9a69a3a0 (button) folded before Flop (didn't bet)
Seat 2: b86c29aa (small blind) folded before Flop
Seat 3: 4264790d (big blind) collected ($0.04)
Seat 4: 1ce64dd8 folded before Flop (didn't bet)
Seat 5: Hero folded before Flop (didn't bet)
Seat 6: 3c1ddc3a folded before Flop (didn't bet)


Poker Hand #RC3334437644: Hold'em No Limit ($0.02/$0.05) - 2025/02/17 20:35:51
Table 'RushAndCash602904' 6-max Seat #1 is the button
Seat 1: ac6a1821 ($5.09 in chips)
Seat 2: 2b9f39df ($5.02 in chips)
Seat 3: 436ecab0 ($1.25 in chips)
Seat 4: 6db42a47 ($9.34 in chips)
Seat 5: Hero ($5 in chips)
Seat 6: 3f079db6 ($22.76 in chips)
2b9f39df: posts small blind $0.02
436ecab0: posts big blind $0.05
*** HOLE CARDS ***
Dealt to ac6a1821 
Dealt to 2b9f39df 
Dealt to 436ecab0 
Dealt to 6db42a47 
Dealt to Hero [As Td]
Dealt to 3f079db6 
6db42a47: folds
Hero: raises $0.05 to $0.1
3f079db6: calls $0.1
ac6a1821: folds
2b9f39df: folds
436ecab0: calls $0.05
*** FLOP *** [3h 3c Ah]
436ecab0: checks
Hero: checks
3f079db6: checks
*** TURN *** [3h 3c Ah] [4h]
436ecab0: bets $0.11
Hero: calls $0.11
3f079db6: raises $0.22 to $0.33
436ecab0: folds
Hero: folds
Uncalled bet ($0.22) returned to 3f079db6
*** SHOWDOWN ***
3f079db6 collected $0.62 from pot
*** SUMMARY ***
Total pot $0.65 | Rake $0.03 | Jackpot $0 | Bingo $0 | Fortune $0 | Tax $0
Board [3h 3c Ah 4h]
Seat 1: ac6a1821 (button) folded before Flop (didn't bet)
Seat 2: 2b9f39df (small blind) folded before Flop
Seat 3: 436ecab0 (big blind) folded on the Turn
Seat 4: 6db42a47 folded before Flop (didn't bet)
Seat 5: Hero folded on the Turn
Seat 6: 3f079db6 won ($0.62)


Poker Hand #RC3334437375: Hold'em No Limit ($0.02/$0.05) - 2025/02/17 20:35:15
Table 'RushAndCash602635' 6-max Seat #1 is the button
Seat 1: 7c99618c ($4.86 in chips)
Seat 2: 860fa4c9 ($5.02 in chips)
Seat 3: Hero ($5 in chips)
Seat 4: 61b789ce ($5 in chips)
Seat 5: 9f70f94d ($5 in chips)
Seat 6: 9d364714 ($6.52 in chips)
860fa4c9: posts small blind $0.02
Hero: posts big blind $0.05
*** HOLE CARDS ***
Dealt to 7c99618c 
Dealt to 860fa4c9 
Dealt to Hero [Ks Qs]
Dealt to 61b789ce 
Dealt to 9f70f94d 
Dealt to 9d364714 
61b789ce: folds
9f70f94d: folds
9d364714: folds
7c99618c: folds
860fa4c9: raises $0.1 to $0.15
Hero: calls $0.1
*** FLOP *** [9h 9s 5d]
860fa4c9: checks
Hero: checks
*** TURN *** [9h 9s 5d] [6d]
860fa4c9: checks
Hero: checks
*** RIVER *** [9h 9s 5d 6d] [5s]
860fa4c9: checks
Hero: checks
860fa4c9: shows [Ac Tc] (Pair of Nines and Pair of Fives)
Hero: shows [Ks Qs] (Pair of Nines and Pair of Fives)
*** SHOWDOWN ***
860fa4c9 collected $0.29 from pot
*** SUMMARY ***
Total pot $0.3 | Rake $0.01 | Jackpot $0 | Bingo $0 | Fortune $0 | Tax $0
Board [9h 9s 5d 6d 5s]
Seat 1: 7c99618c (button) folded before Flop (didn't bet)
Seat 2: 860fa4c9 (small blind) showed [Ac Tc] and won ($0.29) with Pair of Nines and Pair of Fives
Seat 3: Hero (big blind) showed [Ks Qs] and lost with Pair of Nines and Pair of Fives
Seat 4: 61b789ce folded before Flop (didn't bet)
Seat 5: 9f70f94d folded before Flop (didn't bet)
Seat 6: 9d364714 folded before Flop (didn't bet)


Poker Hand #RC3334437342: Hold'em No Limit ($0.02/$0.05) - 2025/02/17 20:35:09
Table 'RushAndCash602602' 6-max Seat #1 is the button
Seat 1: 709ac205 ($12.37 in chips)
Seat 2: 65ca9276 ($7.92 in chips)
Seat 3: ef82d036 ($22.3 in chips)
Seat 4: 731e166b ($5.35 in chips)
Seat 5: 3c1ddc3a ($7.09 in chips)
Seat 6: Hero ($5 in chips)
65ca9276: posts small blind $0.02
ef82d036: posts big blind $0.05
*** HOLE CARDS ***
Dealt to 709ac205 
Dealt to 65ca9276 
Dealt to ef82d036 
Dealt to 731e166b 
Dealt to 3c1ddc3a 
Dealt to Hero [Jh 7s]
731e166b: folds
3c1ddc3a: raises $0.05 to $0.1
Hero: folds
709ac205: folds
65ca9276: folds
ef82d036: calls $0.05
*** FLOP *** [6d 2h 7d]
ef82d036: checks
3c1ddc3a: checks
*** TURN *** [6d 2h 7d] [9d]
ef82d036: bets $0.13
3c1ddc3a: calls $0.13
*** RIVER *** [6d 2h 7d 9d] [3d]
ef82d036: checks
3c1ddc3a: bets $0.24
ef82d036: folds
Uncalled bet ($0.24) returned to 3c1ddc3a
*** SHOWDOWN ***
3c1ddc3a collected $0.46 from pot
*** SUMMARY ***
Total pot $0.48 | Rake $0.02 | Jackpot $0 | Bingo $0 | Fortune $0 | Tax $0
Board [6d 2h 7d 9d 3d]
Seat 1: 709ac205 (button) folded before Flop (didn't bet)
Seat 2: 65ca9276 (small blind) folded before Flop
Seat 3: ef82d036 (big blind) folded on the River
Seat 4: 731e166b folded before Flop (didn't bet)
Seat 5: 3c1ddc3a won ($0.46)
Seat 6: Hero folded before Flop (didn't bet)


Poker Hand #RC3334437318: Hold'em No Limit ($0.02/$0.05) - 2025/02/17 20:35:06
Table 'RushAndCash602578' 6-max Seat #1 is the button
Seat 1: 5f1cdd27 ($5.25 in chips)
Seat 2: 6662e866 ($15.9 in chips)
Seat 3: 4e55fa29 ($4.45 in chips)
Seat 4: Hero ($5 in chips)
Seat 5: f3f5406e ($15.05 in chips)
Seat 6: 6008538 ($3.15 in chips)
6662e866: posts small blind $0.02
4e55fa29: posts big blind $0.05
*** HOLE CARDS ***
Dealt to 5f1cdd27 
Dealt to 6662e866 
Dealt to 4e55fa29 
Dealt to Hero [9s 2h]
Dealt to f3f5406e 
Dealt to 6008538 
Hero: folds
f3f5406e: raises $0.1 to $0.15
6008538: folds
5f1cdd27: folds
6662e866: folds
4e55fa29: folds
Uncalled bet ($0.1) returned to f3f5406e
*** SHOWDOWN ***
f3f5406e collected $0.12 from pot
*** SUMMARY ***
Total pot $0.12 | Rake $0 | Jackpot $0 | Bingo $0 | Fortune $0 | Tax $0
Seat 1: 5f1cdd27 (button) folded before Flop (didn't bet)
Seat 2: 6662e866 (small blind) folded before Flop
Seat 3: 4e55fa29 (big blind) folded before Flop
Seat 4: Hero folded before Flop (didn't bet)
Seat 5: f3f5406e collected ($0.12)
Seat 6: 6008538 folded before Flop (didn't bet)


Poker Hand #RC3334437290: Hold'em No Limit ($0.02/$0.05) - 2025/02/17 20:35:02
Table 'RushAndCash602550' 6-max Seat #1 is the button
Seat 1: 287f8174 ($7.33 in chips)
Seat 2: 673e17b3 ($5 in chips)
Seat 3: 4238ab48 ($4.26 in chips)
Seat 4: Hero ($5 in chips)
Seat 5: f43eaf15 ($8.5 in chips)
Seat 6: 1df270b6 ($8.04 in chips)
673e17b3: posts small blind $0.02
4238ab48: posts big blind $0.05
*** HOLE CARDS ***
Dealt to 287f8174 
Dealt to 673e17b3 
Dealt to 4238ab48 
Dealt to Hero [Qh Jc]
Dealt to f43eaf15 
Dealt to 1df270b6 
Hero: folds
f43eaf15: folds
1df270b6: raises $0.06 to $0.11
287f8174: folds
673e17b3: folds
4238ab48: folds
Uncalled bet ($0.06) returned to 1df270b6
*** SHOWDOWN ***
1df270b6 collected $0.12 from pot
*** SUMMARY ***
Total pot $0.12 | Rake $0 | Jackpot $0 | Bingo $0 | Fortune $0 | Tax $0
Seat 1: 287f8174 (button) folded before Flop (didn't bet)
Seat 2: 673e17b3 (small blind) folded before Flop
Seat 3: 4238ab48 (big blind) folded before Flop
Seat 4: Hero folded before Flop (didn't bet)
Seat 5: f43eaf15 folded before Flop (didn't bet)
Seat 6: 1df270b6 collected ($0.12)


Poker Hand #RC3334437111: Hold'em No Limit ($0.02/$0.05) - 2025/02/17 20:34:36
Table 'RushAndCash602371' 6-max Seat #1 is the button
Seat 1: c35a9a18 ($5 in chips)
Seat 2: Hero ($5 in chips)
Seat 3: eb14a598 ($5.54 in chips)
Seat 4: 491e0e63 ($5 in chips)
Seat 5: 5f8248c5 ($3.83 in chips)
Seat 6: cbfd6c92 ($4.54 in chips)
Hero: posts small blind $0.02
eb14a598: posts big blind $0.05
*** HOLE CARDS ***
Dealt to c35a9a18 
Dealt to Hero [Kh 5h]
Dealt to eb14a598 
Dealt to 491e0e63 
Dealt to 5f8248c5 
Dealt to cbfd6c92 
491e0e63: folds
5f8248c5: folds
cbfd6c92: folds
c35a9a18: folds
Hero: calls $0.03
eb14a598: checks
*** FLOP *** [7d 7s 5d]
Hero: checks
eb14a598: checks
*** TURN *** [7d 7s 5d] [9d]
Hero: checks
eb14a598: bets $0.07
Hero: folds
Uncalled bet ($0.07) returned to eb14a598
*** SHOWDOWN ***
eb14a598 collected $0.1 from pot
*** SUMMARY ***
Total pot $0.1 | Rake $0 | Jackpot $0 | Bingo $0 | Fortune $0 | Tax $0
Board [7d 7s 5d 9d]
Seat 1: c35a9a18 (button) folded before Flop (didn't bet)
Seat 2: Hero (small blind) folded on the Turn
Seat 3: eb14a598 (big blind) won ($0.1)
Seat 4: 491e0e63 folded before Flop (didn't bet)
Seat 5: 5f8248c5 folded before Flop (didn't bet)
Seat 6: cbfd6c92 folded before Flop (didn't bet)


Poker Hand #RC3334437087: Hold'em No Limit ($0.02/$0.05) - 2025/02/17 20:34:32
Table 'RushAndCash602347' 6-max Seat #1 is the button
Seat 1: e2777133 ($7.54 in chips)
Seat 2: c35a9a18 ($5 in chips)
Seat 3: Hero ($5 in chips)
Seat 4: fff52c3e ($6.25 in chips)
Seat 5: e4fd27d ($5 in chips)
Seat 6: 87d5083b ($17.04 in chips)
c35a9a18: posts small blind $0.02
Hero: posts big blind $0.05
*** HOLE CARDS ***
Dealt to e2777133 
Dealt to c35a9a18 
Dealt to Hero [8h 4d]
Dealt to fff52c3e 
Dealt to e4fd27d 
Dealt to 87d5083b 
fff52c3e: folds
e4fd27d: folds
87d5083b: raises $0.05 to $0.1
e2777133: folds
c35a9a18: folds
Hero: folds
Uncalled bet ($0.05) returned to 87d5083b
*** SHOWDOWN ***
87d5083b collected $0.12 from pot
*** SUMMARY ***
Total pot $0.12 | Rake $0 | Jackpot $0 | Bingo $0 | Fortune $0 | Tax $0
Seat 1: e2777133 (button) folded before Flop (didn't bet)
Seat 2: c35a9a18 (small blind) folded before Flop
Seat 3: Hero (big blind) folded before Flop
Seat 4: fff52c3e folded before Flop (didn't bet)
Seat 5: e4fd27d folded before Flop (didn't bet)
Seat 6: 87d5083b collected ($0.12)


Poker Hand #RC3334437064: Hold'em No Limit ($0.02/$0.05) - 2025/02/17 20:34:28
Table 'RushAndCash602324' 6-max Seat #1 is the button
Seat 1: Hero ($5 in chips)
Seat 2: f898e827 ($6.45 in chips)
Seat 3: cf7f09c2 ($12.65 in chips)
Seat 4: 8c6b70e4 ($5.19 in chips)
Seat 5: d793d8f ($5.31 in chips)
Seat 6: b4c33f6c ($5.14 in chips)
f898e827: posts small blind $0.02
cf7f09c2: posts big blind $0.05
*** HOLE CARDS ***
Dealt to Hero [Jh 8s]
Dealt to f898e827 
Dealt to cf7f09c2 
Dealt to 8c6b70e4 
Dealt to d793d8f 
Dealt to b4c33f6c 
8c6b70e4: folds
d793d8f: raises $0.05 to $0.1
b4c33f6c: folds
Hero: folds
f898e827: calls $0.08
cf7f09c2: calls $0.05
*** FLOP *** [5s Kd Ts]
f898e827: checks
cf7f09c2: checks
d793d8f: checks
*** TURN *** [5s Kd Ts] [5c]
f898e827: checks
cf7f09c2: checks
d793d8f: checks
*** RIVER *** [5s Kd Ts 5c] [3h]
f898e827: checks
cf7f09c2: bets $0.1
d793d8f: folds
f898e827: folds
Uncalled bet ($0.1) returned to cf7f09c2
*** SHOWDOWN ***
cf7f09c2 collected $0.29 from pot
*** SUMMARY ***
Total pot $0.3 | Rake $0.01 | Jackpot $0 | Bingo $0 | Fortune $0 | Tax $0
Board [5s Kd Ts 5c 3h]
Seat 1: Hero (button) folded before Flop (didn't bet)
Seat 2: f898e827 (small blind) folded on the River
Seat 3: cf7f09c2 (big blind) won ($0.29)
Seat 4: 8c6b70e4 folded before Flop (didn't bet)
Seat 5: d793d8f folded on the River
Seat 6: b4c33f6c folded before Flop (didn't bet)


Poker Hand #RC3334437017: Hold'em No Limit ($0.02/$0.05) - 2025/02/17 20:34:21
Table 'RushAndCash602277' 6-max Seat #1 is the button
Seat 1: 1e76a4d8 ($6.43 in chips)
Seat 2: 87d5083b ($17.06 in chips)
Seat 3: 9135e49d ($5.26 in chips)
Seat 4: 8c6d38f2 ($5 in chips)
Seat 5: Hero ($5 in chips)
Seat 6: 866bc80c ($5 in chips)
87d5083b: posts small blind $0.02
9135e49d: posts big blind $0.05
*** HOLE CARDS ***
Dealt to 1e76a4d8 
Dealt to 87d5083b 
Dealt to 9135e49d 
Dealt to 8c6d38f2 
Dealt to Hero [7d Js]
Dealt to 866bc80c 
8c6d38f2: folds
Hero: folds
866bc80c: folds
1e76a4d8: raises $0.07 to $0.12
87d5083b: folds
9135e49d: folds
Uncalled bet ($0.07) returned to 1e76a4d8
*** SHOWDOWN ***
1e76a4d8 collected $0.12 from pot
*** SUMMARY ***
Total pot $0.12 | Rake $0 | Jackpot $0 | Bingo $0 | Fortune $0 | Tax $0
Seat 1: 1e76a4d8 (button) collected ($0.12)
Seat 2: 87d5083b (small blind) folded before Flop
Seat 3: 9135e49d (big blind) folded before Flop
Seat 4: 8c6d38f2 folded before Flop (didn't bet)
Seat 5: Hero folded before Flop (didn't bet)
Seat 6: 866bc80c folded before Flop (didn't bet)


Poker Hand #RC3334436885: Hold'em No Limit ($0.02/$0.05) - 2025/02/17 20:34:03
Table 'RushAndCash602145' 6-max Seat #1 is the button
Seat 1: 93cbff75 ($6.68 in chips)
Seat 2: Hero ($5 in chips)
Seat 3: 3b85f8e6 ($13.16 in chips)
Seat 4: ded3640 ($5.16 in chips)
Seat 5: fe374609 ($5.26 in chips)
Seat 6: 21bff972 ($5.92 in chips)
Hero: posts small blind $0.02
3b85f8e6: posts big blind $0.05
*** HOLE CARDS ***
Dealt to 93cbff75 
Dealt to Hero [Kd Td]
Dealt to 3b85f8e6 
Dealt to ded3640 
Dealt to fe374609 
Dealt to 21bff972 
ded3640: raises $0.08 to $0.13
fe374609: folds
21bff972: folds
93cbff75: folds
Hero: folds
3b85f8e6: folds
Uncalled bet ($0.08) returned to ded3640
*** SHOWDOWN ***
ded3640 collected $0.12 from pot
*** SUMMARY ***
Total pot $0.12 | Rake $0 | Jackpot $0 | Bingo $0 | Fortune $0 | Tax $0
Seat 1: 93cbff75 (button) folded before Flop (didn't bet)
Seat 2: Hero (small blind) folded before Flop
Seat 3: 3b85f8e6 (big blind) folded before Flop
Seat 4: ded3640 collected ($0.12)
Seat 5: fe374609 folded before Flop (didn't bet)
Seat 6: 21bff972 folded before Flop (didn't bet)


Poker Hand #RC3334436858: Hold'em No Limit ($0.02/$0.05) - 2025/02/17 20:34:00
Table 'RushAndCash602118' 6-max Seat #1 is the button
Seat 1: dbf5f543 ($4.82 in chips)
Seat 2: 730098b8 ($7.47 in chips)
Seat 3: 4238ab48 ($4.53 in chips)
Seat 4: Hero ($5 in chips)
Seat 5: ac2aecf ($2.88 in chips)
Seat 6: 8f9fd8b1 ($6.08 in chips)
730098b8: posts small blind $0.02
4238ab48: posts big blind $0.05
*** HOLE CARDS ***
Dealt to dbf5f543 
Dealt to 730098b8 
Dealt to 4238ab48 
Dealt to Hero [8d 2c]
Dealt to ac2aecf 
Dealt to 8f9fd8b1 
Hero: folds
ac2aecf: raises $0.05 to $0.1
8f9fd8b1: folds
dbf5f543: folds
730098b8: folds
4238ab48: folds
Uncalled bet ($0.05) returned to ac2aecf
*** SHOWDOWN ***
ac2aecf collected $0.12 from pot
*** SUMMARY ***
Total pot $0.12 | Rake $0 | Jackpot $0 | Bingo $0 | Fortune $0 | Tax $0
Seat 1: dbf5f543 (button) folded before Flop (didn't bet)
Seat 2: 730098b8 (small blind) folded before Flop
Seat 3: 4238ab48 (big blind) folded before Flop
Seat 4: Hero folded before Flop (didn't bet)
Seat 5: ac2aecf collected ($0.12)
Seat 6: 8f9fd8b1 folded before Flop (didn't bet)


Poker Hand #RC3334436837: Hold'em No Limit ($0.02/$0.05) - 2025/02/17 20:33:57
Table 'RushAndCash602097' 6-max Seat #1 is the button
Seat 1: 6191b99d ($2.67 in chips)
Seat 2: 23cd2f90 ($2.77 in chips)
Seat 3: 4ea8e2e ($13.21 in chips)
Seat 4: 4db54282 ($5.04 in chips)
Seat 5: Hero ($5 in chips)
Seat 6: 6dcd0788 ($6.12 in chips)
23cd2f90: posts small blind $0.02
4ea8e2e: posts big blind $0.05
*** HOLE CARDS ***
Dealt to 6191b99d 
Dealt to 23cd2f90 
Dealt to 4ea8e2e 
Dealt to 4db54282 
Dealt to Hero [3s 7d]
Dealt to 6dcd0788 
4db54282: raises $0.05 to $0.1
Hero: folds
6dcd0788: folds
6191b99d: folds
23cd2f90: folds
4ea8e2e: raises $0.4 to $0.5
4db54282: folds
Uncalled bet ($0.4) returned to 4ea8e2e
*** SHOWDOWN ***
4ea8e2e collected $0.21 from pot
*** SUMMARY ***
Total pot $0.22 | Rake $0.01 | Jackpot $0 | Bingo $0 | Fortune $0 | Tax $0
Seat 1: 6191b99d (button) folded before Flop (didn't bet)
Seat 2: 23cd2f90 (small blind) folded before Flop
Seat 3: 4ea8e2e (big blind) showed [4s 8h] and collected ($0.21)
Seat 4: 4db54282 folded before Flop
Seat 5: Hero folded before Flop (didn't bet)
Seat 6: 6dcd0788 folded before Flop (didn't bet)


Poker Hand #RC3334436811: Hold'em No Limit ($0.02/$0.05) - 2025/02/17 20:33:53
Table 'RushAndCash602071' 6-max Seat #1 is the button
Seat 1: 73382638 ($6.74 in chips)
Seat 2: a28ca95c ($19.99 in chips)
Seat 3: Hero ($5 in chips)
Seat 4: 21bff972 ($5.97 in chips)
Seat 5: b64a83d ($6.45 in chips)
Seat 6: 50230f71 ($5.26 in chips)
a28ca95c: posts small blind $0.02
Hero: posts big blind $0.05
*** HOLE CARDS ***
Dealt to 73382638 
Dealt to a28ca95c 
Dealt to Hero [2c Jh]
Dealt to 21bff972 
Dealt to b64a83d 
Dealt to 50230f71 
21bff972: folds
b64a83d: raises $0.05 to $0.1
50230f71: folds
73382638: folds
a28ca95c: raises $0.29 to $0.39
Hero: folds
b64a83d: raises $0.63 to $1.02
a28ca95c: calls $0.63
*** FLOP *** [7h Ad 5s]
a28ca95c: checks
b64a83d: bets $0.52
a28ca95c: calls $0.52
*** TURN *** [7h Ad 5s] [5h]
a28ca95c: checks
b64a83d: checks
*** RIVER *** [7h Ad 5s 5h] [6h]
a28ca95c: checks
b64a83d: checks
a28ca95c: shows [9c 9s] (Pair of Nines and Pair of Fives)
b64a83d: shows [Qc Qd] (Pair of Queens and Pair of Fives)
*** SHOWDOWN ***
b64a83d collected $2.91 from pot
*** SUMMARY ***
Total pot $3.13 | Rake $0.15 | Jackpot $0.07 | Bingo $0 | Fortune $0 | Tax $0
Board [7h Ad 5s 5h 6h]
Seat 1: 73382638 (button) folded before Flop (didn't bet)
Seat 2: a28ca95c (small blind) showed [9c 9s] and lost with Pair of Nines and Pair of Fives
Seat 3: Hero (big blind) folded before Flop
Seat 4: 21bff972 folded before Flop (didn't bet)
Seat 5: b64a83d showed [Qc Qd] and won ($2.91) with Pair of Queens and Pair of Fives
Seat 6: 50230f71 folded before Flop (didn't bet)


Poker Hand #RC3334436791: Hold'em No Limit ($0.02/$0.05) - 2025/02/17 20:33:50
Table 'RushAndCash602051' 6-max Seat #1 is the button
Seat 1: 842d7655 ($5.21 in chips)
Seat 2: 1754e33c ($5.91 in chips)
Seat 3: 144ea2b0 ($10.27 in chips)
Seat 4: Hero ($5 in chips)
Seat 5: eed867f5 ($4.54 in chips)
Seat 6: 929700a0 ($6.66 in chips)
1754e33c: posts small blind $0.02
144ea2b0: posts big blind $0.05
*** HOLE CARDS ***
Dealt to 842d7655 
Dealt to 1754e33c 
Dealt to 144ea2b0 
Dealt to Hero [8d 2s]
Dealt to eed867f5 
Dealt to 929700a0 
Hero: folds
eed867f5: folds
929700a0: raises $0.15 to $0.2
842d7655: folds
1754e33c: folds
144ea2b0: folds
Uncalled bet ($0.15) returned to 929700a0
*** SHOWDOWN ***
929700a0 collected $0.12 from pot
*** SUMMARY ***
Total pot $0.12 | Rake $0 | Jackpot $0 | Bingo $0 | Fortune $0 | Tax $0
Seat 1: 842d7655 (button) folded before Flop (didn't bet)
Seat 2: 1754e33c (small blind) folded before Flop
Seat 3: 144ea2b0 (big blind) folded before Flop
Seat 4: Hero folded before Flop (didn't bet)
Seat 5: eed867f5 folded before Flop (didn't bet)
Seat 6: 929700a0 collected ($0.12)


Poker Hand #RC3334436766: Hold'em No Limit ($0.02/$0.05) - 2025/02/17 20:33:46
Table 'RushAndCash602026' 6-max Seat #1 is the button
Seat 1: Hero ($5 in chips)
Seat 2: 9684e9f0 ($6.35 in chips)
Seat 3: 8508a44f ($5.05 in chips)
Seat 4: 651cc52f ($4.96 in chips)
Seat 5: 6dcd0788 ($6.12 in chips)
Seat 6: 23cd2f90 ($2.82 in chips)
9684e9f0: posts small blind $0.02
8508a44f: posts big blind $0.05
*** HOLE CARDS ***
Dealt to Hero [5c Jd]
Dealt to 9684e9f0 
Dealt to 8508a44f 
Dealt to 651cc52f 
Dealt to 6dcd0788 
Dealt to 23cd2f90 
651cc52f: folds
6dcd0788: folds
23cd2f90: folds
Hero: folds
9684e9f0: folds
Uncalled bet ($0.03) returned to 8508a44f
*** SHOWDOWN ***
8508a44f collected $0.04 from pot
*** SUMMARY ***
Total pot $0.04 | Rake $0 | Jackpot $0 | Bingo $0 | Fortune $0 | Tax $0
Seat 1: Hero (button) folded before Flop (didn't bet)
Seat 2: 9684e9f0 (small blind) folded before Flop
Seat 3: 8508a44f (big blind) collected ($0.04)
Seat 4: 651cc52f folded before Flop (didn't bet)
Seat 5: 6dcd0788 folded before Flop (didn't bet)
Seat 6: 23cd2f90 folded before Flop (didn't bet)


Poker Hand #RC3334436742: Hold'em No Limit ($0.02/$0.05) - 2025/02/17 20:33:42
Table 'RushAndCash602002' 6-max Seat #1 is the button
Seat 1: 21bff972 ($5.99 in chips)
Seat 2: 3f079db6 ($21.15 in chips)
Seat 3: bbd60b52 ($15.61 in chips)
Seat 4: 9f09d482 ($6.59 in chips)
Seat 5: Hero ($5 in chips)
Seat 6: 23cd2f90 ($2.82 in chips)
3f079db6: posts small blind $0.02
bbd60b52: posts big blind $0.05
*** HOLE CARDS ***
Dealt to 21bff972 
Dealt to 3f079db6 
Dealt to bbd60b52 
Dealt to 9f09d482 
Dealt to Hero [Ts 7h]
Dealt to 23cd2f90 
9f09d482: folds
Hero: folds
23cd2f90: folds
21bff972: folds
3f079db6: raises $0.06 to $0.11
bbd60b52: folds
Uncalled bet ($0.06) returned to 3f079db6
*** SHOWDOWN ***
3f079db6 collected $0.1 from pot
*** SUMMARY ***
Total pot $0.1 | Rake $0 | Jackpot $0 | Bingo $0 | Fortune $0 | Tax $0
Seat 1: 21bff972 (button) folded before Flop (didn't bet)
Seat 2: 3f079db6 (small blind) collected ($0.1)
Seat 3: bbd60b52 (big blind) folded before Flop
Seat 4: 9f09d482 folded before Flop (didn't bet)
Seat 5: Hero folded before Flop (didn't bet)
Seat 6: 23cd2f90 folded before Flop (didn't bet)


Poker Hand #RC3334436722: Hold'em No Limit ($0.02/$0.05) - 2025/02/17 20:33:39
Table 'RushAndCash601982' 6-max Seat #1 is the button
Seat 1: 6008538 ($3.08 in chips)
Seat 2: 1e474bac ($5 in chips)
Seat 3: Hero ($5.05 in chips)
Seat 4: f71501ed ($5.49 in chips)
Seat 5: f2e82cf4 ($5.44 in chips)
Seat 6: 692e3a83 ($12.52 in chips)
1e474bac: posts small blind $0.02
Hero: posts big blind $0.05
*** HOLE CARDS ***
Dealt to 6008538 
Dealt to 1e474bac 
Dealt to Hero [2h 5d]
Dealt to f71501ed 
Dealt to f2e82cf4 
Dealt to 692e3a83 
f71501ed: folds
f2e82cf4: folds
692e3a83: raises $0.07 to $0.12
6008538: raises $0.23 to $0.35
1e474bac: folds
Hero: folds
692e3a83: folds
Uncalled bet ($0.23) returned to 6008538
*** SHOWDOWN ***
6008538 collected $0.3 from pot
*** SUMMARY ***
Total pot $0.31 | Rake $0.01 | Jackpot $0 | Bingo $0 | Fortune $0 | Tax $0
Seat 1: 6008538 (button) collected ($0.3)
Seat 2: 1e474bac (small blind) folded before Flop
Seat 3: Hero (big blind) folded before Flop
Seat 4: f71501ed folded before Flop (didn't bet)
Seat 5: f2e82cf4 folded before Flop (didn't bet)
Seat 6: 692e3a83 folded before Flop


Poker Hand #RC3334436640: Hold'em No Limit ($0.02/$0.05) - 2025/02/17 20:33:26
Table 'RushAndCash601900' 6-max Seat #1 is the button
Seat 1: 3d2a56c8 ($5.91 in chips)
Seat 2: 2eb4439f ($6.29 in chips)
Seat 3: e3c5673f ($4.9 in chips)
Seat 4: 53c3b7da ($5.1 in chips)
Seat 5: 48fa5407 ($5.82 in chips)
Seat 6: Hero ($5.05 in chips)
2eb4439f: posts small blind $0.02
e3c5673f: posts big blind $0.05
*** HOLE CARDS ***
Dealt to 3d2a56c8 
Dealt to 2eb4439f 
Dealt to e3c5673f 
Dealt to 53c3b7da 
Dealt to 48fa5407 
Dealt to Hero [5s 6h]
53c3b7da: raises $0.05 to $0.1
48fa5407: folds
Hero: folds
3d2a56c8: folds
2eb4439f: folds
e3c5673f: folds
Uncalled bet ($0.05) returned to 53c3b7da
*** SHOWDOWN ***
53c3b7da collected $0.12 from pot
*** SUMMARY ***
Total pot $0.12 | Rake $0 | Jackpot $0 | Bingo $0 | Fortune $0 | Tax $0
Seat 1: 3d2a56c8 (button) folded before Flop (didn't bet)
Seat 2: 2eb4439f (small blind) folded before Flop
Seat 3: e3c5673f (big blind) folded before Flop
Seat 4: 53c3b7da collected ($0.12)
Seat 5: 48fa5407 folded before Flop (didn't bet)
Seat 6: Hero folded before Flop (didn't bet)


Poker Hand #RC3334436553: Hold'em No Limit ($0.02/$0.05) - 2025/02/17 20:33:14
Table 'RushAndCash601813' 6-max Seat #1 is the button
Seat 1: 24c4874c ($4.96 in chips)
Seat 2: Hero ($5.07 in chips)
Seat 3: 2a393f2d ($5 in chips)
Seat 4: 9b1a3dd2 ($9.01 in chips)
Seat 5: 8dbd0a2d ($5.34 in chips)
Seat 6: 3dbbdac8 ($5 in chips)
Hero: posts small blind $0.02
2a393f2d: posts big blind $0.05
*** HOLE CARDS ***
Dealt to 24c4874c 
Dealt to Hero [9d Kd]
Dealt to 2a393f2d 
Dealt to 9b1a3dd2 
Dealt to 8dbd0a2d 
Dealt to 3dbbdac8 
9b1a3dd2: raises $0.07 to $0.12
8dbd0a2d: folds
3dbbdac8: folds
24c4874c: folds
Hero: folds
2a393f2d: calls $0.07
*** FLOP *** [3c 2h 2s]
2a393f2d: checks
9b1a3dd2: bets $0.09
2a393f2d: folds
Uncalled bet ($0.09) returned to 9b1a3dd2
*** SHOWDOWN ***
9b1a3dd2 collected $0.25 from pot
*** SUMMARY ***
Total pot $0.26 | Rake $0.01 | Jackpot $0 | Bingo $0 | Fortune $0 | Tax $0
Board [3c 2h 2s]
Seat 1: 24c4874c (button) folded before Flop (didn't bet)
Seat 2: Hero (small blind) folded before Flop
Seat 3: 2a393f2d (big blind) folded on the Flop
Seat 4: 9b1a3dd2 won ($0.25)
Seat 5: 8dbd0a2d folded before Flop (didn't bet)
Seat 6: 3dbbdac8 folded before Flop (didn't bet)


Poker Hand #RC3334436531: Hold'em No Limit ($0.02/$0.05) - 2025/02/17 20:33:11
Table 'RushAndCash601791' 6-max Seat #1 is the button
Seat 1: 3100dcf0 ($5.95 in chips)
Seat 2: 5381eb4c ($5.41 in chips)
Seat 3: 7da1f29c ($5.53 in chips)
Seat 4: 673e17b3 ($5.07 in chips)
Seat 5: Hero ($5.07 in chips)
Seat 6: c096c24 ($5.23 in chips)
5381eb4c: posts small blind $0.02
7da1f29c: posts big blind $0.05
*** HOLE CARDS ***
Dealt to 3100dcf0 
Dealt to 5381eb4c 
Dealt to 7da1f29c 
Dealt to 673e17b3 
Dealt to Hero [3d 4d]
Dealt to c096c24 
673e17b3: folds
Hero: folds
c096c24: folds
3100dcf0: folds
5381eb4c: folds
Uncalled bet ($0.03) returned to 7da1f29c
*** SHOWDOWN ***
7da1f29c collected $0.04 from pot
*** SUMMARY ***
Total pot $0.04 | Rake $0 | Jackpot $0 | Bingo $0 | Fortune $0 | Tax $0
Seat 1: 3100dcf0 (button) folded before Flop (didn't bet)
Seat 2: 5381eb4c (small blind) folded before Flop
Seat 3: 7da1f29c (big blind) collected ($0.04)
Seat 4: 673e17b3 folded before Flop (didn't bet)
Seat 5: Hero folded before Flop (didn't bet)
Seat 6: c096c24 folded before Flop (didn't bet)


Poker Hand #RC3334436438: Hold'em No Limit ($0.02/$0.05) - 2025/02/17 20:32:59
Table 'RushAndCash601698' 6-max Seat #1 is the button
Seat 1: b0ee20aa ($20.27 in chips)
Seat 2: ef63200d ($7.49 in chips)
Seat 3: 3b2a8270 ($9.71 in chips)
Seat 4: 2b6388ee ($5.84 in chips)
Seat 5: Hero ($5 in chips)
Seat 6: 8ef8563d ($5.26 in chips)
ef63200d: posts small blind $0.02
3b2a8270: posts big blind $0.05
*** HOLE CARDS ***
Dealt to b0ee20aa 
Dealt to ef63200d 
Dealt to 3b2a8270 
Dealt to 2b6388ee 
Dealt to Hero [Kd Kc]
Dealt to 8ef8563d 
2b6388ee: folds
Hero: raises $0.05 to $0.1
8ef8563d: folds
b0ee20aa: folds
ef63200d: folds
3b2a8270: folds
Uncalled bet ($0.05) returned to Hero
*** SHOWDOWN ***
Hero collected $0.12 from pot
*** SUMMARY ***
Total pot $0.12 | Rake $0 | Jackpot $0 | Bingo $0 | Fortune $0 | Tax $0
Seat 1: b0ee20aa (button) folded before Flop (didn't bet)
Seat 2: ef63200d (small blind) folded before Flop
Seat 3: 3b2a8270 (big blind) folded before Flop
Seat 4: 2b6388ee folded before Flop (didn't bet)
Seat 5: Hero collected ($0.12)
Seat 6: 8ef8563d folded before Flop (didn't bet)


Poker Hand #RC3334436394: Hold'em No Limit ($0.02/$0.05) - 2025/02/17 20:32:52
Table 'RushAndCash601654' 6-max Seat #1 is the button
Seat 1: Hero ($5 in chips)
Seat 2: 9684e9f0 ($6.57 in chips)
Seat 3: e4fd2097 ($16.17 in chips)
Seat 4: 220f45a7 ($3.22 in chips)
Seat 5: 856cc88a ($4.86 in chips)
Seat 6: 18cb11a ($5.64 in chips)
9684e9f0: posts small blind $0.02
e4fd2097: posts big blind $0.05
*** HOLE CARDS ***
Dealt to Hero [2d 3h]
Dealt to 9684e9f0 
Dealt to e4fd2097 
Dealt to 220f45a7 
Dealt to 856cc88a 
Dealt to 18cb11a 
220f45a7: folds
856cc88a: folds
18cb11a: folds
Hero: folds
9684e9f0: folds
Uncalled bet ($0.03) returned to e4fd2097
*** SHOWDOWN ***
e4fd2097 collected $0.04 from pot
*** SUMMARY ***
Total pot $0.04 | Rake $0 | Jackpot $0 | Bingo $0 | Fortune $0 | Tax $0
Seat 1: Hero (button) folded before Flop (didn't bet)
Seat 2: 9684e9f0 (small blind) folded before Flop
Seat 3: e4fd2097 (big blind) collected ($0.04)
Seat 4: 220f45a7 folded before Flop (didn't bet)
Seat 5: 856cc88a folded before Flop (didn't bet)
Seat 6: 18cb11a folded before Flop (didn't bet)


Poker Hand #RC3334436362: Hold'em No Limit ($0.02/$0.05) - 2025/02/17 20:32:48
Table 'RushAndCash601622' 6-max Seat #1 is the button
Seat 1: 6c8cb957 ($5.49 in chips)
Seat 2: 99df5763 ($4.81 in chips)
Seat 3: 100d4f9e ($5.07 in chips)
Seat 4: 12cda2e0 ($17.53 in chips)
Seat 5: Hero ($5 in chips)
Seat 6: 742ccfee ($3.95 in chips)
99df5763: posts small blind $0.02
100d4f9e: posts big blind $0.05
*** HOLE CARDS ***
Dealt to 6c8cb957 
Dealt to 99df5763 
Dealt to 100d4f9e 
Dealt to 12cda2e0 
Dealt to Hero [Ah 5d]
Dealt to 742ccfee 
12cda2e0: folds
Hero: folds
742ccfee: folds
6c8cb957: folds
99df5763: folds
Uncalled bet ($0.03) returned to 100d4f9e
*** SHOWDOWN ***
100d4f9e collected $0.04 from pot
*** SUMMARY ***
Total pot $0.04 | Rake $0 | Jackpot $0 | Bingo $0 | Fortune $0 | Tax $0
Seat 1: 6c8cb957 (button) folded before Flop (didn't bet)
Seat 2: 99df5763 (small blind) folded before Flop
Seat 3: 100d4f9e (big blind) collected ($0.04)
Seat 4: 12cda2e0 folded before Flop (didn't bet)
Seat 5: Hero folded before Flop (didn't bet)
Seat 6: 742ccfee folded before Flop (didn't bet)


Poker Hand #RC3334436343: Hold'em No Limit ($0.02/$0.05) - 2025/02/17 20:32:45
Table 'RushAndCash601603' 6-max Seat #1 is the button
Seat 1: edbb0bb6 ($6.33 in chips)
Seat 2: Hero ($5.02 in chips)
Seat 3: 6be17d4e ($5.22 in chips)
Seat 4: fb6c4072 ($6.27 in chips)
Seat 5: 436ecab0 ($2.21 in chips)
Seat 6: d75cab93 ($5 in chips)
Hero: posts small blind $0.02
6be17d4e: posts big blind $0.05
*** HOLE CARDS ***
Dealt to edbb0bb6 
Dealt to Hero [9s 6h]
Dealt to 6be17d4e 
Dealt to fb6c4072 
Dealt to 436ecab0 
Dealt to d75cab93 
fb6c4072: folds
436ecab0: folds
d75cab93: raises $0.06 to $0.11
edbb0bb6: folds
Hero: folds
6be17d4e: raises $0.44 to $0.55
d75cab93: calls $0.44
*** FLOP *** [3h Jh 3d]
6be17d4e: checks
d75cab93: checks
*** TURN *** [3h Jh 3d] [4s]
6be17d4e: checks
d75cab93: bets $0.5
6be17d4e: calls $0.5
*** RIVER *** [3h Jh 3d 4s] [4c]
6be17d4e: checks
d75cab93: checks
6be17d4e: shows [Jc Js] (Jacks Full over Fours)
d75cab93: shows [7s 7c] (Pair of Sevens and Pair of Fours)
*** SHOWDOWN ***
6be17d4e collected $1.95 from pot
*** SUMMARY ***
Total pot $2.12 | Rake $0.1 | Jackpot $0.07 | Bingo $0 | Fortune $0 | Tax $0
Board [3h Jh 3d 4s 4c]
Seat 1: edbb0bb6 (button) folded before Flop (didn't bet)
Seat 2: Hero (small blind) folded before Flop
Seat 3: 6be17d4e (big blind) showed [Jc Js] and won ($1.95) with Jacks Full over Fours
Seat 4: fb6c4072 folded before Flop (didn't bet)
Seat 5: 436ecab0 folded before Flop (didn't bet)
Seat 6: d75cab93 showed [7s 7c] and lost with Pair of Sevens and Pair of Fours


Poker Hand #RC3334436311: Hold'em No Limit ($0.02/$0.05) - 2025/02/17 20:32:40
Table 'RushAndCash601571' 6-max Seat #1 is the button
Seat 1: b44ff266 ($5.29 in chips)
Seat 2: 64f89f4b ($5.62 in chips)
Seat 3: Hero ($5.07 in chips)
Seat 4: 2f12456d ($5.43 in chips)
Seat 5: 2809b559 ($5.66 in chips)
Seat 6: 8012317b ($11.88 in chips)
64f89f4b: posts small blind $0.02
Hero: posts big blind $0.05
*** HOLE CARDS ***
Dealt to b44ff266 
Dealt to 64f89f4b 
Dealt to Hero [Js 3h]
Dealt to 2f12456d 
Dealt to 2809b559 
Dealt to 8012317b 
2f12456d: folds
2809b559: folds
8012317b: raises $0.07 to $0.12
b44ff266: folds
64f89f4b: folds
Hero: folds
Uncalled bet ($0.07) returned to 8012317b
*** SHOWDOWN ***
8012317b collected $0.12 from pot
*** SUMMARY ***
Total pot $0.12 | Rake $0 | Jackpot $0 | Bingo $0 | Fortune $0 | Tax $0
Seat 1: b44ff266 (button) folded before Flop (didn't bet)
Seat 2: 64f89f4b (small blind) folded before Flop
Seat 3: Hero (big blind) folded before Flop
Seat 4: 2f12456d folded before Flop (didn't bet)
Seat 5: 2809b559 folded before Flop (didn't bet)
Seat 6: 8012317b collected ($0.12)


Poker Hand #RC3334436284: Hold'em No Limit ($0.02/$0.05) - 2025/02/17 20:32:37
Table 'RushAndCash601544' 6-max Seat #1 is the button
Seat 1: 207d9345 ($23.13 in chips)
Seat 2: 27baaa05 ($7.45 in chips)
Seat 3: eed867f5 ($4.61 in chips)
Seat 4: 8dd966e8 ($5.41 in chips)
Seat 5: 59f12f9f ($5.93 in chips)
Seat 6: Hero ($5.07 in chips)
27baaa05: posts small blind $0.02
eed867f5: posts big blind $0.05
*** HOLE CARDS ***
Dealt to 207d9345 
Dealt to 27baaa05 
Dealt to eed867f5 
Dealt to 8dd966e8 
Dealt to 59f12f9f 
Dealt to Hero [2d 2s]
8dd966e8: folds
59f12f9f: folds
Hero: folds
207d9345: folds
27baaa05: raises $0.08 to $0.13
eed867f5: folds
Uncalled bet ($0.08) returned to 27baaa05
*** SHOWDOWN ***
27baaa05 collected $0.1 from pot
*** SUMMARY ***
Total pot $0.1 | Rake $0 | Jackpot $0 | Bingo $0 | Fortune $0 | Tax $0
Seat 1: 207d9345 (button) folded before Flop (didn't bet)
Seat 2: 27baaa05 (small blind) collected ($0.1)
Seat 3: eed867f5 (big blind) folded before Flop
Seat 4: 8dd966e8 folded before Flop (didn't bet)
Seat 5: 59f12f9f folded before Flop (didn't bet)
Seat 6: Hero folded before Flop (didn't bet)


Poker Hand #RC3334436263: Hold'em No Limit ($0.02/$0.05) - 2025/02/17 20:32:34
Table 'RushAndCash601523' 6-max Seat #1 is the button
Seat 1: Hero ($5.07 in chips)
Seat 2: 45833808 ($6.43 in chips)
Seat 3: 6d5fa70b ($6.88 in chips)
Seat 4: f171b990 ($7.34 in chips)
Seat 5: f20f94d9 ($5.86 in chips)
Seat 6: 918d412c ($3.29 in chips)
45833808: posts small blind $0.02
6d5fa70b: posts big blind $0.05
*** HOLE CARDS ***
Dealt to Hero [5h Qh]
Dealt to 45833808 
Dealt to 6d5fa70b 
Dealt to f171b990 
Dealt to f20f94d9 
Dealt to 918d412c 
f171b990: folds
f20f94d9: raises $0.05 to $0.1
918d412c: folds
Hero: folds
45833808: folds
6d5fa70b: folds
Uncalled bet ($0.05) returned to f20f94d9
*** SHOWDOWN ***
f20f94d9 collected $0.12 from pot
*** SUMMARY ***
Total pot $0.12 | Rake $0 | Jackpot $0 | Bingo $0 | Fortune $0 | Tax $0
Seat 1: Hero (button) folded before Flop (didn't bet)
Seat 2: 45833808 (small blind) folded before Flop
Seat 3: 6d5fa70b (big blind) folded before Flop
Seat 4: f171b990 folded before Flop (didn't bet)
Seat 5: f20f94d9 collected ($0.12)
Seat 6: 918d412c folded before Flop (didn't bet)


Poker Hand #RC3334436139: Hold'em No Limit ($0.02/$0.05) - 2025/02/17 20:32:17
Table 'RushAndCash601399' 6-max Seat #1 is the button
Seat 1: 52f43d28 ($7.36 in chips)
Seat 2: 6f8bb9d1 ($7.41 in chips)
Seat 3: 6aa0c391 ($5.79 in chips)
Seat 4: d606d9 ($6.55 in chips)
Seat 5: Hero ($5 in chips)
Seat 6: 1c01f5f5 ($5.47 in chips)
6f8bb9d1: posts small blind $0.02
6aa0c391: posts big blind $0.05
*** HOLE CARDS ***
Dealt to 52f43d28 
Dealt to 6f8bb9d1 
Dealt to 6aa0c391 
Dealt to d606d9 
Dealt to Hero [Jc Jh]
Dealt to 1c01f5f5 
d606d9: folds
Hero: raises $0.05 to $0.1
1c01f5f5: folds
52f43d28: folds
6f8bb9d1: folds
6aa0c391: folds
Uncalled bet ($0.05) returned to Hero
*** SHOWDOWN ***
Hero collected $0.12 from pot
*** SUMMARY ***
Total pot $0.12 | Rake $0 | Jackpot $0 | Bingo $0 | Fortune $0 | Tax $0
Seat 1: 52f43d28 (button) folded before Flop (didn't bet)
Seat 2: 6f8bb9d1 (small blind) folded before Flop
Seat 3: 6aa0c391 (big blind) folded before Flop
Seat 4: d606d9 folded before Flop (didn't bet)
Seat 5: Hero collected ($0.12)
Seat 6: 1c01f5f5 folded before Flop (didn't bet)


Poker Hand #RC3334436116: Hold'em No Limit ($0.02/$0.05) - 2025/02/17 20:32:14
Table 'RushAndCash601376' 6-max Seat #1 is the button
Seat 1: 11fb4d12 ($10.76 in chips)
Seat 2: 7f3dcda7 ($9.34 in chips)
Seat 3: Hero ($5 in chips)
Seat 4: 5b91a195 ($5.16 in chips)
Seat 5: 61b789ce ($5 in chips)
Seat 6: ee5bb31d ($5.19 in chips)
7f3dcda7: posts small blind $0.02
Hero: posts big blind $0.05
*** HOLE CARDS ***
Dealt to 11fb4d12 
Dealt to 7f3dcda7 
Dealt to Hero [8h 3d]
Dealt to 5b91a195 
Dealt to 61b789ce 
Dealt to ee5bb31d 
5b91a195: raises $0.1 to $0.15
61b789ce: folds
ee5bb31d: folds
11fb4d12: raises $0.28 to $0.43
7f3dcda7: folds
Hero: folds
5b91a195: raises $0.93 to $1.36
11fb4d12: calls $0.93
*** FLOP *** [8s Kd Tc]
5b91a195: bets $3.8 and is all-in
11fb4d12: folds
Uncalled bet ($3.8) returned to 5b91a195
*** SHOWDOWN ***
5b91a195 collected $2.59 from pot
*** SUMMARY ***
Total pot $2.79 | Rake $0.13 | Jackpot $0.07 | Bingo $0 | Fortune $0 | Tax $0
Board [8s Kd Tc]
Seat 1: 11fb4d12 (button) folded on the Flop
Seat 2: 7f3dcda7 (small blind) folded before Flop
Seat 3: Hero (big blind) folded before Flop
Seat 4: 5b91a195 won ($2.59)
Seat 5: 61b789ce folded before Flop (didn't bet)
Seat 6: ee5bb31d folded before Flop (didn't bet)


Poker Hand #RC3334436094: Hold'em No Limit ($0.02/$0.05) - 2025/02/17 20:32:11
Table 'RushAndCash601354' 6-max Seat #1 is the button
Seat 1: 5381eb4c ($5.41 in chips)
Seat 2: 9938ef4e ($5 in chips)
Seat 3: b00c4f8 ($9.82 in chips)
Seat 4: Hero ($5 in chips)
Seat 5: fe374609 ($5.4 in chips)
Seat 6: c585480d ($5.33 in chips)
9938ef4e: posts small blind $0.02
b00c4f8: posts big blind $0.05
*** HOLE CARDS ***
Dealt to 5381eb4c 
Dealt to 9938ef4e 
Dealt to b00c4f8 
Dealt to Hero [Th 3d]
Dealt to fe374609 
Dealt to c585480d 
Hero: folds
fe374609: folds
c585480d: folds
5381eb4c: folds
9938ef4e: raises $0.1 to $0.15
b00c4f8: folds
Uncalled bet ($0.1) returned to 9938ef4e
*** SHOWDOWN ***
9938ef4e collected $0.1 from pot
*** SUMMARY ***
Total pot $0.1 | Rake $0 | Jackpot $0 | Bingo $0 | Fortune $0 | Tax $0
Seat 1: 5381eb4c (button) folded before Flop (didn't bet)
Seat 2: 9938ef4e (small blind) collected ($0.1)
Seat 3: b00c4f8 (big blind) folded before Flop
Seat 4: Hero folded before Flop (didn't bet)
Seat 5: fe374609 folded before Flop (didn't bet)
Seat 6: c585480d folded before Flop (didn't bet)


Poker Hand #RC3334436070: Hold'em No Limit ($0.02/$0.05) - 2025/02/17 20:32:07
Table 'RushAndCash601330' 6-max Seat #1 is the button
Seat 1: 84b68722 ($17.83 in chips)
Seat 2: 1aca371e ($7.53 in chips)
Seat 3: 2b9f39df ($5 in chips)
Seat 4: Hero ($5 in chips)
Seat 5: 742ccfee ($4.06 in chips)
Seat 6: 1696890b ($4.44 in chips)
1aca371e: posts small blind $0.02
2b9f39df: posts big blind $0.05
*** HOLE CARDS ***
Dealt to 84b68722 
Dealt to 1aca371e 
Dealt to 2b9f39df 
Dealt to Hero [Qc 5h]
Dealt to 742ccfee 
Dealt to 1696890b 
Hero: folds
742ccfee: folds
1696890b: folds
84b68722: folds
1aca371e: raises $0.11 to $0.16
2b9f39df: folds
Uncalled bet ($0.11) returned to 1aca371e
*** SHOWDOWN ***
1aca371e collected $0.1 from pot
*** SUMMARY ***
Total pot $0.1 | Rake $0 | Jackpot $0 | Bingo $0 | Fortune $0 | Tax $0
Seat 1: 84b68722 (button) folded before Flop (didn't bet)
Seat 2: 1aca371e (small blind) collected ($0.1)
Seat 3: 2b9f39df (big blind) folded before Flop
Seat 4: Hero folded before Flop (didn't bet)
Seat 5: 742ccfee folded before Flop (didn't bet)
Seat 6: 1696890b folded before Flop (didn't bet)


Poker Hand #RC3334436048: Hold'em No Limit ($0.02/$0.05) - 2025/02/17 20:32:04
Table 'RushAndCash601308' 6-max Seat #1 is the button
Seat 1: ef7e6107 ($5 in chips)
Seat 2: Hero ($5 in chips)
Seat 3: 77368e62 ($5.58 in chips)
Seat 4: 56cefdc9 ($3.28 in chips)
Seat 5: 1696890b ($4.44 in chips)
Seat 6: 187f2194 ($9.86 in chips)
Hero: posts small blind $0.02
77368e62: posts big blind $0.05
*** HOLE CARDS ***
Dealt to ef7e6107 
Dealt to Hero [As 7d]
Dealt to 77368e62 
Dealt to 56cefdc9 
Dealt to 1696890b 
Dealt to 187f2194 
56cefdc9: folds
1696890b: folds
187f2194: raises $0.08 to $0.13
ef7e6107: folds
Hero: folds
77368e62: calls $0.08
*** FLOP *** [4h Ad 4c]
77368e62: checks
187f2194: bets $0.25
77368e62: calls $0.25
*** TURN *** [4h Ad 4c] [Th]
77368e62: checks
187f2194: bets $0.72
77368e62: calls $0.72
*** RIVER *** [4h Ad 4c Th] [6d]
77368e62: checks
187f2194: checks
77368e62: shows [Ac 8c] (Pair of Aces and Pair of Fours)
187f2194: shows [Kh Ah] (Pair of Aces and Pair of Fours)
*** SHOWDOWN ***
187f2194 collected $2.05 from pot
*** SUMMARY ***
Total pot $2.22 | Rake $0.1 | Jackpot $0.07 | Bingo $0 | Fortune $0 | Tax $0
Board [4h Ad 4c Th 6d]
Seat 1: ef7e6107 (button) folded before Flop (didn't bet)
Seat 2: Hero (small blind) folded before Flop
Seat 3: 77368e62 (big blind) showed [Ac 8c] and lost with Pair of Aces and Pair of Fours
Seat 4: 56cefdc9 folded before Flop (didn't bet)
Seat 5: 1696890b folded before Flop (didn't bet)
Seat 6: 187f2194 showed [Kh Ah] and won ($2.05) with Pair of Aces and Pair of Fours


Poker Hand #RC3334436022: Hold'em No Limit ($0.02/$0.05) - 2025/02/17 20:32:00
Table 'RushAndCash601282' 6-max Seat #1 is the button
Seat 1: e6dc3dd2 ($6.78 in chips)
Seat 2: 77d1364f ($4.88 in chips)
Seat 3: 19bb03b5 ($13.26 in chips)
Seat 4: d69ec1a4 ($5.52 in chips)
Seat 5: Hero ($5 in chips)
Seat 6: dbf5f543 ($4.75 in chips)
77d1364f: posts small blind $0.02
19bb03b5: posts big blind $0.05
*** HOLE CARDS ***
Dealt to e6dc3dd2 
Dealt to 77d1364f 
Dealt to 19bb03b5 
Dealt to d69ec1a4 
Dealt to Hero [Ts 6s]
Dealt to dbf5f543 
d69ec1a4: folds
Hero: folds
dbf5f543: folds
e6dc3dd2: folds
77d1364f: raises $0.1 to $0.15
19bb03b5: raises $0.35 to $0.5
77d1364f: folds
Uncalled bet ($0.35) returned to 19bb03b5
*** SHOWDOWN ***
19bb03b5 collected $0.29 from pot
*** SUMMARY ***
Total pot $0.3 | Rake $0.01 | Jackpot $0 | Bingo $0 | Fortune $0 | Tax $0
Seat 1: e6dc3dd2 (button) folded before Flop (didn't bet)
Seat 2: 77d1364f (small blind) folded before Flop
Seat 3: 19bb03b5 (big blind) collected ($0.29)
Seat 4: d69ec1a4 folded before Flop (didn't bet)
Seat 5: Hero folded before Flop (didn't bet)
Seat 6: dbf5f543 folded before Flop (didn't bet)


Poker Hand #RC3334435999: Hold'em No Limit ($0.02/$0.05) - 2025/02/17 20:31:56
Table 'RushAndCash601259' 6-max Seat #1 is the button
Seat 1: Hero ($5 in chips)
Seat 2: 48dc6454 ($2.77 in chips)
Seat 3: b4c33f6c ($5.07 in chips)
Seat 4: 6e885b98 ($5 in chips)
Seat 5: f23e7bad ($7.59 in chips)
Seat 6: 45a5085b ($1.8 in chips)
48dc6454: posts small blind $0.02
b4c33f6c: posts big blind $0.05
*** HOLE CARDS ***
Dealt to Hero [Kh 7c]
Dealt to 48dc6454 
Dealt to b4c33f6c 
Dealt to 6e885b98 
Dealt to f23e7bad 
Dealt to 45a5085b 
6e885b98: folds
f23e7bad: folds
45a5085b: raises $0.08 to $0.13
Hero: folds
48dc6454: folds
b4c33f6c: folds
Uncalled bet ($0.08) returned to 45a5085b
*** SHOWDOWN ***
45a5085b collected $0.12 from pot
*** SUMMARY ***
Total pot $0.12 | Rake $0 | Jackpot $0 | Bingo $0 | Fortune $0 | Tax $0
Seat 1: Hero (button) folded before Flop (didn't bet)
Seat 2: 48dc6454 (small blind) folded before Flop
Seat 3: b4c33f6c (big blind) folded before Flop
Seat 4: 6e885b98 folded before Flop (didn't bet)
Seat 5: f23e7bad folded before Flop (didn't bet)
Seat 6: 45a5085b collected ($0.12)


Poker Hand #RC3334435971: Hold'em No Limit ($0.02/$0.05) - 2025/02/17 20:31:52
Table 'RushAndCash601231' 6-max Seat #1 is the button
Seat 1: Hero ($5 in chips)
Seat 2: a223d3ca ($5.06 in chips)
Seat 3: d913286e ($5.96 in chips)
Seat 4: fa40c39c ($5.31 in chips)
Seat 5: 27020fb4 ($12.24 in chips)
Seat 6: b59fc0b9 ($5 in chips)
a223d3ca: posts small blind $0.02
d913286e: posts big blind $0.05
*** HOLE CARDS ***
Dealt to Hero [Ts 5c]
Dealt to a223d3ca 
Dealt to d913286e 
Dealt to fa40c39c 
Dealt to 27020fb4 
Dealt to b59fc0b9 
fa40c39c: folds
27020fb4: folds
b59fc0b9: folds
Hero: folds
a223d3ca: raises $0.08 to $0.13
d913286e: folds
Uncalled bet ($0.08) returned to a223d3ca
*** SHOWDOWN ***
a223d3ca collected $0.1 from pot
*** SUMMARY ***
Total pot $0.1 | Rake $0 | Jackpot $0 | Bingo $0 | Fortune $0 | Tax $0
Seat 1: Hero (button) folded before Flop (didn't bet)
Seat 2: a223d3ca (small blind) collected ($0.1)
Seat 3: d913286e (big blind) folded before Flop
Seat 4: fa40c39c folded before Flop (didn't bet)
Seat 5: 27020fb4 folded before Flop (didn't bet)
Seat 6: b59fc0b9 folded before Flop (didn't bet)


Poker Hand #RC3334435951: Hold'em No Limit ($0.02/$0.05) - 2025/02/17 20:31:49
Table 'RushAndCash601211' 6-max Seat #1 is the button
Seat 1: f95a8210 ($6.24 in chips)
Seat 2: Hero ($5 in chips)
Seat 3: 9b99e93a ($5.51 in chips)
Seat 4: 9b7e5117 ($1.92 in chips)
Seat 5: 38f4cc4d ($4.84 in chips)
Seat 6: 3100dcf0 ($6.08 in chips)
Hero: posts small blind $0.02
9b99e93a: posts big blind $0.05
*** HOLE CARDS ***
Dealt to f95a8210 
Dealt to Hero [5d 7c]
Dealt to 9b99e93a 
Dealt to 9b7e5117 
Dealt to 38f4cc4d 
Dealt to 3100dcf0 
9b7e5117: calls $0.05
38f4cc4d: calls $0.05
3100dcf0: folds
f95a8210: raises $0.15 to $0.2
Hero: folds
9b99e93a: raises $0.52 to $0.72
9b7e5117: folds
38f4cc4d: folds
f95a8210: raises $1.05 to $1.77
9b99e93a: raises $3.74 to $5.51 and is all-in
f95a8210: calls $3.74
9b99e93a: shows [Ah Ad]
f95a8210: shows [Ks Kd]
*** FLOP *** [2d 8s Th]
*** TURN *** [2d 8s Th] [Ts]
*** RIVER *** [2d 8s Th Ts] [7s]
9b7e5117: shows [4h Kh] (Pair of Tens)
*** SHOWDOWN ***
9b99e93a collected $10.92 from pot
*** SUMMARY ***
Total pot $11.14 | Rake $0.15 | Jackpot $0.07 | Bingo $0 | Fortune $0 | Tax $0
Board [2d 8s Th Ts 7s]
Seat 1: f95a8210 (button) showed [Ks Kd] and lost with Pair of Kings and Pair of Tens
Seat 2: Hero (small blind) folded before Flop
Seat 3: 9b99e93a (big blind) showed [Ah Ad] and won ($10.92) with Pair of Aces and Pair of Tens
Seat 4: 9b7e5117 folded before Flop
Seat 5: 38f4cc4d folded before Flop
Seat 6: 3100dcf0 folded before Flop (didn't bet)


Poker Hand #RC3334435931: Hold'em No Limit ($0.02/$0.05) - 2025/02/17 20:31:46
Table 'RushAndCash601191' 6-max Seat #1 is the button
Seat 1: 7de3ae0a ($5.35 in chips)
Seat 2: 570c97fe ($5.99 in chips)
Seat 3: fa7bb2c5 ($5.51 in chips)
Seat 4: 692e3a83 ($12.69 in chips)
Seat 5: ef63200d ($7.17 in chips)
Seat 6: Hero ($5 in chips)
570c97fe: posts small blind $0.02
fa7bb2c5: posts big blind $0.05
*** HOLE CARDS ***
Dealt to 7de3ae0a 
Dealt to 570c97fe 
Dealt to fa7bb2c5 
Dealt to 692e3a83 
Dealt to ef63200d 
Dealt to Hero [5s Qd]
692e3a83: folds
ef63200d: raises $0.05 to $0.1
Hero: folds
7de3ae0a: calls $0.1
570c97fe: calls $0.08
fa7bb2c5: calls $0.05
*** FLOP *** [8s Kh Kc]
570c97fe: checks
fa7bb2c5: checks
ef63200d: bets $0.52
7de3ae0a: folds
570c97fe: folds
fa7bb2c5: folds
Uncalled bet ($0.52) returned to ef63200d
*** SHOWDOWN ***
ef63200d collected $0.38 from pot
*** SUMMARY ***
Total pot $0.4 | Rake $0.02 | Jackpot $0 | Bingo $0 | Fortune $0 | Tax $0
Board [8s Kh Kc]
Seat 1: 7de3ae0a (button) folded on the Flop
Seat 2: 570c97fe (small blind) folded on the Flop
Seat 3: fa7bb2c5 (big blind) folded on the Flop
Seat 4: 692e3a83 folded before Flop (didn't bet)
Seat 5: ef63200d won ($0.38)
Seat 6: Hero folded before Flop (didn't bet)


Poker Hand #RC3334435900: Hold'em No Limit ($0.02/$0.05) - 2025/02/17 20:31:41
Table 'RushAndCash601160' 6-max Seat #1 is the button
Seat 1: 35fb946f ($5.02 in chips)
Seat 2: 79df293 ($5 in chips)
Seat 3: a6ca20e7 ($35.28 in chips)
Seat 4: f20f94d9 ($5.86 in chips)
Seat 5: 97fe2676 ($10.82 in chips)
Seat 6: Hero ($5 in chips)
79df293: posts small blind $0.02
a6ca20e7: posts big blind $0.05
*** HOLE CARDS ***
Dealt to 35fb946f 
Dealt to 79df293 
Dealt to a6ca20e7 
Dealt to f20f94d9 
Dealt to 97fe2676 
Dealt to Hero [4h 3d]
f20f94d9: folds
97fe2676: raises $0.05 to $0.1
Hero: folds
35fb946f: folds
79df293: folds
a6ca20e7: calls $0.05
*** FLOP *** [Js Jd 9c]
a6ca20e7: checks
97fe2676: checks
*** TURN *** [Js Jd 9c] [4d]
a6ca20e7: checks
97fe2676: checks
*** RIVER *** [Js Jd 9c 4d] [3h]
a6ca20e7: checks
97fe2676: checks
a6ca20e7: shows [Ac 5c] (Pair of Jacks)
97fe2676: shows [6d Kd] (Pair of Jacks)
*** SHOWDOWN ***
a6ca20e7 collected $0.21 from pot
*** SUMMARY ***
Total pot $0.22 | Rake $0.01 | Jackpot $0 | Bingo $0 | Fortune $0 | Tax $0
Board [Js Jd 9c 4d 3h]
Seat 1: 35fb946f (button) folded before Flop (didn't bet)
Seat 2: 79df293 (small blind) folded before Flop
Seat 3: a6ca20e7 (big blind) showed [Ac 5c] and won ($0.21) with Pair of Jacks
Seat 4: f20f94d9 folded before Flop (didn't bet)
Seat 5: 97fe2676 showed [6d Kd] and lost with Pair of Jacks
Seat 6: Hero folded before Flop (didn't bet)


Poker Hand #RC3334435853: Hold'em No Limit ($0.02/$0.05) - 2025/02/17 20:31:33
Table 'RushAndCash601113' 6-max Seat #1 is the button
Seat 1: ec1d0d44 ($11.15 in chips)
Seat 2: 598d859f ($5.18 in chips)
Seat 3: dbf5f543 ($4.73 in chips)
Seat 4: Hero ($5 in chips)
Seat 5: 92fa3d91 ($3.25 in chips)
Seat 6: e632d40b ($7.11 in chips)
598d859f: posts small blind $0.02
dbf5f543: posts big blind $0.05
*** HOLE CARDS ***
Dealt to ec1d0d44 
Dealt to 598d859f 
Dealt to dbf5f543 
Dealt to Hero [9h Kc]
Dealt to 92fa3d91 
Dealt to e632d40b 
Hero: folds
92fa3d91: folds
e632d40b: raises $0.05 to $0.1
ec1d0d44: calls $0.1
598d859f: folds
dbf5f543: folds
*** FLOP *** [8s 2s Kd]
e632d40b: checks
ec1d0d44: bets $0.1
e632d40b: folds
Uncalled bet ($0.1) returned to ec1d0d44
*** SHOWDOWN ***
ec1d0d44 collected $0.26 from pot
*** SUMMARY ***
Total pot $0.27 | Rake $0.01 | Jackpot $0 | Bingo $0 | Fortune $0 | Tax $0
Board [8s 2s Kd]
Seat 1: ec1d0d44 (button) won ($0.26)
Seat 2: 598d859f (small blind) folded before Flop
Seat 3: dbf5f543 (big blind) folded before Flop
Seat 4: Hero folded before Flop (didn't bet)
Seat 5: 92fa3d91 folded before Flop (didn't bet)
Seat 6: e632d40b folded on the Flop


Poker Hand #RC3334435813: Hold'em No Limit ($0.02/$0.05) - 2025/02/17 20:31:27
Table 'RushAndCash601073' 6-max Seat #1 is the button
Seat 1: 8ec32764 ($5.24 in chips)
Seat 2: 1e474bac ($5 in chips)
Seat 3: Hero ($5 in chips)
Seat 4: a21d255c ($5.01 in chips)
Seat 5: 1696890b ($4.46 in chips)
Seat 6: 8dbd0a2d ($5.41 in chips)
1e474bac: posts small blind $0.02
Hero: posts big blind $0.05
*** HOLE CARDS ***
Dealt to 8ec32764 
Dealt to 1e474bac 
Dealt to Hero [Ks 9d]
Dealt to a21d255c 
Dealt to 1696890b 
Dealt to 8dbd0a2d 
a21d255c: folds
1696890b: raises $0.1 to $0.15
8dbd0a2d: folds
8ec32764: folds
1e474bac: folds
Hero: folds
Uncalled bet ($0.1) returned to 1696890b
*** SHOWDOWN ***
1696890b collected $0.12 from pot
*** SUMMARY ***
Total pot $0.12 | Rake $0 | Jackpot $0 | Bingo $0 | Fortune $0 | Tax $0
Seat 1: 8ec32764 (button) folded before Flop (didn't bet)
Seat 2: 1e474bac (small blind) folded before Flop
Seat 3: Hero (big blind) folded before Flop
Seat 4: a21d255c folded before Flop (didn't bet)
Seat 5: 1696890b collected ($0.12)
Seat 6: 8dbd0a2d folded before Flop (didn't bet)


Poker Hand #RC3334435786: Hold'em No Limit ($0.02/$0.05) - 2025/02/17 20:31:22
Table 'RushAndCash601046' 6-max Seat #1 is the button
Seat 1: Hero ($5 in chips)
Seat 2: 491e0e63 ($5.02 in chips)
Seat 3: cf593991 ($5 in chips)
Seat 4: 650e9dc7 ($5.68 in chips)
Seat 5: 48fa5407 ($5.29 in chips)
Seat 6: b59fc0b9 ($5 in chips)
491e0e63: posts small blind $0.02
cf593991: posts big blind $0.05
*** HOLE CARDS ***
Dealt to Hero [9c 3h]
Dealt to 491e0e63 
Dealt to cf593991 
Dealt to 650e9dc7 
Dealt to 48fa5407 
Dealt to b59fc0b9 
650e9dc7: folds
48fa5407: raises $0.05 to $0.1
b59fc0b9: folds
Hero: folds
491e0e63: calls $0.08
cf593991: folds
*** FLOP *** [5d Jc 8c]
491e0e63: checks
48fa5407: checks
*** TURN *** [5d Jc 8c] [As]
491e0e63: checks
48fa5407: checks
*** RIVER *** [5d Jc 8c As] [4c]
491e0e63: bets $0.19
48fa5407: raises $5 to $5.19 and is all-in
491e0e63: folds
Uncalled bet ($5) returned to 48fa5407
*** SHOWDOWN ***
48fa5407 collected $0.6 from pot
*** SUMMARY ***
Total pot $0.63 | Rake $0.03 | Jackpot $0 | Bingo $0 | Fortune $0 | Tax $0
Board [5d Jc 8c As 4c]
Seat 1: Hero (button) folded before Flop (didn't bet)
Seat 2: 491e0e63 (small blind) folded on the River
Seat 3: cf593991 (big blind) folded before Flop
Seat 4: 650e9dc7 folded before Flop (didn't bet)
Seat 5: 48fa5407 won ($0.6)
Seat 6: b59fc0b9 folded before Flop (didn't bet)


Poker Hand #RC3334435746: Hold'em No Limit ($0.02/$0.05) - 2025/02/17 20:31:16
Table 'RushAndCash601006' 6-max Seat #1 is the button
Seat 1: 727998e7 ($7.48 in chips)
Seat 2: 220f45a7 ($4.99 in chips)
Seat 3: Hero ($5.02 in chips)
Seat 4: ef7e6107 ($5 in chips)
Seat 5: 1a54a2fc ($5.07 in chips)
Seat 6: 57d6169c ($5.73 in chips)
220f45a7: posts small blind $0.02
Hero: posts big blind $0.05
*** HOLE CARDS ***
Dealt to 727998e7 
Dealt to 220f45a7 
Dealt to Hero [9d 6c]
Dealt to ef7e6107 
Dealt to 1a54a2fc 
Dealt to 57d6169c 
ef7e6107: folds
1a54a2fc: folds
57d6169c: folds
727998e7: raises $0.06 to $0.11
220f45a7: folds
Hero: folds
Uncalled bet ($0.06) returned to 727998e7
*** SHOWDOWN ***
727998e7 collected $0.12 from pot
*** SUMMARY ***
Total pot $0.12 | Rake $0 | Jackpot $0 | Bingo $0 | Fortune $0 | Tax $0
Seat 1: 727998e7 (button) collected ($0.12)
Seat 2: 220f45a7 (small blind) folded before Flop
Seat 3: Hero (big blind) folded before Flop
Seat 4: ef7e6107 folded before Flop (didn't bet)
Seat 5: 1a54a2fc folded before Flop (didn't bet)
Seat 6: 57d6169c folded before Flop (didn't bet)


Poker Hand #RC3334435693: Hold'em No Limit ($0.02/$0.05) - 2025/02/17 20:31:08
Table 'RushAndCash600953' 6-max Seat #1 is the button
Seat 1: 11fb4d12 ($11.88 in chips)
Seat 2: ee3fdfd8 ($5 in chips)
Seat 3: 9ed6ffbf ($4.33 in chips)
Seat 4: a2794999 ($8.13 in chips)
Seat 5: Hero ($5.02 in chips)
Seat 6: 5acd5e40 ($5.03 in chips)
ee3fdfd8: posts small blind $0.02
9ed6ffbf: posts big blind $0.05
*** HOLE CARDS ***
Dealt to 11fb4d12 
Dealt to ee3fdfd8 
Dealt to 9ed6ffbf 
Dealt to a2794999 
Dealt to Hero [Kd 6c]
Dealt to 5acd5e40 
a2794999: folds
Hero: folds
5acd5e40: folds
11fb4d12: folds
ee3fdfd8: folds
Uncalled bet ($0.03) returned to 9ed6ffbf
*** SHOWDOWN ***
9ed6ffbf collected $0.04 from pot
*** SUMMARY ***
Total pot $0.04 | Rake $0 | Jackpot $0 | Bingo $0 | Fortune $0 | Tax $0
Seat 1: 11fb4d12 (button) folded before Flop (didn't bet)
Seat 2: ee3fdfd8 (small blind) folded before Flop
Seat 3: 9ed6ffbf (big blind) collected ($0.04)
Seat 4: a2794999 folded before Flop (didn't bet)
Seat 5: Hero folded before Flop (didn't bet)
Seat 6: 5acd5e40 folded before Flop (didn't bet)


Poker Hand #RC3334435671: Hold'em No Limit ($0.02/$0.05) - 2025/02/17 20:31:04
Table 'RushAndCash600931' 6-max Seat #1 is the button
Seat 1: 33527257 ($5.72 in chips)
Seat 2: Hero ($5.04 in chips)
Seat 3: 1ea0f381 ($5.18 in chips)
Seat 4: c7e9103c ($20.03 in chips)
Seat 5: f02d4645 ($6.17 in chips)
Seat 6: b7d97ee0 ($5.89 in chips)
Hero: posts small blind $0.02
1ea0f381: posts big blind $0.05
*** HOLE CARDS ***
Dealt to 33527257 
Dealt to Hero [Th 3d]
Dealt to 1ea0f381 
Dealt to c7e9103c 
Dealt to f02d4645 
Dealt to b7d97ee0 
c7e9103c: raises $0.08 to $0.13
f02d4645: folds
b7d97ee0: folds
33527257: folds
Hero: folds
1ea0f381: folds
Uncalled bet ($0.08) returned to c7e9103c
*** SHOWDOWN ***
c7e9103c collected $0.12 from pot
*** SUMMARY ***
Total pot $0.12 | Rake $0 | Jackpot $0 | Bingo $0 | Fortune $0 | Tax $0
Seat 1: 33527257 (button) folded before Flop (didn't bet)
Seat 2: Hero (small blind) folded before Flop
Seat 3: 1ea0f381 (big blind) folded before Flop
Seat 4: c7e9103c collected ($0.12)
Seat 5: f02d4645 folded before Flop (didn't bet)
Seat 6: b7d97ee0 folded before Flop (didn't bet)


Poker Hand #RC3334435465: Hold'em No Limit ($0.02/$0.05) - 2025/02/17 20:30:34
Table 'RushAndCash600725' 6-max Seat #1 is the button
Seat 1: f7c356b4 ($5.12 in chips)
Seat 2: dbf5f543 ($4.93 in chips)
Seat 3: d606d9 ($5 in chips)
Seat 4: abe935e1 ($5.46 in chips)
Seat 5: Hero ($5.14 in chips)
Seat 6: d916afa1 ($5.99 in chips)
dbf5f543: posts small blind $0.02
d606d9: posts big blind $0.05
*** HOLE CARDS ***
Dealt to f7c356b4 
Dealt to dbf5f543 
Dealt to d606d9 
Dealt to abe935e1 
Dealt to Hero [7h Ah]
Dealt to d916afa1 
abe935e1: folds
Hero: raises $0.05 to $0.1
d916afa1: folds
f7c356b4: calls $0.1
dbf5f543: folds
d606d9: calls $0.05
*** FLOP *** [5s Ts 9s]
d606d9: checks
Hero: checks
f7c356b4: bets $0.16
d606d9: calls $0.16
Hero: folds
*** TURN *** [5s Ts 9s] [6h]
d606d9: checks
f7c356b4: bets $0.48
d606d9: calls $0.48
*** RIVER *** [5s Ts 9s 6h] [7s]
d606d9: bets $0.93
f7c356b4: calls $0.93
d606d9: shows [As Jd] (Ace High Flush)
f7c356b4: shows [8d Qd] (Tens-High Straight)
*** SHOWDOWN ***
d606d9 collected $3.24 from pot
*** SUMMARY ***
Total pot $3.46 | Rake $0.15 | Jackpot $0.07 | Bingo $0 | Fortune $0 | Tax $0
Board [5s Ts 9s 6h 7s]
Seat 1: f7c356b4 (button) showed [8d Qd] and lost with Tens-High Straight
Seat 2: dbf5f543 (small blind) folded before Flop
Seat 3: d606d9 (big blind) showed [As Jd] and won ($3.24) with Ace High Flush
Seat 4: abe935e1 folded before Flop (didn't bet)
Seat 5: Hero folded on the Flop
Seat 6: d916afa1 folded before Flop (didn't bet)


Poker Hand #RC3334435436: Hold'em No Limit ($0.02/$0.05) - 2025/02/17 20:30:29
Table 'RushAndCash600696' 6-max Seat #1 is the button
Seat 1: eaafe260 ($6.57 in chips)
Seat 2: 70bcf256 ($5 in chips)
Seat 3: 7c99618c ($5.1 in chips)
Seat 4: bb702030 ($7.8 in chips)
Seat 5: Hero ($5.14 in chips)
Seat 6: c0de4e76 ($5.33 in chips)
70bcf256: posts small blind $0.02
7c99618c: posts big blind $0.05
*** HOLE CARDS ***
Dealt to eaafe260 
Dealt to 70bcf256 
Dealt to 7c99618c 
Dealt to bb702030 
Dealt to Hero [3d Jc]
Dealt to c0de4e76 
bb702030: folds
Hero: folds
c0de4e76: folds
eaafe260: folds
70bcf256: raises $0.05 to $0.1
7c99618c: calls $0.05
*** FLOP *** [7s 3s 5c]
70bcf256: bets $0.05
7c99618c: calls $0.05
*** TURN *** [7s 3s 5c] [Jd]
70bcf256: bets $0.05
7c99618c: calls $0.05
*** RIVER *** [7s 3s 5c Jd] [Js]
70bcf256: bets $0.05
7c99618c: calls $0.05
70bcf256: shows [Qd 8d] (Pair of Jacks)
7c99618c: shows [7d As] (Pair of Jacks and Pair of Sevens)
*** SHOWDOWN ***
7c99618c collected $0.48 from pot
*** SUMMARY ***
Total pot $0.5 | Rake $0.02 | Jackpot $0 | Bingo $0 | Fortune $0 | Tax $0
Board [7s 3s 5c Jd Js]
Seat 1: eaafe260 (button) folded before Flop (didn't bet)
Seat 2: 70bcf256 (small blind) showed [Qd 8d] and lost with Pair of Jacks
Seat 3: 7c99618c (big blind) showed [7d As] and won ($0.48) with Pair of Jacks and Pair of Sevens
Seat 4: bb702030 folded before Flop (didn't bet)
Seat 5: Hero folded before Flop (didn't bet)
Seat 6: c0de4e76 folded before Flop (didn't bet)


Poker Hand #RC3334435412: Hold'em No Limit ($0.02/$0.05) - 2025/02/17 20:30:25
Table 'RushAndCash600672' 6-max Seat #1 is the button
Seat 1: e3608384 ($5.34 in chips)
Seat 2: 23cd2f90 ($2.42 in chips)
Seat 3: c24b20b9 ($17.47 in chips)
Seat 4: 825e110f ($5.61 in chips)
Seat 5: e72c7748 ($9.85 in chips)
Seat 6: Hero ($5.14 in chips)
23cd2f90: posts small blind $0.02
c24b20b9: posts big blind $0.05
*** HOLE CARDS ***
Dealt to e3608384 
Dealt to 23cd2f90 
Dealt to c24b20b9 
Dealt to 825e110f 
Dealt to e72c7748 
Dealt to Hero [7c 3s]
825e110f: folds
e72c7748: folds
Hero: folds
e3608384: folds
23cd2f90: folds
Uncalled bet ($0.03) returned to c24b20b9
*** SHOWDOWN ***
c24b20b9 collected $0.04 from pot
*** SUMMARY ***
Total pot $0.04 | Rake $0 | Jackpot $0 | Bingo $0 | Fortune $0 | Tax $0
Seat 1: e3608384 (button) folded before Flop (didn't bet)
Seat 2: 23cd2f90 (small blind) folded before Flop
Seat 3: c24b20b9 (big blind) collected ($0.04)
Seat 4: 825e110f folded before Flop (didn't bet)
Seat 5: e72c7748 folded before Flop (didn't bet)
Seat 6: Hero folded before Flop (didn't bet)


Poker Hand #RC3334435359: Hold'em No Limit ($0.02/$0.05) - 2025/02/17 20:30:17
Table 'RushAndCash600619' 6-max Seat #1 is the button
Seat 1: Hero ($5.14 in chips)
Seat 2: 51f33dae ($19.78 in chips)
Seat 3: d58b99ca ($7.63 in chips)
Seat 4: 1aca371e ($7.65 in chips)
Seat 5: 87d5083b ($19.08 in chips)
Seat 6: c5f53436 ($5.24 in chips)
51f33dae: posts small blind $0.02
d58b99ca: posts big blind $0.05
*** HOLE CARDS ***
Dealt to Hero [Kc Jh]
Dealt to 51f33dae 
Dealt to d58b99ca 
Dealt to 1aca371e 
Dealt to 87d5083b 
Dealt to c5f53436 
1aca371e: folds
87d5083b: raises $0.05 to $0.1
c5f53436: folds
Hero: folds
51f33dae: raises $0.35 to $0.45
d58b99ca: folds
87d5083b: calls $0.35
*** FLOP *** [2h Js Qh]
51f33dae: bets $0.48
87d5083b: calls $0.48
*** TURN *** [2h Js Qh] [Ac]
51f33dae: bets $1.44
87d5083b: folds
Uncalled bet ($1.44) returned to 51f33dae
*** SHOWDOWN ***
51f33dae collected $1.75 from pot
*** SUMMARY ***
Total pot $1.91 | Rake $0.09 | Jackpot $0.07 | Bingo $0 | Fortune $0 | Tax $0
Board [2h Js Qh Ac]
Seat 1: Hero (button) folded before Flop (didn't bet)
Seat 2: 51f33dae (small blind) won ($1.75)
Seat 3: d58b99ca (big blind) folded before Flop
Seat 4: 1aca371e folded before Flop (didn't bet)
Seat 5: 87d5083b folded on the Turn
Seat 6: c5f53436 folded before Flop (didn't bet)


Poker Hand #RC3334435175: Hold'em No Limit ($0.02/$0.05) - 2025/02/17 20:29:48
Table 'RushAndCash600435' 6-max Seat #1 is the button
Seat 1: cedf4726 ($13.09 in chips)
Seat 2: 39109629 ($5.14 in chips)
Seat 3: Hero ($5 in chips)
Seat 4: 4c8dd192 ($12.29 in chips)
Seat 5: 4d8ae83 ($5.36 in chips)
Seat 6: 1937cebf ($5 in chips)
39109629: posts small blind $0.02
Hero: posts big blind $0.05
*** HOLE CARDS ***
Dealt to cedf4726 
Dealt to 39109629 
Dealt to Hero [Ks Kc]
Dealt to 4c8dd192 
Dealt to 4d8ae83 
Dealt to 1937cebf 
4c8dd192: folds
4d8ae83: folds
1937cebf: folds
cedf4726: raises $0.08 to $0.13
39109629: folds
Hero: raises $0.35 to $0.48
cedf4726: folds
Uncalled bet ($0.35) returned to Hero
*** SHOWDOWN ***
Hero collected $0.27 from pot
*** SUMMARY ***
Total pot $0.28 | Rake $0.01 | Jackpot $0 | Bingo $0 | Fortune $0 | Tax $0
Seat 1: cedf4726 (button) folded before Flop
Seat 2: 39109629 (small blind) folded before Flop
Seat 3: Hero (big blind) collected ($0.27)
Seat 4: 4c8dd192 folded before Flop (didn't bet)
Seat 5: 4d8ae83 folded before Flop (didn't bet)
Seat 6: 1937cebf folded before Flop (didn't bet)


Poker Hand #RC3334435151: Hold'em No Limit ($0.02/$0.05) - 2025/02/17 20:29:45
Table 'RushAndCash600411' 6-max Seat #1 is the button
Seat 1: 64e5de41 ($5.18 in chips)
Seat 2: Hero ($5 in chips)
Seat 3: fdc3ee5c ($12.03 in chips)
Seat 4: 7f79d927 ($8.83 in chips)
Seat 5: 1d0217bc ($5.71 in chips)
Seat 6: cf7f09c2 ($10.67 in chips)
Hero: posts small blind $0.02
fdc3ee5c: posts big blind $0.05
*** HOLE CARDS ***
Dealt to 64e5de41 
Dealt to Hero [Js 7h]
Dealt to fdc3ee5c 
Dealt to 7f79d927 
Dealt to 1d0217bc 
Dealt to cf7f09c2 
7f79d927: folds
1d0217bc: folds
cf7f09c2: folds
64e5de41: raises $0.08 to $0.13
Hero: folds
fdc3ee5c: raises $0.42 to $0.55
64e5de41: calls $0.42
*** FLOP *** [3s 3h 3d]
fdc3ee5c: bets $0.36
64e5de41: calls $0.36
*** TURN *** [3s 3h 3d] [5c]
fdc3ee5c: bets $1.35
64e5de41: folds
Uncalled bet ($1.35) returned to fdc3ee5c
*** SHOWDOWN ***
fdc3ee5c collected $1.69 from pot
*** SUMMARY ***
Total pot $1.84 | Rake $0.08 | Jackpot $0.07 | Bingo $0 | Fortune $0 | Tax $0
Board [3s 3h 3d 5c]
Seat 1: 64e5de41 (button) folded on the Turn
Seat 2: Hero (small blind) folded before Flop
Seat 3: fdc3ee5c (big blind) won ($1.69)
Seat 4: 7f79d927 folded before Flop (didn't bet)
Seat 5: 1d0217bc folded before Flop (didn't bet)
Seat 6: cf7f09c2 folded before Flop (didn't bet)


Poker Hand #RC3334435130: Hold'em No Limit ($0.02/$0.05) - 2025/02/17 20:29:42
Table 'RushAndCash600390' 6-max Seat #1 is the button
Seat 1: b9d877b0 ($5 in chips)
Seat 2: ac2aecf ($1.93 in chips)
Seat 3: 2a5d53e8 ($5.05 in chips)
Seat 4: 5381eb4c ($5.86 in chips)
Seat 5: Hero ($5 in chips)
Seat 6: d738c756 ($3.37 in chips)
ac2aecf: posts small blind $0.02
2a5d53e8: posts big blind $0.05
*** HOLE CARDS ***
Dealt to b9d877b0 
Dealt to ac2aecf 
Dealt to 2a5d53e8 
Dealt to 5381eb4c 
Dealt to Hero [Ks 6c]
Dealt to d738c756 
5381eb4c: folds
Hero: folds
d738c756: raises $0.05 to $0.1
b9d877b0: folds
ac2aecf: folds
2a5d53e8: calls $0.05
*** FLOP *** [3s Kd Jd]
2a5d53e8: checks
d738c756: checks
*** TURN *** [3s Kd Jd] [7s]
2a5d53e8: bets $0.11
d738c756: calls $0.11
*** RIVER *** [3s Kd Jd 7s] [8c]
2a5d53e8: checks
d738c756: checks
2a5d53e8: shows [Jc Qc] (Pair of Jacks)
d738c756: shows [Ad 9h] (Ace-High)
*** SHOWDOWN ***
2a5d53e8 collected $0.42 from pot
*** SUMMARY ***
Total pot $0.44 | Rake $0.02 | Jackpot $0 | Bingo $0 | Fortune $0 | Tax $0
Board [3s Kd Jd 7s 8c]
Seat 1: b9d877b0 (button) folded before Flop (didn't bet)
Seat 2: ac2aecf (small blind) folded before Flop
Seat 3: 2a5d53e8 (big blind) showed [Jc Qc] and won ($0.42) with Pair of Jacks
Seat 4: 5381eb4c folded before Flop (didn't bet)
Seat 5: Hero folded before Flop (didn't bet)
Seat 6: d738c756 showed [Ad 9h] and lost with Ace-High


Poker Hand #RC3334435089: Hold'em No Limit ($0.02/$0.05) - 2025/02/17 20:29:36
Table 'RushAndCash600349' 6-max Seat #1 is the button
Seat 1: c8e834fc ($4.48 in chips)
Seat 2: 9f008576 ($8.07 in chips)
Seat 3: 5ebadbd5 ($5.81 in chips)
Seat 4: ab8d5924 ($5.05 in chips)
Seat 5: d1cd1071 ($15.35 in chips)
Seat 6: Hero ($5 in chips)
9f008576: posts small blind $0.02
5ebadbd5: posts big blind $0.05
*** HOLE CARDS ***
Dealt to c8e834fc 
Dealt to 9f008576 
Dealt to 5ebadbd5 
Dealt to ab8d5924 
Dealt to d1cd1071 
Dealt to Hero [9h Ad]
ab8d5924: folds
d1cd1071: raises $0.06 to $0.11
Hero: folds
c8e834fc: calls $0.11
9f008576: calls $0.09
5ebadbd5: folds
*** FLOP *** [Kh 4c 5h]
9f008576: checks
d1cd1071: checks
c8e834fc: bets $0.19
9f008576: folds
d1cd1071: calls $0.19
*** TURN *** [Kh 4c 5h] [3c]
d1cd1071: checks
c8e834fc: checks
*** RIVER *** [Kh 4c 5h 3c] [As]
d1cd1071: checks
c8e834fc: checks
d1cd1071: shows [Qh Qs] (Pair of Queens)
c8e834fc: shows [4s 6s] (Pair of Fours)
*** SHOWDOWN ***
d1cd1071 collected $0.73 from pot
*** SUMMARY ***
Total pot $0.76 | Rake $0.03 | Jackpot $0 | Bingo $0 | Fortune $0 | Tax $0
Board [Kh 4c 5h 3c As]
Seat 1: c8e834fc (button) showed [4s 6s] and lost with Pair of Fours
Seat 2: 9f008576 (small blind) folded on the Flop
Seat 3: 5ebadbd5 (big blind) folded before Flop
Seat 4: ab8d5924 folded before Flop (didn't bet)
Seat 5: d1cd1071 showed [Qh Qs] and won ($0.73) with Pair of Queens
Seat 6: Hero folded before Flop (didn't bet)


Poker Hand #RC3334435063: Hold'em No Limit ($0.02/$0.05) - 2025/02/17 20:29:32
Table 'RushAndCash600323' 6-max Seat #1 is the button
Seat 1: 21bff972 ($6.51 in chips)
Seat 2: 1aae5bdb ($5.3 in chips)
Seat 3: 87b4e331 ($6.4 in chips)
Seat 4: Hero ($5 in chips)
Seat 5: d738c756 ($3.37 in chips)
Seat 6: f6655046 ($5.09 in chips)
1aae5bdb: posts small blind $0.02
87b4e331: posts big blind $0.05
*** HOLE CARDS ***
Dealt to 21bff972 
Dealt to 1aae5bdb 
Dealt to 87b4e331 
Dealt to Hero [2s 4c]
Dealt to d738c756 
Dealt to f6655046 
Hero: folds
d738c756: folds
f6655046: folds
21bff972: folds
1aae5bdb: raises $0.1 to $0.15
87b4e331: calls $0.1
*** FLOP *** [3h 5d Tc]
1aae5bdb: bets $0.1
87b4e331: folds
Uncalled bet ($0.1) returned to 1aae5bdb
*** SHOWDOWN ***
1aae5bdb collected $0.29 from pot
*** SUMMARY ***
Total pot $0.3 | Rake $0.01 | Jackpot $0 | Bingo $0 | Fortune $0 | Tax $0
Board [3h 5d Tc]
Seat 1: 21bff972 (button) folded before Flop (didn't bet)
Seat 2: 1aae5bdb (small blind) won ($0.29)
Seat 3: 87b4e331 (big blind) folded on the Flop
Seat 4: Hero folded before Flop (didn't bet)
Seat 5: d738c756 folded before Flop (didn't bet)
Seat 6: f6655046 folded before Flop (didn't bet)


Poker Hand #RC3334435039: Hold'em No Limit ($0.02/$0.05) - 2025/02/17 20:29:29
Table 'RushAndCash600299' 6-max Seat #1 is the button
Seat 1: Hero ($5 in chips)
Seat 2: 27baaa05 ($6.59 in chips)
Seat 3: bbdadd69 ($5.61 in chips)
Seat 4: 9ec2ef41 ($8.14 in chips)
Seat 5: 8e07c53 ($5 in chips)
Seat 6: 6662e866 ($14.66 in chips)
27baaa05: posts small blind $0.02
bbdadd69: posts big blind $0.05
*** HOLE CARDS ***
Dealt to Hero [3s 9s]
Dealt to 27baaa05 
Dealt to bbdadd69 
Dealt to 9ec2ef41 
Dealt to 8e07c53 
Dealt to 6662e866 
9ec2ef41: folds
8e07c53: folds
6662e866: folds
Hero: folds
27baaa05: raises $0.08 to $0.13
bbdadd69: raises $0.26 to $0.39
27baaa05: folds
Uncalled bet ($0.26) returned to bbdadd69
*** SHOWDOWN ***
bbdadd69 collected $0.25 from pot
*** SUMMARY ***
Total pot $0.26 | Rake $0.01 | Jackpot $0 | Bingo $0 | Fortune $0 | Tax $0
Seat 1: Hero (button) folded before Flop (didn't bet)
Seat 2: 27baaa05 (small blind) folded before Flop
Seat 3: bbdadd69 (big blind) collected ($0.25)
Seat 4: 9ec2ef41 folded before Flop (didn't bet)
Seat 5: 8e07c53 folded before Flop (didn't bet)
Seat 6: 6662e866 folded before Flop (didn't bet)


Poker Hand #RC3334435017: Hold'em No Limit ($0.02/$0.05) - 2025/02/17 20:29:25
Table 'RushAndCash600277' 6-max Seat #1 is the button
Seat 1: 7c99618c ($5.12 in chips)
Seat 2: Hero ($5 in chips)
Seat 3: 64f89f4b ($5.49 in chips)
Seat 4: 84fb210c ($10.96 in chips)
Seat 5: 8896706d ($5.92 in chips)
Seat 6: a3df4f6b ($4.9 in chips)
Hero: posts small blind $0.02
64f89f4b: posts big blind $0.05
*** HOLE CARDS ***
Dealt to 7c99618c 
Dealt to Hero [Js 8h]
Dealt to 64f89f4b 
Dealt to 84fb210c 
Dealt to 8896706d 
Dealt to a3df4f6b 
84fb210c: folds
8896706d: folds
a3df4f6b: folds
7c99618c: folds
Hero: folds
Uncalled bet ($0.03) returned to 64f89f4b
*** SHOWDOWN ***
64f89f4b collected $0.04 from pot
*** SUMMARY ***
Total pot $0.04 | Rake $0 | Jackpot $0 | Bingo $0 | Fortune $0 | Tax $0
Seat 1: 7c99618c (button) folded before Flop (didn't bet)
Seat 2: Hero (small blind) folded before Flop
Seat 3: 64f89f4b (big blind) collected ($0.04)
Seat 4: 84fb210c folded before Flop (didn't bet)
Seat 5: 8896706d folded before Flop (didn't bet)
Seat 6: a3df4f6b folded before Flop (didn't bet)


Poker Hand #RC3334434834: Hold'em No Limit ($0.02/$0.05) - 2025/02/17 20:28:56
Table 'RushAndCash600094' 6-max Seat #1 is the button
Seat 1: 8d7c8253 ($5 in chips)
Seat 2: f1f26d78 ($9.73 in chips)
Seat 3: Hero ($5 in chips)
Seat 4: 3b85f8e6 ($12.53 in chips)
Seat 5: fa84cc2d ($17.11 in chips)
Seat 6: 9598e06a ($6.93 in chips)
f1f26d78: posts small blind $0.02
Hero: posts big blind $0.05
*** HOLE CARDS ***
Dealt to 8d7c8253 
Dealt to f1f26d78 
Dealt to Hero [2c 2h]
Dealt to 3b85f8e6 
Dealt to fa84cc2d 
Dealt to 9598e06a 
3b85f8e6: folds
fa84cc2d: raises $0.07 to $0.12
9598e06a: folds
8d7c8253: folds
f1f26d78: folds
Hero: calls $0.07
*** FLOP *** [5h 9h Td]
Hero: checks
fa84cc2d: bets $0.13
Hero: folds
Uncalled bet ($0.13) returned to fa84cc2d
*** SHOWDOWN ***
fa84cc2d collected $0.25 from pot
*** SUMMARY ***
Total pot $0.26 | Rake $0.01 | Jackpot $0 | Bingo $0 | Fortune $0 | Tax $0
Board [5h 9h Td]
Seat 1: 8d7c8253 (button) folded before Flop (didn't bet)
Seat 2: f1f26d78 (small blind) folded before Flop
Seat 3: Hero (big blind) folded on the Flop
Seat 4: 3b85f8e6 folded before Flop (didn't bet)
Seat 5: fa84cc2d won ($0.25)
Seat 6: 9598e06a folded before Flop (didn't bet)


Poker Hand #RC3334434799: Hold'em No Limit ($0.02/$0.05) - 2025/02/17 20:28:51
Table 'RushAndCash600059' 6-max Seat #1 is the button
Seat 1: eaafe260 ($5.09 in chips)
Seat 2: fe374609 ($5.66 in chips)
Seat 3: 436ecab0 ($2.68 in chips)
Seat 4: a6ca20e7 ($35.03 in chips)
Seat 5: Hero ($5 in chips)
Seat 6: 598d859f ($9.44 in chips)
fe374609: posts small blind $0.02
436ecab0: posts big blind $0.05
*** HOLE CARDS ***
Dealt to eaafe260 
Dealt to fe374609 
Dealt to 436ecab0 
Dealt to a6ca20e7 
Dealt to Hero [Jh Ks]
Dealt to 598d859f 
a6ca20e7: raises $0.06 to $0.11
Hero: folds
598d859f: folds
eaafe260: folds
fe374609: folds
436ecab0: folds
Uncalled bet ($0.06) returned to a6ca20e7
*** SHOWDOWN ***
a6ca20e7 collected $0.12 from pot
*** SUMMARY ***
Total pot $0.12 | Rake $0 | Jackpot $0 | Bingo $0 | Fortune $0 | Tax $0
Seat 1: eaafe260 (button) folded before Flop (didn't bet)
Seat 2: fe374609 (small blind) folded before Flop
Seat 3: 436ecab0 (big blind) folded before Flop
Seat 4: a6ca20e7 collected ($0.12)
Seat 5: Hero folded before Flop (didn't bet)
Seat 6: 598d859f folded before Flop (didn't bet)


Poker Hand #RC3334434779: Hold'em No Limit ($0.02/$0.05) - 2025/02/17 20:28:48
Table 'RushAndCash600039' 6-max Seat #1 is the button
Seat 1: 68b3fe79 ($5.51 in chips)
Seat 2: 8dbd0a2d ($5.74 in chips)
Seat 3: 5381eb4c ($5.79 in chips)
Seat 4: Hero ($5 in chips)
Seat 5: 3ad61ed1 ($5.44 in chips)
Seat 6: bbd60b52 ($15.89 in chips)
8dbd0a2d: posts small blind $0.02
5381eb4c: posts big blind $0.05
*** HOLE CARDS ***
Dealt to 68b3fe79 
Dealt to 8dbd0a2d 
Dealt to 5381eb4c 
Dealt to Hero [3d 6h]
Dealt to 3ad61ed1 
Dealt to bbd60b52 
Hero: folds
3ad61ed1: folds
bbd60b52: folds
68b3fe79: folds
8dbd0a2d: raises $0.1 to $0.15
5381eb4c: folds
Uncalled bet ($0.1) returned to 8dbd0a2d
*** SHOWDOWN ***
8dbd0a2d collected $0.1 from pot
*** SUMMARY ***
Total pot $0.1 | Rake $0 | Jackpot $0 | Bingo $0 | Fortune $0 | Tax $0
Seat 1: 68b3fe79 (button) folded before Flop (didn't bet)
Seat 2: 8dbd0a2d (small blind) collected ($0.1)
Seat 3: 5381eb4c (big blind) folded before Flop
Seat 4: Hero folded before Flop (didn't bet)
Seat 5: 3ad61ed1 folded before Flop (didn't bet)
Seat 6: bbd60b52 folded before Flop (didn't bet)


Poker Hand #RC3334434756: Hold'em No Limit ($0.02/$0.05) - 2025/02/17 20:28:45
Table 'RushAndCash600016' 6-max Seat #1 is the button
Seat 1: 6662e866 ($14.86 in chips)
Seat 2: 87cdcefe ($4.02 in chips)
Seat 3: a9af8bb8 ($5 in chips)
Seat 4: 1df270b6 ($7.73 in chips)
Seat 5: Hero ($5 in chips)
Seat 6: 68b3fe79 ($5.51 in chips)
87cdcefe: posts small blind $0.02
a9af8bb8: posts big blind $0.05
*** HOLE CARDS ***
Dealt to 6662e866 
Dealt to 87cdcefe 
Dealt to a9af8bb8 
Dealt to 1df270b6 
Dealt to Hero [Js Th]
Dealt to 68b3fe79 
1df270b6: folds
Hero: folds
68b3fe79: folds
6662e866: raises $0.05 to $0.1
87cdcefe: calls $0.08
a9af8bb8: folds
*** FLOP *** [Ac 3d 7s]
87cdcefe: checks
6662e866: bets $0.1
87cdcefe: calls $0.1
*** TURN *** [Ac 3d 7s] [As]
87cdcefe: checks
6662e866: checks
*** RIVER *** [Ac 3d 7s As] [Qh]
87cdcefe: bets $0.34
6662e866: folds
Uncalled bet ($0.34) returned to 87cdcefe
*** SHOWDOWN ***
87cdcefe collected $0.43 from pot
*** SUMMARY ***
Total pot $0.45 | Rake $0.02 | Jackpot $0 | Bingo $0 | Fortune $0 | Tax $0
Board [Ac 3d 7s As Qh]
Seat 1: 6662e866 (button) folded on the River
Seat 2: 87cdcefe (small blind) won ($0.43)
Seat 3: a9af8bb8 (big blind) folded before Flop
Seat 4: 1df270b6 folded before Flop (didn't bet)
Seat 5: Hero folded before Flop (didn't bet)
Seat 6: 68b3fe79 folded before Flop (didn't bet)


Poker Hand #RC3334374733: Hold'em No Limit ($0.02/$0.05) - 2025/02/17 20:28:41
Table 'RushAndCash599993' 6-max Seat #1 is the button
Seat 1: cedf4726 ($13.23 in chips)
Seat 2: 64e5de41 ($5.34 in chips)
Seat 3: 4238ab48 ($4.37 in chips)
Seat 4: 10392725 ($5.44 in chips)
Seat 5: f898e827 ($5.25 in chips)
Seat 6: Hero ($5 in chips)
64e5de41: posts small blind $0.02
4238ab48: posts big blind $0.05
*** HOLE CARDS ***
Dealt to cedf4726 
Dealt to 64e5de41 
Dealt to 4238ab48 
Dealt to 10392725 
Dealt to f898e827 
Dealt to Hero [7s Jh]
10392725: raises $0.05 to $0.1
f898e827: folds
Hero: folds
cedf4726: calls $0.1
64e5de41: folds
4238ab48: folds
*** FLOP *** [Js Kc Qs]
10392725: bets $0.21
cedf4726: folds
Uncalled bet ($0.21) returned to 10392725
*** SHOWDOWN ***
10392725 collected $0.26 from pot
*** SUMMARY ***
Total pot $0.27 | Rake $0.01 | Jackpot $0 | Bingo $0 | Fortune $0 | Tax $0
Board [Js Kc Qs]
Seat 1: cedf4726 (button) folded on the Flop
Seat 2: 64e5de41 (small blind) folded before Flop
Seat 3: 4238ab48 (big blind) folded before Flop
Seat 4: 10392725 won ($0.26)
Seat 5: f898e827 folded before Flop (didn't bet)
Seat 6: Hero folded before Flop (didn't bet)


Poker Hand #RC3334374708: Hold'em No Limit ($0.02/$0.05) - 2025/02/17 20:28:38
Table 'RushAndCash599968' 6-max Seat #1 is the button
Seat 1: 6d5fa70b ($6.88 in chips)
Seat 2: Hero ($5 in chips)
Seat 3: fb6c4072 ($6.36 in chips)
Seat 4: 64e5de41 ($5.34 in chips)
Seat 5: 50053f22 ($6.66 in chips)
Seat 6: 207d9345 ($22.66 in chips)
Hero: posts small blind $0.02
fb6c4072: posts big blind $0.05
*** HOLE CARDS ***
Dealt to 6d5fa70b 
Dealt to Hero [2h 7s]
Dealt to fb6c4072 
Dealt to 64e5de41 
Dealt to 50053f22 
Dealt to 207d9345 
64e5de41: folds
50053f22: folds
207d9345: folds
6d5fa70b: raises $0.08 to $0.13
Hero: folds
fb6c4072: folds
Uncalled bet ($0.08) returned to 6d5fa70b
*** SHOWDOWN ***
6d5fa70b collected $0.12 from pot
*** SUMMARY ***
Total pot $0.12 | Rake $0 | Jackpot $0 | Bingo $0 | Fortune $0 | Tax $0
Seat 1: 6d5fa70b (button) collected ($0.12)
Seat 2: Hero (small blind) folded before Flop
Seat 3: fb6c4072 (big blind) folded before Flop
Seat 4: 64e5de41 folded before Flop (didn't bet)
Seat 5: 50053f22 folded before Flop (didn't bet)
Seat 6: 207d9345 folded before Flop (didn't bet)


Poker Hand #RC3334374684: Hold'em No Limit ($0.02/$0.05) - 2025/02/17 20:28:35
Table 'RushAndCash599944' 6-max Seat #1 is the button
Seat 1: e6dc3dd2 ($7.32 in chips)
Seat 2: d32b2e06 ($9.81 in chips)
Seat 3: bbdadd69 ($5 in chips)
Seat 4: Hero ($5 in chips)
Seat 5: f1f26d78 ($9.78 in chips)
Seat 6: 5f1cdd27 ($5 in chips)
d32b2e06: posts small blind $0.02
bbdadd69: posts big blind $0.05
*** HOLE CARDS ***
Dealt to e6dc3dd2 
Dealt to d32b2e06 
Dealt to bbdadd69 
Dealt to Hero [4c Qh]
Dealt to f1f26d78 
Dealt to 5f1cdd27 
Hero: folds
f1f26d78: folds
5f1cdd27: raises $0.05 to $0.1
e6dc3dd2: folds
d32b2e06: folds
bbdadd69: folds
Uncalled bet ($0.05) returned to 5f1cdd27
*** SHOWDOWN ***
5f1cdd27 collected $0.12 from pot
*** SUMMARY ***
Total pot $0.12 | Rake $0 | Jackpot $0 | Bingo $0 | Fortune $0 | Tax $0
Seat 1: e6dc3dd2 (button) folded before Flop (didn't bet)
Seat 2: d32b2e06 (small blind) folded before Flop
Seat 3: bbdadd69 (big blind) folded before Flop
Seat 4: Hero folded before Flop (didn't bet)
Seat 5: f1f26d78 folded before Flop (didn't bet)
Seat 6: 5f1cdd27 collected ($0.12)


Poker Hand #RC3334374661: Hold'em No Limit ($0.02/$0.05) - 2025/02/17 20:28:32
Table 'RushAndCash599921' 6-max Seat #1 is the button
Seat 1: 287f8174 ($5.02 in chips)
Seat 2: 6c0f6dbf ($14.71 in chips)
Seat 3: Hero ($5.05 in chips)
Seat 4: e26361cd ($7.23 in chips)
Seat 5: e2a2e9b3 ($5.07 in chips)
Seat 6: 86768906 ($8.88 in chips)
6c0f6dbf: posts small blind $0.02
Hero: posts big blind $0.05
*** HOLE CARDS ***
Dealt to 287f8174 
Dealt to 6c0f6dbf 
Dealt to Hero [6c 2s]
Dealt to e26361cd 
Dealt to e2a2e9b3 
Dealt to 86768906 
e26361cd: folds
e2a2e9b3: folds
86768906: folds
287f8174: raises $0.08 to $0.13
6c0f6dbf: folds
Hero: folds
Uncalled bet ($0.08) returned to 287f8174
*** SHOWDOWN ***
287f8174 collected $0.12 from pot
*** SUMMARY ***
Total pot $0.12 | Rake $0 | Jackpot $0 | Bingo $0 | Fortune $0 | Tax $0
Seat 1: 287f8174 (button) collected ($0.12)
Seat 2: 6c0f6dbf (small blind) folded before Flop
Seat 3: Hero (big blind) folded before Flop
Seat 4: e26361cd folded before Flop (didn't bet)
Seat 5: e2a2e9b3 folded before Flop (didn't bet)
Seat 6: 86768906 folded before Flop (didn't bet)


Poker Hand #RC3334374639: Hold'em No Limit ($0.02/$0.05) - 2025/02/17 20:28:29
Table 'RushAndCash599899' 6-max Seat #1 is the button
Seat 1: Hero ($5.05 in chips)
Seat 2: 5c8c19b7 ($5.25 in chips)
Seat 3: c1784884 ($5 in chips)
Seat 4: 1f187ba0 ($5.05 in chips)
Seat 5: ef63200d ($7.66 in chips)
Seat 6: ed38df5e ($5 in chips)
5c8c19b7: posts small blind $0.02
c1784884: posts big blind $0.05
*** HOLE CARDS ***
Dealt to Hero [6s 4c]
Dealt to 5c8c19b7 
Dealt to c1784884 
Dealt to 1f187ba0 
Dealt to ef63200d 
Dealt to ed38df5e 
1f187ba0: folds
ef63200d: raises $0.05 to $0.1
ed38df5e: folds
Hero: folds
5c8c19b7: folds
c1784884: folds
Uncalled bet ($0.05) returned to ef63200d
*** SHOWDOWN ***
ef63200d collected $0.12 from pot
*** SUMMARY ***
Total pot $0.12 | Rake $0 | Jackpot $0 | Bingo $0 | Fortune $0 | Tax $0
Seat 1: Hero (button) folded before Flop (didn't bet)
Seat 2: 5c8c19b7 (small blind) folded before Flop
Seat 3: c1784884 (big blind) folded before Flop
Seat 4: 1f187ba0 folded before Flop (didn't bet)
Seat 5: ef63200d collected ($0.12)
Seat 6: ed38df5e folded before Flop (didn't bet)


Poker Hand #RC3334374619: Hold'em No Limit ($0.02/$0.05) - 2025/02/17 20:28:26
Table 'RushAndCash599879' 6-max Seat #1 is the button
Seat 1: ab77a003 ($5.05 in chips)
Seat 2: 6ebc3323 ($13 in chips)
Seat 3: e352a329 ($5.24 in chips)
Seat 4: Hero ($5.05 in chips)
Seat 5: 12cda2e0 ($17.1 in chips)
Seat 6: 25f30dbe ($5.26 in chips)
6ebc3323: posts small blind $0.02
e352a329: posts big blind $0.05
*** HOLE CARDS ***
Dealt to ab77a003 
Dealt to 6ebc3323 
Dealt to e352a329 
Dealt to Hero [8d Qs]
Dealt to 12cda2e0 
Dealt to 25f30dbe 
Hero: folds
12cda2e0: folds
25f30dbe: folds
ab77a003: folds
6ebc3323: folds
Uncalled bet ($0.03) returned to e352a329
*** SHOWDOWN ***
e352a329 collected $0.04 from pot
*** SUMMARY ***
Total pot $0.04 | Rake $0 | Jackpot $0 | Bingo $0 | Fortune $0 | Tax $0
Seat 1: ab77a003 (button) folded before Flop (didn't bet)
Seat 2: 6ebc3323 (small blind) folded before Flop
Seat 3: e352a329 (big blind) collected ($0.04)
Seat 4: Hero folded before Flop (didn't bet)
Seat 5: 12cda2e0 folded before Flop (didn't bet)
Seat 6: 25f30dbe folded before Flop (didn't bet)


Poker Hand #RC3334374598: Hold'em No Limit ($0.02/$0.05) - 2025/02/17 20:28:23
Table 'RushAndCash599858' 6-max Seat #1 is the button
Seat 1: 2809b559 ($5 in chips)
Seat 2: d1f305bd ($5 in chips)
Seat 3: 92fa3d91 ($3.47 in chips)
Seat 4: Hero ($5.05 in chips)
Seat 5: 1696890b ($5.21 in chips)
Seat 6: c4eb9775 ($17.59 in chips)
d1f305bd: posts small blind $0.02
92fa3d91: posts big blind $0.05
*** HOLE CARDS ***
Dealt to 2809b559 
Dealt to d1f305bd 
Dealt to 92fa3d91 
Dealt to Hero [Th 7d]
Dealt to 1696890b 
Dealt to c4eb9775 
Hero: folds
1696890b: raises $0.1 to $0.15
c4eb9775: folds
2809b559: folds
d1f305bd: folds
92fa3d91: folds
Uncalled bet ($0.1) returned to 1696890b
*** SHOWDOWN ***
1696890b collected $0.12 from pot
*** SUMMARY ***
Total pot $0.12 | Rake $0 | Jackpot $0 | Bingo $0 | Fortune $0 | Tax $0
Seat 1: 2809b559 (button) folded before Flop (didn't bet)
Seat 2: d1f305bd (small blind) folded before Flop
Seat 3: 92fa3d91 (big blind) folded before Flop
Seat 4: Hero folded before Flop (didn't bet)
Seat 5: 1696890b collected ($0.12)
Seat 6: c4eb9775 folded before Flop (didn't bet)


Poker Hand #RC3334374457: Hold'em No Limit ($0.02/$0.05) - 2025/02/17 20:28:00
Table 'RushAndCash599717' 6-max Seat #1 is the button
Seat 1: b0ee20aa ($23.12 in chips)
Seat 2: df0ebddc ($5.16 in chips)
Seat 3: Hero ($5.2 in chips)
Seat 4: fb6c4072 ($6.31 in chips)
Seat 5: 6eae6bcb ($8.66 in chips)
Seat 6: 835df346 ($16.27 in chips)
df0ebddc: posts small blind $0.02
Hero: posts big blind $0.05
*** HOLE CARDS ***
Dealt to b0ee20aa 
Dealt to df0ebddc 
Dealt to Hero [Ah Th]
Dealt to fb6c4072 
Dealt to 6eae6bcb 
Dealt to 835df346 
fb6c4072: folds
6eae6bcb: raises $0.1 to $0.15
835df346: folds
b0ee20aa: folds
df0ebddc: folds
Hero: calls $0.1
*** FLOP *** [9d 8s Jc]
Hero: checks
6eae6bcb: checks
*** TURN *** [9d 8s Jc] [Tc]
Hero: checks
6eae6bcb: bets $0.11
Hero: folds
Uncalled bet ($0.11) returned to 6eae6bcb
*** SHOWDOWN ***
6eae6bcb collected $0.31 from pot
*** SUMMARY ***
Total pot $0.32 | Rake $0.01 | Jackpot $0 | Bingo $0 | Fortune $0 | Tax $0
Board [9d 8s Jc Tc]
Seat 1: b0ee20aa (button) folded before Flop (didn't bet)
Seat 2: df0ebddc (small blind) folded before Flop
Seat 3: Hero (big blind) folded on the Turn
Seat 4: fb6c4072 folded before Flop (didn't bet)
Seat 5: 6eae6bcb won ($0.31)
Seat 6: 835df346 folded before Flop (didn't bet)


Poker Hand #RC3334374437: Hold'em No Limit ($0.02/$0.05) - 2025/02/17 20:27:57
Table 'RushAndCash599697' 6-max Seat #1 is the button
Seat 1: Hero ($5.2 in chips)
Seat 2: fcc3c3cc ($5.11 in chips)
Seat 3: fc8b0177 ($6.43 in chips)
Seat 4: f1ef2c72 ($9.17 in chips)
Seat 5: d793d8f ($5.04 in chips)
Seat 6: 8f9fd8b1 ($5.29 in chips)
fcc3c3cc: posts small blind $0.02
fc8b0177: posts big blind $0.05
*** HOLE CARDS ***
Dealt to Hero [4c Qd]
Dealt to fcc3c3cc 
Dealt to fc8b0177 
Dealt to f1ef2c72 
Dealt to d793d8f 
Dealt to 8f9fd8b1 
f1ef2c72: folds
d793d8f: folds
8f9fd8b1: folds
Hero: folds
fcc3c3cc: folds
Uncalled bet ($0.03) returned to fc8b0177
*** SHOWDOWN ***
fc8b0177 collected $0.04 from pot
*** SUMMARY ***
Total pot $0.04 | Rake $0 | Jackpot $0 | Bingo $0 | Fortune $0 | Tax $0
Seat 1: Hero (button) folded before Flop (didn't bet)
Seat 2: fcc3c3cc (small blind) folded before Flop
Seat 3: fc8b0177 (big blind) collected ($0.04)
Seat 4: f1ef2c72 folded before Flop (didn't bet)
Seat 5: d793d8f folded before Flop (didn't bet)
Seat 6: 8f9fd8b1 folded before Flop (didn't bet)


Poker Hand #RC3334374417: Hold'em No Limit ($0.02/$0.05) - 2025/02/17 20:27:54
Table 'RushAndCash599677' 6-max Seat #1 is the button
Seat 1: b7d97ee0 ($5.93 in chips)
Seat 2: Hero ($5.22 in chips)
Seat 3: 53c3b7da ($4.14 in chips)
Seat 4: faba3abb ($5 in chips)
Seat 5: fa40c39c ($5.56 in chips)
Seat 6: 4190d158 ($5.98 in chips)
Hero: posts small blind $0.02
53c3b7da: posts big blind $0.05
*** HOLE CARDS ***
Dealt to b7d97ee0 
Dealt to Hero [6s Kc]
Dealt to 53c3b7da 
Dealt to faba3abb 
Dealt to fa40c39c 
Dealt to 4190d158 
faba3abb: folds
fa40c39c: folds
4190d158: folds
b7d97ee0: folds
Hero: folds
Uncalled bet ($0.03) returned to 53c3b7da
*** SHOWDOWN ***
53c3b7da collected $0.04 from pot
*** SUMMARY ***
Total pot $0.04 | Rake $0 | Jackpot $0 | Bingo $0 | Fortune $0 | Tax $0
Seat 1: b7d97ee0 (button) folded before Flop (didn't bet)
Seat 2: Hero (small blind) folded before Flop
Seat 3: 53c3b7da (big blind) collected ($0.04)
Seat 4: faba3abb folded before Flop (didn't bet)
Seat 5: fa40c39c folded before Flop (didn't bet)
Seat 6: 4190d158 folded before Flop (didn't bet)


Poker Hand #RC3334374286: Hold'em No Limit ($0.02/$0.05) - 2025/02/17 20:27:33
Table 'RushAndCash599546' 6-max Seat #1 is the button
Seat 1: Hero ($5.32 in chips)
Seat 2: b7d97ee0 ($5.79 in chips)
Seat 3: 1df270b6 ($7.97 in chips)
Seat 4: 53c3b7da ($4.16 in chips)
Seat 5: 856cc88a ($5.04 in chips)
Seat 6: d201e5fe ($6.56 in chips)
b7d97ee0: posts small blind $0.02
1df270b6: posts big blind $0.05
*** HOLE CARDS ***
Dealt to Hero [Qh Th]
Dealt to b7d97ee0 
Dealt to 1df270b6 
Dealt to 53c3b7da 
Dealt to 856cc88a 
Dealt to d201e5fe 
53c3b7da: folds
856cc88a: folds
d201e5fe: folds
Hero: raises $0.05 to $0.1
b7d97ee0: raises $0.46 to $0.56
1df270b6: folds
Hero: folds
Uncalled bet ($0.46) returned to b7d97ee0
*** SHOWDOWN ***
b7d97ee0 collected $0.24 from pot
*** SUMMARY ***
Total pot $0.25 | Rake $0.01 | Jackpot $0 | Bingo $0 | Fortune $0 | Tax $0
Seat 1: Hero (button) folded before Flop
Seat 2: b7d97ee0 (small blind) collected ($0.24)
Seat 3: 1df270b6 (big blind) folded before Flop
Seat 4: 53c3b7da folded before Flop (didn't bet)
Seat 5: 856cc88a folded before Flop (didn't bet)
Seat 6: d201e5fe folded before Flop (didn't bet)


Poker Hand #RC3334374269: Hold'em No Limit ($0.02/$0.05) - 2025/02/17 20:27:30
Table 'RushAndCash599529' 6-max Seat #1 is the button
Seat 1: 9684e9f0 ($5 in chips)
Seat 2: 1b6c31ec ($5 in chips)
Seat 3: b0ee20aa ($23.12 in chips)
Seat 4: c95c6ae6 ($14.33 in chips)
Seat 5: ec1d0d44 ($10 in chips)
Seat 6: Hero ($5.32 in chips)
1b6c31ec: posts small blind $0.02
b0ee20aa: posts big blind $0.05
*** HOLE CARDS ***
Dealt to 9684e9f0 
Dealt to 1b6c31ec 
Dealt to b0ee20aa 
Dealt to c95c6ae6 
Dealt to ec1d0d44 
Dealt to Hero [4s Th]
c95c6ae6: folds
ec1d0d44: raises $0.06 to $0.11
Hero: folds
9684e9f0: folds
1b6c31ec: calls $0.09
b0ee20aa: folds
*** FLOP *** [9h 4c 9c]
1b6c31ec: checks
ec1d0d44: bets $0.1
1b6c31ec: folds
Uncalled bet ($0.1) returned to ec1d0d44
*** SHOWDOWN ***
ec1d0d44 collected $0.26 from pot
*** SUMMARY ***
Total pot $0.27 | Rake $0.01 | Jackpot $0 | Bingo $0 | Fortune $0 | Tax $0
Board [9h 4c 9c]
Seat 1: 9684e9f0 (button) folded before Flop (didn't bet)
Seat 2: 1b6c31ec (small blind) folded on the Flop
Seat 3: b0ee20aa (big blind) folded before Flop
Seat 4: c95c6ae6 folded before Flop (didn't bet)
Seat 5: ec1d0d44 won ($0.26)
Seat 6: Hero folded before Flop (didn't bet)


Poker Hand #RC3334374112: Hold'em No Limit ($0.02/$0.05) - 2025/02/17 20:27:06
Table 'RushAndCash599372' 6-max Seat #1 is the button
Seat 1: 1c01f5f5 ($4.86 in chips)
Seat 2: e5903036 ($16.44 in chips)
Seat 3: 95a5d925 ($5 in chips)
Seat 4: Hero ($5.25 in chips)
Seat 5: c45332c4 ($5.56 in chips)
Seat 6: 59f12f9f ($5 in chips)
e5903036: posts small blind $0.02
95a5d925: posts big blind $0.05
*** HOLE CARDS ***
Dealt to 1c01f5f5 
Dealt to e5903036 
Dealt to 95a5d925 
Dealt to Hero [Qs Ad]
Dealt to c45332c4 
Dealt to 59f12f9f 
Hero: raises $0.05 to $0.1
c45332c4: folds
59f12f9f: folds
1c01f5f5: folds
e5903036: folds
95a5d925: folds
Uncalled bet ($0.05) returned to Hero
*** SHOWDOWN ***
Hero collected $0.12 from pot
*** SUMMARY ***
Total pot $0.12 | Rake $0 | Jackpot $0 | Bingo $0 | Fortune $0 | Tax $0
Seat 1: 1c01f5f5 (button) folded before Flop (didn't bet)
Seat 2: e5903036 (small blind) folded before Flop
Seat 3: 95a5d925 (big blind) folded before Flop
Seat 4: Hero collected ($0.12)
Seat 5: c45332c4 folded before Flop (didn't bet)
Seat 6: 59f12f9f folded before Flop (didn't bet)


Poker Hand #RC3334374090: Hold'em No Limit ($0.02/$0.05) - 2025/02/17 20:27:02
Table 'RushAndCash599350' 6-max Seat #1 is the button
Seat 1: ec796181 ($4.93 in chips)
Seat 2: 1c01f5f5 ($4.88 in chips)
Seat 3: 573eb753 ($5.47 in chips)
Seat 4: f553bfb4 ($7.04 in chips)
Seat 5: 39109629 ($5.23 in chips)
Seat 6: Hero ($5.25 in chips)
1c01f5f5: posts small blind $0.02
573eb753: posts big blind $0.05
*** HOLE CARDS ***
Dealt to ec796181 
Dealt to 1c01f5f5 
Dealt to 573eb753 
Dealt to f553bfb4 
Dealt to 39109629 
Dealt to Hero [Qc 7d]
f553bfb4: folds
39109629: raises $0.08 to $0.13
Hero: folds
ec796181: folds
1c01f5f5: folds
573eb753: calls $0.08
*** FLOP *** [Tc Js Ac]
573eb753: checks
39109629: checks
*** TURN *** [Tc Js Ac] [Td]
573eb753: checks
39109629: checks
*** RIVER *** [Tc Js Ac Td] [6d]
573eb753: checks
39109629: checks
573eb753: shows [8c 9c] (Pair of Tens)
39109629: shows [8s 8h] (Pair of Tens and Pair of Eights)
*** SHOWDOWN ***
39109629 collected $0.27 from pot
*** SUMMARY ***
Total pot $0.28 | Rake $0.01 | Jackpot $0 | Bingo $0 | Fortune $0 | Tax $0
Board [Tc Js Ac Td 6d]
Seat 1: ec796181 (button) folded before Flop (didn't bet)
Seat 2: 1c01f5f5 (small blind) folded before Flop
Seat 3: 573eb753 (big blind) showed [8c 9c] and lost with Pair of Tens
Seat 4: f553bfb4 folded before Flop (didn't bet)
Seat 5: 39109629 showed [8s 8h] and won ($0.27) with Pair of Tens and Pair of Eights
Seat 6: Hero folded before Flop (didn't bet)


Poker Hand #RC3334374067: Hold'em No Limit ($0.02/$0.05) - 2025/02/17 20:26:59
Table 'RushAndCash599327' 6-max Seat #1 is the button
Seat 1: 14b45b97 ($10.46 in chips)
Seat 2: Hero ($5.27 in chips)
Seat 3: fdc3ee5c ($12.67 in chips)
Seat 4: 84fb210c ($11.2 in chips)
Seat 5: cc01248b ($5.94 in chips)
Seat 6: 7c99618c ($5.29 in chips)
Hero: posts small blind $0.02
fdc3ee5c: posts big blind $0.05
*** HOLE CARDS ***
Dealt to 14b45b97 
Dealt to Hero [7h 2d]
Dealt to fdc3ee5c 
Dealt to 84fb210c 
Dealt to cc01248b 
Dealt to 7c99618c 
84fb210c: folds
cc01248b: folds
7c99618c: folds
14b45b97: folds
Hero: folds
Uncalled bet ($0.03) returned to fdc3ee5c
*** SHOWDOWN ***
fdc3ee5c collected $0.04 from pot
*** SUMMARY ***
Total pot $0.04 | Rake $0 | Jackpot $0 | Bingo $0 | Fortune $0 | Tax $0
Seat 1: 14b45b97 (button) folded before Flop (didn't bet)
Seat 2: Hero (small blind) folded before Flop
Seat 3: fdc3ee5c (big blind) collected ($0.04)
Seat 4: 84fb210c folded before Flop (didn't bet)
Seat 5: cc01248b folded before Flop (didn't bet)
Seat 6: 7c99618c folded before Flop (didn't bet)


Poker Hand #RC3334373840: Hold'em No Limit ($0.02/$0.05) - 2025/02/17 20:26:26
Table 'RushAndCash599100' 6-max Seat #1 is the button
Seat 1: 1dbfd698 ($8.66 in chips)
Seat 2: e92b360e ($13.46 in chips)
Seat 3: Hero ($5.07 in chips)
Seat 4: e8e95c39 ($5.87 in chips)
Seat 5: dc9e794c ($5.16 in chips)
Seat 6: bfc75c9 ($12.73 in chips)
e92b360e: posts small blind $0.02
Hero: posts big blind $0.05
*** HOLE CARDS ***
Dealt to 1dbfd698 
Dealt to e92b360e 
Dealt to Hero [Td 8d]
Dealt to e8e95c39 
Dealt to dc9e794c 
Dealt to bfc75c9 
e8e95c39: folds
dc9e794c: raises $0.05 to $0.1
bfc75c9: folds
1dbfd698: folds
e92b360e: folds
Hero: calls $0.05
*** FLOP *** [Qd As Jh]
Hero: checks
dc9e794c: bets $0.05
Hero: calls $0.05
*** TURN *** [Qd As Jh] [9h]
Hero: checks
dc9e794c: bets $0.05
Hero: raises $0.33 to $0.38
dc9e794c: folds
Uncalled bet ($0.33) returned to Hero
*** SHOWDOWN ***
Hero collected $0.4 from pot
*** SUMMARY ***
Total pot $0.42 | Rake $0.02 | Jackpot $0 | Bingo $0 | Fortune $0 | Tax $0
Board [Qd As Jh 9h]
Seat 1: 1dbfd698 (button) folded before Flop (didn't bet)
Seat 2: e92b360e (small blind) folded before Flop
Seat 3: Hero (big blind) won ($0.4)
Seat 4: e8e95c39 folded before Flop (didn't bet)
Seat 5: dc9e794c folded on the Turn
Seat 6: bfc75c9 folded before Flop (didn't bet)


Poker Hand #RC3334373818: Hold'em No Limit ($0.02/$0.05) - 2025/02/17 20:26:23
Table 'RushAndCash599078' 6-max Seat #1 is the button
Seat 1: 9dd1ff39 ($6.94 in chips)
Seat 2: 6c122cb5 ($7.19 in chips)
Seat 3: 6d2abfa5 ($6.5 in chips)
Seat 4: 5265b128 ($5.14 in chips)
Seat 5: 90fb5891 ($15.63 in chips)
Seat 6: Hero ($5.07 in chips)
6c122cb5: posts small blind $0.02
6d2abfa5: posts big blind $0.05
*** HOLE CARDS ***
Dealt to 9dd1ff39 
Dealt to 6c122cb5 
Dealt to 6d2abfa5 
Dealt to 5265b128 
Dealt to 90fb5891 
Dealt to Hero [3c Ts]
5265b128: raises $0.08 to $0.13
90fb5891: folds
Hero: folds
9dd1ff39: folds
6c122cb5: folds
6d2abfa5: folds
Uncalled bet ($0.08) returned to 5265b128
*** SHOWDOWN ***
5265b128 collected $0.12 from pot
*** SUMMARY ***
Total pot $0.12 | Rake $0 | Jackpot $0 | Bingo $0 | Fortune $0 | Tax $0
Seat 1: 9dd1ff39 (button) folded before Flop (didn't bet)
Seat 2: 6c122cb5 (small blind) folded before Flop
Seat 3: 6d2abfa5 (big blind) folded before Flop
Seat 4: 5265b128 collected ($0.12)
Seat 5: 90fb5891 folded before Flop (didn't bet)
Seat 6: Hero folded before Flop (didn't bet)


Poker Hand #RC3334373735: Hold'em No Limit ($0.02/$0.05) - 2025/02/17 20:26:10
Table 'RushAndCash598995' 6-max Seat #1 is the button
Seat 1: d97dda86 ($5 in chips)
Seat 2: 8e07c53 ($5.21 in chips)
Seat 3: cd1f87c8 ($2.71 in chips)
Seat 4: 9f09d482 ($5.12 in chips)
Seat 5: 4e3196ec ($6.09 in chips)
Seat 6: Hero ($5 in chips)
8e07c53: posts small blind $0.02
cd1f87c8: posts big blind $0.05
*** HOLE CARDS ***
Dealt to d97dda86 
Dealt to 8e07c53 
Dealt to cd1f87c8 
Dealt to 9f09d482 
Dealt to 4e3196ec 
Dealt to Hero [Qs Ah]
9f09d482: folds
4e3196ec: folds
Hero: raises $0.05 to $0.1
d97dda86: folds
8e07c53: folds
cd1f87c8: folds
Uncalled bet ($0.05) returned to Hero
*** SHOWDOWN ***
Hero collected $0.12 from pot
*** SUMMARY ***
Total pot $0.12 | Rake $0 | Jackpot $0 | Bingo $0 | Fortune $0 | Tax $0
Seat 1: d97dda86 (button) folded before Flop (didn't bet)
Seat 2: 8e07c53 (small blind) folded before Flop
Seat 3: cd1f87c8 (big blind) folded before Flop
Seat 4: 9f09d482 folded before Flop (didn't bet)
Seat 5: 4e3196ec folded before Flop (didn't bet)
Seat 6: Hero collected ($0.12)


Poker Hand #RC3334373712: Hold'em No Limit ($0.02/$0.05) - 2025/02/17 20:26:07
Table 'RushAndCash598972' 6-max Seat #1 is the button
Seat 1: 5265b128 ($5.14 in chips)
Seat 2: 9f09d482 ($5.14 in chips)
Seat 3: b501555b ($9.6 in chips)
Seat 4: e632d40b ($7.66 in chips)
Seat 5: fcc3c3cc ($4.93 in chips)
Seat 6: Hero ($5 in chips)
9f09d482: posts small blind $0.02
b501555b: posts big blind $0.05
*** HOLE CARDS ***
Dealt to 5265b128 
Dealt to 9f09d482 
Dealt to b501555b 
Dealt to e632d40b 
Dealt to fcc3c3cc 
Dealt to Hero [5s Jd]
e632d40b: folds
fcc3c3cc: raises $0.08 to $0.13
Hero: folds
5265b128: folds
9f09d482: folds
b501555b: calls $0.08
*** FLOP *** [8h 7d 6s]
b501555b: checks
fcc3c3cc: bets $0.18
b501555b: calls $0.18
*** TURN *** [8h 7d 6s] [3c]
b501555b: checks
fcc3c3cc: checks
*** RIVER *** [8h 7d 6s 3c] [7s]
b501555b: checks
fcc3c3cc: checks
b501555b: shows [Jc Tc] (Pair of Sevens)
fcc3c3cc: shows [Kc 9c] (Pair of Sevens)
*** SHOWDOWN ***
fcc3c3cc collected $0.61 from pot
*** SUMMARY ***
Total pot $0.64 | Rake $0.03 | Jackpot $0 | Bingo $0 | Fortune $0 | Tax $0
Board [8h 7d 6s 3c 7s]
Seat 1: 5265b128 (button) folded before Flop (didn't bet)
Seat 2: 9f09d482 (small blind) folded before Flop
Seat 3: b501555b (big blind) showed [Jc Tc] and lost with Pair of Sevens
Seat 4: e632d40b folded before Flop (didn't bet)
Seat 5: fcc3c3cc showed [Kc 9c] and won ($0.61) with Pair of Sevens
Seat 6: Hero folded before Flop (didn't bet)


Poker Hand #RC3334373689: Hold'em No Limit ($0.02/$0.05) - 2025/02/17 20:26:03
Table 'RushAndCash598949' 6-max Seat #1 is the button
Seat 1: Hero ($5 in chips)
Seat 2: c45332c4 ($5.58 in chips)
Seat 3: 8282d87b ($5 in chips)
Seat 4: e74a324 ($6.21 in chips)
Seat 5: 7cfb455f ($5.98 in chips)
Seat 6: 11fb4d12 ($5.21 in chips)
c45332c4: posts small blind $0.02
8282d87b: posts big blind $0.05
*** HOLE CARDS ***
Dealt to Hero [2d 7d]
Dealt to c45332c4 
Dealt to 8282d87b 
Dealt to e74a324 
Dealt to 7cfb455f 
Dealt to 11fb4d12 
e74a324: folds
7cfb455f: folds
11fb4d12: folds
Hero: folds
c45332c4: folds
Uncalled bet ($0.03) returned to 8282d87b
*** SHOWDOWN ***
8282d87b collected $0.04 from pot
*** SUMMARY ***
Total pot $0.04 | Rake $0 | Jackpot $0 | Bingo $0 | Fortune $0 | Tax $0
Seat 1: Hero (button) folded before Flop (didn't bet)
Seat 2: c45332c4 (small blind) folded before Flop
Seat 3: 8282d87b (big blind) collected ($0.04)
Seat 4: e74a324 folded before Flop (didn't bet)
Seat 5: 7cfb455f folded before Flop (didn't bet)
Seat 6: 11fb4d12 folded before Flop (didn't bet)


Poker Hand #RC3334373663: Hold'em No Limit ($0.02/$0.05) - 2025/02/17 20:25:59
Table 'RushAndCash598923' 6-max Seat #1 is the button
Seat 1: 4dd12e47 ($4.6 in chips)
Seat 2: 7a5bf293 ($5.02 in chips)
Seat 3: Hero ($5 in chips)
Seat 4: bfc75c9 ($12.77 in chips)
Seat 5: 7b6a3077 ($6.31 in chips)
Seat 6: ae49e9c ($5.39 in chips)
7a5bf293: posts small blind $0.02
Hero: posts big blind $0.05
*** HOLE CARDS ***
Dealt to 4dd12e47 
Dealt to 7a5bf293 
Dealt to Hero [2c Jc]
Dealt to bfc75c9 
Dealt to 7b6a3077 
Dealt to ae49e9c 
bfc75c9: folds
7b6a3077: folds
ae49e9c: raises $0.08 to $0.13
4dd12e47: folds
7a5bf293: raises $0.37 to $0.5
Hero: folds
ae49e9c: calls $0.37
*** FLOP *** [Jd 2d 2h]
7a5bf293: bets $0.35
ae49e9c: calls $0.35
*** TURN *** [Jd 2d 2h] [9h]
7a5bf293: bets $1.15
ae49e9c: calls $1.15
*** RIVER *** [Jd 2d 2h 9h] [2s]
7a5bf293: bets $3.02 and is all-in
ae49e9c: folds
Uncalled bet ($3.02) returned to 7a5bf293
*** SHOWDOWN ***
7a5bf293 collected $3.83 from pot
*** SUMMARY ***
Total pot $4.05 | Rake $0.15 | Jackpot $0.07 | Bingo $0 | Fortune $0 | Tax $0
Board [Jd 2d 2h 9h 2s]
Seat 1: 4dd12e47 (button) folded before Flop (didn't bet)
Seat 2: 7a5bf293 (small blind) won ($3.83)
Seat 3: Hero (big blind) folded before Flop
Seat 4: bfc75c9 folded before Flop (didn't bet)
Seat 5: 7b6a3077 folded before Flop (didn't bet)
Seat 6: ae49e9c folded on the River


Poker Hand #RC3334373642: Hold'em No Limit ($0.02/$0.05) - 2025/02/17 20:25:56
Table 'RushAndCash598902' 6-max Seat #1 is the button
Seat 1: b9e511a ($22.31 in chips)
Seat 2: Hero ($5 in chips)
Seat 3: 52f43d28 ($7.15 in chips)
Seat 4: e4fd2097 ($15.62 in chips)
Seat 5: 28e11496 ($8.98 in chips)
Seat 6: deccd7eb ($5 in chips)
Hero: posts small blind $0.02
52f43d28: posts big blind $0.05
*** HOLE CARDS ***
Dealt to b9e511a 
Dealt to Hero [3c 4h]
Dealt to 52f43d28 
Dealt to e4fd2097 
Dealt to 28e11496 
Dealt to deccd7eb 
e4fd2097: folds
28e11496: raises $0.05 to $0.1
deccd7eb: folds
b9e511a: folds
Hero: folds
52f43d28: folds
Uncalled bet ($0.05) returned to 28e11496
*** SHOWDOWN ***
28e11496 collected $0.12 from pot
*** SUMMARY ***
Total pot $0.12 | Rake $0 | Jackpot $0 | Bingo $0 | Fortune $0 | Tax $0
Seat 1: b9e511a (button) folded before Flop (didn't bet)
Seat 2: Hero (small blind) folded before Flop
Seat 3: 52f43d28 (big blind) folded before Flop
Seat 4: e4fd2097 folded before Flop (didn't bet)
Seat 5: 28e11496 collected ($0.12)
Seat 6: deccd7eb folded before Flop (didn't bet)


Poker Hand #RC3334373619: Hold'em No Limit ($0.02/$0.05) - 2025/02/17 20:25:53
Table 'RushAndCash598879' 6-max Seat #1 is the button
Seat 1: 2a5d53e8 ($1.12 in chips)
Seat 2: 71e00d83 ($12.89 in chips)
Seat 3: 3c1ddc3a ($7.59 in chips)
Seat 4: Hero ($5 in chips)
Seat 5: 3b85f8e6 ($14.45 in chips)
Seat 6: b61b14d7 ($5.28 in chips)
71e00d83: posts small blind $0.02
3c1ddc3a: posts big blind $0.05
*** HOLE CARDS ***
Dealt to 2a5d53e8 
Dealt to 71e00d83 
Dealt to 3c1ddc3a 
Dealt to Hero [3h 4h]
Dealt to 3b85f8e6 
Dealt to b61b14d7 
Hero: folds
3b85f8e6: folds
b61b14d7: folds
2a5d53e8: folds
71e00d83: raises $0.05 to $0.1
3c1ddc3a: calls $0.05
*** FLOP *** [7d Qs 7h]
71e00d83: bets $0.07
3c1ddc3a: folds
Uncalled bet ($0.07) returned to 71e00d83
*** SHOWDOWN ***
71e00d83 collected $0.19 from pot
*** SUMMARY ***
Total pot $0.2 | Rake $0.01 | Jackpot $0 | Bingo $0 | Fortune $0 | Tax $0
Board [7d Qs 7h]
Seat 1: 2a5d53e8 (button) folded before Flop (didn't bet)
Seat 2: 71e00d83 (small blind) won ($0.19)
Seat 3: 3c1ddc3a (big blind) folded on the Flop
Seat 4: Hero folded before Flop (didn't bet)
Seat 5: 3b85f8e6 folded before Flop (didn't bet)
Seat 6: b61b14d7 folded before Flop (didn't bet)


Poker Hand #RC3334373599: Hold'em No Limit ($0.02/$0.05) - 2025/02/17 20:25:49
Table 'RushAndCash598859' 6-max Seat #1 is the button
Seat 1: 16b0b958 ($5 in chips)
Seat 2: c24b20b9 ($17.31 in chips)
Seat 3: 6662e866 ($15.86 in chips)
Seat 4: Hero ($5 in chips)
Seat 5: b9369e69 ($5.89 in chips)
Seat 6: f45ac3d0 ($5 in chips)
c24b20b9: posts small blind $0.02
6662e866: posts big blind $0.05
*** HOLE CARDS ***
Dealt to 16b0b958 
Dealt to c24b20b9 
Dealt to 6662e866 
Dealt to Hero [2c Kh]
Dealt to b9369e69 
Dealt to f45ac3d0 
Hero: folds
b9369e69: raises $0.05 to $0.1
f45ac3d0: folds
16b0b958: folds
c24b20b9: folds
6662e866: folds
Uncalled bet ($0.05) returned to b9369e69
*** SHOWDOWN ***
b9369e69 collected $0.12 from pot
*** SUMMARY ***
Total pot $0.12 | Rake $0 | Jackpot $0 | Bingo $0 | Fortune $0 | Tax $0
Seat 1: 16b0b958 (button) folded before Flop (didn't bet)
Seat 2: c24b20b9 (small blind) folded before Flop
Seat 3: 6662e866 (big blind) folded before Flop
Seat 4: Hero folded before Flop (didn't bet)
Seat 5: b9369e69 collected ($0.12)
Seat 6: f45ac3d0 folded before Flop (didn't bet)


Poker Hand #RC3334373579: Hold'em No Limit ($0.02/$0.05) - 2025/02/17 20:25:46
Table 'RushAndCash598839' 6-max Seat #1 is the button
Seat 1: 71e00d83 ($12.89 in chips)
Seat 2: 144ea2b0 ($10.53 in chips)
Seat 3: a6ca20e7 ($34.62 in chips)
Seat 4: f553bfb4 ($5.52 in chips)
Seat 5: e74a324 ($6.19 in chips)
Seat 6: Hero ($5 in chips)
144ea2b0: posts small blind $0.02
a6ca20e7: posts big blind $0.05
*** HOLE CARDS ***
Dealt to 71e00d83 
Dealt to 144ea2b0 
Dealt to a6ca20e7 
Dealt to f553bfb4 
Dealt to e74a324 
Dealt to Hero [Qd 7d]
f553bfb4: folds
e74a324: raises $0.05 to $0.1
Hero: folds
71e00d83: folds
144ea2b0: folds
a6ca20e7: folds
Uncalled bet ($0.05) returned to e74a324
*** SHOWDOWN ***
e74a324 collected $0.12 from pot
*** SUMMARY ***
Total pot $0.12 | Rake $0 | Jackpot $0 | Bingo $0 | Fortune $0 | Tax $0
Seat 1: 71e00d83 (button) folded before Flop (didn't bet)
Seat 2: 144ea2b0 (small blind) folded before Flop
Seat 3: a6ca20e7 (big blind) folded before Flop
Seat 4: f553bfb4 folded before Flop (didn't bet)
Seat 5: e74a324 collected ($0.12)
Seat 6: Hero folded before Flop (didn't bet)


Poker Hand #RC3334373391: Hold'em No Limit ($0.02/$0.05) - 2025/02/17 20:25:18
Table 'RushAndCash598651' 6-max Seat #1 is the button
Seat 1: f0d238ad ($9.79 in chips)
Seat 2: da25c79c ($5 in chips)
Seat 3: Hero ($5 in chips)
Seat 4: 13ffafdd ($5.18 in chips)
Seat 5: e69e22e ($5 in chips)
Seat 6: 9ccadbb5 ($13.15 in chips)
da25c79c: posts small blind $0.02
Hero: posts big blind $0.05
*** HOLE CARDS ***
Dealt to f0d238ad 
Dealt to da25c79c 
Dealt to Hero [Ad 4d]
Dealt to 13ffafdd 
Dealt to e69e22e 
Dealt to 9ccadbb5 
13ffafdd: raises $0.05 to $0.1
e69e22e: folds
9ccadbb5: folds
f0d238ad: folds
da25c79c: folds
Hero: calls $0.05
*** FLOP *** [Qs Ts 7s]
Hero: checks
13ffafdd: bets $0.19
Hero: folds
Uncalled bet ($0.19) returned to 13ffafdd
*** SHOWDOWN ***
13ffafdd collected $0.21 from pot
*** SUMMARY ***
Total pot $0.22 | Rake $0.01 | Jackpot $0 | Bingo $0 | Fortune $0 | Tax $0
Board [Qs Ts 7s]
Seat 1: f0d238ad (button) folded before Flop (didn't bet)
Seat 2: da25c79c (small blind) folded before Flop
Seat 3: Hero (big blind) folded on the Flop
Seat 4: 13ffafdd won ($0.21)
Seat 5: e69e22e folded before Flop (didn't bet)
Seat 6: 9ccadbb5 folded before Flop (didn't bet)


Poker Hand #RC3334373346: Hold'em No Limit ($0.02/$0.05) - 2025/02/17 20:25:11
Table 'RushAndCash598606' 6-max Seat #1 is the button
Seat 1: 6008538 ($4.42 in chips)
Seat 2: 7cfb455f ($5.91 in chips)
Seat 3: 5f78b1e2 ($4.58 in chips)
Seat 4: 188c8947 ($4.23 in chips)
Seat 5: 53c3b7da ($4.24 in chips)
Seat 6: Hero ($5 in chips)
7cfb455f: posts small blind $0.02
5f78b1e2: posts big blind $0.05
*** HOLE CARDS ***
Dealt to 6008538 
Dealt to 7cfb455f 
Dealt to 5f78b1e2 
Dealt to 188c8947 
Dealt to 53c3b7da 
Dealt to Hero [3s 2h]
188c8947: folds
53c3b7da: folds
Hero: folds
6008538: folds
7cfb455f: raises $0.1 to $0.15
5f78b1e2: folds
Uncalled bet ($0.1) returned to 7cfb455f
*** SHOWDOWN ***
7cfb455f collected $0.1 from pot
*** SUMMARY ***
Total pot $0.1 | Rake $0 | Jackpot $0 | Bingo $0 | Fortune $0 | Tax $0
Seat 1: 6008538 (button) folded before Flop (didn't bet)
Seat 2: 7cfb455f (small blind) collected ($0.1)
Seat 3: 5f78b1e2 (big blind) folded before Flop
Seat 4: 188c8947 folded before Flop (didn't bet)
Seat 5: 53c3b7da folded before Flop (didn't bet)
Seat 6: Hero folded before Flop (didn't bet)


Poker Hand #RC3334373324: Hold'em No Limit ($0.02/$0.05) - 2025/02/17 20:25:08
Table 'RushAndCash598584' 6-max Seat #1 is the button
Seat 1: 46997984 ($6.91 in chips)
Seat 2: Hero ($5 in chips)
Seat 3: b9d877b0 ($5 in chips)
Seat 4: 188c8947 ($4.23 in chips)
Seat 5: 7c99618c ($5.64 in chips)
Seat 6: 6d5fa70b ($6.76 in chips)
Hero: posts small blind $0.02
b9d877b0: posts big blind $0.05
*** HOLE CARDS ***
Dealt to 46997984 
Dealt to Hero [6s Qh]
Dealt to b9d877b0 
Dealt to 188c8947 
Dealt to 7c99618c 
Dealt to 6d5fa70b 
188c8947: folds
7c99618c: folds
6d5fa70b: folds
46997984: raises $0.1 to $0.15
Hero: folds
b9d877b0: folds
Uncalled bet ($0.1) returned to 46997984
*** SHOWDOWN ***
46997984 collected $0.12 from pot
*** SUMMARY ***
Total pot $0.12 | Rake $0 | Jackpot $0 | Bingo $0 | Fortune $0 | Tax $0
Seat 1: 46997984 (button) collected ($0.12)
Seat 2: Hero (small blind) folded before Flop
Seat 3: b9d877b0 (big blind) folded before Flop
Seat 4: 188c8947 folded before Flop (didn't bet)
Seat 5: 7c99618c folded before Flop (didn't bet)
Seat 6: 6d5fa70b folded before Flop (didn't bet)


Poker Hand #RC3334373303: Hold'em No Limit ($0.02/$0.05) - 2025/02/17 20:25:04
Table 'RushAndCash598563' 6-max Seat #1 is the button
Seat 1: Hero ($5 in chips)
Seat 2: 1696890b ($4.88 in chips)
Seat 3: 6a5a3ab6 ($7.46 in chips)
Seat 4: 84d78f72 ($5.57 in chips)
Seat 5: 1d2427ef ($5 in chips)
Seat 6: d1cd1071 ($15.18 in chips)
1696890b: posts small blind $0.02
6a5a3ab6: posts big blind $0.05
*** HOLE CARDS ***
Dealt to Hero [6s 4c]
Dealt to 1696890b 
Dealt to 6a5a3ab6 
Dealt to 84d78f72 
Dealt to 1d2427ef 
Dealt to d1cd1071 
84d78f72: folds
1d2427ef: raises $0.05 to $0.1
d1cd1071: folds
Hero: folds
1696890b: folds
6a5a3ab6: folds
Uncalled bet ($0.05) returned to 1d2427ef
*** SHOWDOWN ***
1d2427ef collected $0.12 from pot
*** SUMMARY ***
Total pot $0.12 | Rake $0 | Jackpot $0 | Bingo $0 | Fortune $0 | Tax $0
Seat 1: Hero (button) folded before Flop (didn't bet)
Seat 2: 1696890b (small blind) folded before Flop
Seat 3: 6a5a3ab6 (big blind) folded before Flop
Seat 4: 84d78f72 folded before Flop (didn't bet)
Seat 5: 1d2427ef collected ($0.12)
Seat 6: d1cd1071 folded before Flop (didn't bet)


Poker Hand #RC3334373286: Hold'em No Limit ($0.02/$0.05) - 2025/02/17 20:25:01
Table 'RushAndCash598546' 6-max Seat #1 is the button
Seat 1: 1aae5bdb ($5.37 in chips)
Seat 2: 63499226 ($3.73 in chips)
Seat 3: cf593991 ($5.96 in chips)
Seat 4: 29471264 ($6.52 in chips)
Seat 5: Hero ($5 in chips)
Seat 6: 6f6c01fc ($5.69 in chips)
63499226: posts small blind $0.02
cf593991: posts big blind $0.05
*** HOLE CARDS ***
Dealt to 1aae5bdb 
Dealt to 63499226 
Dealt to cf593991 
Dealt to 29471264 
Dealt to Hero [3d 2c]
Dealt to 6f6c01fc 
29471264: folds
Hero: folds
6f6c01fc: folds
1aae5bdb: folds
63499226: folds
Uncalled bet ($0.03) returned to cf593991
*** SHOWDOWN ***
cf593991 collected $0.04 from pot
*** SUMMARY ***
Total pot $0.04 | Rake $0 | Jackpot $0 | Bingo $0 | Fortune $0 | Tax $0
Seat 1: 1aae5bdb (button) folded before Flop (didn't bet)
Seat 2: 63499226 (small blind) folded before Flop
Seat 3: cf593991 (big blind) collected ($0.04)
Seat 4: 29471264 folded before Flop (didn't bet)
Seat 5: Hero folded before Flop (didn't bet)
Seat 6: 6f6c01fc folded before Flop (didn't bet)


Poker Hand #RC3334373262: Hold'em No Limit ($0.02/$0.05) - 2025/02/17 20:24:58
Table 'RushAndCash598522' 6-max Seat #1 is the button
Seat 1: Hero ($5 in chips)
Seat 2: 6d2abfa5 ($6.71 in chips)
Seat 3: 16f2e5ce ($8.63 in chips)
Seat 4: c1784884 ($5.16 in chips)
Seat 5: 9f09d482 ($5.39 in chips)
Seat 6: fa7bb2c5 ($5.02 in chips)
6d2abfa5: posts small blind $0.02
16f2e5ce: posts big blind $0.05
*** HOLE CARDS ***
Dealt to Hero [Jc 4c]
Dealt to 6d2abfa5 
Dealt to 16f2e5ce 
Dealt to c1784884 
Dealt to 9f09d482 
Dealt to fa7bb2c5 
c1784884: folds
9f09d482: folds
fa7bb2c5: folds
Hero: folds
6d2abfa5: folds
Uncalled bet ($0.03) returned to 16f2e5ce
*** SHOWDOWN ***
16f2e5ce collected $0.04 from pot
*** SUMMARY ***
Total pot $0.04 | Rake $0 | Jackpot $0 | Bingo $0 | Fortune $0 | Tax $0
Seat 1: Hero (button) folded before Flop (didn't bet)
Seat 2: 6d2abfa5 (small blind) folded before Flop
Seat 3: 16f2e5ce (big blind) collected ($0.04)
Seat 4: c1784884 folded before Flop (didn't bet)
Seat 5: 9f09d482 folded before Flop (didn't bet)
Seat 6: fa7bb2c5 folded before Flop (didn't bet)


Poker Hand #RC3334373230: Hold'em No Limit ($0.02/$0.05) - 2025/02/17 20:24:53
Table 'RushAndCash598490' 6-max Seat #1 is the button
Seat 1: 5be1ddae ($3.67 in chips)
Seat 2: 7b1c045a ($4.67 in chips)
Seat 3: Hero ($5.05 in chips)
Seat 4: c4eb9775 ($17.57 in chips)
Seat 5: c11c2441 ($5.05 in chips)
Seat 6: f26bf81c ($4.9 in chips)
7b1c045a: posts small blind $0.02
Hero: posts big blind $0.05
*** HOLE CARDS ***
Dealt to 5be1ddae 
Dealt to 7b1c045a 
Dealt to Hero [Qd 5c]
Dealt to c4eb9775 
Dealt to c11c2441 
Dealt to f26bf81c 
c4eb9775: folds
c11c2441: folds
f26bf81c: folds
5be1ddae: raises $0.08 to $0.13
7b1c045a: folds
Hero: folds
Uncalled bet ($0.08) returned to 5be1ddae
*** SHOWDOWN ***
5be1ddae collected $0.12 from pot
*** SUMMARY ***
Total pot $0.12 | Rake $0 | Jackpot $0 | Bingo $0 | Fortune $0 | Tax $0
Seat 1: 5be1ddae (button) collected ($0.12)
Seat 2: 7b1c045a (small blind) folded before Flop
Seat 3: Hero (big blind) folded before Flop
Seat 4: c4eb9775 folded before Flop (didn't bet)
Seat 5: c11c2441 folded before Flop (didn't bet)
Seat 6: f26bf81c folded before Flop (didn't bet)


Poker Hand #RC3334373090: Hold'em No Limit ($0.02/$0.05) - 2025/02/17 20:24:30
Table 'RushAndCash598350' 6-max Seat #1 is the button
Seat 1: 68b3fe79 ($5.21 in chips)
Seat 2: Hero ($5.07 in chips)
Seat 3: df6ad119 ($5.11 in chips)
Seat 4: 90b5d23c ($5.27 in chips)
Seat 5: 6eae6bcb ($7.45 in chips)
Seat 6: a28ca95c ($18.24 in chips)
Hero: posts small blind $0.02
df6ad119: posts big blind $0.05
*** HOLE CARDS ***
Dealt to 68b3fe79 
Dealt to Hero [9h 8d]
Dealt to df6ad119 
Dealt to 90b5d23c 
Dealt to 6eae6bcb 
Dealt to a28ca95c 
90b5d23c: folds
6eae6bcb: folds
a28ca95c: folds
68b3fe79: raises $0.08 to $0.13
Hero: folds
df6ad119: folds
Uncalled bet ($0.08) returned to 68b3fe79
*** SHOWDOWN ***
68b3fe79 collected $0.12 from pot
*** SUMMARY ***
Total pot $0.12 | Rake $0 | Jackpot $0 | Bingo $0 | Fortune $0 | Tax $0
Seat 1: 68b3fe79 (button) collected ($0.12)
Seat 2: Hero (small blind) folded before Flop
Seat 3: df6ad119 (big blind) folded before Flop
Seat 4: 90b5d23c folded before Flop (didn't bet)
Seat 5: 6eae6bcb folded before Flop (didn't bet)
Seat 6: a28ca95c folded before Flop (didn't bet)


Poker Hand #RC3334373070: Hold'em No Limit ($0.02/$0.05) - 2025/02/17 20:24:27
Table 'RushAndCash598330' 6-max Seat #1 is the button
Seat 1: a86de18f ($1.52 in chips)
Seat 2: 459728f6 ($6.66 in chips)
Seat 3: 634fda30 ($7.79 in chips)
Seat 4: af9df96 ($5 in chips)
Seat 5: 28e11496 ($9.03 in chips)
Seat 6: Hero ($5.07 in chips)
459728f6: posts small blind $0.02
634fda30: posts big blind $0.05
*** HOLE CARDS ***
Dealt to a86de18f 
Dealt to 459728f6 
Dealt to 634fda30 
Dealt to af9df96 
Dealt to 28e11496 
Dealt to Hero [3d 7d]
af9df96: folds
28e11496: folds
Hero: folds
a86de18f: folds
459728f6: raises $0.1 to $0.15
634fda30: folds
Uncalled bet ($0.1) returned to 459728f6
*** SHOWDOWN ***
459728f6 collected $0.1 from pot
*** SUMMARY ***
Total pot $0.1 | Rake $0 | Jackpot $0 | Bingo $0 | Fortune $0 | Tax $0
Seat 1: a86de18f (button) folded before Flop (didn't bet)
Seat 2: 459728f6 (small blind) collected ($0.1)
Seat 3: 634fda30 (big blind) folded before Flop
Seat 4: af9df96 folded before Flop (didn't bet)
Seat 5: 28e11496 folded before Flop (didn't bet)
Seat 6: Hero folded before Flop (didn't bet)


Poker Hand #RC3334373051: Hold'em No Limit ($0.02/$0.05) - 2025/02/17 20:24:24
Table 'RushAndCash598311' 6-max Seat #1 is the button
Seat 1: 1e86c3d2 ($5.58 in chips)
Seat 2: 3b85f8e6 ($14.33 in chips)
Seat 3: 6d5fa70b ($6.79 in chips)
Seat 4: 94b22b92 ($6.19 in chips)
Seat 5: Hero ($5.07 in chips)
Seat 6: 7de3ae0a ($5.11 in chips)
3b85f8e6: posts small blind $0.02
6d5fa70b: posts big blind $0.05
*** HOLE CARDS ***
Dealt to 1e86c3d2 
Dealt to 3b85f8e6 
Dealt to 6d5fa70b 
Dealt to 94b22b92 
Dealt to Hero [Jc 5h]
Dealt to 7de3ae0a 
94b22b92: folds
Hero: folds
7de3ae0a: folds
1e86c3d2: raises $0.08 to $0.13
3b85f8e6: raises $0.36 to $0.49
6d5fa70b: folds
1e86c3d2: folds
Uncalled bet ($0.36) returned to 3b85f8e6
*** SHOWDOWN ***
3b85f8e6 collected $0.3 from pot
*** SUMMARY ***
Total pot $0.31 | Rake $0.01 | Jackpot $0 | Bingo $0 | Fortune $0 | Tax $0
Seat 1: 1e86c3d2 (button) folded before Flop
Seat 2: 3b85f8e6 (small blind) collected ($0.3)
Seat 3: 6d5fa70b (big blind) folded before Flop
Seat 4: 94b22b92 folded before Flop (didn't bet)
Seat 5: Hero folded before Flop (didn't bet)
Seat 6: 7de3ae0a folded before Flop (didn't bet)


Poker Hand #RC3334373028: Hold'em No Limit ($0.02/$0.05) - 2025/02/17 20:24:21
Table 'RushAndCash598288' 6-max Seat #1 is the button
Seat 1: 742ccfee ($3.03 in chips)
Seat 2: 3b85f8e6 ($14.35 in chips)
Seat 3: 87205baf ($9.16 in chips)
Seat 4: 7de3ae0a ($5.11 in chips)
Seat 5: Hero ($5.07 in chips)
Seat 6: 8047b2ca ($4.51 in chips)
3b85f8e6: posts small blind $0.02
87205baf: posts big blind $0.05
*** HOLE CARDS ***
Dealt to 742ccfee 
Dealt to 3b85f8e6 
Dealt to 87205baf 
Dealt to 7de3ae0a 
Dealt to Hero [8h 3h]
Dealt to 8047b2ca 
7de3ae0a: folds
Hero: folds
8047b2ca: folds
742ccfee: folds
3b85f8e6: folds
Uncalled bet ($0.03) returned to 87205baf
*** SHOWDOWN ***
87205baf collected $0.04 from pot
*** SUMMARY ***
Total pot $0.04 | Rake $0 | Jackpot $0 | Bingo $0 | Fortune $0 | Tax $0
Seat 1: 742ccfee (button) folded before Flop (didn't bet)
Seat 2: 3b85f8e6 (small blind) folded before Flop
Seat 3: 87205baf (big blind) collected ($0.04)
Seat 4: 7de3ae0a folded before Flop (didn't bet)
Seat 5: Hero folded before Flop (didn't bet)
Seat 6: 8047b2ca folded before Flop (didn't bet)


Poker Hand #RC3334372952: Hold'em No Limit ($0.02/$0.05) - 2025/02/17 20:24:10
Table 'RushAndCash598212' 6-max Seat #1 is the button
Seat 1: c95c6ae6 ($14.16 in chips)
Seat 2: 4d8ae83 ($5 in chips)
Seat 3: 48dc6454 ($3.49 in chips)
Seat 4: d32b2e06 ($9.64 in chips)
Seat 5: 6f6c01fc ($5.96 in chips)
Seat 6: Hero ($5 in chips)
4d8ae83: posts small blind $0.02
48dc6454: posts big blind $0.05
*** HOLE CARDS ***
Dealt to c95c6ae6 
Dealt to 4d8ae83 
Dealt to 48dc6454 
Dealt to d32b2e06 
Dealt to 6f6c01fc 
Dealt to Hero [Ac Jc]
d32b2e06: folds
6f6c01fc: folds
Hero: raises $0.05 to $0.1
c95c6ae6: folds
4d8ae83: folds
48dc6454: folds
Uncalled bet ($0.05) returned to Hero
*** SHOWDOWN ***
Hero collected $0.12 from pot
*** SUMMARY ***
Total pot $0.12 | Rake $0 | Jackpot $0 | Bingo $0 | Fortune $0 | Tax $0
Seat 1: c95c6ae6 (button) folded before Flop (didn't bet)
Seat 2: 4d8ae83 (small blind) folded before Flop
Seat 3: 48dc6454 (big blind) folded before Flop
Seat 4: d32b2e06 folded before Flop (didn't bet)
Seat 5: 6f6c01fc folded before Flop (didn't bet)
Seat 6: Hero collected ($0.12)


Poker Hand #RC3334372926: Hold'em No Limit ($0.02/$0.05) - 2025/02/17 20:24:06
Table 'RushAndCash598186' 6-max Seat #1 is the button
Seat 1: Hero ($5 in chips)
Seat 2: 816260d0 ($5 in chips)
Seat 3: ef7b5599 ($16.41 in chips)
Seat 4: fdc3ee5c ($12.69 in chips)
Seat 5: 38a4c833 ($14.54 in chips)
Seat 6: 74b25a0c ($5.23 in chips)
816260d0: posts small blind $0.02
ef7b5599: posts big blind $0.05
*** HOLE CARDS ***
Dealt to Hero [Jd 2c]
Dealt to 816260d0 
Dealt to ef7b5599 
Dealt to fdc3ee5c 
Dealt to 38a4c833 
Dealt to 74b25a0c 
fdc3ee5c: raises $0.05 to $0.1
38a4c833: folds
74b25a0c: calls $0.1
Hero: folds
816260d0: folds
ef7b5599: folds
*** FLOP *** [2d 4d Kc]
fdc3ee5c: checks
74b25a0c: checks
*** TURN *** [2d 4d Kc] [5d]
fdc3ee5c: bets $0.13
74b25a0c: folds
Uncalled bet ($0.13) returned to fdc3ee5c
*** SHOWDOWN ***
fdc3ee5c collected $0.26 from pot
*** SUMMARY ***
Total pot $0.27 | Rake $0.01 | Jackpot $0 | Bingo $0 | Fortune $0 | Tax $0
Board [2d 4d Kc 5d]
Seat 1: Hero (button) folded before Flop (didn't bet)
Seat 2: 816260d0 (small blind) folded before Flop
Seat 3: ef7b5599 (big blind) folded before Flop
Seat 4: fdc3ee5c won ($0.26)
Seat 5: 38a4c833 folded before Flop (didn't bet)
Seat 6: 74b25a0c folded on the Turn


Poker Hand #RC3334372678: Hold'em No Limit ($0.02/$0.05) - 2025/02/17 20:23:24
Table 'RushAndCash597938' 6-max Seat #1 is the button
Seat 1: 157631a0 ($6.41 in chips)
Seat 2: Hero ($5 in chips)
Seat 3: 29471264 ($6.66 in chips)
Seat 4: 73382638 ($5 in chips)
Seat 5: 74b25a0c ($5.07 in chips)
Seat 6: c11c2441 ($5.16 in chips)
Hero: posts small blind $0.02
29471264: posts big blind $0.05
*** HOLE CARDS ***
Dealt to 157631a0 
Dealt to Hero [6d 6c]
Dealt to 29471264 
Dealt to 73382638 
Dealt to 74b25a0c 
Dealt to c11c2441 
73382638: folds
74b25a0c: raises $0.07 to $0.12
c11c2441: folds
157631a0: folds
Hero: calls $0.1
29471264: folds
*** FLOP *** [Th Ks 5d]
Hero: checks
74b25a0c: checks
*** TURN *** [Th Ks 5d] [Ah]
Hero: checks
74b25a0c: bets $0.16
Hero: folds
Uncalled bet ($0.16) returned to 74b25a0c
*** SHOWDOWN ***
74b25a0c collected $0.28 from pot
*** SUMMARY ***
Total pot $0.29 | Rake $0.01 | Jackpot $0 | Bingo $0 | Fortune $0 | Tax $0
Board [Th Ks 5d Ah]
Seat 1: 157631a0 (button) folded before Flop (didn't bet)
Seat 2: Hero (small blind) folded on the Turn
Seat 3: 29471264 (big blind) folded before Flop
Seat 4: 73382638 folded before Flop (didn't bet)
Seat 5: 74b25a0c won ($0.28)
Seat 6: c11c2441 folded before Flop (didn't bet)


Poker Hand #RC3334372563: Hold'em No Limit ($0.02/$0.05) - 2025/02/17 20:23:06
Table 'RushAndCash597823' 6-max Seat #1 is the button
Seat 1: 8930769f ($1.75 in chips)
Seat 2: b3aefb75 ($10.87 in chips)
Seat 3: Hero ($5 in chips)
Seat 4: 7dd18ea7 ($6.63 in chips)
Seat 5: 2ef61f09 ($8.53 in chips)
Seat 6: ab77a003 ($5.26 in chips)
b3aefb75: posts small blind $0.02
Hero: posts big blind $0.05
*** HOLE CARDS ***
Dealt to 8930769f 
Dealt to b3aefb75 
Dealt to Hero [8s Qs]
Dealt to 7dd18ea7 
Dealt to 2ef61f09 
Dealt to ab77a003 
7dd18ea7: raises $0.05 to $0.1
2ef61f09: folds
ab77a003: raises $0.25 to $0.35
8930769f: folds
b3aefb75: folds
Hero: folds
7dd18ea7: folds
Uncalled bet ($0.25) returned to ab77a003
*** SHOWDOWN ***
ab77a003 collected $0.26 from pot
*** SUMMARY ***
Total pot $0.27 | Rake $0.01 | Jackpot $0 | Bingo $0 | Fortune $0 | Tax $0
Seat 1: 8930769f (button) folded before Flop (didn't bet)
Seat 2: b3aefb75 (small blind) folded before Flop
Seat 3: Hero (big blind) folded before Flop
Seat 4: 7dd18ea7 folded before Flop
Seat 5: 2ef61f09 folded before Flop (didn't bet)
Seat 6: ab77a003 collected ($0.26)


Poker Hand #RC3334372543: Hold'em No Limit ($0.02/$0.05) - 2025/02/17 20:23:03
Table 'RushAndCash597803' 6-max Seat #1 is the button
Seat 1: 352d2b7 ($4.93 in chips)
Seat 2: 8e39de43 ($5.09 in chips)
Seat 3: 6d5fa70b ($7.07 in chips)
Seat 4: 92099542 ($5.02 in chips)
Seat 5: 93735ac4 ($4.35 in chips)
Seat 6: Hero ($5 in chips)
8e39de43: posts small blind $0.02
6d5fa70b: posts big blind $0.05
*** HOLE CARDS ***
Dealt to 352d2b7 
Dealt to 8e39de43 
Dealt to 6d5fa70b 
Dealt to 92099542 
Dealt to 93735ac4 
Dealt to Hero [6c Td]
92099542: folds
93735ac4: calls $0.05
Hero: folds
352d2b7: folds
8e39de43: folds
6d5fa70b: checks
*** FLOP *** [Qd 5d Th]
6d5fa70b: checks
93735ac4: bets $0.06
6d5fa70b: folds
Uncalled bet ($0.06) returned to 93735ac4
*** SHOWDOWN ***
93735ac4 collected $0.12 from pot
*** SUMMARY ***
Total pot $0.12 | Rake $0 | Jackpot $0 | Bingo $0 | Fortune $0 | Tax $0
Board [Qd 5d Th]
Seat 1: 352d2b7 (button) folded before Flop (didn't bet)
Seat 2: 8e39de43 (small blind) folded before Flop
Seat 3: 6d5fa70b (big blind) folded on the Flop
Seat 4: 92099542 folded before Flop (didn't bet)
Seat 5: 93735ac4 won ($0.12)
Seat 6: Hero folded before Flop (didn't bet)


Poker Hand #RC3334372524: Hold'em No Limit ($0.02/$0.05) - 2025/02/17 20:22:59
Table 'RushAndCash597784' 6-max Seat #1 is the button
Seat 1: f0deee96 ($3.33 in chips)
Seat 2: bfc75c9 ($11.94 in chips)
Seat 3: 4052bb6f ($6.08 in chips)
Seat 4: 8c3789e ($7.06 in chips)
Seat 5: Hero ($5 in chips)
Seat 6: f0d238ad ($10.29 in chips)
bfc75c9: posts small blind $0.02
4052bb6f: posts big blind $0.05
*** HOLE CARDS ***
Dealt to f0deee96 
Dealt to bfc75c9 
Dealt to 4052bb6f 
Dealt to 8c3789e 
Dealt to Hero [9d 4h]
Dealt to f0d238ad 
8c3789e: folds
Hero: folds
f0d238ad: folds
f0deee96: folds
bfc75c9: raises $0.1 to $0.15
4052bb6f: calls $0.1
*** FLOP *** [Jd 9c Tc]
bfc75c9: checks
4052bb6f: checks
*** TURN *** [Jd 9c Tc] [9s]
bfc75c9: bets $0.3
4052bb6f: folds
Uncalled bet ($0.3) returned to bfc75c9
*** SHOWDOWN ***
bfc75c9 collected $0.29 from pot
*** SUMMARY ***
Total pot $0.3 | Rake $0.01 | Jackpot $0 | Bingo $0 | Fortune $0 | Tax $0
Board [Jd 9c Tc 9s]
Seat 1: f0deee96 (button) folded before Flop (didn't bet)
Seat 2: bfc75c9 (small blind) won ($0.29)
Seat 3: 4052bb6f (big blind) folded on the Turn
Seat 4: 8c3789e folded before Flop (didn't bet)
Seat 5: Hero folded before Flop (didn't bet)
Seat 6: f0d238ad folded before Flop (didn't bet)


Poker Hand #RC3334372462: Hold'em No Limit ($0.02/$0.05) - 2025/02/17 20:22:50
Table 'RushAndCash597722' 6-max Seat #1 is the button
Seat 1: 4e3196ec ($5.3 in chips)
Seat 2: f3cdfeee ($5 in chips)
Seat 3: f682e86b ($4.53 in chips)
Seat 4: 24c4874c ($4.9 in chips)
Seat 5: 860b5247 ($8.36 in chips)
Seat 6: Hero ($5 in chips)
f3cdfeee: posts small blind $0.02
f682e86b: posts big blind $0.05
*** HOLE CARDS ***
Dealt to 4e3196ec 
Dealt to f3cdfeee 
Dealt to f682e86b 
Dealt to 24c4874c 
Dealt to 860b5247 
Dealt to Hero [Tc 6d]
24c4874c: folds
860b5247: folds
Hero: folds
4e3196ec: folds
f3cdfeee: folds
Uncalled bet ($0.03) returned to f682e86b
*** SHOWDOWN ***
f682e86b collected $0.04 from pot
*** SUMMARY ***
Total pot $0.04 | Rake $0 | Jackpot $0 | Bingo $0 | Fortune $0 | Tax $0
Seat 1: 4e3196ec (button) folded before Flop (didn't bet)
Seat 2: f3cdfeee (small blind) folded before Flop
Seat 3: f682e86b (big blind) collected ($0.04)
Seat 4: 24c4874c folded before Flop (didn't bet)
Seat 5: 860b5247 folded before Flop (didn't bet)
Seat 6: Hero folded before Flop (didn't bet)


Poker Hand #RC3334372438: Hold'em No Limit ($0.02/$0.05) - 2025/02/17 20:22:46
Table 'RushAndCash597698' 6-max Seat #1 is the button
Seat 1: 9a69a3a0 ($5.07 in chips)
Seat 2: Hero ($5 in chips)
Seat 3: 918d412c ($2.84 in chips)
Seat 4: d913286e ($6.37 in chips)
Seat 5: dbf5f543 ($7.36 in chips)
Seat 6: d32b2e06 ($10.08 in chips)
Hero: posts small blind $0.02
918d412c: posts big blind $0.05
*** HOLE CARDS ***
Dealt to 9a69a3a0 
Dealt to Hero [7h 2d]
Dealt to 918d412c 
Dealt to d913286e 
Dealt to dbf5f543 
Dealt to d32b2e06 
d913286e: folds
dbf5f543: folds
d32b2e06: folds
9a69a3a0: raises $0.05 to $0.1
Hero: folds
918d412c: folds
Uncalled bet ($0.05) returned to 9a69a3a0
*** SHOWDOWN ***
9a69a3a0 collected $0.12 from pot
*** SUMMARY ***
Total pot $0.12 | Rake $0 | Jackpot $0 | Bingo $0 | Fortune $0 | Tax $0
Seat 1: 9a69a3a0 (button) collected ($0.12)
Seat 2: Hero (small blind) folded before Flop
Seat 3: 918d412c (big blind) folded before Flop
Seat 4: d913286e folded before Flop (didn't bet)
Seat 5: dbf5f543 folded before Flop (didn't bet)
Seat 6: d32b2e06 folded before Flop (didn't bet)


Poker Hand #RC3334372270: Hold'em No Limit ($0.02/$0.05) - 2025/02/17 20:22:20
Table 'RushAndCash597530' 6-max Seat #1 is the button
Seat 1: 886c894a ($9.33 in chips)
Seat 2: 9ed6ffbf ($5.29 in chips)
Seat 3: Hero ($5 in chips)
Seat 4: 9135e49d ($5.07 in chips)
Seat 5: 7fc44808 ($11.17 in chips)
Seat 6: b282789b ($5.59 in chips)
9ed6ffbf: posts small blind $0.02
Hero: posts big blind $0.05
*** HOLE CARDS ***
Dealt to 886c894a 
Dealt to 9ed6ffbf 
Dealt to Hero [8s Js]
Dealt to 9135e49d 
Dealt to 7fc44808 
Dealt to b282789b 
9135e49d: raises $0.05 to $0.1
7fc44808: folds
b282789b: folds
886c894a: folds
9ed6ffbf: folds
Hero: calls $0.05
*** FLOP *** [3d Ah Jd]
Hero: checks
9135e49d: bets $0.13
Hero: calls $0.13
*** TURN *** [3d Ah Jd] [Qs]
Hero: checks
9135e49d: bets $0.27
Hero: folds
Uncalled bet ($0.27) returned to 9135e49d
*** SHOWDOWN ***
9135e49d collected $0.46 from pot
*** SUMMARY ***
Total pot $0.48 | Rake $0.02 | Jackpot $0 | Bingo $0 | Fortune $0 | Tax $0
Board [3d Ah Jd Qs]
Seat 1: 886c894a (button) folded before Flop (didn't bet)
Seat 2: 9ed6ffbf (small blind) folded before Flop
Seat 3: Hero (big blind) folded on the Turn
Seat 4: 9135e49d won ($0.46)
Seat 5: 7fc44808 folded before Flop (didn't bet)
Seat 6: b282789b folded before Flop (didn't bet)


Poker Hand #RC3334372111: Hold'em No Limit ($0.02/$0.05) - 2025/02/17 20:21:51
Table 'RushAndCash597371' 6-max Seat #1 is the button
Seat 1: Hero ($5 in chips)
Seat 2: a0a16222 ($5 in chips)
Seat 3: 883394d6 ($3 in chips)
Seat 4: 87cdcefe ($2.95 in chips)
Seat 5: b0ee20aa ($15.04 in chips)
Seat 6: 93dfef8b ($5.07 in chips)
Cash Drop to Pot : total $0.5 
a0a16222: posts small blind $0.02
883394d6: posts big blind $0.05
*** HOLE CARDS ***
Dealt to Hero [5c Qc]
Dealt to a0a16222 
Dealt to 883394d6 
Dealt to 87cdcefe 
Dealt to b0ee20aa 
Dealt to 93dfef8b 
87cdcefe: folds
b0ee20aa: folds
93dfef8b: folds
Hero: calls $0.05
a0a16222: folds
883394d6: checks
*** FLOP *** [7h Kd 9s]
883394d6: bets $0.31
Hero: folds
Uncalled bet ($0.31) returned to 883394d6
*** SHOWDOWN ***
883394d6 collected $0.59 from pot
*** SUMMARY ***
Total pot $0.62 | Rake $0.03 | Jackpot $0 | Bingo $0 | Fortune $0 | Tax $0
Board [7h Kd 9s]
Seat 1: Hero (button) folded on the Flop
Seat 2: a0a16222 (small blind) folded before Flop
Seat 3: 883394d6 (big blind) won ($0.59)
Seat 4: 87cdcefe folded before Flop (didn't bet)
Seat 5: b0ee20aa folded before Flop (didn't bet)
Seat 6: 93dfef8b folded before Flop (didn't bet)


Poker Hand #RC3334372088: Hold'em No Limit ($0.02/$0.05) - 2025/02/17 20:21:48
Table 'RushAndCash597348' 6-max Seat #1 is the button
Seat 1: 860fa4c9 ($5.48 in chips)
Seat 2: e8e95c39 ($5.77 in chips)
Seat 3: ccd13bc4 ($11.09 in chips)
Seat 4: Hero ($5 in chips)
Seat 5: e92b360e ($10.68 in chips)
Seat 6: 21bff972 ($6.94 in chips)
e8e95c39: posts small blind $0.02
ccd13bc4: posts big blind $0.05
*** HOLE CARDS ***
Dealt to 860fa4c9 
Dealt to e8e95c39 
Dealt to ccd13bc4 
Dealt to Hero [7h Ks]
Dealt to e92b360e 
Dealt to 21bff972 
Hero: folds
e92b360e: folds
21bff972: folds
860fa4c9: folds
e8e95c39: folds
Uncalled bet ($0.03) returned to ccd13bc4
*** SHOWDOWN ***
ccd13bc4 collected $0.04 from pot
*** SUMMARY ***
Total pot $0.04 | Rake $0 | Jackpot $0 | Bingo $0 | Fortune $0 | Tax $0
Seat 1: 860fa4c9 (button) folded before Flop (didn't bet)
Seat 2: e8e95c39 (small blind) folded before Flop
Seat 3: ccd13bc4 (big blind) collected ($0.04)
Seat 4: Hero folded before Flop (didn't bet)
Seat 5: e92b360e folded before Flop (didn't bet)
Seat 6: 21bff972 folded before Flop (didn't bet)


Poker Hand #RC3334372068: Hold'em No Limit ($0.02/$0.05) - 2025/02/17 20:21:45
Table 'RushAndCash597328' 6-max Seat #1 is the button
Seat 1: f3f5406e ($11.62 in chips)
Seat 2: 5acd5e40 ($5.17 in chips)
Seat 3: 767730bd ($5.18 in chips)
Seat 4: fa40c39c ($6.04 in chips)
Seat 5: 796ed2b8 ($5 in chips)
Seat 6: Hero ($5 in chips)
5acd5e40: posts small blind $0.02
767730bd: posts big blind $0.05
*** HOLE CARDS ***
Dealt to f3f5406e 
Dealt to 5acd5e40 
Dealt to 767730bd 
Dealt to fa40c39c 
Dealt to 796ed2b8 
Dealt to Hero [Qc 9h]
fa40c39c: folds
796ed2b8: folds
Hero: folds
f3f5406e: folds
5acd5e40: folds
Uncalled bet ($0.03) returned to 767730bd
*** SHOWDOWN ***
767730bd collected $0.04 from pot
*** SUMMARY ***
Total pot $0.04 | Rake $0 | Jackpot $0 | Bingo $0 | Fortune $0 | Tax $0
Seat 1: f3f5406e (button) folded before Flop (didn't bet)
Seat 2: 5acd5e40 (small blind) folded before Flop
Seat 3: 767730bd (big blind) collected ($0.04)
Seat 4: fa40c39c folded before Flop (didn't bet)
Seat 5: 796ed2b8 folded before Flop (didn't bet)
Seat 6: Hero folded before Flop (didn't bet)


Poker Hand #RC3334371890: Hold'em No Limit ($0.02/$0.05) - 2025/02/17 20:21:17
Table 'RushAndCash597150' 6-max Seat #1 is the button
Seat 1: Hero ($5 in chips)
Seat 2: 77936ad9 ($5 in chips)
Seat 3: 6c122cb5 ($6.62 in chips)
Seat 4: 2bb9098c ($4.93 in chips)
Seat 5: 24c4874c ($3.55 in chips)
Seat 6: f26bf81c ($4.31 in chips)
77936ad9: posts small blind $0.02
6c122cb5: posts big blind $0.05
*** HOLE CARDS ***
Dealt to Hero [Th Ah]
Dealt to 77936ad9 
Dealt to 6c122cb5 
Dealt to 2bb9098c 
Dealt to 24c4874c 
Dealt to f26bf81c 
2bb9098c: folds
24c4874c: folds
f26bf81c: folds
Hero: raises $0.05 to $0.1
77936ad9: folds
6c122cb5: calls $0.05
*** FLOP *** [Kh 4s 3d]
6c122cb5: checks
Hero: checks
*** TURN *** [Kh 4s 3d] [8s]
6c122cb5: bets $0.1
Hero: folds
Uncalled bet ($0.1) returned to 6c122cb5
*** SHOWDOWN ***
6c122cb5 collected $0.21 from pot
*** SUMMARY ***
Total pot $0.22 | Rake $0.01 | Jackpot $0 | Bingo $0 | Fortune $0 | Tax $0
Board [Kh 4s 3d 8s]
Seat 1: Hero (button) folded on the Turn
Seat 2: 77936ad9 (small blind) folded before Flop
Seat 3: 6c122cb5 (big blind) won ($0.21)
Seat 4: 2bb9098c folded before Flop (didn't bet)
Seat 5: 24c4874c folded before Flop (didn't bet)
Seat 6: f26bf81c folded before Flop (didn't bet)


Poker Hand #RC3334371849: Hold'em No Limit ($0.02/$0.05) - 2025/02/17 20:21:10
Table 'RushAndCash597109' 6-max Seat #1 is the button
Seat 1: 4ea8e2e ($13.85 in chips)
Seat 2: 5f8248c5 ($3.29 in chips)
Seat 3: 4190d158 ($5 in chips)
Seat 4: Hero ($5 in chips)
Seat 5: bddf8e1e ($11.27 in chips)
Seat 6: 220f45a7 ($5.4 in chips)
5f8248c5: posts small blind $0.02
4190d158: posts big blind $0.05
*** HOLE CARDS ***
Dealt to 4ea8e2e 
Dealt to 5f8248c5 
Dealt to 4190d158 
Dealt to Hero [9c 7c]
Dealt to bddf8e1e 
Dealt to 220f45a7 
Hero: folds
bddf8e1e: folds
220f45a7: raises $0.06 to $0.11
4ea8e2e: folds
5f8248c5: folds
4190d158: folds
Uncalled bet ($0.06) returned to 220f45a7
*** SHOWDOWN ***
220f45a7 collected $0.12 from pot
*** SUMMARY ***
Total pot $0.12 | Rake $0 | Jackpot $0 | Bingo $0 | Fortune $0 | Tax $0
Seat 1: 4ea8e2e (button) folded before Flop (didn't bet)
Seat 2: 5f8248c5 (small blind) folded before Flop
Seat 3: 4190d158 (big blind) folded before Flop
Seat 4: Hero folded before Flop (didn't bet)
Seat 5: bddf8e1e folded before Flop (didn't bet)
Seat 6: 220f45a7 collected ($0.12)


Poker Hand #RC3334371826: Hold'em No Limit ($0.02/$0.05) - 2025/02/17 20:21:06
Table 'RushAndCash597086' 6-max Seat #1 is the button
Seat 1: b282789b ($5.66 in chips)
Seat 2: Hero ($5 in chips)
Seat 3: 1754e33c ($5 in chips)
Seat 4: 80b2520f ($9.45 in chips)
Seat 5: 3fdb54c2 ($5.42 in chips)
Seat 6: 16f2e5ce ($8.21 in chips)
Hero: posts small blind $0.02
1754e33c: posts big blind $0.05
*** HOLE CARDS ***
Dealt to b282789b 
Dealt to Hero [Ts 5c]
Dealt to 1754e33c 
Dealt to 80b2520f 
Dealt to 3fdb54c2 
Dealt to 16f2e5ce 
80b2520f: folds
3fdb54c2: folds
16f2e5ce: folds
b282789b: folds
Hero: folds
Uncalled bet ($0.03) returned to 1754e33c
*** SHOWDOWN ***
1754e33c collected $0.04 from pot
*** SUMMARY ***
Total pot $0.04 | Rake $0 | Jackpot $0 | Bingo $0 | Fortune $0 | Tax $0
Seat 1: b282789b (button) folded before Flop (didn't bet)
Seat 2: Hero (small blind) folded before Flop
Seat 3: 1754e33c (big blind) collected ($0.04)
Seat 4: 80b2520f folded before Flop (didn't bet)
Seat 5: 3fdb54c2 folded before Flop (didn't bet)
Seat 6: 16f2e5ce folded before Flop (didn't bet)


Poker Hand #RC3334371737: Hold'em No Limit ($0.02/$0.05) - 2025/02/17 20:20:52
Table 'RushAndCash596997' 6-max Seat #1 is the button
Seat 1: 3d9dea9b ($4.12 in chips)
Seat 2: c1784884 ($5.02 in chips)
Seat 3: Hero ($5 in chips)
Seat 4: 5c64b878 ($5.31 in chips)
Seat 5: 816260d0 ($5 in chips)
Seat 6: 32d40ce0 ($6.57 in chips)
c1784884: posts small blind $0.02
Hero: posts big blind $0.05
*** HOLE CARDS ***
Dealt to 3d9dea9b 
Dealt to c1784884 
Dealt to Hero [4s 4d]
Dealt to 5c64b878 
Dealt to 816260d0 
Dealt to 32d40ce0 
5c64b878: folds
816260d0: folds
32d40ce0: raises $0.07 to $0.12
3d9dea9b: raises $0.24 to $0.36
c1784884: calls $0.34
Hero: folds
32d40ce0: folds
*** FLOP *** [6h 5d Ah]
c1784884: checks
3d9dea9b: bets $0.45
c1784884: calls $0.45
*** TURN *** [6h 5d Ah] [2s]
c1784884: checks
3d9dea9b: checks
*** RIVER *** [6h 5d Ah 2s] [4c]
c1784884: bets $0.6
3d9dea9b: folds
Uncalled bet ($0.6) returned to c1784884
*** SHOWDOWN ***
c1784884 collected $1.64 from pot
*** SUMMARY ***
Total pot $1.79 | Rake $0.08 | Jackpot $0.07 | Bingo $0 | Fortune $0 | Tax $0
Board [6h 5d Ah 2s 4c]
Seat 1: 3d9dea9b (button) folded on the River
Seat 2: c1784884 (small blind) won ($1.64)
Seat 3: Hero (big blind) folded before Flop
Seat 4: 5c64b878 folded before Flop (didn't bet)
Seat 5: 816260d0 folded before Flop (didn't bet)
Seat 6: 32d40ce0 folded before Flop


Poker Hand #RC3334371504: Hold'em No Limit ($0.02/$0.05) - 2025/02/17 20:20:13
Table 'RushAndCash596764' 6-max Seat #1 is the button
Seat 1: 4238ab48 ($5.06 in chips)
Seat 2: 8c6d38f2 ($5.33 in chips)
Seat 3: fe532acc ($5 in chips)
Seat 4: 6c122cb5 ($6.58 in chips)
Seat 5: Hero ($5 in chips)
Seat 6: 709ac205 ($10.06 in chips)
8c6d38f2: posts small blind $0.02
fe532acc: posts big blind $0.05
*** HOLE CARDS ***
Dealt to 4238ab48 
Dealt to 8c6d38f2 
Dealt to fe532acc 
Dealt to 6c122cb5 
Dealt to Hero [Kh As]
Dealt to 709ac205 
6c122cb5: folds
Hero: raises $0.05 to $0.1
709ac205: raises $0.25 to $0.35
4238ab48: folds
8c6d38f2: folds
fe532acc: folds
Hero: calls $0.25
*** FLOP *** [2d 5h 7h]
Hero: checks
709ac205: checks
*** TURN *** [2d 5h 7h] [8c]
Hero: checks
709ac205: checks
*** RIVER *** [2d 5h 7h 8c] [8s]
Hero: checks
709ac205: checks
Hero: shows [Kh As] (Pair of Eights)
709ac205: shows [Ac 5c] (Pair of Eights and Pair of Fives)
*** SHOWDOWN ***
709ac205 collected $0.74 from pot
*** SUMMARY ***
Total pot $0.77 | Rake $0.03 | Jackpot $0 | Bingo $0 | Fortune $0 | Tax $0
Board [2d 5h 7h 8c 8s]
Seat 1: 4238ab48 (button) folded before Flop (didn't bet)
Seat 2: 8c6d38f2 (small blind) folded before Flop
Seat 3: fe532acc (big blind) folded before Flop
Seat 4: 6c122cb5 folded before Flop (didn't bet)
Seat 5: Hero showed [Kh As] and lost with Pair of Eights
Seat 6: 709ac205 showed [Ac 5c] and won ($0.74) with Pair of Eights and Pair of Fives


Poker Hand #RC3334371484: Hold'em No Limit ($0.02/$0.05) - 2025/02/17 20:20:10
Table 'RushAndCash596744' 6-max Seat #1 is the button
Seat 1: 63a77bff ($5.3 in chips)
Seat 2: f0deee96 ($3.55 in chips)
Seat 3: 651cc52f ($4.62 in chips)
Seat 4: Hero ($5 in chips)
Seat 5: 577aa3d3 ($4.19 in chips)
Seat 6: 5acd5e40 ($5.07 in chips)
f0deee96: posts small blind $0.02
651cc52f: posts big blind $0.05
*** HOLE CARDS ***
Dealt to 63a77bff 
Dealt to f0deee96 
Dealt to 651cc52f 
Dealt to Hero [9h 6s]
Dealt to 577aa3d3 
Dealt to 5acd5e40 
Hero: folds
577aa3d3: folds
5acd5e40: folds
63a77bff: raises $0.08 to $0.13
f0deee96: folds
651cc52f: calls $0.08
*** FLOP *** [2d Th 2h]
651cc52f: bets $0.21
63a77bff: calls $0.21
*** TURN *** [2d Th 2h] [9d]
651cc52f: bets $0.24
63a77bff: calls $0.24
*** RIVER *** [2d Th 2h 9d] [4d]
651cc52f: checks
63a77bff: checks
651cc52f: shows [8h 9s] (Pair of Nines and Pair of Twos)
63a77bff: shows [Td Qc] (Pair of Tens and Pair of Twos)
*** SHOWDOWN ***
63a77bff collected $1.13 from pot
*** SUMMARY ***
Total pot $1.18 | Rake $0.05 | Jackpot $0 | Bingo $0 | Fortune $0 | Tax $0
Board [2d Th 2h 9d 4d]
Seat 1: 63a77bff (button) showed [Td Qc] and won ($1.13) with Pair of Tens and Pair of Twos
Seat 2: f0deee96 (small blind) folded before Flop
Seat 3: 651cc52f (big blind) showed [8h 9s] and lost with Pair of Nines and Pair of Twos
Seat 4: Hero folded before Flop (didn't bet)
Seat 5: 577aa3d3 folded before Flop (didn't bet)
Seat 6: 5acd5e40 folded before Flop (didn't bet)


Poker Hand #RC3334371465: Hold'em No Limit ($0.02/$0.05) - 2025/02/17 20:20:06
Table 'RushAndCash596725' 6-max Seat #1 is the button
Seat 1: c95c6ae6 ($13.05 in chips)
Seat 2: Hero ($5 in chips)
Seat 3: 42fca4f9 ($4.85 in chips)
Seat 4: 86768906 ($9.8 in chips)
Seat 5: 6c122cb5 ($6.58 in chips)
Seat 6: 84fb210c ($9.42 in chips)
Hero: posts small blind $0.02
42fca4f9: posts big blind $0.05
*** HOLE CARDS ***
Dealt to c95c6ae6 
Dealt to Hero [4d 8c]
Dealt to 42fca4f9 
Dealt to 86768906 
Dealt to 6c122cb5 
Dealt to 84fb210c 
86768906: raises $0.05 to $0.1
6c122cb5: folds
84fb210c: folds
c95c6ae6: raises $0.27 to $0.37
Hero: folds
42fca4f9: folds
86768906: folds
Uncalled bet ($0.27) returned to c95c6ae6
*** SHOWDOWN ***
c95c6ae6 collected $0.26 from pot
*** SUMMARY ***
Total pot $0.27 | Rake $0.01 | Jackpot $0 | Bingo $0 | Fortune $0 | Tax $0
Seat 1: c95c6ae6 (button) collected ($0.26)
Seat 2: Hero (small blind) folded before Flop
Seat 3: 42fca4f9 (big blind) folded before Flop
Seat 4: 86768906 folded before Flop
Seat 5: 6c122cb5 folded before Flop (didn't bet)
Seat 6: 84fb210c folded before Flop (didn't bet)


Poker Hand #RC3334371108: Hold'em No Limit ($0.02/$0.05) - 2025/02/17 20:19:03
Table 'RushAndCash596368' 6-max Seat #1 is the button
Seat 1: Hero ($5.13 in chips)
Seat 2: 703f26be ($4.84 in chips)
Seat 3: 84fb210c ($9.64 in chips)
Seat 4: 6d5fa70b ($6.23 in chips)
Seat 5: ec1d0d44 ($9.95 in chips)
Seat 6: d5283567 ($10.12 in chips)
703f26be: posts small blind $0.02
84fb210c: posts big blind $0.05
*** HOLE CARDS ***
Dealt to Hero [Kc As]
Dealt to 703f26be 
Dealt to 84fb210c 
Dealt to 6d5fa70b 
Dealt to ec1d0d44 
Dealt to d5283567 
6d5fa70b: folds
ec1d0d44: folds
d5283567: raises $0.1 to $0.15
Hero: raises $0.29 to $0.44
703f26be: folds
84fb210c: folds
d5283567: calls $0.29
*** FLOP *** [Jh Ks 5s]
d5283567: bets $0.95
Hero: calls $0.95
*** TURN *** [Jh Ks 5s] [6s]
d5283567: bets $2.85
Hero: raises $0.89 to $3.74 and is all-in
d5283567: calls $0.89
Hero: shows [Kc As] (Pair of Kings)
d5283567: shows [Qs Ts] (King High Flush)
d5283567: Chooses to EV Cashout
*** RIVER *** [Jh Ks 5s 6s] [Ac]
d5283567: Pays Cashout Risk ($1.71)
*** SHOWDOWN ***
d5283567 collected $10.11 from pot
*** SUMMARY ***
Total pot $10.33 | Rake $0.15 | Jackpot $0.07 | Bingo $0 | Fortune $0 | Tax $0
Board [Jh Ks 5s 6s Ac]
Seat 1: Hero (button) showed [Kc As] and lost with Pair of Aces and Pair of Kings
Seat 2: 703f26be (small blind) folded before Flop
Seat 3: 84fb210c (big blind) folded before Flop
Seat 4: 6d5fa70b folded before Flop (didn't bet)
Seat 5: ec1d0d44 folded before Flop (didn't bet)
Seat 6: d5283567 showed [Qs Ts] and won ($10.11) with King High Flush, Cashout Risk ($1.71)


Poker Hand #RC3334371071: Hold'em No Limit ($0.02/$0.05) - 2025/02/17 20:18:57
Table 'RushAndCash596331' 6-max Seat #1 is the button
Seat 1: c7d7e6aa ($12.36 in chips)
Seat 2: 186b316a ($5 in chips)
Seat 3: 343fb64e ($6.87 in chips)
Seat 4: fa84cc2d ($13.9 in chips)
Seat 5: a2794999 ($5.02 in chips)
Seat 6: Hero ($5.13 in chips)
186b316a: posts small blind $0.02
343fb64e: posts big blind $0.05
*** HOLE CARDS ***
Dealt to c7d7e6aa 
Dealt to 186b316a 
Dealt to 343fb64e 
Dealt to fa84cc2d 
Dealt to a2794999 
Dealt to Hero [Js Qc]
fa84cc2d: folds
a2794999: raises $0.05 to $0.1
Hero: folds
c7d7e6aa: raises $0.21 to $0.31
186b316a: folds
343fb64e: folds
a2794999: folds
Uncalled bet ($0.21) returned to c7d7e6aa
*** SHOWDOWN ***
c7d7e6aa collected $0.26 from pot
*** SUMMARY ***
Total pot $0.27 | Rake $0.01 | Jackpot $0 | Bingo $0 | Fortune $0 | Tax $0
Seat 1: c7d7e6aa (button) collected ($0.26)
Seat 2: 186b316a (small blind) folded before Flop
Seat 3: 343fb64e (big blind) folded before Flop
Seat 4: fa84cc2d folded before Flop (didn't bet)
Seat 5: a2794999 folded before Flop
Seat 6: Hero folded before Flop (didn't bet)


Poker Hand #RC3334371051: Hold'em No Limit ($0.02/$0.05) - 2025/02/17 20:18:54
Table 'RushAndCash596311' 6-max Seat #1 is the button
Seat 1: cff58cde ($5.37 in chips)
Seat 2: 634fda30 ($7.05 in chips)
Seat 3: Hero ($5.18 in chips)
Seat 4: 7c99618c ($6.97 in chips)
Seat 5: 92099542 ($4.79 in chips)
Seat 6: 343fb64e ($6.87 in chips)
634fda30: posts small blind $0.02
Hero: posts big blind $0.05
*** HOLE CARDS ***
Dealt to cff58cde 
Dealt to 634fda30 
Dealt to Hero [9d 4s]
Dealt to 7c99618c 
Dealt to 92099542 
Dealt to 343fb64e 
7c99618c: folds
92099542: folds
343fb64e: folds
cff58cde: raises $0.05 to $0.1
634fda30: folds
Hero: folds
Uncalled bet ($0.05) returned to cff58cde
*** SHOWDOWN ***
cff58cde collected $0.12 from pot
*** SUMMARY ***
Total pot $0.12 | Rake $0 | Jackpot $0 | Bingo $0 | Fortune $0 | Tax $0
Seat 1: cff58cde (button) collected ($0.12)
Seat 2: 634fda30 (small blind) folded before Flop
Seat 3: Hero (big blind) folded before Flop
Seat 4: 7c99618c folded before Flop (didn't bet)
Seat 5: 92099542 folded before Flop (didn't bet)
Seat 6: 343fb64e folded before Flop (didn't bet)


Poker Hand #RC3334371029: Hold'em No Limit ($0.02/$0.05) - 2025/02/17 20:18:50
Table 'RushAndCash596289' 6-max Seat #1 is the button
Seat 1: 5db4cca ($4.81 in chips)
Seat 2: dc32cc03 ($5.28 in chips)
Seat 3: 6d2abfa5 ($5.5 in chips)
Seat 4: 99af2b58 ($11.35 in chips)
Seat 5: Hero ($5.18 in chips)
Seat 6: b66d20fa ($16.39 in chips)
dc32cc03: posts small blind $0.02
6d2abfa5: posts big blind $0.05
*** HOLE CARDS ***
Dealt to 5db4cca 
Dealt to dc32cc03 
Dealt to 6d2abfa5 
Dealt to 99af2b58 
Dealt to Hero [Ac 2c]
Dealt to b66d20fa 
99af2b58: folds
Hero: folds
b66d20fa: raises $0.07 to $0.12
5db4cca: folds
dc32cc03: folds
6d2abfa5: folds
Uncalled bet ($0.07) returned to b66d20fa
*** SHOWDOWN ***
b66d20fa collected $0.12 from pot
*** SUMMARY ***
Total pot $0.12 | Rake $0 | Jackpot $0 | Bingo $0 | Fortune $0 | Tax $0
Seat 1: 5db4cca (button) folded before Flop (didn't bet)
Seat 2: dc32cc03 (small blind) folded before Flop
Seat 3: 6d2abfa5 (big blind) folded before Flop
Seat 4: 99af2b58 folded before Flop (didn't bet)
Seat 5: Hero folded before Flop (didn't bet)
Seat 6: b66d20fa collected ($0.12)


Poker Hand #RC3334371010: Hold'em No Limit ($0.02/$0.05) - 2025/02/17 20:18:47
Table 'RushAndCash596270' 6-max Seat #1 is the button
Seat 1: dc32cc03 ($5.28 in chips)
Seat 2: 7cf45cbd ($7.33 in chips)
Seat 3: 8e39de43 ($5.07 in chips)
Seat 4: 63a77bff ($5.21 in chips)
Seat 5: aea62364 ($0.72 in chips)
Seat 6: Hero ($5.18 in chips)
7cf45cbd: posts small blind $0.02
8e39de43: posts big blind $0.05
*** HOLE CARDS ***
Dealt to dc32cc03 
Dealt to 7cf45cbd 
Dealt to 8e39de43 
Dealt to 63a77bff 
Dealt to aea62364 
Dealt to Hero [6d 2h]
63a77bff: folds
aea62364: folds
Hero: folds
dc32cc03: folds
7cf45cbd: raises $0.05 to $0.1
8e39de43: calls $0.05
*** FLOP *** [3h Kc 8c]
7cf45cbd: bets $0.1
8e39de43: folds
Uncalled bet ($0.1) returned to 7cf45cbd
*** SHOWDOWN ***
7cf45cbd collected $0.19 from pot
*** SUMMARY ***
Total pot $0.2 | Rake $0.01 | Jackpot $0 | Bingo $0 | Fortune $0 | Tax $0
Board [3h Kc 8c]
Seat 1: dc32cc03 (button) folded before Flop (didn't bet)
Seat 2: 7cf45cbd (small blind) won ($0.19)
Seat 3: 8e39de43 (big blind) folded on the Flop
Seat 4: 63a77bff folded before Flop (didn't bet)
Seat 5: aea62364 folded before Flop (didn't bet)
Seat 6: Hero folded before Flop (didn't bet)


Poker Hand #RC3334370987: Hold'em No Limit ($0.02/$0.05) - 2025/02/17 20:18:43
Table 'RushAndCash596247' 6-max Seat #1 is the button
Seat 1: 16f2e5ce ($7.74 in chips)
Seat 2: b9d877b0 ($5 in chips)
Seat 3: d1cd1071 ($12.95 in chips)
Seat 4: e68a71ba ($8.05 in chips)
Seat 5: Hero ($5.18 in chips)
Seat 6: b66d20fa ($16.39 in chips)
b9d877b0: posts small blind $0.02
d1cd1071: posts big blind $0.05
*** HOLE CARDS ***
Dealt to 16f2e5ce 
Dealt to b9d877b0 
Dealt to d1cd1071 
Dealt to e68a71ba 
Dealt to Hero [Kh 7c]
Dealt to b66d20fa 
e68a71ba: folds
Hero: folds
b66d20fa: folds
16f2e5ce: raises $0.05 to $0.1
b9d877b0: folds
d1cd1071: calls $0.05
*** FLOP *** [5s Qd 8s]
d1cd1071: checks
16f2e5ce: bets $0.08
d1cd1071: calls $0.08
*** TURN *** [5s Qd 8s] [Kc]
d1cd1071: checks
16f2e5ce: bets $0.29
d1cd1071: folds
Uncalled bet ($0.29) returned to 16f2e5ce
*** SHOWDOWN ***
16f2e5ce collected $0.37 from pot
*** SUMMARY ***
Total pot $0.38 | Rake $0.01 | Jackpot $0 | Bingo $0 | Fortune $0 | Tax $0
Board [5s Qd 8s Kc]
Seat 1: 16f2e5ce (button) won ($0.37)
Seat 2: b9d877b0 (small blind) folded before Flop
Seat 3: d1cd1071 (big blind) folded on the Turn
Seat 4: e68a71ba folded before Flop (didn't bet)
Seat 5: Hero folded before Flop (didn't bet)
Seat 6: b66d20fa folded before Flop (didn't bet)


Poker Hand #RC3334370963: Hold'em No Limit ($0.02/$0.05) - 2025/02/17 20:18:39
Table 'RushAndCash596223' 6-max Seat #1 is the button
Seat 1: 33bc9b8e ($10.05 in chips)
Seat 2: 4052bb6f ($5.07 in chips)
Seat 3: Hero ($5.23 in chips)
Seat 4: 9b4fbe63 ($12.37 in chips)
Seat 5: 9f09d482 ($5.41 in chips)
Seat 6: ab35fc95 ($6.76 in chips)
4052bb6f: posts small blind $0.02
Hero: posts big blind $0.05
*** HOLE CARDS ***
Dealt to 33bc9b8e 
Dealt to 4052bb6f 
Dealt to Hero [4s 7c]
Dealt to 9b4fbe63 
Dealt to 9f09d482 
Dealt to ab35fc95 
9b4fbe63: folds
9f09d482: folds
ab35fc95: folds
33bc9b8e: raises $0.07 to $0.12
4052bb6f: folds
Hero: folds
Uncalled bet ($0.07) returned to 33bc9b8e
*** SHOWDOWN ***
33bc9b8e collected $0.12 from pot
*** SUMMARY ***
Total pot $0.12 | Rake $0 | Jackpot $0 | Bingo $0 | Fortune $0 | Tax $0
Seat 1: 33bc9b8e (button) collected ($0.12)
Seat 2: 4052bb6f (small blind) folded before Flop
Seat 3: Hero (big blind) folded before Flop
Seat 4: 9b4fbe63 folded before Flop (didn't bet)
Seat 5: 9f09d482 folded before Flop (didn't bet)
Seat 6: ab35fc95 folded before Flop (didn't bet)


Poker Hand #RC3334370801: Hold'em No Limit ($0.02/$0.05) - 2025/02/17 20:18:11
Table 'RushAndCash596061' 6-max Seat #1 is the button
Seat 1: Hero ($5.33 in chips)
Seat 2: fe532acc ($5 in chips)
Seat 3: 2486dbda ($2 in chips)
Seat 4: d9a113f2 ($5.09 in chips)
Seat 5: fc8b0177 ($6.28 in chips)
Seat 6: 731e166b ($5 in chips)
fe532acc: posts small blind $0.02
2486dbda: posts big blind $0.05
*** HOLE CARDS ***
Dealt to Hero [Th Ac]
Dealt to fe532acc 
Dealt to 2486dbda 
Dealt to d9a113f2 
Dealt to fc8b0177 
Dealt to 731e166b 
d9a113f2: folds
fc8b0177: raises $0.05 to $0.1
731e166b: folds
Hero: calls $0.1
fe532acc: folds
2486dbda: raises $0.15 to $0.25
fc8b0177: calls $0.15
Hero: folds
*** FLOP *** [5c Ah Qh]
2486dbda: checks
fc8b0177: bets $0.19
2486dbda: folds
Uncalled bet ($0.19) returned to fc8b0177
*** SHOWDOWN ***
fc8b0177 collected $0.59 from pot
*** SUMMARY ***
Total pot $0.62 | Rake $0.03 | Jackpot $0 | Bingo $0 | Fortune $0 | Tax $0
Board [5c Ah Qh]
Seat 1: Hero (button) folded before Flop
Seat 2: fe532acc (small blind) folded before Flop
Seat 3: 2486dbda (big blind) folded on the Flop
Seat 4: d9a113f2 folded before Flop (didn't bet)
Seat 5: fc8b0177 won ($0.59)
Seat 6: 731e166b folded before Flop (didn't bet)


Poker Hand #RC3334370774: Hold'em No Limit ($0.02/$0.05) - 2025/02/17 20:18:07
Table 'RushAndCash596034' 6-max Seat #1 is the button
Seat 1: d32b2e06 ($10.05 in chips)
Seat 2: Hero ($5.35 in chips)
Seat 3: 63a77bff ($5.36 in chips)
Seat 4: c812cddb ($12.53 in chips)
Seat 5: fa499268 ($5 in chips)
Seat 6: 2809b559 ($6.71 in chips)
Hero: posts small blind $0.02
63a77bff: posts big blind $0.05
*** HOLE CARDS ***
Dealt to d32b2e06 
Dealt to Hero [6c Qh]
Dealt to 63a77bff 
Dealt to c812cddb 
Dealt to fa499268 
Dealt to 2809b559 
c812cddb: folds
fa499268: raises $0.08 to $0.13
2809b559: folds
d32b2e06: folds
Hero: folds
63a77bff: calls $0.08
*** FLOP *** [Js 9h 3h]
63a77bff: checks
fa499268: bets $0.22
63a77bff: folds
Uncalled bet ($0.22) returned to fa499268
*** SHOWDOWN ***
fa499268 collected $0.27 from pot
*** SUMMARY ***
Total pot $0.28 | Rake $0.01 | Jackpot $0 | Bingo $0 | Fortune $0 | Tax $0
Board [Js 9h 3h]
Seat 1: d32b2e06 (button) folded before Flop (didn't bet)
Seat 2: Hero (small blind) folded before Flop
Seat 3: 63a77bff (big blind) folded on the Flop
Seat 4: c812cddb folded before Flop (didn't bet)
Seat 5: fa499268 won ($0.27)
Seat 6: 2809b559 folded before Flop (didn't bet)


Poker Hand #RC3334370733: Hold'em No Limit ($0.02/$0.05) - 2025/02/17 20:18:00
Table 'RushAndCash595993' 6-max Seat #1 is the button
Seat 1: 35fb946f ($5.41 in chips)
Seat 2: 2d3097f1 ($5 in chips)
Seat 3: b439c64b ($5 in chips)
Seat 4: 3922b684 ($13.92 in chips)
Seat 5: Hero ($5.35 in chips)
Seat 6: 33527257 ($5.68 in chips)
2d3097f1: posts small blind $0.02
b439c64b: posts big blind $0.05
*** HOLE CARDS ***
Dealt to 35fb946f 
Dealt to 2d3097f1 
Dealt to b439c64b 
Dealt to 3922b684 
Dealt to Hero [5d 2d]
Dealt to 33527257 
3922b684: folds
Hero: folds
33527257: raises $0.08 to $0.13
35fb946f: folds
2d3097f1: folds
b439c64b: calls $0.08
*** FLOP *** [5s Ad 7h]
b439c64b: checks
33527257: bets $0.1
b439c64b: raises $0.16 to $0.26
33527257: calls $0.16
*** TURN *** [5s Ad 7h] [Tc]
b439c64b: bets $0.27
33527257: folds
Uncalled bet ($0.27) returned to b439c64b
*** SHOWDOWN ***
b439c64b collected $0.76 from pot
*** SUMMARY ***
Total pot $0.8 | Rake $0.04 | Jackpot $0 | Bingo $0 | Fortune $0 | Tax $0
Board [5s Ad 7h Tc]
Seat 1: 35fb946f (button) folded before Flop (didn't bet)
Seat 2: 2d3097f1 (small blind) folded before Flop
Seat 3: b439c64b (big blind) won ($0.76)
Seat 4: 3922b684 folded before Flop (didn't bet)
Seat 5: Hero folded before Flop (didn't bet)
Seat 6: 33527257 folded on the Turn


Poker Hand #RC3334370654: Hold'em No Limit ($0.02/$0.05) - 2025/02/17 20:17:45
Table 'RushAndCash595914' 6-max Seat #1 is the button
Seat 1: 92fa3d91 ($3.86 in chips)
Seat 2: 63499226 ($4.01 in chips)
Seat 3: 2ef61f09 ($5.07 in chips)
Seat 4: Hero ($5.35 in chips)
Seat 5: 191b60c1 ($12.81 in chips)
Seat 6: fa84cc2d ($13.94 in chips)
63499226: posts small blind $0.02
2ef61f09: posts big blind $0.05
*** HOLE CARDS ***
Dealt to 92fa3d91 
Dealt to 63499226 
Dealt to 2ef61f09 
Dealt to Hero [6h Td]
Dealt to 191b60c1 
Dealt to fa84cc2d 
Hero: folds
191b60c1: folds
fa84cc2d: folds
92fa3d91: folds
63499226: folds
Uncalled bet ($0.03) returned to 2ef61f09
*** SHOWDOWN ***
2ef61f09 collected $0.04 from pot
*** SUMMARY ***
Total pot $0.04 | Rake $0 | Jackpot $0 | Bingo $0 | Fortune $0 | Tax $0
Seat 1: 92fa3d91 (button) folded before Flop (didn't bet)
Seat 2: 63499226 (small blind) folded before Flop
Seat 3: 2ef61f09 (big blind) collected ($0.04)
Seat 4: Hero folded before Flop (didn't bet)
Seat 5: 191b60c1 folded before Flop (didn't bet)
Seat 6: fa84cc2d folded before Flop (didn't bet)


Poker Hand #RC3334370612: Hold'em No Limit ($0.02/$0.05) - 2025/02/17 20:17:38
Table 'RushAndCash595872' 6-max Seat #1 is the button
Seat 1: 5acd5e40 ($5 in chips)
Seat 2: 4190d158 ($5.25 in chips)
Seat 3: 5871193e ($5 in chips)
Seat 4: b34012ac ($5.89 in chips)
Seat 5: Hero ($5.35 in chips)
Seat 6: deccd7eb ($5.32 in chips)
4190d158: posts small blind $0.02
5871193e: posts big blind $0.05
*** HOLE CARDS ***
Dealt to 5acd5e40 
Dealt to 4190d158 
Dealt to 5871193e 
Dealt to b34012ac 
Dealt to Hero [2h 9h]
Dealt to deccd7eb 
b34012ac: folds
Hero: folds
deccd7eb: folds
5acd5e40: folds
4190d158: folds
Uncalled bet ($0.03) returned to 5871193e
*** SHOWDOWN ***
5871193e collected $0.04 from pot
*** SUMMARY ***
Total pot $0.04 | Rake $0 | Jackpot $0 | Bingo $0 | Fortune $0 | Tax $0
Seat 1: 5acd5e40 (button) folded before Flop (didn't bet)
Seat 2: 4190d158 (small blind) folded before Flop
Seat 3: 5871193e (big blind) collected ($0.04)
Seat 4: b34012ac folded before Flop (didn't bet)
Seat 5: Hero folded before Flop (didn't bet)
Seat 6: deccd7eb folded before Flop (didn't bet)


Poker Hand #RC3334370598: Hold'em No Limit ($0.02/$0.05) - 2025/02/17 20:17:35
Table 'RushAndCash595858' 6-max Seat #1 is the button
Seat 1: Hero ($5.35 in chips)
Seat 2: 87b4e331 ($6.68 in chips)
Seat 3: 5bf5cd50 ($5.05 in chips)
Seat 4: 18af90c ($10.03 in chips)
Seat 5: 63499226 ($4.01 in chips)
Seat 6: c4eb9775 ($11.81 in chips)
87b4e331: posts small blind $0.02
5bf5cd50: posts big blind $0.05
*** HOLE CARDS ***
Dealt to Hero [6h 4d]
Dealt to 87b4e331 
Dealt to 5bf5cd50 
Dealt to 18af90c 
Dealt to 63499226 
Dealt to c4eb9775 
18af90c: folds
63499226: folds
c4eb9775: folds
Hero: folds
87b4e331: folds
Uncalled bet ($0.03) returned to 5bf5cd50
*** SHOWDOWN ***
5bf5cd50 collected $0.04 from pot
*** SUMMARY ***
Total pot $0.04 | Rake $0 | Jackpot $0 | Bingo $0 | Fortune $0 | Tax $0
Seat 1: Hero (button) folded before Flop (didn't bet)
Seat 2: 87b4e331 (small blind) folded before Flop
Seat 3: 5bf5cd50 (big blind) collected ($0.04)
Seat 4: 18af90c folded before Flop (didn't bet)
Seat 5: 63499226 folded before Flop (didn't bet)
Seat 6: c4eb9775 folded before Flop (didn't bet)


Poker Hand #RC3334370580: Hold'em No Limit ($0.02/$0.05) - 2025/02/17 20:17:32
Table 'RushAndCash595840' 6-max Seat #1 is the button
Seat 1: 6a5a3ab6 ($6.76 in chips)
Seat 2: Hero ($5.37 in chips)
Seat 3: fa84cc2d ($13.92 in chips)
Seat 4: 1a54a2fc ($5 in chips)
Seat 5: 89f1fee1 ($5.43 in chips)
Seat 6: 6d2abfa5 ($5.43 in chips)
Hero: posts small blind $0.02
fa84cc2d: posts big blind $0.05
*** HOLE CARDS ***
Dealt to 6a5a3ab6 
Dealt to Hero [2s Jc]
Dealt to fa84cc2d 
Dealt to 1a54a2fc 
Dealt to 89f1fee1 
Dealt to 6d2abfa5 
1a54a2fc: folds
89f1fee1: folds
6d2abfa5: folds
6a5a3ab6: folds
Hero: folds
Uncalled bet ($0.03) returned to fa84cc2d
*** SHOWDOWN ***
fa84cc2d collected $0.04 from pot
*** SUMMARY ***
Total pot $0.04 | Rake $0 | Jackpot $0 | Bingo $0 | Fortune $0 | Tax $0
Seat 1: 6a5a3ab6 (button) folded before Flop (didn't bet)
Seat 2: Hero (small blind) folded before Flop
Seat 3: fa84cc2d (big blind) collected ($0.04)
Seat 4: 1a54a2fc folded before Flop (didn't bet)
Seat 5: 89f1fee1 folded before Flop (didn't bet)
Seat 6: 6d2abfa5 folded before Flop (didn't bet)


Poker Hand #RC3334370562: Hold'em No Limit ($0.02/$0.05) - 2025/02/17 20:17:29
Table 'RushAndCash595822' 6-max Seat #1 is the button
Seat 1: 37558bf9 ($5.32 in chips)
Seat 2: 835df346 ($16.11 in chips)
Seat 3: Hero ($5.42 in chips)
Seat 4: d913286e ($6.34 in chips)
Seat 5: 936e1bce ($7.15 in chips)
Seat 6: eea81bce ($5.41 in chips)
835df346: posts small blind $0.02
Hero: posts big blind $0.05
*** HOLE CARDS ***
Dealt to 37558bf9 
Dealt to 835df346 
Dealt to Hero [8s Th]
Dealt to d913286e 
Dealt to 936e1bce 
Dealt to eea81bce 
d913286e: folds
936e1bce: raises $0.05 to $0.1
eea81bce: folds
37558bf9: folds
835df346: folds
Hero: folds
Uncalled bet ($0.05) returned to 936e1bce
*** SHOWDOWN ***
936e1bce collected $0.12 from pot
*** SUMMARY ***
Total pot $0.12 | Rake $0 | Jackpot $0 | Bingo $0 | Fortune $0 | Tax $0
Seat 1: 37558bf9 (button) folded before Flop (didn't bet)
Seat 2: 835df346 (small blind) folded before Flop
Seat 3: Hero (big blind) folded before Flop
Seat 4: d913286e folded before Flop (didn't bet)
Seat 5: 936e1bce collected ($0.12)
Seat 6: eea81bce folded before Flop (didn't bet)


Poker Hand #RC3334370526: Hold'em No Limit ($0.02/$0.05) - 2025/02/17 20:17:22
Table 'RushAndCash595786' 6-max Seat #1 is the button
Seat 1: 7c99618c ($6.94 in chips)
Seat 2: 6eae6bcb ($5.7 in chips)
Seat 3: 8dbd0a2d ($5.69 in chips)
Seat 4: f5fcc522 ($9.87 in chips)
Seat 5: Hero ($5.42 in chips)
Seat 6: f5592199 ($6.03 in chips)
6eae6bcb: posts small blind $0.02
8dbd0a2d: posts big blind $0.05
*** HOLE CARDS ***
Dealt to 7c99618c 
Dealt to 6eae6bcb 
Dealt to 8dbd0a2d 
Dealt to f5fcc522 
Dealt to Hero [4c 4d]
Dealt to f5592199 
f5fcc522: folds
Hero: folds
f5592199: folds
7c99618c: folds
6eae6bcb: folds
Uncalled bet ($0.03) returned to 8dbd0a2d
*** SHOWDOWN ***
8dbd0a2d collected $0.04 from pot
*** SUMMARY ***
Total pot $0.04 | Rake $0 | Jackpot $0 | Bingo $0 | Fortune $0 | Tax $0
Seat 1: 7c99618c (button) folded before Flop (didn't bet)
Seat 2: 6eae6bcb (small blind) folded before Flop
Seat 3: 8dbd0a2d (big blind) collected ($0.04)
Seat 4: f5fcc522 folded before Flop (didn't bet)
Seat 5: Hero folded before Flop (didn't bet)
Seat 6: f5592199 folded before Flop (didn't bet)


Poker Hand #RC3334370507: Hold'em No Limit ($0.02/$0.05) - 2025/02/17 20:17:19
Table 'RushAndCash595767' 6-max Seat #1 is the button
Seat 1: Hero ($5.42 in chips)
Seat 2: 6d2abfa5 ($5.45 in chips)
Seat 3: 9e314792 ($4.61 in chips)
Seat 4: a28ca95c ($12.15 in chips)
Seat 5: f3fc119a ($6.66 in chips)
Seat 6: f5592199 ($6.03 in chips)
6d2abfa5: posts small blind $0.02
9e314792: posts big blind $0.05
*** HOLE CARDS ***
Dealt to Hero [6h 2d]
Dealt to 6d2abfa5 
Dealt to 9e314792 
Dealt to a28ca95c 
Dealt to f3fc119a 
Dealt to f5592199 
a28ca95c: folds
f3fc119a: folds
f5592199: folds
Hero: folds
6d2abfa5: folds
Uncalled bet ($0.03) returned to 9e314792
*** SHOWDOWN ***
9e314792 collected $0.04 from pot
*** SUMMARY ***
Total pot $0.04 | Rake $0 | Jackpot $0 | Bingo $0 | Fortune $0 | Tax $0
Seat 1: Hero (button) folded before Flop (didn't bet)
Seat 2: 6d2abfa5 (small blind) folded before Flop
Seat 3: 9e314792 (big blind) collected ($0.04)
Seat 4: a28ca95c folded before Flop (didn't bet)
Seat 5: f3fc119a folded before Flop (didn't bet)
Seat 6: f5592199 folded before Flop (didn't bet)


Poker Hand #RC3334370369: Hold'em No Limit ($0.02/$0.05) - 2025/02/17 20:16:55
Table 'RushAndCash595629' 6-max Seat #1 is the button
Seat 1: e3a10bfa ($5.42 in chips)
Seat 2: b66d20fa ($16.58 in chips)
Seat 3: 27020fb4 ($5.81 in chips)
Seat 4: 2c0804e1 ($9.82 in chips)
Seat 5: Hero ($5.52 in chips)
Seat 6: 4c8dd192 ($9.17 in chips)
b66d20fa: posts small blind $0.02
27020fb4: posts big blind $0.05
*** HOLE CARDS ***
Dealt to e3a10bfa 
Dealt to b66d20fa 
Dealt to 27020fb4 
Dealt to 2c0804e1 
Dealt to Hero [Ks Qc]
Dealt to 4c8dd192 
2c0804e1: folds
Hero: raises $0.05 to $0.1
4c8dd192: folds
e3a10bfa: folds
b66d20fa: folds
27020fb4: calls $0.05
*** FLOP *** [8c Js 9h]
27020fb4: checks
Hero: checks
*** TURN *** [8c Js 9h] [6s]
27020fb4: bets $0.18
Hero: folds
Uncalled bet ($0.18) returned to 27020fb4
*** SHOWDOWN ***
27020fb4 collected $0.21 from pot
*** SUMMARY ***
Total pot $0.22 | Rake $0.01 | Jackpot $0 | Bingo $0 | Fortune $0 | Tax $0
Board [8c Js 9h 6s]
Seat 1: e3a10bfa (button) folded before Flop (didn't bet)
Seat 2: b66d20fa (small blind) folded before Flop
Seat 3: 27020fb4 (big blind) won ($0.21)
Seat 4: 2c0804e1 folded before Flop (didn't bet)
Seat 5: Hero folded on the Turn
Seat 6: 4c8dd192 folded before Flop (didn't bet)


Poker Hand #RC3334369949: Hold'em No Limit ($0.02/$0.05) - 2025/02/17 20:15:29
Table 'RushAndCash595209' 6-max Seat #1 is the button
Seat 1: 21effd0c ($5.34 in chips)
Seat 2: fe0566a4 ($12.25 in chips)
Seat 3: 4c8dd192 ($9.65 in chips)
Seat 4: 6d2abfa5 ($5.01 in chips)
Seat 5: ef82d036 ($23.67 in chips)
Seat 6: Hero ($5.06 in chips)
fe0566a4: posts small blind $0.02
4c8dd192: posts big blind $0.05
*** HOLE CARDS ***
Dealt to 21effd0c 
Dealt to fe0566a4 
Dealt to 4c8dd192 
Dealt to 6d2abfa5 
Dealt to ef82d036 
Dealt to Hero [Qs Ks]
6d2abfa5: folds
ef82d036: folds
Hero: raises $0.05 to $0.1
21effd0c: folds
fe0566a4: folds
4c8dd192: calls $0.05
*** FLOP *** [Ah 4s Jh]
4c8dd192: checks
Hero: bets $0.08
4c8dd192: calls $0.08
*** TURN *** [Ah 4s Jh] [Ts]
4c8dd192: checks
Hero: bets $0.3
4c8dd192: calls $0.3
*** RIVER *** [Ah 4s Jh Ts] [Td]
4c8dd192: checks
Hero: bets $0.5
4c8dd192: folds
Uncalled bet ($0.5) returned to Hero
*** SHOWDOWN ***
Hero collected $0.94 from pot
*** SUMMARY ***
Total pot $0.98 | Rake $0.04 | Jackpot $0 | Bingo $0 | Fortune $0 | Tax $0
Board [Ah 4s Jh Ts Td]
Seat 1: 21effd0c (button) folded before Flop (didn't bet)
Seat 2: fe0566a4 (small blind) folded before Flop
Seat 3: 4c8dd192 (big blind) folded on the River
Seat 4: 6d2abfa5 folded before Flop (didn't bet)
Seat 5: ef82d036 folded before Flop (didn't bet)
Seat 6: Hero won ($0.94)


Poker Hand #RC3334369895: Hold'em No Limit ($0.02/$0.05) - 2025/02/17 20:15:19
Table 'RushAndCash595155' 6-max Seat #1 is the button
Seat 1: 8ffbb474 ($11.37 in chips)
Seat 2: Hero ($5.08 in chips)
Seat 3: 2f4d445 ($5.7 in chips)
Seat 4: 9013f95e ($12.02 in chips)
Seat 5: 207d9345 ($16.59 in chips)
Seat 6: 6183e175 ($17.57 in chips)
Hero: posts small blind $0.02
2f4d445: posts big blind $0.05
*** HOLE CARDS ***
Dealt to 8ffbb474 
Dealt to Hero [7s Jh]
Dealt to 2f4d445 
Dealt to 9013f95e 
Dealt to 207d9345 
Dealt to 6183e175 
9013f95e: folds
207d9345: folds
6183e175: folds
8ffbb474: folds
Hero: folds
Uncalled bet ($0.03) returned to 2f4d445
*** SHOWDOWN ***
2f4d445 collected $0.04 from pot
*** SUMMARY ***
Total pot $0.04 | Rake $0 | Jackpot $0 | Bingo $0 | Fortune $0 | Tax $0
Seat 1: 8ffbb474 (button) folded before Flop (didn't bet)
Seat 2: Hero (small blind) folded before Flop
Seat 3: 2f4d445 (big blind) collected ($0.04)
Seat 4: 9013f95e folded before Flop (didn't bet)
Seat 5: 207d9345 folded before Flop (didn't bet)
Seat 6: 6183e175 folded before Flop (didn't bet)


Poker Hand #RC3334369873: Hold'em No Limit ($0.02/$0.05) - 2025/02/17 20:15:16
Table 'RushAndCash595133' 6-max Seat #1 is the button
Seat 1: 7f3dcda7 ($8.36 in chips)
Seat 2: 2c0804e1 ($9.47 in chips)
Seat 3: Hero ($5.13 in chips)
Seat 4: 18af90c ($10.27 in chips)
Seat 5: 48dc6454 ($5.23 in chips)
Seat 6: 598d859f ($5.55 in chips)
2c0804e1: posts small blind $0.02
Hero: posts big blind $0.05
*** HOLE CARDS ***
Dealt to 7f3dcda7 
Dealt to 2c0804e1 
Dealt to Hero [Js 2h]
Dealt to 18af90c 
Dealt to 48dc6454 
Dealt to 598d859f 
18af90c: raises $0.05 to $0.1
48dc6454: folds
598d859f: folds
7f3dcda7: folds
2c0804e1: folds
Hero: folds
Uncalled bet ($0.05) returned to 18af90c
*** SHOWDOWN ***
18af90c collected $0.12 from pot
*** SUMMARY ***
Total pot $0.12 | Rake $0 | Jackpot $0 | Bingo $0 | Fortune $0 | Tax $0
Seat 1: 7f3dcda7 (button) folded before Flop (didn't bet)
Seat 2: 2c0804e1 (small blind) folded before Flop
Seat 3: Hero (big blind) folded before Flop
Seat 4: 18af90c collected ($0.12)
Seat 5: 48dc6454 folded before Flop (didn't bet)
Seat 6: 598d859f folded before Flop (didn't bet)


Poker Hand #RC3334369857: Hold'em No Limit ($0.02/$0.05) - 2025/02/17 20:15:13
Table 'RushAndCash595117' 6-max Seat #1 is the button
Seat 1: fcad3124 ($5.07 in chips)
Seat 2: 4e3c3196 ($21.35 in chips)
Seat 3: 26823915 ($5.64 in chips)
Seat 4: 19bb03b5 ($6.64 in chips)
Seat 5: 8e39de43 ($5.07 in chips)
Seat 6: Hero ($5.13 in chips)
4e3c3196: posts small blind $0.02
26823915: posts big blind $0.05
*** HOLE CARDS ***
Dealt to fcad3124 
Dealt to 4e3c3196 
Dealt to 26823915 
Dealt to 19bb03b5 
Dealt to 8e39de43 
Dealt to Hero [4d 8c]
19bb03b5: folds
8e39de43: folds
Hero: folds
fcad3124: raises $0.05 to $0.1
4e3c3196: folds
26823915: calls $0.05
*** FLOP *** [3s 8h 9d]
26823915: checks
fcad3124: checks
*** TURN *** [3s 8h 9d] [3c]
26823915: checks
fcad3124: checks
*** RIVER *** [3s 8h 9d 3c] [Jd]
26823915: checks
fcad3124: checks
26823915: shows [Qd Ah] (Pair of Treys)
fcad3124: shows [Qh Ks] (Pair of Treys)
*** SHOWDOWN ***
26823915 collected $0.21 from pot
*** SUMMARY ***
Total pot $0.22 | Rake $0.01 | Jackpot $0 | Bingo $0 | Fortune $0 | Tax $0
Board [3s 8h 9d 3c Jd]
Seat 1: fcad3124 (button) showed [Qh Ks] and lost with Pair of Treys
Seat 2: 4e3c3196 (small blind) folded before Flop
Seat 3: 26823915 (big blind) showed [Qd Ah] and won ($0.21) with Pair of Treys
Seat 4: 19bb03b5 folded before Flop (didn't bet)
Seat 5: 8e39de43 folded before Flop (didn't bet)
Seat 6: Hero folded before Flop (didn't bet)


Poker Hand #RC3334369839: Hold'em No Limit ($0.02/$0.05) - 2025/02/17 20:15:09
Table 'RushAndCash595099' 6-max Seat #1 is the button
Seat 1: 75a97e80 ($18.63 in chips)
Seat 2: a2794999 ($5.07 in chips)
Seat 3: 817f21da ($5.71 in chips)
Seat 4: Hero ($5.13 in chips)
Seat 5: c4483bd8 ($5.07 in chips)
Seat 6: b5fbac7c ($5.26 in chips)
a2794999: posts small blind $0.02
817f21da: posts big blind $0.05
*** HOLE CARDS ***
Dealt to 75a97e80 
Dealt to a2794999 
Dealt to 817f21da 
Dealt to Hero [9h Ah]
Dealt to c4483bd8 
Dealt to b5fbac7c 
Hero: folds
c4483bd8: folds
b5fbac7c: folds
75a97e80: folds
a2794999: folds
Uncalled bet ($0.03) returned to 817f21da
*** SHOWDOWN ***
817f21da collected $0.04 from pot
*** SUMMARY ***
Total pot $0.04 | Rake $0 | Jackpot $0 | Bingo $0 | Fortune $0 | Tax $0
Seat 1: 75a97e80 (button) folded before Flop (didn't bet)
Seat 2: a2794999 (small blind) folded before Flop
Seat 3: 817f21da (big blind) collected ($0.04)
Seat 4: Hero folded before Flop (didn't bet)
Seat 5: c4483bd8 folded before Flop (didn't bet)
Seat 6: b5fbac7c folded before Flop (didn't bet)


Poker Hand #RC3334369813: Hold'em No Limit ($0.02/$0.05) - 2025/02/17 20:15:05
Table 'RushAndCash595073' 6-max Seat #1 is the button
Seat 1: f71f9fc0 ($4.12 in chips)
Seat 2: d58b99ca ($8.83 in chips)
Seat 3: 41720de0 ($15.4 in chips)
Seat 4: Hero ($5.13 in chips)
Seat 5: 84fb210c ($9.34 in chips)
Seat 6: 275443dc ($4.69 in chips)
d58b99ca: posts small blind $0.02
41720de0: posts big blind $0.05
*** HOLE CARDS ***
Dealt to f71f9fc0 
Dealt to d58b99ca 
Dealt to 41720de0 
Dealt to Hero [Kd 3h]
Dealt to 84fb210c 
Dealt to 275443dc 
Hero: folds
84fb210c: folds
275443dc: folds
f71f9fc0: raises $0.06 to $0.11
d58b99ca: raises $0.37 to $0.48
41720de0: folds
f71f9fc0: folds
Uncalled bet ($0.37) returned to d58b99ca
*** SHOWDOWN ***
d58b99ca collected $0.26 from pot
*** SUMMARY ***
Total pot $0.27 | Rake $0.01 | Jackpot $0 | Bingo $0 | Fortune $0 | Tax $0
Seat 1: f71f9fc0 (button) folded before Flop
Seat 2: d58b99ca (small blind) collected ($0.26)
Seat 3: 41720de0 (big blind) folded before Flop
Seat 4: Hero folded before Flop (didn't bet)
Seat 5: 84fb210c folded before Flop (didn't bet)
Seat 6: 275443dc folded before Flop (didn't bet)


Poker Hand #RC3334369792: Hold'em No Limit ($0.02/$0.05) - 2025/02/17 20:15:01
Table 'RushAndCash595052' 6-max Seat #1 is the button
Seat 1: Hero ($5.13 in chips)
Seat 2: a0a16222 ($7.56 in chips)
Seat 3: 8324de89 ($9.55 in chips)
Seat 4: 858b70a7 ($4.67 in chips)
Seat 5: 730098b8 ($7.57 in chips)
Seat 6: 6eae6bcb ($5.45 in chips)
a0a16222: posts small blind $0.02
8324de89: posts big blind $0.05
*** HOLE CARDS ***
Dealt to Hero [6c Qh]
Dealt to a0a16222 
Dealt to 8324de89 
Dealt to 858b70a7 
Dealt to 730098b8 
Dealt to 6eae6bcb 
858b70a7: folds
730098b8: raises $0.08 to $0.13
6eae6bcb: folds
Hero: folds
a0a16222: folds
8324de89: folds
Uncalled bet ($0.08) returned to 730098b8
*** SHOWDOWN ***
730098b8 collected $0.12 from pot
*** SUMMARY ***
Total pot $0.12 | Rake $0 | Jackpot $0 | Bingo $0 | Fortune $0 | Tax $0
Seat 1: Hero (button) folded before Flop (didn't bet)
Seat 2: a0a16222 (small blind) folded before Flop
Seat 3: 8324de89 (big blind) folded before Flop
Seat 4: 858b70a7 folded before Flop (didn't bet)
Seat 5: 730098b8 collected ($0.12)
Seat 6: 6eae6bcb folded before Flop (didn't bet)


Poker Hand #RC3334369767: Hold'em No Limit ($0.02/$0.05) - 2025/02/17 20:14:57
Table 'RushAndCash595027' 6-max Seat #1 is the button
Seat 1: 904f2b1b ($4.55 in chips)
Seat 2: Hero ($5.15 in chips)
Seat 3: 488a283c ($3.49 in chips)
Seat 4: a0c50ee7 ($5.83 in chips)
Seat 5: f71501ed ($6.15 in chips)
Seat 6: a9cbe77d ($5 in chips)
Hero: posts small blind $0.02
488a283c: posts big blind $0.05
*** HOLE CARDS ***
Dealt to 904f2b1b 
Dealt to Hero [3s Qd]
Dealt to 488a283c 
Dealt to a0c50ee7 
Dealt to f71501ed 
Dealt to a9cbe77d 
a0c50ee7: raises $0.08 to $0.13
f71501ed: raises $0.25 to $0.38
a9cbe77d: folds
904f2b1b: folds
Hero: folds
488a283c: folds
a0c50ee7: calls $0.25
*** FLOP *** [Tc Ts 2h]
a0c50ee7: checks
f71501ed: bets $0.26
a0c50ee7: calls $0.26
*** TURN *** [Tc Ts 2h] [Qh]
a0c50ee7: checks
f71501ed: checks
*** RIVER *** [Tc Ts 2h Qh] [Qs]
a0c50ee7: checks
f71501ed: checks
a0c50ee7: shows [Js Jc] (Pair of Queens and Pair of Jacks)
f71501ed: shows [Kh Kc] (Pair of Kings and Pair of Queens)
*** SHOWDOWN ***
f71501ed collected $1.29 from pot
*** SUMMARY ***
Total pot $1.35 | Rake $0.06 | Jackpot $0 | Bingo $0 | Fortune $0 | Tax $0
Board [Tc Ts 2h Qh Qs]
Seat 1: 904f2b1b (button) folded before Flop (didn't bet)
Seat 2: Hero (small blind) folded before Flop
Seat 3: 488a283c (big blind) folded before Flop
Seat 4: a0c50ee7 showed [Js Jc] and lost with Pair of Queens and Pair of Jacks
Seat 5: f71501ed showed [Kh Kc] and won ($1.29) with Pair of Kings and Pair of Queens
Seat 6: a9cbe77d folded before Flop (didn't bet)


Poker Hand #RC3334369716: Hold'em No Limit ($0.02/$0.05) - 2025/02/17 20:14:49
Table 'RushAndCash594976' 6-max Seat #1 is the button
Seat 1: 918d412c ($2.14 in chips)
Seat 2: 9a633d8d ($7.58 in chips)
Seat 3: Hero ($5.13 in chips)
Seat 4: 9ccadbb5 ($12.82 in chips)
Seat 5: cda72279 ($1.99 in chips)
Seat 6: fa84cc2d ($14.11 in chips)
9a633d8d: posts small blind $0.02
Hero: posts big blind $0.05
*** HOLE CARDS ***
Dealt to 918d412c 
Dealt to 9a633d8d 
Dealt to Hero [Kh 7h]
Dealt to 9ccadbb5 
Dealt to cda72279 
Dealt to fa84cc2d 
9ccadbb5: folds
cda72279: folds
fa84cc2d: folds
918d412c: folds
9a633d8d: folds
Uncalled bet ($0.03) returned to Hero
*** SHOWDOWN ***
Hero collected $0.04 from pot
*** SUMMARY ***
Total pot $0.04 | Rake $0 | Jackpot $0 | Bingo $0 | Fortune $0 | Tax $0
Seat 1: 918d412c (button) folded before Flop (didn't bet)
Seat 2: 9a633d8d (small blind) folded before Flop
Seat 3: Hero (big blind) collected ($0.04)
Seat 4: 9ccadbb5 folded before Flop (didn't bet)
Seat 5: cda72279 folded before Flop (didn't bet)
Seat 6: fa84cc2d folded before Flop (didn't bet)


Poker Hand #RC3334369695: Hold'em No Limit ($0.02/$0.05) - 2025/02/17 20:14:46
Table 'RushAndCash594955' 6-max Seat #1 is the button
Seat 1: 92ac71f9 ($5 in chips)
Seat 2: 9b4fbe63 ($12.65 in chips)
Seat 3: 87b4e331 ($6.91 in chips)
Seat 4: 82010c93 ($4.56 in chips)
Seat 5: 7f832000 ($5.33 in chips)
Seat 6: Hero ($5.13 in chips)
9b4fbe63: posts small blind $0.02
87b4e331: posts big blind $0.05
*** HOLE CARDS ***
Dealt to 92ac71f9 
Dealt to 9b4fbe63 
Dealt to 87b4e331 
Dealt to 82010c93 
Dealt to 7f832000 
Dealt to Hero [4c 7h]
82010c93: folds
7f832000: folds
Hero: folds
92ac71f9: raises $0.05 to $0.1
9b4fbe63: folds
87b4e331: folds
Uncalled bet ($0.05) returned to 92ac71f9
*** SHOWDOWN ***
92ac71f9 collected $0.12 from pot
*** SUMMARY ***
Total pot $0.12 | Rake $0 | Jackpot $0 | Bingo $0 | Fortune $0 | Tax $0
Seat 1: 92ac71f9 (button) collected ($0.12)
Seat 2: 9b4fbe63 (small blind) folded before Flop
Seat 3: 87b4e331 (big blind) folded before Flop
Seat 4: 82010c93 folded before Flop (didn't bet)
Seat 5: 7f832000 folded before Flop (didn't bet)
Seat 6: Hero folded before Flop (didn't bet)


Poker Hand #RC3334369615: Hold'em No Limit ($0.02/$0.05) - 2025/02/17 20:14:31
Table 'RushAndCash594875' 6-max Seat #1 is the button
Seat 1: ab9f01cc ($9.58 in chips)
Seat 2: 9ccadbb5 ($12.86 in chips)
Seat 3: b44ff266 ($5.12 in chips)
Seat 4: Hero ($5.13 in chips)
Seat 5: 3fdb54c2 ($5.49 in chips)
Seat 6: e9c5dfd7 ($5.5 in chips)
9ccadbb5: posts small blind $0.02
b44ff266: posts big blind $0.05
*** HOLE CARDS ***
Dealt to ab9f01cc 
Dealt to 9ccadbb5 
Dealt to b44ff266 
Dealt to Hero [Td 3d]
Dealt to 3fdb54c2 
Dealt to e9c5dfd7 
Hero: folds
3fdb54c2: folds
e9c5dfd7: raises $0.05 to $0.1
ab9f01cc: calls $0.1
9ccadbb5: folds
b44ff266: raises $0.51 to $0.61
e9c5dfd7: folds
ab9f01cc: calls $0.51
*** FLOP *** [7s 7h 3s]
b44ff266: bets $0.38
ab9f01cc: folds
Uncalled bet ($0.38) returned to b44ff266
*** SHOWDOWN ***
b44ff266 collected $1.28 from pot
*** SUMMARY ***
Total pot $1.34 | Rake $0.06 | Jackpot $0 | Bingo $0 | Fortune $0 | Tax $0
Board [7s 7h 3s]
Seat 1: ab9f01cc (button) folded on the Flop
Seat 2: 9ccadbb5 (small blind) folded before Flop
Seat 3: b44ff266 (big blind) won ($1.28)
Seat 4: Hero folded before Flop (didn't bet)
Seat 5: 3fdb54c2 folded before Flop (didn't bet)
Seat 6: e9c5dfd7 folded before Flop


Poker Hand #RC3334369509: Hold'em No Limit ($0.02/$0.05) - 2025/02/17 20:14:14
Table 'RushAndCash594769' 6-max Seat #1 is the button
Seat 1: 1165d8f0 ($6.09 in chips)
Seat 2: c7e9103c ($20.81 in chips)
Seat 3: 36753d76 ($5.4 in chips)
Seat 4: 48dc6454 ($5.23 in chips)
Seat 5: 2544b1ed ($6.04 in chips)
Seat 6: Hero ($5.13 in chips)
c7e9103c: posts small blind $0.02
36753d76: posts big blind $0.05
*** HOLE CARDS ***
Dealt to 1165d8f0 
Dealt to c7e9103c 
Dealt to 36753d76 
Dealt to 48dc6454 
Dealt to 2544b1ed 
Dealt to Hero [5d 8d]
48dc6454: folds
2544b1ed: folds
Hero: folds
1165d8f0: folds
c7e9103c: raises $0.1 to $0.15
36753d76: calls $0.1
*** FLOP *** [Kc 5h 3c]
c7e9103c: bets $0.15
36753d76: calls $0.15
*** TURN *** [Kc 5h 3c] [8s]
c7e9103c: checks
36753d76: checks
*** RIVER *** [Kc 5h 3c 8s] [As]
c7e9103c: checks
36753d76: checks
c7e9103c: shows [8c 6c] (Pair of Eights)
36753d76: shows [9d Kd] (Pair of Kings)
*** SHOWDOWN ***
36753d76 collected $0.57 from pot
*** SUMMARY ***
Total pot $0.6 | Rake $0.03 | Jackpot $0 | Bingo $0 | Fortune $0 | Tax $0
Board [Kc 5h 3c 8s As]
Seat 1: 1165d8f0 (button) folded before Flop (didn't bet)
Seat 2: c7e9103c (small blind) showed [8c 6c] and lost with Pair of Eights
Seat 3: 36753d76 (big blind) showed [9d Kd] and won ($0.57) with Pair of Kings
Seat 4: 48dc6454 folded before Flop (didn't bet)
Seat 5: 2544b1ed folded before Flop (didn't bet)
Seat 6: Hero folded before Flop (didn't bet)


Poker Hand #RC3334369464: Hold'em No Limit ($0.02/$0.05) - 2025/02/17 20:14:06
Table 'RushAndCash594724' 6-max Seat #1 is the button
Seat 1: Hero ($5.13 in chips)
Seat 2: c182b1a3 ($5.25 in chips)
Seat 3: 9babc997 ($3.96 in chips)
Seat 4: 69c3afd2 ($5 in chips)
Seat 5: 727998e7 ($6.01 in chips)
Seat 6: 8a752a8f ($5.93 in chips)
c182b1a3: posts small blind $0.02
9babc997: posts big blind $0.05
*** HOLE CARDS ***
Dealt to Hero [9d 7h]
Dealt to c182b1a3 
Dealt to 9babc997 
Dealt to 69c3afd2 
Dealt to 727998e7 
Dealt to 8a752a8f 
69c3afd2: folds
727998e7: folds
8a752a8f: folds
Hero: folds
c182b1a3: folds
Uncalled bet ($0.03) returned to 9babc997
*** SHOWDOWN ***
9babc997 collected $0.04 from pot
*** SUMMARY ***
Total pot $0.04 | Rake $0 | Jackpot $0 | Bingo $0 | Fortune $0 | Tax $0
Seat 1: Hero (button) folded before Flop (didn't bet)
Seat 2: c182b1a3 (small blind) folded before Flop
Seat 3: 9babc997 (big blind) collected ($0.04)
Seat 4: 69c3afd2 folded before Flop (didn't bet)
Seat 5: 727998e7 folded before Flop (didn't bet)
Seat 6: 8a752a8f folded before Flop (didn't bet)


Poker Hand #RC3334369447: Hold'em No Limit ($0.02/$0.05) - 2025/02/17 20:14:03
Table 'RushAndCash594707' 6-max Seat #1 is the button
Seat 1: 144ea2b0 ($5.18 in chips)
Seat 2: Hero ($5.15 in chips)
Seat 3: 2d72cb67 ($5.21 in chips)
Seat 4: eb09e492 ($7.76 in chips)
Seat 5: e4d8df1d ($5.07 in chips)
Seat 6: b3aefb75 ($10.8 in chips)
Hero: posts small blind $0.02
2d72cb67: posts big blind $0.05
*** HOLE CARDS ***
Dealt to 144ea2b0 
Dealt to Hero [Kd 7h]
Dealt to 2d72cb67 
Dealt to eb09e492 
Dealt to e4d8df1d 
Dealt to b3aefb75 
eb09e492: folds
e4d8df1d: folds
b3aefb75: folds
144ea2b0: folds
Hero: folds
Uncalled bet ($0.03) returned to 2d72cb67
*** SHOWDOWN ***
2d72cb67 collected $0.04 from pot
*** SUMMARY ***
Total pot $0.04 | Rake $0 | Jackpot $0 | Bingo $0 | Fortune $0 | Tax $0
Seat 1: 144ea2b0 (button) folded before Flop (didn't bet)
Seat 2: Hero (small blind) folded before Flop
Seat 3: 2d72cb67 (big blind) collected ($0.04)
Seat 4: eb09e492 folded before Flop (didn't bet)
Seat 5: e4d8df1d folded before Flop (didn't bet)
Seat 6: b3aefb75 folded before Flop (didn't bet)


Poker Hand #RC3334369426: Hold'em No Limit ($0.02/$0.05) - 2025/02/17 20:14:00
Table 'RushAndCash594686' 6-max Seat #1 is the button
Seat 1: dc9e794c ($5.07 in chips)
Seat 2: 1e76a4d8 ($6.14 in chips)
Seat 3: Hero ($5.2 in chips)
Seat 4: e4d8df1d ($5.07 in chips)
Seat 5: 1a54a2fc ($5.49 in chips)
Seat 6: 50d9f656 ($6.4 in chips)
1e76a4d8: posts small blind $0.02
Hero: posts big blind $0.05
*** HOLE CARDS ***
Dealt to dc9e794c 
Dealt to 1e76a4d8 
Dealt to Hero [Kd 8s]
Dealt to e4d8df1d 
Dealt to 1a54a2fc 
Dealt to 50d9f656 
e4d8df1d: folds
1a54a2fc: raises $0.08 to $0.13
50d9f656: folds
dc9e794c: folds
1e76a4d8: folds
Hero: folds
Uncalled bet ($0.08) returned to 1a54a2fc
*** SHOWDOWN ***
1a54a2fc collected $0.12 from pot
*** SUMMARY ***
Total pot $0.12 | Rake $0 | Jackpot $0 | Bingo $0 | Fortune $0 | Tax $0
Seat 1: dc9e794c (button) folded before Flop (didn't bet)
Seat 2: 1e76a4d8 (small blind) folded before Flop
Seat 3: Hero (big blind) folded before Flop
Seat 4: e4d8df1d folded before Flop (didn't bet)
Seat 5: 1a54a2fc collected ($0.12)
Seat 6: 50d9f656 folded before Flop (didn't bet)


Poker Hand #RC3334369264: Hold'em No Limit ($0.02/$0.05) - 2025/02/17 20:13:32
Table 'RushAndCash594524' 6-max Seat #1 is the button
Seat 1: 92fa3d91 ($3.85 in chips)
Seat 2: 904f2b1b ($5.05 in chips)
Seat 3: dc9e794c ($5.27 in chips)
Seat 4: fe532acc ($5.34 in chips)
Seat 5: 8012317b ($5.41 in chips)
Seat 6: Hero ($5 in chips)
904f2b1b: posts small blind $0.02
dc9e794c: posts big blind $0.05
*** HOLE CARDS ***
Dealt to 92fa3d91 
Dealt to 904f2b1b 
Dealt to dc9e794c 
Dealt to fe532acc 
Dealt to 8012317b 
Dealt to Hero [Td Kc]
fe532acc: folds
8012317b: folds
Hero: raises $0.05 to $0.1
92fa3d91: folds
904f2b1b: folds
dc9e794c: calls $0.05
*** FLOP *** [2d Qh Kh]
dc9e794c: bets $0.05
Hero: calls $0.05
*** TURN *** [2d Qh Kh] [3d]
dc9e794c: bets $0.05
Hero: raises $0.15 to $0.2
dc9e794c: folds
Uncalled bet ($0.15) returned to Hero
*** SHOWDOWN ***
Hero collected $0.4 from pot
*** SUMMARY ***
Total pot $0.42 | Rake $0.02 | Jackpot $0 | Bingo $0 | Fortune $0 | Tax $0
Board [2d Qh Kh 3d]
Seat 1: 92fa3d91 (button) folded before Flop (didn't bet)
Seat 2: 904f2b1b (small blind) folded before Flop
Seat 3: dc9e794c (big blind) folded on the Turn
Seat 4: fe532acc folded before Flop (didn't bet)
Seat 5: 8012317b folded before Flop (didn't bet)
Seat 6: Hero won ($0.4)


Poker Hand #RC3334369245: Hold'em No Limit ($0.02/$0.05) - 2025/02/17 20:13:29
Table 'RushAndCash594505' 6-max Seat #1 is the button
Seat 1: e68a71ba ($5.07 in chips)
Seat 2: ab5e89b2 ($6.48 in chips)
Seat 3: f3fc119a ($7.28 in chips)
Seat 4: bbd60b52 ($15.83 in chips)
Seat 5: 42fca4f9 ($5.16 in chips)
Seat 6: Hero ($5 in chips)
ab5e89b2: posts small blind $0.02
f3fc119a: posts big blind $0.05
*** HOLE CARDS ***
Dealt to e68a71ba 
Dealt to ab5e89b2 
Dealt to f3fc119a 
Dealt to bbd60b52 
Dealt to 42fca4f9 
Dealt to Hero [7c 2h]
bbd60b52: folds
42fca4f9: folds
Hero: folds
e68a71ba: raises $0.05 to $0.1
ab5e89b2: folds
f3fc119a: folds
Uncalled bet ($0.05) returned to e68a71ba
*** SHOWDOWN ***
e68a71ba collected $0.12 from pot
*** SUMMARY ***
Total pot $0.12 | Rake $0 | Jackpot $0 | Bingo $0 | Fortune $0 | Tax $0
Seat 1: e68a71ba (button) collected ($0.12)
Seat 2: ab5e89b2 (small blind) folded before Flop
Seat 3: f3fc119a (big blind) folded before Flop
Seat 4: bbd60b52 folded before Flop (didn't bet)
Seat 5: 42fca4f9 folded before Flop (didn't bet)
Seat 6: Hero folded before Flop (didn't bet)


Poker Hand #RC3334369226: Hold'em No Limit ($0.02/$0.05) - 2025/02/17 20:13:26
Table 'RushAndCash594486' 6-max Seat #1 is the button
Seat 1: f0d238ad ($7.27 in chips)
Seat 2: e670889d ($6.88 in chips)
Seat 3: 8c6d38f2 ($5.22 in chips)
Seat 4: 7b1c045a ($6.4 in chips)
Seat 5: Hero ($5 in chips)
Seat 6: 42fca4f9 ($5.16 in chips)
e670889d: posts small blind $0.02
8c6d38f2: posts big blind $0.05
*** HOLE CARDS ***
Dealt to f0d238ad 
Dealt to e670889d 
Dealt to 8c6d38f2 
Dealt to 7b1c045a 
Dealt to Hero [3d 4h]
Dealt to 42fca4f9 
7b1c045a: raises $0.07 to $0.12
Hero: folds
42fca4f9: folds
f0d238ad: calls $0.12
e670889d: folds
8c6d38f2: folds
*** FLOP *** [Kc Qd 5h]
7b1c045a: checks
f0d238ad: checks
*** TURN *** [Kc Qd 5h] [As]
7b1c045a: checks
f0d238ad: checks
*** RIVER *** [Kc Qd 5h As] [Td]
7b1c045a: checks
f0d238ad: checks
7b1c045a: shows [8d 9d] (Ace-High)
f0d238ad: shows [8h 8s] (Pair of Eights)
*** SHOWDOWN ***
f0d238ad collected $0.3 from pot
*** SUMMARY ***
Total pot $0.31 | Rake $0.01 | Jackpot $0 | Bingo $0 | Fortune $0 | Tax $0
Board [Kc Qd 5h As Td]
Seat 1: f0d238ad (button) showed [8h 8s] and won ($0.3) with Pair of Eights
Seat 2: e670889d (small blind) folded before Flop
Seat 3: 8c6d38f2 (big blind) folded before Flop
Seat 4: 7b1c045a showed [8d 9d] and lost with Ace-High
Seat 5: Hero folded before Flop (didn't bet)
Seat 6: 42fca4f9 folded before Flop (didn't bet)


Poker Hand #RC3334369034: Hold'em No Limit ($0.02/$0.05) - 2025/02/17 20:12:56
Table 'RushAndCash594294' 6-max Seat #1 is the button
Seat 1: 6981f344 ($5 in chips)
Seat 2: Hero ($5.09 in chips)
Seat 3: deccd7eb ($5.25 in chips)
Seat 4: e632d40b ($5 in chips)
Seat 5: 56e8cd9a ($2.69 in chips)
Seat 6: 32d40ce0 ($7.26 in chips)
Hero: posts small blind $0.02
deccd7eb: posts big blind $0.05
*** HOLE CARDS ***
Dealt to 6981f344 
Dealt to Hero [Jd 8c]
Dealt to deccd7eb 
Dealt to e632d40b 
Dealt to 56e8cd9a 
Dealt to 32d40ce0 
e632d40b: folds
56e8cd9a: folds
32d40ce0: folds
6981f344: folds
Hero: calls $0.03
deccd7eb: raises $0.08 to $0.13
Hero: calls $0.08
*** FLOP *** [4s Qc 2h]
Hero: checks
deccd7eb: bets $0.09
Hero: folds
Uncalled bet ($0.09) returned to deccd7eb
*** SHOWDOWN ***
deccd7eb collected $0.25 from pot
*** SUMMARY ***
Total pot $0.26 | Rake $0.01 | Jackpot $0 | Bingo $0 | Fortune $0 | Tax $0
Board [4s Qc 2h]
Seat 1: 6981f344 (button) folded before Flop (didn't bet)
Seat 2: Hero (small blind) folded on the Flop
Seat 3: deccd7eb (big blind) won ($0.25)
Seat 4: e632d40b folded before Flop (didn't bet)
Seat 5: 56e8cd9a folded before Flop (didn't bet)
Seat 6: 32d40ce0 folded before Flop (didn't bet)


Poker Hand #RC3334369017: Hold'em No Limit ($0.02/$0.05) - 2025/02/17 20:12:53
Table 'RushAndCash594277' 6-max Seat #1 is the button
Seat 1: 30c2b6c7 ($5.73 in chips)
Seat 2: 120fe547 ($4.35 in chips)
Seat 3: Hero ($5.14 in chips)
Seat 4: ed41f291 ($5 in chips)
Seat 5: 93735ac4 ($4.29 in chips)
Seat 6: 7dd18ea7 ($6.28 in chips)
120fe547: posts small blind $0.02
Hero: posts big blind $0.05
*** HOLE CARDS ***
Dealt to 30c2b6c7 
Dealt to 120fe547 
Dealt to Hero [6c Kc]
Dealt to ed41f291 
Dealt to 93735ac4 
Dealt to 7dd18ea7 
ed41f291: raises $0.05 to $0.1
93735ac4: folds
7dd18ea7: folds
30c2b6c7: folds
120fe547: folds
Hero: folds
Uncalled bet ($0.05) returned to ed41f291
*** SHOWDOWN ***
ed41f291 collected $0.12 from pot
*** SUMMARY ***
Total pot $0.12 | Rake $0 | Jackpot $0 | Bingo $0 | Fortune $0 | Tax $0
Seat 1: 30c2b6c7 (button) folded before Flop (didn't bet)
Seat 2: 120fe547 (small blind) folded before Flop
Seat 3: Hero (big blind) folded before Flop
Seat 4: ed41f291 collected ($0.12)
Seat 5: 93735ac4 folded before Flop (didn't bet)
Seat 6: 7dd18ea7 folded before Flop (didn't bet)


Poker Hand #RC3334368938: Hold'em No Limit ($0.02/$0.05) - 2025/02/17 20:12:41
Table 'RushAndCash594198' 6-max Seat #1 is the button
Seat 1: Hero ($5.07 in chips)
Seat 2: 626511c8 ($4.49 in chips)
Seat 3: 5be1ddae ($4.41 in chips)
Seat 4: 6d2abfa5 ($5.67 in chips)
Seat 5: 21bff972 ($6.53 in chips)
Seat 6: ab35fc95 ($5.65 in chips)
626511c8: posts small blind $0.02
5be1ddae: posts big blind $0.05
*** HOLE CARDS ***
Dealt to Hero [Jh Th]
Dealt to 626511c8 
Dealt to 5be1ddae 
Dealt to 6d2abfa5 
Dealt to 21bff972 
Dealt to ab35fc95 
6d2abfa5: folds
21bff972: folds
ab35fc95: folds
Hero: raises $0.05 to $0.1
626511c8: folds
5be1ddae: folds
Uncalled bet ($0.05) returned to Hero
*** SHOWDOWN ***
Hero collected $0.12 from pot
*** SUMMARY ***
Total pot $0.12 | Rake $0 | Jackpot $0 | Bingo $0 | Fortune $0 | Tax $0
Seat 1: Hero (button) collected ($0.12)
Seat 2: 626511c8 (small blind) folded before Flop
Seat 3: 5be1ddae (big blind) folded before Flop
Seat 4: 6d2abfa5 folded before Flop (didn't bet)
Seat 5: 21bff972 folded before Flop (didn't bet)
Seat 6: ab35fc95 folded before Flop (didn't bet)


Poker Hand #RC3334368868: Hold'em No Limit ($0.02/$0.05) - 2025/02/17 20:12:30
Table 'RushAndCash594128' 6-max Seat #1 is the button
Seat 1: eaafe260 ($5 in chips)
Seat 2: c066ebc7 ($5.26 in chips)
Seat 3: 803e9f05 ($5.98 in chips)
Seat 4: 489e38c2 ($6.09 in chips)
Seat 5: 18cb11a ($7.14 in chips)
Seat 6: Hero ($5 in chips)
c066ebc7: posts small blind $0.02
803e9f05: posts big blind $0.05
*** HOLE CARDS ***
Dealt to eaafe260 
Dealt to c066ebc7 
Dealt to 803e9f05 
Dealt to 489e38c2 
Dealt to 18cb11a 
Dealt to Hero [Ac Js]
489e38c2: folds
18cb11a: folds
Hero: raises $0.05 to $0.1
eaafe260: folds
c066ebc7: folds
803e9f05: folds
Uncalled bet ($0.05) returned to Hero
*** SHOWDOWN ***
Hero collected $0.12 from pot
*** SUMMARY ***
Total pot $0.12 | Rake $0 | Jackpot $0 | Bingo $0 | Fortune $0 | Tax $0
Seat 1: eaafe260 (button) folded before Flop (didn't bet)
Seat 2: c066ebc7 (small blind) folded before Flop
Seat 3: 803e9f05 (big blind) folded before Flop
Seat 4: 489e38c2 folded before Flop (didn't bet)
Seat 5: 18cb11a folded before Flop (didn't bet)
Seat 6: Hero collected ($0.12)


Poker Hand #RC3334368851: Hold'em No Limit ($0.02/$0.05) - 2025/02/17 20:12:27
Table 'RushAndCash594111' 6-max Seat #1 is the button
Seat 1: 5f8248c5 ($2.15 in chips)
Seat 2: 99af2b58 ($11.64 in chips)
Seat 3: 5871193e ($5.03 in chips)
Seat 4: b1aa19ba ($5.14 in chips)
Seat 5: Hero ($5 in chips)
Seat 6: c066ebc7 ($5.26 in chips)
99af2b58: posts small blind $0.02
5871193e: posts big blind $0.05
*** HOLE CARDS ***
Dealt to 5f8248c5 
Dealt to 99af2b58 
Dealt to 5871193e 
Dealt to b1aa19ba 
Dealt to Hero [6d Qc]
Dealt to c066ebc7 
b1aa19ba: raises $0.05 to $0.1
Hero: folds
c066ebc7: folds
5f8248c5: folds
99af2b58: folds
5871193e: calls $0.05
*** FLOP *** [8s 6h Td]
5871193e: checks
b1aa19ba: checks
*** TURN *** [8s 6h Td] [Ac]
5871193e: bets $0.11
b1aa19ba: folds
Uncalled bet ($0.11) returned to 5871193e
*** SHOWDOWN ***
5871193e collected $0.21 from pot
*** SUMMARY ***
Total pot $0.22 | Rake $0.01 | Jackpot $0 | Bingo $0 | Fortune $0 | Tax $0
Board [8s 6h Td Ac]
Seat 1: 5f8248c5 (button) folded before Flop (didn't bet)
Seat 2: 99af2b58 (small blind) folded before Flop
Seat 3: 5871193e (big blind) won ($0.21)
Seat 4: b1aa19ba folded on the Turn
Seat 5: Hero folded before Flop (didn't bet)
Seat 6: c066ebc7 folded before Flop (didn't bet)


Poker Hand #RC3334368758: Hold'em No Limit ($0.02/$0.05) - 2025/02/17 20:12:12
Table 'RushAndCash594018' 6-max Seat #1 is the button
Seat 1: 4ff3fcdb ($9.76 in chips)
Seat 2: 9b63101d ($13.1 in chips)
Seat 3: f3f5406e ($14.03 in chips)
Seat 4: fe532acc ($5.32 in chips)
Seat 5: c7d7e6aa ($5.61 in chips)
Seat 6: Hero ($5 in chips)
9b63101d: posts small blind $0.02
f3f5406e: posts big blind $0.05
*** HOLE CARDS ***
Dealt to 4ff3fcdb 
Dealt to 9b63101d 
Dealt to f3f5406e 
Dealt to fe532acc 
Dealt to c7d7e6aa 
Dealt to Hero [Jc 7c]
fe532acc: folds
c7d7e6aa: folds
Hero: folds
4ff3fcdb: folds
9b63101d: folds
Uncalled bet ($0.03) returned to f3f5406e
*** SHOWDOWN ***
f3f5406e collected $0.04 from pot
*** SUMMARY ***
Total pot $0.04 | Rake $0 | Jackpot $0 | Bingo $0 | Fortune $0 | Tax $0
Seat 1: 4ff3fcdb (button) folded before Flop (didn't bet)
Seat 2: 9b63101d (small blind) folded before Flop
Seat 3: f3f5406e (big blind) collected ($0.04)
Seat 4: fe532acc folded before Flop (didn't bet)
Seat 5: c7d7e6aa folded before Flop (didn't bet)
Seat 6: Hero folded before Flop (didn't bet)


Poker Hand #RC3334368521: Hold'em No Limit ($0.02/$0.05) - 2025/02/17 20:11:37
Table 'RushAndCash593781' 6-max Seat #1 is the button
Seat 1: a2794999 ($5.01 in chips)
Seat 2: Hero ($5 in chips)
Seat 3: 7fc44808 ($5.87 in chips)
Seat 4: fe532acc ($5.39 in chips)
Seat 5: 6878e82a ($5 in chips)
Seat 6: 939e7cc4 ($5.1 in chips)
Hero: posts small blind $0.02
7fc44808: posts big blind $0.05
*** HOLE CARDS ***
Dealt to a2794999 
Dealt to Hero [Ac 8c]
Dealt to 7fc44808 
Dealt to fe532acc 
Dealt to 6878e82a 
Dealt to 939e7cc4 
fe532acc: folds
6878e82a: folds
939e7cc4: folds
a2794999: folds
Hero: calls $0.03
7fc44808: raises $0.1 to $0.15
Hero: calls $0.1
*** FLOP *** [5h Qs Ks]
Hero: checks
7fc44808: bets $0.1
Hero: folds
Uncalled bet ($0.1) returned to 7fc44808
*** SHOWDOWN ***
7fc44808 collected $0.29 from pot
*** SUMMARY ***
Total pot $0.3 | Rake $0.01 | Jackpot $0 | Bingo $0 | Fortune $0 | Tax $0
Board [5h Qs Ks]
Seat 1: a2794999 (button) folded before Flop (didn't bet)
Seat 2: Hero (small blind) folded on the Flop
Seat 3: 7fc44808 (big blind) won ($0.29)
Seat 4: fe532acc folded before Flop (didn't bet)
Seat 5: 6878e82a folded before Flop (didn't bet)
Seat 6: 939e7cc4 folded before Flop (didn't bet)


Poker Hand #RC3334368486: Hold'em No Limit ($0.02/$0.05) - 2025/02/17 20:11:31
Table 'RushAndCash593746' 6-max Seat #1 is the button
Seat 1: 3100dcf0 ($5.1 in chips)
Seat 2: 3fdb54c2 ($5.41 in chips)
Seat 3: Hero ($5 in chips)
Seat 4: 803e9f05 ($6.05 in chips)
Seat 5: f25a1768 ($6.93 in chips)
Seat 6: 835df346 ($15.53 in chips)
3fdb54c2: posts small blind $0.02
Hero: posts big blind $0.05
*** HOLE CARDS ***
Dealt to 3100dcf0 
Dealt to 3fdb54c2 
Dealt to Hero [6d 5s]
Dealt to 803e9f05 
Dealt to f25a1768 
Dealt to 835df346 
803e9f05: folds
f25a1768: folds
835df346: folds
3100dcf0: folds
3fdb54c2: calls $0.03
Hero: checks
*** FLOP *** [4c Js 3h]
3fdb54c2: bets $0.05
Hero: folds
Uncalled bet ($0.05) returned to 3fdb54c2
*** SHOWDOWN ***
3fdb54c2 collected $0.1 from pot
*** SUMMARY ***
Total pot $0.1 | Rake $0 | Jackpot $0 | Bingo $0 | Fortune $0 | Tax $0
Board [4c Js 3h]
Seat 1: 3100dcf0 (button) folded before Flop (didn't bet)
Seat 2: 3fdb54c2 (small blind) won ($0.1)
Seat 3: Hero (big blind) folded on the Flop
Seat 4: 803e9f05 folded before Flop (didn't bet)
Seat 5: f25a1768 folded before Flop (didn't bet)
Seat 6: 835df346 folded before Flop (didn't bet)


Poker Hand #RC3334368460: Hold'em No Limit ($0.02/$0.05) - 2025/02/17 20:11:27
Table 'RushAndCash593720' 6-max Seat #1 is the button
Seat 1: Hero ($5 in chips)
Seat 2: 1e86c3d2 ($5.33 in chips)
Seat 3: 7b286ce1 ($5 in chips)
Seat 4: fb6c4072 ($5.02 in chips)
Seat 5: f171b990 ($5.21 in chips)
Seat 6: 27020fb4 ($5.39 in chips)
1e86c3d2: posts small blind $0.02
7b286ce1: posts big blind $0.05
*** HOLE CARDS ***
Dealt to Hero [3h 6c]
Dealt to 1e86c3d2 
Dealt to 7b286ce1 
Dealt to fb6c4072 
Dealt to f171b990 
Dealt to 27020fb4 
fb6c4072: folds
f171b990: folds
27020fb4: folds
Hero: folds
1e86c3d2: raises $0.1 to $0.15
7b286ce1: folds
Uncalled bet ($0.1) returned to 1e86c3d2
*** SHOWDOWN ***
1e86c3d2 collected $0.1 from pot
*** SUMMARY ***
Total pot $0.1 | Rake $0 | Jackpot $0 | Bingo $0 | Fortune $0 | Tax $0
Seat 1: Hero (button) folded before Flop (didn't bet)
Seat 2: 1e86c3d2 (small blind) collected ($0.1)
Seat 3: 7b286ce1 (big blind) folded before Flop
Seat 4: fb6c4072 folded before Flop (didn't bet)
Seat 5: f171b990 folded before Flop (didn't bet)
Seat 6: 27020fb4 folded before Flop (didn't bet)


Poker Hand #RC3334368437: Hold'em No Limit ($0.02/$0.05) - 2025/02/17 20:11:24
Table 'RushAndCash593697' 6-max Seat #1 is the button
Seat 1: 7b286ce1 ($5 in chips)
Seat 2: 54fe77bd ($5.65 in chips)
Seat 3: e5f214e5 ($8.67 in chips)
Seat 4: a8b128fb ($13.98 in chips)
Seat 5: 120fe547 ($4.5 in chips)
Seat 6: Hero ($5 in chips)
54fe77bd: posts small blind $0.02
e5f214e5: posts big blind $0.05
*** HOLE CARDS ***
Dealt to 7b286ce1 
Dealt to 54fe77bd 
Dealt to e5f214e5 
Dealt to a8b128fb 
Dealt to 120fe547 
Dealt to Hero [Ac 7s]
a8b128fb: raises $0.05 to $0.1
120fe547: folds
Hero: folds
7b286ce1: folds
54fe77bd: folds
e5f214e5: calls $0.05
*** FLOP *** [8c 8d 7d]
e5f214e5: checks
a8b128fb: checks
*** TURN *** [8c 8d 7d] [Jh]
e5f214e5: checks
a8b128fb: bets $0.11
e5f214e5: folds
Uncalled bet ($0.11) returned to a8b128fb
*** SHOWDOWN ***
a8b128fb collected $0.21 from pot
*** SUMMARY ***
Total pot $0.22 | Rake $0.01 | Jackpot $0 | Bingo $0 | Fortune $0 | Tax $0
Board [8c 8d 7d Jh]
Seat 1: 7b286ce1 (button) folded before Flop (didn't bet)
Seat 2: 54fe77bd (small blind) folded before Flop
Seat 3: e5f214e5 (big blind) folded on the Turn
Seat 4: a8b128fb won ($0.21)
Seat 5: 120fe547 folded before Flop (didn't bet)
Seat 6: Hero folded before Flop (didn't bet)


Poker Hand #RC3334368416: Hold'em No Limit ($0.02/$0.05) - 2025/02/17 20:11:21
Table 'RushAndCash593676' 6-max Seat #1 is the button
Seat 1: 90fb5891 ($6.04 in chips)
Seat 2: b167a4a5 ($15.22 in chips)
Seat 3: 10a7b2c7 ($4.83 in chips)
Seat 4: Hero ($5 in chips)
Seat 5: bbdadd69 ($6.98 in chips)
Seat 6: 15346d36 ($4.86 in chips)
b167a4a5: posts small blind $0.02
10a7b2c7: posts big blind $0.05
*** HOLE CARDS ***
Dealt to 90fb5891 
Dealt to b167a4a5 
Dealt to 10a7b2c7 
Dealt to Hero [2d 6c]
Dealt to bbdadd69 
Dealt to 15346d36 
Hero: folds
bbdadd69: raises $0.05 to $0.1
15346d36: folds
90fb5891: folds
b167a4a5: folds
10a7b2c7: folds
Uncalled bet ($0.05) returned to bbdadd69
*** SHOWDOWN ***
bbdadd69 collected $0.12 from pot
*** SUMMARY ***
Total pot $0.12 | Rake $0 | Jackpot $0 | Bingo $0 | Fortune $0 | Tax $0
Seat 1: 90fb5891 (button) folded before Flop (didn't bet)
Seat 2: b167a4a5 (small blind) folded before Flop
Seat 3: 10a7b2c7 (big blind) folded before Flop
Seat 4: Hero folded before Flop (didn't bet)
Seat 5: bbdadd69 collected ($0.12)
Seat 6: 15346d36 folded before Flop (didn't bet)


Poker Hand #RC3334368383: Hold'em No Limit ($0.02/$0.05) - 2025/02/17 20:11:16
Table 'RushAndCash593643' 6-max Seat #1 is the button
Seat 1: 18767060 ($13.33 in chips)
Seat 2: eaafe260 ($5 in chips)
Seat 3: 4190d158 ($5 in chips)
Seat 4: f0deee96 ($4.15 in chips)
Seat 5: 6aa0c391 ($5.21 in chips)
Seat 6: Hero ($5 in chips)
eaafe260: posts small blind $0.02
4190d158: posts big blind $0.05
*** HOLE CARDS ***
Dealt to 18767060 
Dealt to eaafe260 
Dealt to 4190d158 
Dealt to f0deee96 
Dealt to 6aa0c391 
Dealt to Hero [As 4c]
f0deee96: folds
6aa0c391: raises $0.08 to $0.13
Hero: folds
18767060: folds
eaafe260: folds
4190d158: folds
Uncalled bet ($0.08) returned to 6aa0c391
*** SHOWDOWN ***
6aa0c391 collected $0.12 from pot
*** SUMMARY ***
Total pot $0.12 | Rake $0 | Jackpot $0 | Bingo $0 | Fortune $0 | Tax $0
Seat 1: 18767060 (button) folded before Flop (didn't bet)
Seat 2: eaafe260 (small blind) folded before Flop
Seat 3: 4190d158 (big blind) folded before Flop
Seat 4: f0deee96 folded before Flop (didn't bet)
Seat 5: 6aa0c391 collected ($0.12)
Seat 6: Hero folded before Flop (didn't bet)


Poker Hand #RC3334368361: Hold'em No Limit ($0.02/$0.05) - 2025/02/17 20:11:13
Table 'RushAndCash593621' 6-max Seat #1 is the button
Seat 1: 92ac71f9 ($5.12 in chips)
Seat 2: Hero ($5 in chips)
Seat 3: 25b4d6e7 ($11.91 in chips)
Seat 4: 491e0e63 ($5 in chips)
Seat 5: 9c9041e6 ($5.07 in chips)
Seat 6: c62b7a0b ($20.58 in chips)
Hero: posts small blind $0.02
25b4d6e7: posts big blind $0.05
*** HOLE CARDS ***
Dealt to 92ac71f9 
Dealt to Hero [4c Qc]
Dealt to 25b4d6e7 
Dealt to 491e0e63 
Dealt to 9c9041e6 
Dealt to c62b7a0b 
491e0e63: folds
9c9041e6: folds
c62b7a0b: folds
92ac71f9: raises $0.05 to $0.1
Hero: folds
25b4d6e7: calls $0.05
*** FLOP *** [5h 2h Ad]
25b4d6e7: checks
92ac71f9: bets $0.05
25b4d6e7: calls $0.05
*** TURN *** [5h 2h Ad] [Td]
25b4d6e7: checks
92ac71f9: checks
*** RIVER *** [5h 2h Ad Td] [2c]
25b4d6e7: bets $0.24
92ac71f9: folds
Uncalled bet ($0.24) returned to 25b4d6e7
*** SHOWDOWN ***
25b4d6e7 collected $0.31 from pot
*** SUMMARY ***
Total pot $0.32 | Rake $0.01 | Jackpot $0 | Bingo $0 | Fortune $0 | Tax $0
Board [5h 2h Ad Td 2c]
Seat 1: 92ac71f9 (button) folded on the River
Seat 2: Hero (small blind) folded before Flop
Seat 3: 25b4d6e7 (big blind) won ($0.31)
Seat 4: 491e0e63 folded before Flop (didn't bet)
Seat 5: 9c9041e6 folded before Flop (didn't bet)
Seat 6: c62b7a0b folded before Flop (didn't bet)


Poker Hand #RC3334368340: Hold'em No Limit ($0.02/$0.05) - 2025/02/17 20:11:10
Table 'RushAndCash593600' 6-max Seat #1 is the button
Seat 1: Hero ($5 in chips)
Seat 2: 92ac71f9 ($5.14 in chips)
Seat 3: 16f2e5ce ($5.36 in chips)
Seat 4: 2f8cd08f ($5.37 in chips)
Seat 5: 144ea2b0 ($5.72 in chips)
Seat 6: 918d412c ($3.82 in chips)
92ac71f9: posts small blind $0.02
16f2e5ce: posts big blind $0.05
*** HOLE CARDS ***
Dealt to Hero [Ks 2h]
Dealt to 92ac71f9 
Dealt to 16f2e5ce 
Dealt to 2f8cd08f 
Dealt to 144ea2b0 
Dealt to 918d412c 
2f8cd08f: raises $0.05 to $0.1
144ea2b0: folds
918d412c: folds
Hero: folds
92ac71f9: folds
16f2e5ce: folds
Uncalled bet ($0.05) returned to 2f8cd08f
*** SHOWDOWN ***
2f8cd08f collected $0.12 from pot
*** SUMMARY ***
Total pot $0.12 | Rake $0 | Jackpot $0 | Bingo $0 | Fortune $0 | Tax $0
Seat 1: Hero (button) folded before Flop (didn't bet)
Seat 2: 92ac71f9 (small blind) folded before Flop
Seat 3: 16f2e5ce (big blind) folded before Flop
Seat 4: 2f8cd08f collected ($0.12)
Seat 5: 144ea2b0 folded before Flop (didn't bet)
Seat 6: 918d412c folded before Flop (didn't bet)


Poker Hand #RC3334368196: Hold'em No Limit ($0.02/$0.05) - 2025/02/17 20:10:49
Table 'RushAndCash593456' 6-max Seat #1 is the button
Seat 1: e025df94 ($7.43 in chips)
Seat 2: 5201dded ($5 in chips)
Seat 3: Hero ($5 in chips)
Seat 4: 4052bb6f ($5.24 in chips)
Seat 5: e80ee414 ($1.62 in chips)
Seat 6: f423ee1f ($7.46 in chips)
Cash Drop to Pot : total $0.5 
5201dded: posts small blind $0.02
Hero: posts big blind $0.05
*** HOLE CARDS ***
Dealt to e025df94 
Dealt to 5201dded 
Dealt to Hero [7h Qd]
Dealt to 4052bb6f 
Dealt to e80ee414 
Dealt to f423ee1f 
4052bb6f: folds
e80ee414: calls $0.05
f423ee1f: calls $0.05
e025df94: raises $0.15 to $0.2
5201dded: calls $0.18
Hero: folds
e80ee414: calls $0.15
f423ee1f: calls $0.15
*** FLOP *** [5d 7d 8d]
5201dded: bets $1.35
e80ee414: folds
f423ee1f: folds
e025df94: folds
Uncalled bet ($1.35) returned to 5201dded
*** SHOWDOWN ***
5201dded collected $1.29 from pot
*** SUMMARY ***
Total pot $1.35 | Rake $0.06 | Jackpot $0 | Bingo $0 | Fortune $0 | Tax $0
Board [5d 7d 8d]
Seat 1: e025df94 (button) folded on the Flop
Seat 2: 5201dded (small blind) won ($1.29)
Seat 3: Hero (big blind) folded before Flop
Seat 4: 4052bb6f folded before Flop (didn't bet)
Seat 5: e80ee414 folded on the Flop
Seat 6: f423ee1f folded on the Flop


Poker Hand #RC3334368176: Hold'em No Limit ($0.02/$0.05) - 2025/02/17 20:10:46
Table 'RushAndCash593436' 6-max Seat #1 is the button
Seat 1: f423ee1f ($7.46 in chips)
Seat 2: 8ffbb474 ($5.71 in chips)
Seat 3: 7c57f010 ($7.25 in chips)
Seat 4: e80ee414 ($1.62 in chips)
Seat 5: Hero ($5 in chips)
Seat 6: 5201dded ($5 in chips)
8ffbb474: posts small blind $0.02
7c57f010: posts big blind $0.05
*** HOLE CARDS ***
Dealt to f423ee1f 
Dealt to 8ffbb474 
Dealt to 7c57f010 
Dealt to e80ee414 
Dealt to Hero [7c Td]
Dealt to 5201dded 
e80ee414: folds
Hero: folds
5201dded: folds
f423ee1f: folds
8ffbb474: folds
Uncalled bet ($0.03) returned to 7c57f010
*** SHOWDOWN ***
7c57f010 collected $0.04 from pot
*** SUMMARY ***
Total pot $0.04 | Rake $0 | Jackpot $0 | Bingo $0 | Fortune $0 | Tax $0
Seat 1: f423ee1f (button) folded before Flop (didn't bet)
Seat 2: 8ffbb474 (small blind) folded before Flop
Seat 3: 7c57f010 (big blind) collected ($0.04)
Seat 4: e80ee414 folded before Flop (didn't bet)
Seat 5: Hero folded before Flop (didn't bet)
Seat 6: 5201dded folded before Flop (didn't bet)


Poker Hand #RC3334368088: Hold'em No Limit ($0.02/$0.05) - 2025/02/17 20:10:32
Table 'RushAndCash593348' 6-max Seat #1 is the button
Seat 1: ab35fc95 ($5.72 in chips)
Seat 2: 9bc8386 ($5.26 in chips)
Seat 3: 1aca371e ($5.9 in chips)
Seat 4: Hero ($5 in chips)
Seat 5: e92b360e ($9.23 in chips)
Seat 6: e7b2e2aa ($5.21 in chips)
9bc8386: posts small blind $0.02
1aca371e: posts big blind $0.05
*** HOLE CARDS ***
Dealt to ab35fc95 
Dealt to 9bc8386 
Dealt to 1aca371e 
Dealt to Hero [8h 7d]
Dealt to e92b360e 
Dealt to e7b2e2aa 
Hero: folds
e92b360e: folds
e7b2e2aa: folds
ab35fc95: folds
9bc8386: raises $0.1 to $0.15
1aca371e: calls $0.1
*** FLOP *** [Kd Qc Th]
9bc8386: checks
1aca371e: checks
*** TURN *** [Kd Qc Th] [2s]
9bc8386: checks
1aca371e: bets $0.24
9bc8386: folds
Uncalled bet ($0.24) returned to 1aca371e
*** SHOWDOWN ***
1aca371e collected $0.29 from pot
*** SUMMARY ***
Total pot $0.3 | Rake $0.01 | Jackpot $0 | Bingo $0 | Fortune $0 | Tax $0
Board [Kd Qc Th 2s]
Seat 1: ab35fc95 (button) folded before Flop (didn't bet)
Seat 2: 9bc8386 (small blind) folded on the Turn
Seat 3: 1aca371e (big blind) won ($0.29)
Seat 4: Hero folded before Flop (didn't bet)
Seat 5: e92b360e folded before Flop (didn't bet)
Seat 6: e7b2e2aa folded before Flop (didn't bet)


Poker Hand #RC3334368067: Hold'em No Limit ($0.02/$0.05) - 2025/02/17 20:10:29
Table 'RushAndCash593327' 6-max Seat #1 is the button
Seat 1: 57ea871 ($4.93 in chips)
Seat 2: b282789b ($5.37 in chips)
Seat 3: 2136c68 ($5 in chips)
Seat 4: ab35fc95 ($5.72 in chips)
Seat 5: e4d8df1d ($5 in chips)
Seat 6: Hero ($5 in chips)
b282789b: posts small blind $0.02
2136c68: posts big blind $0.05
*** HOLE CARDS ***
Dealt to 57ea871 
Dealt to b282789b 
Dealt to 2136c68 
Dealt to ab35fc95 
Dealt to e4d8df1d 
Dealt to Hero [8d Js]
ab35fc95: folds
e4d8df1d: folds
Hero: folds
57ea871: folds
b282789b: folds
Uncalled bet ($0.03) returned to 2136c68
*** SHOWDOWN ***
2136c68 collected $0.04 from pot
*** SUMMARY ***
Total pot $0.04 | Rake $0 | Jackpot $0 | Bingo $0 | Fortune $0 | Tax $0
Seat 1: 57ea871 (button) folded before Flop (didn't bet)
Seat 2: b282789b (small blind) folded before Flop
Seat 3: 2136c68 (big blind) collected ($0.04)
Seat 4: ab35fc95 folded before Flop (didn't bet)
Seat 5: e4d8df1d folded before Flop (didn't bet)
Seat 6: Hero folded before Flop (didn't bet)


Poker Hand #RC3334368015: Hold'em No Limit ($0.02/$0.05) - 2025/02/17 20:10:20
Table 'RushAndCash593275' 6-max Seat #1 is the button
Seat 1: Hero ($5 in chips)
Seat 2: 598d859f ($5.43 in chips)
Seat 3: 7c57f010 ($7.3 in chips)
Seat 4: f45ac3d0 ($5.8 in chips)
Seat 5: 7a5bf293 ($5.06 in chips)
Seat 6: 4c7728b5 ($5 in chips)
598d859f: posts small blind $0.02
7c57f010: posts big blind $0.05
*** HOLE CARDS ***
Dealt to Hero [6s 6h]
Dealt to 598d859f 
Dealt to 7c57f010 
Dealt to f45ac3d0 
Dealt to 7a5bf293 
Dealt to 4c7728b5 
f45ac3d0: folds
7a5bf293: folds
4c7728b5: raises $0.08 to $0.13
Hero: folds
598d859f: folds
7c57f010: folds
Uncalled bet ($0.08) returned to 4c7728b5
*** SHOWDOWN ***
4c7728b5 collected $0.12 from pot
*** SUMMARY ***
Total pot $0.12 | Rake $0 | Jackpot $0 | Bingo $0 | Fortune $0 | Tax $0
Seat 1: Hero (button) folded before Flop (didn't bet)
Seat 2: 598d859f (small blind) folded before Flop
Seat 3: 7c57f010 (big blind) folded before Flop
Seat 4: f45ac3d0 folded before Flop (didn't bet)
Seat 5: 7a5bf293 folded before Flop (didn't bet)
Seat 6: 4c7728b5 collected ($0.12)


Poker Hand #RC3334367992: Hold'em No Limit ($0.02/$0.05) - 2025/02/17 20:10:17
Table 'RushAndCash593252' 6-max Seat #1 is the button
Seat 1: c9ea832 ($6.54 in chips)
Seat 2: f25a1768 ($6.78 in chips)
Seat 3: Hero ($5 in chips)
Seat 4: 6183e175 ($17.79 in chips)
Seat 5: a1e98d09 ($1.48 in chips)
Seat 6: 19bb03b5 ($7.04 in chips)
f25a1768: posts small blind $0.02
Hero: posts big blind $0.05
*** HOLE CARDS ***
Dealt to c9ea832 
Dealt to f25a1768 
Dealt to Hero [3d Tc]
Dealt to 6183e175 
Dealt to a1e98d09 
Dealt to 19bb03b5 
6183e175: folds
a1e98d09: raises $0.05 to $0.1
19bb03b5: folds
c9ea832: raises $0.32 to $0.42
f25a1768: folds
Hero: folds
a1e98d09: folds
Uncalled bet ($0.32) returned to c9ea832
*** SHOWDOWN ***
c9ea832 collected $0.26 from pot
*** SUMMARY ***
Total pot $0.27 | Rake $0.01 | Jackpot $0 | Bingo $0 | Fortune $0 | Tax $0
Seat 1: c9ea832 (button) collected ($0.26)
Seat 2: f25a1768 (small blind) folded before Flop
Seat 3: Hero (big blind) folded before Flop
Seat 4: 6183e175 folded before Flop (didn't bet)
Seat 5: a1e98d09 folded before Flop
Seat 6: 19bb03b5 folded before Flop (didn't bet)


Poker Hand #RC3334367967: Hold'em No Limit ($0.02/$0.05) - 2025/02/17 20:10:13
Table 'RushAndCash593227' 6-max Seat #1 is the button
Seat 1: 80b2520f ($12.54 in chips)
Seat 2: Hero ($5 in chips)
Seat 3: 6c0f6dbf ($5 in chips)
Seat 4: 84fb210c ($8.69 in chips)
Seat 5: 936e1bce ($5.04 in chips)
Seat 6: ccddedff ($14.21 in chips)
Hero: posts small blind $0.02
6c0f6dbf: posts big blind $0.05
*** HOLE CARDS ***
Dealt to 80b2520f 
Dealt to Hero [7c 4s]
Dealt to 6c0f6dbf 
Dealt to 84fb210c 
Dealt to 936e1bce 
Dealt to ccddedff 
84fb210c: raises $0.05 to $0.1
936e1bce: folds
ccddedff: calls $0.1
80b2520f: folds
Hero: folds
6c0f6dbf: folds
*** FLOP *** [9s 5h 5c]
84fb210c: checks
ccddedff: bets $0.05
84fb210c: folds
Uncalled bet ($0.05) returned to ccddedff
*** SHOWDOWN ***
ccddedff collected $0.26 from pot
*** SUMMARY ***
Total pot $0.27 | Rake $0.01 | Jackpot $0 | Bingo $0 | Fortune $0 | Tax $0
Board [9s 5h 5c]
Seat 1: 80b2520f (button) folded before Flop (didn't bet)
Seat 2: Hero (small blind) folded before Flop
Seat 3: 6c0f6dbf (big blind) folded before Flop
Seat 4: 84fb210c folded on the Flop
Seat 5: 936e1bce folded before Flop (didn't bet)
Seat 6: ccddedff won ($0.26)


Poker Hand #RC3334367943: Hold'em No Limit ($0.02/$0.05) - 2025/02/17 20:10:10
Table 'RushAndCash593203' 6-max Seat #1 is the button
Seat 1: f6ddf5f7 ($6.09 in chips)
Seat 2: eea81bce ($6.07 in chips)
Seat 3: 945593bf ($5 in chips)
Seat 4: b9d877b0 ($5 in chips)
Seat 5: 886c894a ($11.51 in chips)
Seat 6: Hero ($5 in chips)
eea81bce: posts small blind $0.02
945593bf: posts big blind $0.05
*** HOLE CARDS ***
Dealt to f6ddf5f7 
Dealt to eea81bce 
Dealt to 945593bf 
Dealt to b9d877b0 
Dealt to 886c894a 
Dealt to Hero [Kc 4c]
b9d877b0: raises $0.08 to $0.13
886c894a: calls $0.13
Hero: folds
f6ddf5f7: folds
eea81bce: folds
945593bf: folds
*** FLOP *** [9d 9c As]
b9d877b0: bets $0.1
886c894a: folds
Uncalled bet ($0.1) returned to b9d877b0
*** SHOWDOWN ***
b9d877b0 collected $0.32 from pot
*** SUMMARY ***
Total pot $0.33 | Rake $0.01 | Jackpot $0 | Bingo $0 | Fortune $0 | Tax $0
Board [9d 9c As]
Seat 1: f6ddf5f7 (button) folded before Flop (didn't bet)
Seat 2: eea81bce (small blind) folded before Flop
Seat 3: 945593bf (big blind) folded before Flop
Seat 4: b9d877b0 won ($0.32)
Seat 5: 886c894a folded on the Flop
Seat 6: Hero folded before Flop (didn't bet)


Poker Hand #RC3334367919: Hold'em No Limit ($0.02/$0.05) - 2025/02/17 20:10:07
Table 'RushAndCash593179' 6-max Seat #1 is the button
Seat 1: 52b3e671 ($6.04 in chips)
Seat 2: ec64208b ($5 in chips)
Seat 3: ab77a003 ($5 in chips)
Seat 4: 97bc7ae0 ($7.59 in chips)
Seat 5: ea485a4d ($5.03 in chips)
Seat 6: Hero ($5 in chips)
ec64208b: posts small blind $0.02
ab77a003: posts big blind $0.05
*** HOLE CARDS ***
Dealt to 52b3e671 
Dealt to ec64208b 
Dealt to ab77a003 
Dealt to 97bc7ae0 
Dealt to ea485a4d 
Dealt to Hero [8c 4c]
97bc7ae0: folds
ea485a4d: folds
Hero: folds
52b3e671: folds
ec64208b: raises $0.1 to $0.15
ab77a003: calls $0.1
*** FLOP *** [2s 7c 6c]
ec64208b: checks
ab77a003: checks
*** TURN *** [2s 7c 6c] [Td]
ec64208b: checks
ab77a003: bets $0.1
ec64208b: folds
Uncalled bet ($0.1) returned to ab77a003
*** SHOWDOWN ***
ab77a003 collected $0.29 from pot
*** SUMMARY ***
Total pot $0.3 | Rake $0.01 | Jackpot $0 | Bingo $0 | Fortune $0 | Tax $0
Board [2s 7c 6c Td]
Seat 1: 52b3e671 (button) folded before Flop (didn't bet)
Seat 2: ec64208b (small blind) folded on the Turn
Seat 3: ab77a003 (big blind) won ($0.29)
Seat 4: 97bc7ae0 folded before Flop (didn't bet)
Seat 5: ea485a4d folded before Flop (didn't bet)
Seat 6: Hero folded before Flop (didn't bet)


Poker Hand #RC3334367897: Hold'em No Limit ($0.02/$0.05) - 2025/02/17 20:10:04
Table 'RushAndCash593157' 6-max Seat #1 is the button
Seat 1: 6c122cb5 ($5 in chips)
Seat 2: 83c366a4 ($5.52 in chips)
Seat 3: 929700a0 ($5.17 in chips)
Seat 4: bcbd875d ($8.14 in chips)
Seat 5: aa5b23ed ($5.07 in chips)
Seat 6: Hero ($5 in chips)
83c366a4: posts small blind $0.02
929700a0: posts big blind $0.05
*** HOLE CARDS ***
Dealt to 6c122cb5 
Dealt to 83c366a4 
Dealt to 929700a0 
Dealt to bcbd875d 
Dealt to aa5b23ed 
Dealt to Hero [6c Qd]
bcbd875d: folds
aa5b23ed: raises $0.1 to $0.15
Hero: folds
6c122cb5: folds
83c366a4: folds
929700a0: raises $0.35 to $0.5
aa5b23ed: calls $0.35
*** FLOP *** [9d 8h 3s]
929700a0: bets $0.54
aa5b23ed: calls $0.54
*** TURN *** [9d 8h 3s] [9s]
929700a0: bets $0.95
aa5b23ed: calls $0.95
*** RIVER *** [9d 8h 3s 9s] [2c]
929700a0: bets $1
aa5b23ed: folds
Uncalled bet ($1) returned to 929700a0
*** SHOWDOWN ***
929700a0 collected $3.78 from pot
*** SUMMARY ***
Total pot $4 | Rake $0.15 | Jackpot $0.07 | Bingo $0 | Fortune $0 | Tax $0
Board [9d 8h 3s 9s 2c]
Seat 1: 6c122cb5 (button) folded before Flop (didn't bet)
Seat 2: 83c366a4 (small blind) folded before Flop
Seat 3: 929700a0 (big blind) showed [Kh As] and won ($3.78)
Seat 4: bcbd875d folded before Flop (didn't bet)
Seat 5: aa5b23ed folded on the River
Seat 6: Hero folded before Flop (didn't bet)


Poker Hand #RC3334367874: Hold'em No Limit ($0.02/$0.05) - 2025/02/17 20:10:00
Table 'RushAndCash593134' 6-max Seat #1 is the button
Seat 1: 3b2a8270 ($13.79 in chips)
Seat 2: a28ca95c ($9.03 in chips)
Seat 3: 23a94355 ($5 in chips)
Seat 4: f3f5406e ($16.03 in chips)
Seat 5: Hero ($5 in chips)
Seat 6: 90f78eaa ($9.94 in chips)
a28ca95c: posts small blind $0.02
23a94355: posts big blind $0.05
*** HOLE CARDS ***
Dealt to 3b2a8270 
Dealt to a28ca95c 
Dealt to 23a94355 
Dealt to f3f5406e 
Dealt to Hero [9c 5h]
Dealt to 90f78eaa 
f3f5406e: raises $0.1 to $0.15
Hero: folds
90f78eaa: folds
3b2a8270: folds
a28ca95c: raises $0.41 to $0.56
23a94355: folds
f3f5406e: calls $0.41
*** FLOP *** [7h Tc 4c]
a28ca95c: bets $0.39
f3f5406e: calls $0.39
*** TURN *** [7h Tc 4c] [7s]
a28ca95c: checks
f3f5406e: bets $0.98
a28ca95c: calls $0.98
*** RIVER *** [7h Tc 4c 7s] [8c]
a28ca95c: bets $3.02
f3f5406e: folds
Uncalled bet ($3.02) returned to a28ca95c
*** SHOWDOWN ***
a28ca95c collected $3.69 from pot
*** SUMMARY ***
Total pot $3.91 | Rake $0.15 | Jackpot $0.07 | Bingo $0 | Fortune $0 | Tax $0
Board [7h Tc 4c 7s 8c]
Seat 1: 3b2a8270 (button) folded before Flop (didn't bet)
Seat 2: a28ca95c (small blind) won ($3.69)
Seat 3: 23a94355 (big blind) folded before Flop
Seat 4: f3f5406e folded on the River
Seat 5: Hero folded before Flop (didn't bet)
Seat 6: 90f78eaa folded before Flop (didn't bet)


Poker Hand #RC3334367811: Hold'em No Limit ($0.02/$0.05) - 2025/02/17 20:09:50
Table 'RushAndCash593071' 6-max Seat #1 is the button
Seat 1: Hero ($5 in chips)
Seat 2: cff58cde ($5.02 in chips)
Seat 3: dc9e794c ($5.11 in chips)
Seat 4: b66d20fa ($15.22 in chips)
Seat 5: 8324de89 ($5.63 in chips)
Seat 6: 120cc9c4 ($21.16 in chips)
cff58cde: posts small blind $0.02
dc9e794c: posts big blind $0.05
*** HOLE CARDS ***
Dealt to Hero [9d Qs]
Dealt to cff58cde 
Dealt to dc9e794c 
Dealt to b66d20fa 
Dealt to 8324de89 
Dealt to 120cc9c4 
b66d20fa: folds
8324de89: folds
120cc9c4: folds
Hero: folds
cff58cde: raises $0.08 to $0.13
dc9e794c: calls $0.08
*** FLOP *** [6c 5c Js]
cff58cde: checks
dc9e794c: bets $0.05
cff58cde: raises $0.18 to $0.23
dc9e794c: folds
Uncalled bet ($0.18) returned to cff58cde
*** SHOWDOWN ***
cff58cde collected $0.35 from pot
*** SUMMARY ***
Total pot $0.36 | Rake $0.01 | Jackpot $0 | Bingo $0 | Fortune $0 | Tax $0
Board [6c 5c Js]
Seat 1: Hero (button) folded before Flop (didn't bet)
Seat 2: cff58cde (small blind) won ($0.35)
Seat 3: dc9e794c (big blind) folded on the Flop
Seat 4: b66d20fa folded before Flop (didn't bet)
Seat 5: 8324de89 folded before Flop (didn't bet)
Seat 6: 120cc9c4 folded before Flop (didn't bet)


Poker Hand #RC3334367350: Hold'em No Limit ($0.02/$0.05) - 2025/02/17 20:08:38
Table 'RushAndCash592610' 6-max Seat #1 is the button
Seat 1: d86379c5 ($5.32 in chips)
Seat 2: Hero ($5 in chips)
Seat 3: 73682246 ($13.92 in chips)
Seat 4: 6dcd0788 ($5 in chips)
Seat 5: 9864109b ($5 in chips)
Seat 6: e9c5dfd7 ($5 in chips)
Hero: posts small blind $0.02
73682246: posts big blind $0.05
*** HOLE CARDS ***
Dealt to d86379c5 
Dealt to Hero [Jh Ac]
Dealt to 73682246 
Dealt to 6dcd0788 
Dealt to 9864109b 
Dealt to e9c5dfd7 
6dcd0788: folds
9864109b: folds
e9c5dfd7: raises $0.05 to $0.1
d86379c5: folds
Hero: calls $0.08
73682246: calls $0.05
*** FLOP *** [Jc 8s Kh]
Hero: checks
73682246: checks
e9c5dfd7: bets $0.15
Hero: calls $0.15
73682246: folds
*** TURN *** [Jc 8s Kh] [7d]
Hero: checks
e9c5dfd7: checks
*** RIVER *** [Jc 8s Kh 7d] [6h]
Hero: checks
e9c5dfd7: bets $0.3
Hero: folds
Uncalled bet ($0.3) returned to e9c5dfd7
*** SHOWDOWN ***
e9c5dfd7 collected $0.57 from pot
*** SUMMARY ***
Total pot $0.6 | Rake $0.03 | Jackpot $0 | Bingo $0 | Fortune $0 | Tax $0
Board [Jc 8s Kh 7d 6h]
Seat 1: d86379c5 (button) folded before Flop (didn't bet)
Seat 2: Hero (small blind) folded on the River
Seat 3: 73682246 (big blind) folded on the Flop
Seat 4: 6dcd0788 folded before Flop (didn't bet)
Seat 5: 9864109b folded before Flop (didn't bet)
Seat 6: e9c5dfd7 won ($0.57)


Poker Hand #RC3334367084: Hold'em No Limit ($0.02/$0.05) - 2025/02/17 20:07:56
Table 'RushAndCash592344' 6-max Seat #1 is the button
Seat 1: 97fe2676 ($9.48 in chips)
Seat 2: 45d33c76 ($7.12 in chips)
Seat 3: Hero ($5.07 in chips)
Seat 4: 929700a0 ($5.32 in chips)
Seat 5: be95cbec ($7.87 in chips)
Seat 6: 1a2d8f33 ($5.25 in chips)
45d33c76: posts small blind $0.02
Hero: posts big blind $0.05
*** HOLE CARDS ***
Dealt to 97fe2676 
Dealt to 45d33c76 
Dealt to Hero [Qs Qd]
Dealt to 929700a0 
Dealt to be95cbec 
Dealt to 1a2d8f33 
929700a0: folds
be95cbec: folds
1a2d8f33: folds
97fe2676: raises $0.05 to $0.1
45d33c76: folds
Hero: raises $0.28 to $0.38
97fe2676: raises $0.59 to $0.97
Hero: folds
Uncalled bet ($0.59) returned to 97fe2676
*** SHOWDOWN ***
97fe2676 collected $0.75 from pot
*** SUMMARY ***
Total pot $0.78 | Rake $0.03 | Jackpot $0 | Bingo $0 | Fortune $0 | Tax $0
Seat 1: 97fe2676 (button) collected ($0.75)
Seat 2: 45d33c76 (small blind) folded before Flop
Seat 3: Hero (big blind) folded before Flop
Seat 4: 929700a0 folded before Flop (didn't bet)
Seat 5: be95cbec folded before Flop (didn't bet)
Seat 6: 1a2d8f33 folded before Flop (didn't bet)


Poker Hand #RC3334367064: Hold'em No Limit ($0.02/$0.05) - 2025/02/17 20:07:52
Table 'RushAndCash592324' 6-max Seat #1 is the button
Seat 1: 207d9345 ($16.98 in chips)
Seat 2: f5592199 ($5.18 in chips)
Seat 3: af9df96 ($6.87 in chips)
Seat 4: cda72279 ($2.1 in chips)
Seat 5: Hero ($5.07 in chips)
Seat 6: d0475ba7 ($6.6 in chips)
f5592199: posts small blind $0.02
af9df96: posts big blind $0.05
*** HOLE CARDS ***
Dealt to 207d9345 
Dealt to f5592199 
Dealt to af9df96 
Dealt to cda72279 
Dealt to Hero [5h 3s]
Dealt to d0475ba7 
cda72279: raises $0.1 to $0.15
Hero: folds
d0475ba7: calls $0.15
207d9345: folds
f5592199: folds
af9df96: folds
*** FLOP *** [9d 4d 5d]
cda72279: checks
d0475ba7: checks
*** TURN *** [9d 4d 5d] [8d]
cda72279: checks
d0475ba7: checks
*** RIVER *** [9d 4d 5d 8d] [2d]
cda72279: checks
d0475ba7: checks
cda72279: shows [9c 9s] (Nine High Flush)
d0475ba7: shows [Tc Qh] (Nine High Flush)
*** SHOWDOWN ***
cda72279 collected $0.19 from pot
d0475ba7 collected $0.18 from pot
*** SUMMARY ***
Total pot $0.37 | Rake $0 | Jackpot $0 | Bingo $0 | Fortune $0 | Tax $0
Board [9d 4d 5d 8d 2d]
Seat 1: 207d9345 (button) folded before Flop (didn't bet)
Seat 2: f5592199 (small blind) folded before Flop
Seat 3: af9df96 (big blind) folded before Flop
Seat 4: cda72279 showed [9c 9s] and won ($0.19) with Nine High Flush
Seat 5: Hero folded before Flop (didn't bet)
Seat 6: d0475ba7 showed [Tc Qh] and won ($0.18) with Nine High Flush


Poker Hand #RC3334366982: Hold'em No Limit ($0.02/$0.05) - 2025/02/17 20:07:39
Table 'RushAndCash592242' 6-max Seat #1 is the button
Seat 1: 35fb946f ($5 in chips)
Seat 2: f25a1768 ($7.41 in chips)
Seat 3: 656af102 ($5 in chips)
Seat 4: 5871193e ($5.04 in chips)
Seat 5: Hero ($5 in chips)
Seat 6: 14620cce ($15.88 in chips)
f25a1768: posts small blind $0.02
656af102: posts big blind $0.05
*** HOLE CARDS ***
Dealt to 35fb946f 
Dealt to f25a1768 
Dealt to 656af102 
Dealt to 5871193e 
Dealt to Hero [Td Ac]
Dealt to 14620cce 
5871193e: folds
Hero: raises $0.05 to $0.1
14620cce: folds
35fb946f: folds
f25a1768: folds
656af102: folds
Uncalled bet ($0.05) returned to Hero
*** SHOWDOWN ***
Hero collected $0.12 from pot
*** SUMMARY ***
Total pot $0.12 | Rake $0 | Jackpot $0 | Bingo $0 | Fortune $0 | Tax $0
Seat 1: 35fb946f (button) folded before Flop (didn't bet)
Seat 2: f25a1768 (small blind) folded before Flop
Seat 3: 656af102 (big blind) folded before Flop
Seat 4: 5871193e folded before Flop (didn't bet)
Seat 5: Hero collected ($0.12)
Seat 6: 14620cce folded before Flop (didn't bet)


Poker Hand #RC3334366962: Hold'em No Limit ($0.02/$0.05) - 2025/02/17 20:07:36
Table 'RushAndCash592222' 6-max Seat #1 is the button
Seat 1: a0a16222 ($7.18 in chips)
Seat 2: fe0566a4 ($6.3 in chips)
Seat 3: 69d7bf2c ($5.3 in chips)
Seat 4: f71501ed ($6.55 in chips)
Seat 5: Hero ($5 in chips)
Seat 6: 7dd18ea7 ($6.38 in chips)
fe0566a4: posts small blind $0.02
69d7bf2c: posts big blind $0.05
*** HOLE CARDS ***
Dealt to a0a16222 
Dealt to fe0566a4 
Dealt to 69d7bf2c 
Dealt to f71501ed 
Dealt to Hero [Jh 5d]
Dealt to 7dd18ea7 
f71501ed: folds
Hero: folds
7dd18ea7: folds
a0a16222: folds
fe0566a4: raises $0.05 to $0.1
69d7bf2c: calls $0.05
*** FLOP *** [Tc Qh 9h]
fe0566a4: checks
69d7bf2c: checks
*** TURN *** [Tc Qh 9h] [4h]
fe0566a4: bets $0.15
69d7bf2c: folds
Uncalled bet ($0.15) returned to fe0566a4
*** SHOWDOWN ***
fe0566a4 collected $0.19 from pot
*** SUMMARY ***
Total pot $0.2 | Rake $0.01 | Jackpot $0 | Bingo $0 | Fortune $0 | Tax $0
Board [Tc Qh 9h 4h]
Seat 1: a0a16222 (button) folded before Flop (didn't bet)
Seat 2: fe0566a4 (small blind) won ($0.19)
Seat 3: 69d7bf2c (big blind) folded on the Turn
Seat 4: f71501ed folded before Flop (didn't bet)
Seat 5: Hero folded before Flop (didn't bet)
Seat 6: 7dd18ea7 folded before Flop (didn't bet)


Poker Hand #RC3334366518: Hold'em No Limit ($0.02/$0.05) - 2025/02/17 20:06:26
Table 'RushAndCash591778' 6-max Seat #1 is the button
Seat 1: Hero ($5 in chips)
Seat 2: 936e1bce ($5 in chips)
Seat 3: 939e7cc4 ($5.08 in chips)
Seat 4: b26ad954 ($11.51 in chips)
Seat 5: 187f2194 ($6.1 in chips)
Seat 6: f5592199 ($5 in chips)
936e1bce: posts small blind $0.02
939e7cc4: posts big blind $0.05
*** HOLE CARDS ***
Dealt to Hero [Ad Kc]
Dealt to 936e1bce 
Dealt to 939e7cc4 
Dealt to b26ad954 
Dealt to 187f2194 
Dealt to f5592199 
b26ad954: raises $0.1 to $0.15
187f2194: folds
f5592199: folds
Hero: raises $0.29 to $0.44
936e1bce: folds
939e7cc4: folds
b26ad954: calls $0.29
*** FLOP *** [2c 5h 9d]
b26ad954: checks
Hero: checks
*** TURN *** [2c 5h 9d] [3c]
b26ad954: checks
Hero: checks
*** RIVER *** [2c 5h 9d 3c] [3s]
b26ad954: bets $0.32
Hero: calls $0.32
b26ad954: shows [7c 7h] (Pair of Sevens and Pair of Treys)
Hero: shows [Ad Kc] (Pair of Treys)
*** SHOWDOWN ***
b26ad954 collected $1.45 from pot
*** SUMMARY ***
Total pot $1.59 | Rake $0.07 | Jackpot $0.07 | Bingo $0 | Fortune $0 | Tax $0
Board [2c 5h 9d 3c 3s]
Seat 1: Hero (button) showed [Ad Kc] and lost with Pair of Treys
Seat 2: 936e1bce (small blind) folded before Flop
Seat 3: 939e7cc4 (big blind) folded before Flop
Seat 4: b26ad954 showed [7c 7h] and won ($1.45) with Pair of Sevens and Pair of Treys
Seat 5: 187f2194 folded before Flop (didn't bet)
Seat 6: f5592199 folded before Flop (didn't bet)


Poker Hand #RC3334366355: Hold'em No Limit ($0.02/$0.05) - 2025/02/17 20:06:01
Table 'RushAndCash591615' 6-max Seat #1 is the button
Seat 1: d16d905f ($5 in chips)
Seat 2: Hero ($5 in chips)
Seat 3: f3fc119a ($6.91 in chips)
Seat 4: a6ca20e7 ($33.12 in chips)
Seat 5: fa499268 ($5.05 in chips)
Seat 6: a22f05f1 ($5.38 in chips)
Hero: posts small blind $0.02
f3fc119a: posts big blind $0.05
*** HOLE CARDS ***
Dealt to d16d905f 
Dealt to Hero [7d 8d]
Dealt to f3fc119a 
Dealt to a6ca20e7 
Dealt to fa499268 
Dealt to a22f05f1 
a6ca20e7: folds
fa499268: folds
a22f05f1: raises $0.06 to $0.11
d16d905f: folds
Hero: calls $0.09
f3fc119a: folds
*** FLOP *** [Tc Kd Qh]
Hero: checks
a22f05f1: checks
*** TURN *** [Tc Kd Qh] [Ac]
Hero: checks
a22f05f1: bets $0.21
Hero: folds
Uncalled bet ($0.21) returned to a22f05f1
*** SHOWDOWN ***
a22f05f1 collected $0.26 from pot
*** SUMMARY ***
Total pot $0.27 | Rake $0.01 | Jackpot $0 | Bingo $0 | Fortune $0 | Tax $0
Board [Tc Kd Qh Ac]
Seat 1: d16d905f (button) folded before Flop (didn't bet)
Seat 2: Hero (small blind) folded on the Turn
Seat 3: f3fc119a (big blind) folded before Flop
Seat 4: a6ca20e7 folded before Flop (didn't bet)
Seat 5: fa499268 folded before Flop (didn't bet)
Seat 6: a22f05f1 won ($0.26)


Poker Hand #RC3334366251: Hold'em No Limit ($0.02/$0.05) - 2025/02/17 20:05:46
Table 'RushAndCash591511' 6-max Seat #1 is the button
Seat 1: 3922b684 ($7 in chips)
Seat 2: 7dd18ea7 ($5.54 in chips)
Seat 3: Hero ($5 in chips)
Seat 4: fb6c913 ($3.27 in chips)
Seat 5: b42dd6b5 ($5.42 in chips)
Seat 6: af9eb074 ($5.35 in chips)
7dd18ea7: posts small blind $0.02
Hero: posts big blind $0.05
*** HOLE CARDS ***
Dealt to 3922b684 
Dealt to 7dd18ea7 
Dealt to Hero [5s Td]
Dealt to fb6c913 
Dealt to b42dd6b5 
Dealt to af9eb074 
fb6c913: folds
b42dd6b5: raises $0.08 to $0.13
af9eb074: folds
3922b684: folds
7dd18ea7: folds
Hero: folds
Uncalled bet ($0.08) returned to b42dd6b5
*** SHOWDOWN ***
b42dd6b5 collected $0.12 from pot
*** SUMMARY ***
Total pot $0.12 | Rake $0 | Jackpot $0 | Bingo $0 | Fortune $0 | Tax $0
Seat 1: 3922b684 (button) folded before Flop (didn't bet)
Seat 2: 7dd18ea7 (small blind) folded before Flop
Seat 3: Hero (big blind) folded before Flop
Seat 4: fb6c913 folded before Flop (didn't bet)
Seat 5: b42dd6b5 collected ($0.12)
Seat 6: af9eb074 folded before Flop (didn't bet)


