Poker Hand #RC3334603768: Hold'em No Limit ($0.02/$0.05) - 2025/02/17 21:51:40
Table 'RushAndCash639028' 6-max Seat #1 is the button
Seat 1: Hero ($11.42 in chips)
Seat 2: c3ae0b9c ($6.89 in chips)
Seat 3: 6ad786fd ($5.35 in chips)
Seat 4: c83a952b ($5.05 in chips)
Seat 5: b74983a1 ($5.42 in chips)
Seat 6: def09fe5 ($4.84 in chips)
c3ae0b9c: posts small blind $0.02
6ad786fd: posts big blind $0.05
*** HOLE CARDS ***
Dealt to Hero [Kd Jc]
Dealt to c3ae0b9c 
Dealt to 6ad786fd 
Dealt to c83a952b 
Dealt to b74983a1 
Dealt to def09fe5 
c83a952b: folds
b74983a1: raises $0.06 to $0.11
def09fe5: folds
Hero: calls $0.11
c3ae0b9c: folds
6ad786fd: folds
*** FLOP *** [Qh Th 3h]
b74983a1: checks
Hero: checks
*** TURN *** [Qh Th 3h] [7h]
b74983a1: checks
Hero: checks
*** RIVER *** [Qh Th 3h 7h] [3d]
b74983a1: checks
Hero: checks
b74983a1: shows [6s As] (Pair of Treys)
Hero: shows [Kd Jc] (Pair of Treys)
*** SHOWDOWN ***
b74983a1 collected $0.28 from pot
*** SUMMARY ***
Total pot $0.29 | Rake $0.01 | Jackpot $0 | Bingo $0 | Fortune $0 | Tax $0
Board [Qh Th 3h 7h 3d]
Seat 1: Hero (button) showed [Kd Jc] and lost with Pair of Treys
Seat 2: c3ae0b9c (small blind) folded before Flop
Seat 3: 6ad786fd (big blind) folded before Flop
Seat 4: c83a952b folded before Flop (didn't bet)
Seat 5: b74983a1 showed [6s As] and won ($0.28) with Pair of Treys
Seat 6: def09fe5 folded before Flop (didn't bet)


Poker Hand #RC3334603737: Hold'em No Limit ($0.02/$0.05) - 2025/02/17 21:51:36
Table 'RushAndCash638997' 6-max Seat #1 is the button
Seat 1: 37bc5b77 ($5.01 in chips)
Seat 2: 656af102 ($6.59 in chips)
Seat 3: 567830db ($5.84 in chips)
Seat 4: 319021b1 ($8.7 in chips)
Seat 5: Hero ($11.42 in chips)
Seat 6: abef7df7 ($5.1 in chips)
656af102: posts small blind $0.02
567830db: posts big blind $0.05
*** HOLE CARDS ***
Dealt to 37bc5b77 
Dealt to 656af102 
Dealt to 567830db 
Dealt to 319021b1 
Dealt to Hero [4s 5c]
Dealt to abef7df7 
319021b1: folds
Hero: folds
abef7df7: raises $0.07 to $0.12
37bc5b77: folds
656af102: folds
567830db: calls $0.07
*** FLOP *** [4d Qh Ks]
567830db: checks
abef7df7: bets $0.13
567830db: calls $0.13
*** TURN *** [4d Qh Ks] [7h]
567830db: checks
abef7df7: checks
*** RIVER *** [4d Qh Ks 7h] [5h]
567830db: bets $0.52
abef7df7: calls $0.52
567830db: shows [Js Ah] (Ace-High)
abef7df7: shows [Kh Ac] (Pair of Kings)
*** SHOWDOWN ***
abef7df7 collected $1.42 from pot
*** SUMMARY ***
Total pot $1.56 | Rake $0.07 | Jackpot $0.07 | Bingo $0 | Fortune $0 | Tax $0
Board [4d Qh Ks 7h 5h]
Seat 1: 37bc5b77 (button) folded before Flop (didn't bet)
Seat 2: 656af102 (small blind) folded before Flop
Seat 3: 567830db (big blind) showed [Js Ah] and lost with Ace-High
Seat 4: 319021b1 folded before Flop (didn't bet)
Seat 5: Hero folded before Flop (didn't bet)
Seat 6: abef7df7 showed [Kh Ac] and won ($1.42) with Pair of Kings


Poker Hand #RC3334603704: Hold'em No Limit ($0.02/$0.05) - 2025/02/17 21:51:32
Table 'RushAndCash638964' 6-max Seat #1 is the button
Seat 1: 9f70f94d ($5.02 in chips)
Seat 2: Hero ($11.44 in chips)
Seat 3: f6efd55a ($7.54 in chips)
Seat 4: e5dc0403 ($5 in chips)
Seat 5: c340e245 ($5 in chips)
Seat 6: 4299b97d ($5.23 in chips)
Hero: posts small blind $0.02
f6efd55a: posts big blind $0.05
*** HOLE CARDS ***
Dealt to 9f70f94d 
Dealt to Hero [9h 6d]
Dealt to f6efd55a 
Dealt to e5dc0403 
Dealt to c340e245 
Dealt to 4299b97d 
e5dc0403: folds
c340e245: folds
4299b97d: folds
9f70f94d: raises $0.05 to $0.1
Hero: folds
f6efd55a: folds
Uncalled bet ($0.05) returned to 9f70f94d
*** SHOWDOWN ***
9f70f94d collected $0.12 from pot
*** SUMMARY ***
Total pot $0.12 | Rake $0 | Jackpot $0 | Bingo $0 | Fortune $0 | Tax $0
Seat 1: 9f70f94d (button) collected ($0.12)
Seat 2: Hero (small blind) folded before Flop
Seat 3: f6efd55a (big blind) folded before Flop
Seat 4: e5dc0403 folded before Flop (didn't bet)
Seat 5: c340e245 folded before Flop (didn't bet)
Seat 6: 4299b97d folded before Flop (didn't bet)


Poker Hand #RC3334603389: Hold'em No Limit ($0.02/$0.05) - 2025/02/17 21:50:55
Table 'RushAndCash638649' 6-max Seat #1 is the button
Seat 1: 656af102 ($6.53 in chips)
Seat 2: a19fb924 ($7.81 in chips)
Seat 3: Hero ($11.1 in chips)
Seat 4: 75631992 ($5.89 in chips)
Seat 5: 32972137 ($5.2 in chips)
Seat 6: 95d29c49 ($5.47 in chips)
a19fb924: posts small blind $0.02
Hero: posts big blind $0.05
*** HOLE CARDS ***
Dealt to 656af102 
Dealt to a19fb924 
Dealt to Hero [6c Kc]
Dealt to 75631992 
Dealt to 32972137 
Dealt to 95d29c49 
75631992: folds
32972137: folds
95d29c49: raises $0.05 to $0.1
656af102: folds
a19fb924: folds
Hero: calls $0.05
*** FLOP *** [8c 2h Ac]
Hero: checks
95d29c49: bets $0.05
Hero: calls $0.05
*** TURN *** [8c 2h Ac] [Qd]
Hero: checks
95d29c49: bets $0.2
Hero: calls $0.2
*** RIVER *** [8c 2h Ac Qd] [9c]
Hero: checks
95d29c49: checks
Hero: shows [6c Kc] (Ace High Flush)
95d29c49: shows [Jh Kh] (Ace-High)
*** SHOWDOWN ***
Hero collected $0.69 from pot
*** SUMMARY ***
Total pot $0.72 | Rake $0.03 | Jackpot $0 | Bingo $0 | Fortune $0 | Tax $0
Board [8c 2h Ac Qd 9c]
Seat 1: 656af102 (button) folded before Flop (didn't bet)
Seat 2: a19fb924 (small blind) folded before Flop
Seat 3: Hero (big blind) showed [6c Kc] and won ($0.69) with Ace High Flush
Seat 4: 75631992 folded before Flop (didn't bet)
Seat 5: 32972137 folded before Flop (didn't bet)
Seat 6: 95d29c49 showed [Jh Kh] and lost with Ace-High


Poker Hand #RC3334603357: Hold'em No Limit ($0.02/$0.05) - 2025/02/17 21:50:52
Table 'RushAndCash638617' 6-max Seat #1 is the button
Seat 1: 8c3789e ($5.99 in chips)
Seat 2: 37865b6f ($6.3 in chips)
Seat 3: 927781da ($5.11 in chips)
Seat 4: e6ee1d7f ($5 in chips)
Seat 5: 4cb872a ($8.77 in chips)
Seat 6: Hero ($11.1 in chips)
37865b6f: posts small blind $0.02
927781da: posts big blind $0.05
*** HOLE CARDS ***
Dealt to 8c3789e 
Dealt to 37865b6f 
Dealt to 927781da 
Dealt to e6ee1d7f 
Dealt to 4cb872a 
Dealt to Hero [Qd 7d]
e6ee1d7f: raises $0.06 to $0.11
4cb872a: folds
Hero: folds
8c3789e: folds
37865b6f: folds
927781da: folds
Uncalled bet ($0.06) returned to e6ee1d7f
*** SHOWDOWN ***
e6ee1d7f collected $0.12 from pot
*** SUMMARY ***
Total pot $0.12 | Rake $0 | Jackpot $0 | Bingo $0 | Fortune $0 | Tax $0
Seat 1: 8c3789e (button) folded before Flop (didn't bet)
Seat 2: 37865b6f (small blind) folded before Flop
Seat 3: 927781da (big blind) folded before Flop
Seat 4: e6ee1d7f collected ($0.12)
Seat 5: 4cb872a folded before Flop (didn't bet)
Seat 6: Hero folded before Flop (didn't bet)


Poker Hand #RC3334603319: Hold'em No Limit ($0.02/$0.05) - 2025/02/17 21:50:49
Table 'RushAndCash638579' 6-max Seat #1 is the button
Seat 1: b2e12d09 ($5.62 in chips)
Seat 2: Hero ($11.12 in chips)
Seat 3: cc91d9ca ($10.17 in chips)
Seat 4: 8b825942 ($4 in chips)
Seat 5: 2dc40675 ($12.14 in chips)
Seat 6: b44e8327 ($5.32 in chips)
Hero: posts small blind $0.02
cc91d9ca: posts big blind $0.05
*** HOLE CARDS ***
Dealt to b2e12d09 
Dealt to Hero [Ts 9c]
Dealt to cc91d9ca 
Dealt to 8b825942 
Dealt to 2dc40675 
Dealt to b44e8327 
8b825942: folds
2dc40675: folds
b44e8327: folds
b2e12d09: raises $0.08 to $0.13
Hero: folds
cc91d9ca: folds
Uncalled bet ($0.08) returned to b2e12d09
*** SHOWDOWN ***
b2e12d09 collected $0.12 from pot
*** SUMMARY ***
Total pot $0.12 | Rake $0 | Jackpot $0 | Bingo $0 | Fortune $0 | Tax $0
Seat 1: b2e12d09 (button) collected ($0.12)
Seat 2: Hero (small blind) folded before Flop
Seat 3: cc91d9ca (big blind) folded before Flop
Seat 4: 8b825942 folded before Flop (didn't bet)
Seat 5: 2dc40675 folded before Flop (didn't bet)
Seat 6: b44e8327 folded before Flop (didn't bet)


Poker Hand #RC3334603285: Hold'em No Limit ($0.02/$0.05) - 2025/02/17 21:50:45
Table 'RushAndCash638545' 6-max Seat #1 is the button
Seat 1: 75631992 ($5.89 in chips)
Seat 2: ba72b338 ($5 in chips)
Seat 3: 1f960832 ($5.74 in chips)
Seat 4: ac56502f ($4.25 in chips)
Seat 5: 663d0aa ($1.61 in chips)
Seat 6: Hero ($11.12 in chips)
ba72b338: posts small blind $0.02
1f960832: posts big blind $0.05
*** HOLE CARDS ***
Dealt to 75631992 
Dealt to ba72b338 
Dealt to 1f960832 
Dealt to ac56502f 
Dealt to 663d0aa 
Dealt to Hero [7s Ts]
ac56502f: raises $0.07 to $0.12
663d0aa: folds
Hero: folds
75631992: folds
ba72b338: calls $0.1
1f960832: raises $0.63 to $0.75
ac56502f: folds
ba72b338: folds
Uncalled bet ($0.63) returned to 1f960832
*** SHOWDOWN ***
1f960832 collected $0.35 from pot
*** SUMMARY ***
Total pot $0.36 | Rake $0.01 | Jackpot $0 | Bingo $0 | Fortune $0 | Tax $0
Seat 1: 75631992 (button) folded before Flop (didn't bet)
Seat 2: ba72b338 (small blind) folded before Flop
Seat 3: 1f960832 (big blind) collected ($0.35)
Seat 4: ac56502f folded before Flop
Seat 5: 663d0aa folded before Flop (didn't bet)
Seat 6: Hero folded before Flop (didn't bet)


Poker Hand #RC3334603254: Hold'em No Limit ($0.02/$0.05) - 2025/02/17 21:50:42
Table 'RushAndCash638514' 6-max Seat #1 is the button
Seat 1: 2642904 ($6.49 in chips)
Seat 2: e89f6814 ($5.88 in chips)
Seat 3: f737c730 ($5.07 in chips)
Seat 4: 76e7cdfc ($5.84 in chips)
Seat 5: Hero ($11.12 in chips)
Seat 6: a8fd1cce ($4.02 in chips)
e89f6814: posts small blind $0.02
f737c730: posts big blind $0.05
*** HOLE CARDS ***
Dealt to 2642904 
Dealt to e89f6814 
Dealt to f737c730 
Dealt to 76e7cdfc 
Dealt to Hero [7c Tc]
Dealt to a8fd1cce 
76e7cdfc: folds
Hero: folds
a8fd1cce: folds
2642904: folds
e89f6814: raises $0.1 to $0.15
f737c730: folds
Uncalled bet ($0.1) returned to e89f6814
*** SHOWDOWN ***
e89f6814 collected $0.1 from pot
*** SUMMARY ***
Total pot $0.1 | Rake $0 | Jackpot $0 | Bingo $0 | Fortune $0 | Tax $0
Seat 1: 2642904 (button) folded before Flop (didn't bet)
Seat 2: e89f6814 (small blind) collected ($0.1)
Seat 3: f737c730 (big blind) folded before Flop
Seat 4: 76e7cdfc folded before Flop (didn't bet)
Seat 5: Hero folded before Flop (didn't bet)
Seat 6: a8fd1cce folded before Flop (didn't bet)


Poker Hand #RC3334603221: Hold'em No Limit ($0.02/$0.05) - 2025/02/17 21:50:39
Table 'RushAndCash638481' 6-max Seat #1 is the button
Seat 1: 6d5fa70b ($9.76 in chips)
Seat 2: Hero ($11.14 in chips)
Seat 3: ac97d851 ($5 in chips)
Seat 4: 704863d2 ($11.09 in chips)
Seat 5: 55e0d4fe ($8.85 in chips)
Seat 6: f0d238ad ($17.27 in chips)
Hero: posts small blind $0.02
ac97d851: posts big blind $0.05
*** HOLE CARDS ***
Dealt to 6d5fa70b 
Dealt to Hero [6h Ad]
Dealt to ac97d851 
Dealt to 704863d2 
Dealt to 55e0d4fe 
Dealt to f0d238ad 
704863d2: folds
55e0d4fe: raises $0.07 to $0.12
f0d238ad: folds
6d5fa70b: folds
Hero: folds
ac97d851: raises $0.42 to $0.54
55e0d4fe: folds
Uncalled bet ($0.42) returned to ac97d851
*** SHOWDOWN ***
ac97d851 collected $0.25 from pot
*** SUMMARY ***
Total pot $0.26 | Rake $0.01 | Jackpot $0 | Bingo $0 | Fortune $0 | Tax $0
Seat 1: 6d5fa70b (button) folded before Flop (didn't bet)
Seat 2: Hero (small blind) folded before Flop
Seat 3: ac97d851 (big blind) collected ($0.25)
Seat 4: 704863d2 folded before Flop (didn't bet)
Seat 5: 55e0d4fe folded before Flop
Seat 6: f0d238ad folded before Flop (didn't bet)


Poker Hand #RC3334603081: Hold'em No Limit ($0.02/$0.05) - 2025/02/17 21:50:25
Table 'RushAndCash638341' 6-max Seat #1 is the button
Seat 1: c27051e0 ($5.19 in chips)
Seat 2: 55e0d4fe ($8.87 in chips)
Seat 3: 3f6d99d0 ($4.71 in chips)
Seat 4: a63aa4b7 ($16.2 in chips)
Seat 5: Hero ($11.07 in chips)
Seat 6: 8cf3ad10 ($19.01 in chips)
55e0d4fe: posts small blind $0.02
3f6d99d0: posts big blind $0.05
*** HOLE CARDS ***
Dealt to c27051e0 
Dealt to 55e0d4fe 
Dealt to 3f6d99d0 
Dealt to a63aa4b7 
Dealt to Hero [Th Td]
Dealt to 8cf3ad10 
a63aa4b7: folds
Hero: raises $0.05 to $0.1
8cf3ad10: folds
c27051e0: folds
55e0d4fe: folds
3f6d99d0: folds
Uncalled bet ($0.05) returned to Hero
*** SHOWDOWN ***
Hero collected $0.12 from pot
*** SUMMARY ***
Total pot $0.12 | Rake $0 | Jackpot $0 | Bingo $0 | Fortune $0 | Tax $0
Seat 1: c27051e0 (button) folded before Flop (didn't bet)
Seat 2: 55e0d4fe (small blind) folded before Flop
Seat 3: 3f6d99d0 (big blind) folded before Flop
Seat 4: a63aa4b7 folded before Flop (didn't bet)
Seat 5: Hero collected ($0.12)
Seat 6: 8cf3ad10 folded before Flop (didn't bet)


Poker Hand #RC3334602980: Hold'em No Limit ($0.02/$0.05) - 2025/02/17 21:50:14
Table 'RushAndCash638240' 6-max Seat #1 is the button
Seat 1: be371600 ($5 in chips)
Seat 2: 1c0eec17 ($5.21 in chips)
Seat 3: Hero ($11.12 in chips)
Seat 4: 915fe0fb ($5.78 in chips)
Seat 5: 4506a4f6 ($5.76 in chips)
Seat 6: 7725a7cb ($5 in chips)
Cash Drop to Pot : total $1 
1c0eec17: posts small blind $0.02
Hero: posts big blind $0.05
*** HOLE CARDS ***
Dealt to be371600 
Dealt to 1c0eec17 
Dealt to Hero [4s 2c]
Dealt to 915fe0fb 
Dealt to 4506a4f6 
Dealt to 7725a7cb 
915fe0fb: calls $0.05
4506a4f6: folds
7725a7cb: calls $0.05
be371600: raises $4.95 to $5 and is all-in
1c0eec17: folds
Hero: folds
915fe0fb: folds
7725a7cb: folds
Uncalled bet ($4.95) returned to be371600
*** SHOWDOWN ***
be371600 collected $1.16 from pot
*** SUMMARY ***
Total pot $1.22 | Rake $0.06 | Jackpot $0 | Bingo $0 | Fortune $0 | Tax $0
Seat 1: be371600 (button) collected ($1.16)
Seat 2: 1c0eec17 (small blind) folded before Flop
Seat 3: Hero (big blind) folded before Flop
Seat 4: 915fe0fb folded before Flop
Seat 5: 4506a4f6 folded before Flop (didn't bet)
Seat 6: 7725a7cb folded before Flop


Poker Hand #RC3334602943: Hold'em No Limit ($0.02/$0.05) - 2025/02/17 21:50:10
Table 'RushAndCash638203' 6-max Seat #1 is the button
Seat 1: 273e47ba ($5.12 in chips)
Seat 2: 39109629 ($5.47 in chips)
Seat 3: Hero ($11.17 in chips)
Seat 4: c28bd986 ($5 in chips)
Seat 5: 68d3973 ($5 in chips)
Seat 6: ec2814be ($5.49 in chips)
39109629: posts small blind $0.02
Hero: posts big blind $0.05
*** HOLE CARDS ***
Dealt to 273e47ba 
Dealt to 39109629 
Dealt to Hero [4h Qc]
Dealt to c28bd986 
Dealt to 68d3973 
Dealt to ec2814be 
c28bd986: folds
68d3973: folds
ec2814be: raises $0.05 to $0.1
273e47ba: folds
39109629: folds
Hero: folds
Uncalled bet ($0.05) returned to ec2814be
*** SHOWDOWN ***
ec2814be collected $0.12 from pot
*** SUMMARY ***
Total pot $0.12 | Rake $0 | Jackpot $0 | Bingo $0 | Fortune $0 | Tax $0
Seat 1: 273e47ba (button) folded before Flop (didn't bet)
Seat 2: 39109629 (small blind) folded before Flop
Seat 3: Hero (big blind) folded before Flop
Seat 4: c28bd986 folded before Flop (didn't bet)
Seat 5: 68d3973 folded before Flop (didn't bet)
Seat 6: ec2814be collected ($0.12)


Poker Hand #RC3334602827: Hold'em No Limit ($0.02/$0.05) - 2025/02/17 21:49:59
Table 'RushAndCash638087' 6-max Seat #1 is the button
Seat 1: Hero ($11.1 in chips)
Seat 2: 81f29d91 ($6.49 in chips)
Seat 3: c565c977 ($5.17 in chips)
Seat 4: c7ebaea4 ($5 in chips)
Seat 5: 644e5259 ($4.36 in chips)
Seat 6: b58ce910 ($5.36 in chips)
81f29d91: posts small blind $0.02
c565c977: posts big blind $0.05
*** HOLE CARDS ***
Dealt to Hero [7c Ac]
Dealt to 81f29d91 
Dealt to c565c977 
Dealt to c7ebaea4 
Dealt to 644e5259 
Dealt to b58ce910 
c7ebaea4: folds
644e5259: folds
b58ce910: folds
Hero: raises $0.05 to $0.1
81f29d91: folds
c565c977: folds
Uncalled bet ($0.05) returned to Hero
*** SHOWDOWN ***
Hero collected $0.12 from pot
*** SUMMARY ***
Total pot $0.12 | Rake $0 | Jackpot $0 | Bingo $0 | Fortune $0 | Tax $0
Seat 1: Hero (button) collected ($0.12)
Seat 2: 81f29d91 (small blind) folded before Flop
Seat 3: c565c977 (big blind) folded before Flop
Seat 4: c7ebaea4 folded before Flop (didn't bet)
Seat 5: 644e5259 folded before Flop (didn't bet)
Seat 6: b58ce910 folded before Flop (didn't bet)


Poker Hand #RC3334602798: Hold'em No Limit ($0.02/$0.05) - 2025/02/17 21:49:55
Table 'RushAndCash638058' 6-max Seat #1 is the button
Seat 1: Hero ($11.1 in chips)
Seat 2: 7fe74cc5 ($15.61 in chips)
Seat 3: 820e1571 ($5.39 in chips)
Seat 4: c9f8ff1c ($5.69 in chips)
Seat 5: a9bca211 ($5.16 in chips)
Seat 6: 6f121564 ($3.2 in chips)
7fe74cc5: posts small blind $0.02
820e1571: posts big blind $0.05
*** HOLE CARDS ***
Dealt to Hero [8h Ac]
Dealt to 7fe74cc5 
Dealt to 820e1571 
Dealt to c9f8ff1c 
Dealt to a9bca211 
Dealt to 6f121564 
c9f8ff1c: folds
a9bca211: folds
6f121564: folds
Hero: folds
7fe74cc5: raises $0.06 to $0.11
820e1571: calls $0.06
*** FLOP *** [8s 7d 9c]
7fe74cc5: bets $0.08
820e1571: calls $0.08
*** TURN *** [8s 7d 9c] [5d]
7fe74cc5: bets $0.19
820e1571: folds
Uncalled bet ($0.19) returned to 7fe74cc5
*** SHOWDOWN ***
7fe74cc5 collected $0.37 from pot
*** SUMMARY ***
Total pot $0.38 | Rake $0.01 | Jackpot $0 | Bingo $0 | Fortune $0 | Tax $0
Board [8s 7d 9c 5d]
Seat 1: Hero (button) folded before Flop (didn't bet)
Seat 2: 7fe74cc5 (small blind) won ($0.37)
Seat 3: 820e1571 (big blind) folded on the Turn
Seat 4: c9f8ff1c folded before Flop (didn't bet)
Seat 5: a9bca211 folded before Flop (didn't bet)
Seat 6: 6f121564 folded before Flop (didn't bet)


Poker Hand #RC3334602765: Hold'em No Limit ($0.02/$0.05) - 2025/02/17 21:49:52
Table 'RushAndCash638025' 6-max Seat #1 is the button
Seat 1: 75a97e80 ($7.61 in chips)
Seat 2: 7b1424ef ($5.26 in chips)
Seat 3: 345ce3dc ($5.53 in chips)
Seat 4: a3876ba0 ($5 in chips)
Seat 5: Hero ($11.1 in chips)
Seat 6: db6b60a1 ($6.31 in chips)
7b1424ef: posts small blind $0.02
345ce3dc: posts big blind $0.05
*** HOLE CARDS ***
Dealt to 75a97e80 
Dealt to 7b1424ef 
Dealt to 345ce3dc 
Dealt to a3876ba0 
Dealt to Hero [4c Tc]
Dealt to db6b60a1 
a3876ba0: folds
Hero: folds
db6b60a1: folds
75a97e80: raises $0.1 to $0.15
7b1424ef: calls $0.13
345ce3dc: folds
*** FLOP *** [8h 5h 3c]
7b1424ef: checks
75a97e80: checks
*** TURN *** [8h 5h 3c] [Ah]
7b1424ef: bets $0.24
75a97e80: calls $0.24
*** RIVER *** [8h 5h 3c Ah] [Kc]
7b1424ef: checks
75a97e80: checks
7b1424ef: shows [Kh Qs] (Pair of Kings)
75a97e80: shows [Ad 9s] (Pair of Aces)
*** SHOWDOWN ***
75a97e80 collected $0.79 from pot
*** SUMMARY ***
Total pot $0.83 | Rake $0.04 | Jackpot $0 | Bingo $0 | Fortune $0 | Tax $0
Board [8h 5h 3c Ah Kc]
Seat 1: 75a97e80 (button) showed [Ad 9s] and won ($0.79) with Pair of Aces
Seat 2: 7b1424ef (small blind) showed [Kh Qs] and lost with Pair of Kings
Seat 3: 345ce3dc (big blind) folded before Flop
Seat 4: a3876ba0 folded before Flop (didn't bet)
Seat 5: Hero folded before Flop (didn't bet)
Seat 6: db6b60a1 folded before Flop (didn't bet)


Poker Hand #RC3334602735: Hold'em No Limit ($0.02/$0.05) - 2025/02/17 21:49:49
Table 'RushAndCash637995' 6-max Seat #1 is the button
Seat 1: 58065c52 ($6.03 in chips)
Seat 2: 2e8ab509 ($13.56 in chips)
Seat 3: 7aca7e93 ($5.29 in chips)
Seat 4: Hero ($11.1 in chips)
Seat 5: 1941fa92 ($4.75 in chips)
Seat 6: 7cf365ea ($11.36 in chips)
2e8ab509: posts small blind $0.02
7aca7e93: posts big blind $0.05
*** HOLE CARDS ***
Dealt to 58065c52 
Dealt to 2e8ab509 
Dealt to 7aca7e93 
Dealt to Hero [Jd 2s]
Dealt to 1941fa92 
Dealt to 7cf365ea 
Hero: folds
1941fa92: folds
7cf365ea: folds
58065c52: raises $0.08 to $0.13
2e8ab509: folds
7aca7e93: calls $0.08
*** FLOP *** [Ad Ah 2h]
7aca7e93: checks
58065c52: checks
*** TURN *** [Ad Ah 2h] [7d]
7aca7e93: checks
58065c52: checks
*** RIVER *** [Ad Ah 2h 7d] [Ac]
7aca7e93: checks
58065c52: checks
7aca7e93: shows [Ks 8c] (Three Aces)
58065c52: shows [5d Kd] (Three Aces)
*** SHOWDOWN ***
7aca7e93 collected $0.27 from pot
*** SUMMARY ***
Total pot $0.28 | Rake $0.01 | Jackpot $0 | Bingo $0 | Fortune $0 | Tax $0
Board [Ad Ah 2h 7d Ac]
Seat 1: 58065c52 (button) showed [5d Kd] and lost with Three Aces
Seat 2: 2e8ab509 (small blind) folded before Flop
Seat 3: 7aca7e93 (big blind) showed [Ks 8c] and won ($0.27) with Three Aces
Seat 4: Hero folded before Flop (didn't bet)
Seat 5: 1941fa92 folded before Flop (didn't bet)
Seat 6: 7cf365ea folded before Flop (didn't bet)


Poker Hand #RC3334602708: Hold'em No Limit ($0.02/$0.05) - 2025/02/17 21:49:46
Table 'RushAndCash637968' 6-max Seat #1 is the button
Seat 1: Hero ($11.1 in chips)
Seat 2: d46eb2ef ($5 in chips)
Seat 3: bf7ff92b ($5.91 in chips)
Seat 4: 529120ac ($3.92 in chips)
Seat 5: ac70607c ($5.41 in chips)
Seat 6: 7c8b3964 ($9.48 in chips)
d46eb2ef: posts small blind $0.02
bf7ff92b: posts big blind $0.05
*** HOLE CARDS ***
Dealt to Hero [Ac 2d]
Dealt to d46eb2ef 
Dealt to bf7ff92b 
Dealt to 529120ac 
Dealt to ac70607c 
Dealt to 7c8b3964 
529120ac: raises $0.05 to $0.1
ac70607c: folds
7c8b3964: folds
Hero: folds
d46eb2ef: folds
bf7ff92b: folds
Uncalled bet ($0.05) returned to 529120ac
*** SHOWDOWN ***
529120ac collected $0.12 from pot
*** SUMMARY ***
Total pot $0.12 | Rake $0 | Jackpot $0 | Bingo $0 | Fortune $0 | Tax $0
Seat 1: Hero (button) folded before Flop (didn't bet)
Seat 2: d46eb2ef (small blind) folded before Flop
Seat 3: bf7ff92b (big blind) folded before Flop
Seat 4: 529120ac collected ($0.12)
Seat 5: ac70607c folded before Flop (didn't bet)
Seat 6: 7c8b3964 folded before Flop (didn't bet)


Poker Hand #RC3334602671: Hold'em No Limit ($0.02/$0.05) - 2025/02/17 21:49:41
Table 'RushAndCash637931' 6-max Seat #1 is the button
Seat 1: f1fc05db ($3.97 in chips)
Seat 2: Hero ($11.12 in chips)
Seat 3: b10195a2 ($5.65 in chips)
Seat 4: 5b653011 ($4.08 in chips)
Seat 5: c24b20b9 ($17.36 in chips)
Seat 6: 7b1424ef ($5.31 in chips)
Hero: posts small blind $0.02
b10195a2: posts big blind $0.05
*** HOLE CARDS ***
Dealt to f1fc05db 
Dealt to Hero [6h Ks]
Dealt to b10195a2 
Dealt to 5b653011 
Dealt to c24b20b9 
Dealt to 7b1424ef 
5b653011: raises $0.05 to $0.1
c24b20b9: folds
7b1424ef: folds
f1fc05db: folds
Hero: folds
b10195a2: folds
Uncalled bet ($0.05) returned to 5b653011
*** SHOWDOWN ***
5b653011 collected $0.12 from pot
*** SUMMARY ***
Total pot $0.12 | Rake $0 | Jackpot $0 | Bingo $0 | Fortune $0 | Tax $0
Seat 1: f1fc05db (button) folded before Flop (didn't bet)
Seat 2: Hero (small blind) folded before Flop
Seat 3: b10195a2 (big blind) folded before Flop
Seat 4: 5b653011 collected ($0.12)
Seat 5: c24b20b9 folded before Flop (didn't bet)
Seat 6: 7b1424ef folded before Flop (didn't bet)


Poker Hand #RC3334602215: Hold'em No Limit ($0.02/$0.05) - 2025/02/17 21:48:51
Table 'RushAndCash637475' 6-max Seat #1 is the button
Seat 1: Hero ($10.48 in chips)
Seat 2: abef7df7 ($4.24 in chips)
Seat 3: 719071b8 ($7.21 in chips)
Seat 4: 9fa2589a ($4.31 in chips)
Seat 5: 5b653011 ($4.64 in chips)
Seat 6: 493727d2 ($10.63 in chips)
abef7df7: posts small blind $0.02
719071b8: posts big blind $0.05
*** HOLE CARDS ***
Dealt to Hero [Kd Kh]
Dealt to abef7df7 
Dealt to 719071b8 
Dealt to 9fa2589a 
Dealt to 5b653011 
Dealt to 493727d2 
9fa2589a: folds
5b653011: raises $0.05 to $0.1
493727d2: folds
Hero: raises $0.22 to $0.32
abef7df7: folds
719071b8: folds
5b653011: calls $0.22
*** FLOP *** [5h 3d Ah]
5b653011: checks
Hero: bets $0.24
5b653011: calls $0.24
*** TURN *** [5h 3d Ah] [7h]
5b653011: checks
Hero: checks
*** RIVER *** [5h 3d Ah 7h] [Kc]
5b653011: checks
Hero: bets $0.9
5b653011: folds
Uncalled bet ($0.9) returned to Hero
*** SHOWDOWN ***
Hero collected $1.13 from pot
*** SUMMARY ***
Total pot $1.19 | Rake $0.06 | Jackpot $0 | Bingo $0 | Fortune $0 | Tax $0
Board [5h 3d Ah 7h Kc]
Seat 1: Hero (button) won ($1.13)
Seat 2: abef7df7 (small blind) folded before Flop
Seat 3: 719071b8 (big blind) folded before Flop
Seat 4: 9fa2589a folded before Flop (didn't bet)
Seat 5: 5b653011 folded on the River
Seat 6: 493727d2 folded before Flop (didn't bet)


Poker Hand #RC3334602188: Hold'em No Limit ($0.02/$0.05) - 2025/02/17 21:48:48
Table 'RushAndCash637448' 6-max Seat #1 is the button
Seat 1: e6b639b4 ($5.07 in chips)
Seat 2: 3455b228 ($1.88 in chips)
Seat 3: Hero ($10.53 in chips)
Seat 4: b44e8327 ($5.49 in chips)
Seat 5: e0d14e10 ($5.62 in chips)
Seat 6: 7eb5dbb3 ($12.23 in chips)
3455b228: posts small blind $0.02
Hero: posts big blind $0.05
*** HOLE CARDS ***
Dealt to e6b639b4 
Dealt to 3455b228 
Dealt to Hero [9h 5s]
Dealt to b44e8327 
Dealt to e0d14e10 
Dealt to 7eb5dbb3 
b44e8327: folds
e0d14e10: folds
7eb5dbb3: folds
e6b639b4: folds
3455b228: folds
Uncalled bet ($0.03) returned to Hero
*** SHOWDOWN ***
Hero collected $0.04 from pot
*** SUMMARY ***
Total pot $0.04 | Rake $0 | Jackpot $0 | Bingo $0 | Fortune $0 | Tax $0
Seat 1: e6b639b4 (button) folded before Flop (didn't bet)
Seat 2: 3455b228 (small blind) folded before Flop
Seat 3: Hero (big blind) collected ($0.04)
Seat 4: b44e8327 folded before Flop (didn't bet)
Seat 5: e0d14e10 folded before Flop (didn't bet)
Seat 6: 7eb5dbb3 folded before Flop (didn't bet)


Poker Hand #RC3334601956: Hold'em No Limit ($0.02/$0.05) - 2025/02/17 21:48:20
Table 'RushAndCash637216' 6-max Seat #1 is the button
Seat 1: 493727d2 ($10.73 in chips)
Seat 2: 62e1fc77 ($5.06 in chips)
Seat 3: 787e1958 ($5.16 in chips)
Seat 4: ba806aaa ($1.44 in chips)
Seat 5: Hero ($10.58 in chips)
Seat 6: e76863c8 ($9.4 in chips)
Cash Drop to Pot : total $0.5 
62e1fc77: posts small blind $0.02
787e1958: posts big blind $0.05
*** HOLE CARDS ***
Dealt to 493727d2 
Dealt to 62e1fc77 
Dealt to 787e1958 
Dealt to ba806aaa 
Dealt to Hero [Jd Tc]
Dealt to e76863c8 
ba806aaa: calls $0.05
Hero: calls $0.05
e76863c8: calls $0.05
493727d2: calls $0.05
62e1fc77: raises $0.8 to $0.85
787e1958: folds
ba806aaa: folds
Hero: folds
e76863c8: calls $0.8
493727d2: folds
*** FLOP *** [2c 9s 4s]
62e1fc77: bets $1.35
e76863c8: folds
Uncalled bet ($1.35) returned to 62e1fc77
*** SHOWDOWN ***
62e1fc77 collected $2.22 from pot
*** SUMMARY ***
Total pot $2.4 | Rake $0.11 | Jackpot $0.07 | Bingo $0 | Fortune $0 | Tax $0
Board [2c 9s 4s]
Seat 1: 493727d2 (button) folded before Flop
Seat 2: 62e1fc77 (small blind) won ($2.22)
Seat 3: 787e1958 (big blind) folded before Flop
Seat 4: ba806aaa folded before Flop
Seat 5: Hero folded before Flop
Seat 6: e76863c8 folded on the Flop


Poker Hand #RC3334601926: Hold'em No Limit ($0.02/$0.05) - 2025/02/17 21:48:17
Table 'RushAndCash637186' 6-max Seat #1 is the button
Seat 1: b3362681 ($7.73 in chips)
Seat 2: d3671a33 ($5.87 in chips)
Seat 3: 3e6e7b99 ($7.1 in chips)
Seat 4: Hero ($10.58 in chips)
Seat 5: 1e300ec0 ($5.33 in chips)
Seat 6: 59238e48 ($5.21 in chips)
d3671a33: posts small blind $0.02
3e6e7b99: posts big blind $0.05
*** HOLE CARDS ***
Dealt to b3362681 
Dealt to d3671a33 
Dealt to 3e6e7b99 
Dealt to Hero [Kd Tc]
Dealt to 1e300ec0 
Dealt to 59238e48 
Hero: folds
1e300ec0: folds
59238e48: folds
b3362681: folds
d3671a33: folds
Uncalled bet ($0.03) returned to 3e6e7b99
*** SHOWDOWN ***
3e6e7b99 collected $0.04 from pot
*** SUMMARY ***
Total pot $0.04 | Rake $0 | Jackpot $0 | Bingo $0 | Fortune $0 | Tax $0
Seat 1: b3362681 (button) folded before Flop (didn't bet)
Seat 2: d3671a33 (small blind) folded before Flop
Seat 3: 3e6e7b99 (big blind) collected ($0.04)
Seat 4: Hero folded before Flop (didn't bet)
Seat 5: 1e300ec0 folded before Flop (didn't bet)
Seat 6: 59238e48 folded before Flop (didn't bet)


Poker Hand #RC3334601892: Hold'em No Limit ($0.02/$0.05) - 2025/02/17 21:48:13
Table 'RushAndCash637152' 6-max Seat #1 is the button
Seat 1: abef7df7 ($4.74 in chips)
Seat 2: Hero ($10.6 in chips)
Seat 3: c349b3b1 ($5 in chips)
Seat 4: db90e8c7 ($5 in chips)
Seat 5: 1c0eec17 ($4.74 in chips)
Seat 6: 419eb9fb ($8.75 in chips)
Hero: posts small blind $0.02
c349b3b1: posts big blind $0.05
*** HOLE CARDS ***
Dealt to abef7df7 
Dealt to Hero [3s 2c]
Dealt to c349b3b1 
Dealt to db90e8c7 
Dealt to 1c0eec17 
Dealt to 419eb9fb 
db90e8c7: folds
1c0eec17: folds
419eb9fb: folds
abef7df7: folds
Hero: folds
Uncalled bet ($0.03) returned to c349b3b1
*** SHOWDOWN ***
c349b3b1 collected $0.04 from pot
*** SUMMARY ***
Total pot $0.04 | Rake $0 | Jackpot $0 | Bingo $0 | Fortune $0 | Tax $0
Seat 1: abef7df7 (button) folded before Flop (didn't bet)
Seat 2: Hero (small blind) folded before Flop
Seat 3: c349b3b1 (big blind) collected ($0.04)
Seat 4: db90e8c7 folded before Flop (didn't bet)
Seat 5: 1c0eec17 folded before Flop (didn't bet)
Seat 6: 419eb9fb folded before Flop (didn't bet)


Poker Hand #RC3334601862: Hold'em No Limit ($0.02/$0.05) - 2025/02/17 21:48:10
Table 'RushAndCash637122' 6-max Seat #1 is the button
Seat 1: Hero ($10.6 in chips)
Seat 2: 59238e48 ($5.23 in chips)
Seat 3: aadfce52 ($7.13 in chips)
Seat 4: 8d7c8253 ($5.45 in chips)
Seat 5: 89bcbb95 ($9.48 in chips)
Seat 6: 4fa289e4 ($7.17 in chips)
59238e48: posts small blind $0.02
aadfce52: posts big blind $0.05
*** HOLE CARDS ***
Dealt to Hero [7s Jh]
Dealt to 59238e48 
Dealt to aadfce52 
Dealt to 8d7c8253 
Dealt to 89bcbb95 
Dealt to 4fa289e4 
8d7c8253: folds
89bcbb95: folds
4fa289e4: raises $0.05 to $0.1
Hero: folds
59238e48: folds
aadfce52: calls $0.05
*** FLOP *** [4s 6s 9d]
aadfce52: checks
4fa289e4: checks
*** TURN *** [4s 6s 9d] [Td]
aadfce52: checks
4fa289e4: bets $0.17
aadfce52: calls $0.17
*** RIVER *** [4s 6s 9d Td] [Kh]
aadfce52: checks
4fa289e4: checks
aadfce52: shows [9h Jc] (Pair of Nines)
4fa289e4: shows [Tc Ah] (Pair of Tens)
*** SHOWDOWN ***
4fa289e4 collected $0.54 from pot
*** SUMMARY ***
Total pot $0.56 | Rake $0.02 | Jackpot $0 | Bingo $0 | Fortune $0 | Tax $0
Board [4s 6s 9d Td Kh]
Seat 1: Hero (button) folded before Flop (didn't bet)
Seat 2: 59238e48 (small blind) folded before Flop
Seat 3: aadfce52 (big blind) showed [9h Jc] and lost with Pair of Nines
Seat 4: 8d7c8253 folded before Flop (didn't bet)
Seat 5: 89bcbb95 folded before Flop (didn't bet)
Seat 6: 4fa289e4 showed [Tc Ah] and won ($0.54) with Pair of Tens


Poker Hand #RC3334601822: Hold'em No Limit ($0.02/$0.05) - 2025/02/17 21:48:06
Table 'RushAndCash637082' 6-max Seat #1 is the button
Seat 1: 1e474bac ($5.05 in chips)
Seat 2: 3a228f55 ($5.6 in chips)
Seat 3: c543f924 ($5.37 in chips)
Seat 4: f7759ba6 ($5.5 in chips)
Seat 5: Hero ($10.6 in chips)
Seat 6: f07c337a ($4.66 in chips)
3a228f55: posts small blind $0.02
c543f924: posts big blind $0.05
*** HOLE CARDS ***
Dealt to 1e474bac 
Dealt to 3a228f55 
Dealt to c543f924 
Dealt to f7759ba6 
Dealt to Hero [8s 2h]
Dealt to f07c337a 
f7759ba6: folds
Hero: folds
f07c337a: raises $0.05 to $0.1
1e474bac: folds
3a228f55: calls $0.08
c543f924: folds
*** FLOP *** [Td Js 4d]
3a228f55: checks
f07c337a: bets $0.19
3a228f55: calls $0.19
*** TURN *** [Td Js 4d] [5h]
3a228f55: checks
f07c337a: bets $0.48
3a228f55: calls $0.48
*** RIVER *** [Td Js 4d 5h] [Tc]
3a228f55: checks
f07c337a: checks
3a228f55: shows [Kc Qs] (Pair of Tens)
f07c337a: shows [Kh Jh] (Pair of Jacks and Pair of Tens)
*** SHOWDOWN ***
f07c337a collected $1.45 from pot
*** SUMMARY ***
Total pot $1.59 | Rake $0.07 | Jackpot $0.07 | Bingo $0 | Fortune $0 | Tax $0
Board [Td Js 4d 5h Tc]
Seat 1: 1e474bac (button) folded before Flop (didn't bet)
Seat 2: 3a228f55 (small blind) showed [Kc Qs] and lost with Pair of Tens
Seat 3: c543f924 (big blind) folded before Flop
Seat 4: f7759ba6 folded before Flop (didn't bet)
Seat 5: Hero folded before Flop (didn't bet)
Seat 6: f07c337a showed [Kh Jh] and won ($1.45) with Pair of Jacks and Pair of Tens


Poker Hand #RC3334601793: Hold'em No Limit ($0.02/$0.05) - 2025/02/17 21:48:03
Table 'RushAndCash637053' 6-max Seat #1 is the button
Seat 1: 49ccafb4 ($5 in chips)
Seat 2: b2e12d09 ($5 in chips)
Seat 3: Hero ($10.58 in chips)
Seat 4: 6b09dc81 ($4.95 in chips)
Seat 5: ef00759f ($2.09 in chips)
Seat 6: 5c08f408 ($4.74 in chips)
b2e12d09: posts small blind $0.02
Hero: posts big blind $0.05
*** HOLE CARDS ***
Dealt to 49ccafb4 
Dealt to b2e12d09 
Dealt to Hero [4c 3d]
Dealt to 6b09dc81 
Dealt to ef00759f 
Dealt to 5c08f408 
6b09dc81: folds
ef00759f: folds
5c08f408: raises $0.08 to $0.13
49ccafb4: folds
b2e12d09: folds
Hero: folds
Uncalled bet ($0.08) returned to 5c08f408
*** SHOWDOWN ***
5c08f408 collected $0.12 from pot
*** SUMMARY ***
Total pot $0.12 | Rake $0 | Jackpot $0 | Bingo $0 | Fortune $0 | Tax $0
Seat 1: 49ccafb4 (button) folded before Flop (didn't bet)
Seat 2: b2e12d09 (small blind) folded before Flop
Seat 3: Hero (big blind) folded before Flop
Seat 4: 6b09dc81 folded before Flop (didn't bet)
Seat 5: ef00759f folded before Flop (didn't bet)
Seat 6: 5c08f408 collected ($0.12)


Poker Hand #RC3334601762: Hold'em No Limit ($0.02/$0.05) - 2025/02/17 21:47:59
Table 'RushAndCash637022' 6-max Seat #1 is the button
Seat 1: f84a49f0 ($5 in chips)
Seat 2: 22975d ($5 in chips)
Seat 3: Hero ($10.63 in chips)
Seat 4: 3a228f55 ($5.6 in chips)
Seat 5: 345ce3dc ($5.69 in chips)
Seat 6: 697412e ($11.8 in chips)
22975d: posts small blind $0.02
Hero: posts big blind $0.05
*** HOLE CARDS ***
Dealt to f84a49f0 
Dealt to 22975d 
Dealt to Hero [7h 2s]
Dealt to 3a228f55 
Dealt to 345ce3dc 
Dealt to 697412e 
3a228f55: folds
345ce3dc: folds
697412e: folds
f84a49f0: folds
22975d: folds
Uncalled bet ($0.03) returned to Hero
*** SHOWDOWN ***
Hero collected $0.04 from pot
*** SUMMARY ***
Total pot $0.04 | Rake $0 | Jackpot $0 | Bingo $0 | Fortune $0 | Tax $0
Seat 1: f84a49f0 (button) folded before Flop (didn't bet)
Seat 2: 22975d (small blind) folded before Flop
Seat 3: Hero (big blind) collected ($0.04)
Seat 4: 3a228f55 folded before Flop (didn't bet)
Seat 5: 345ce3dc folded before Flop (didn't bet)
Seat 6: 697412e folded before Flop (didn't bet)


Poker Hand #RC3334601727: Hold'em No Limit ($0.02/$0.05) - 2025/02/17 21:47:55
Table 'RushAndCash636987' 6-max Seat #1 is the button
Seat 1: 820e1571 ($5.63 in chips)
Seat 2: 49ccafb4 ($5 in chips)
Seat 3: a52538e ($2.18 in chips)
Seat 4: Hero ($10.63 in chips)
Seat 5: 4038bf09 ($5 in chips)
Seat 6: e16b78a9 ($5.38 in chips)
49ccafb4: posts small blind $0.02
a52538e: posts big blind $0.05
*** HOLE CARDS ***
Dealt to 820e1571 
Dealt to 49ccafb4 
Dealt to a52538e 
Dealt to Hero [6d Tc]
Dealt to 4038bf09 
Dealt to e16b78a9 
Hero: folds
4038bf09: raises $0.05 to $0.1
e16b78a9: folds
820e1571: folds
49ccafb4: folds
a52538e: calls $0.05
*** FLOP *** [2h 5c 3d]
a52538e: checks
4038bf09: bets $0.05
a52538e: calls $0.05
*** TURN *** [2h 5c 3d] [Qs]
a52538e: checks
4038bf09: bets $0.05
a52538e: calls $0.05
*** RIVER *** [2h 5c 3d Qs] [8s]
a52538e: checks
4038bf09: bets $0.05
a52538e: calls $0.05
4038bf09: shows [Ts Jd] (Queen-High)
a52538e: shows [Ah Js] (Ace-High)
*** SHOWDOWN ***
a52538e collected $0.5 from pot
*** SUMMARY ***
Total pot $0.52 | Rake $0.02 | Jackpot $0 | Bingo $0 | Fortune $0 | Tax $0
Board [2h 5c 3d Qs 8s]
Seat 1: 820e1571 (button) folded before Flop (didn't bet)
Seat 2: 49ccafb4 (small blind) folded before Flop
Seat 3: a52538e (big blind) showed [Ah Js] and won ($0.5) with Ace-High
Seat 4: Hero folded before Flop (didn't bet)
Seat 5: 4038bf09 showed [Ts Jd] and lost with Queen-High
Seat 6: e16b78a9 folded before Flop (didn't bet)


Poker Hand #RC3334601696: Hold'em No Limit ($0.02/$0.05) - 2025/02/17 21:47:52
Table 'RushAndCash636956' 6-max Seat #1 is the button
Seat 1: e16b78a9 ($5.38 in chips)
Seat 2: e0a9129e ($4.38 in chips)
Seat 3: b6ef8553 ($5.12 in chips)
Seat 4: cea9730b ($7.81 in chips)
Seat 5: Hero ($10.63 in chips)
Seat 6: 3e6e7b99 ($7.03 in chips)
e0a9129e: posts small blind $0.02
b6ef8553: posts big blind $0.05
*** HOLE CARDS ***
Dealt to e16b78a9 
Dealt to e0a9129e 
Dealt to b6ef8553 
Dealt to cea9730b 
Dealt to Hero [4d Tc]
Dealt to 3e6e7b99 
cea9730b: folds
Hero: folds
3e6e7b99: folds
e16b78a9: folds
e0a9129e: calls $0.03
b6ef8553: checks
*** FLOP *** [3d 5c Kd]
e0a9129e: checks
b6ef8553: bets $0.05
e0a9129e: folds
Uncalled bet ($0.05) returned to b6ef8553
*** SHOWDOWN ***
b6ef8553 collected $0.1 from pot
*** SUMMARY ***
Total pot $0.1 | Rake $0 | Jackpot $0 | Bingo $0 | Fortune $0 | Tax $0
Board [3d 5c Kd]
Seat 1: e16b78a9 (button) folded before Flop (didn't bet)
Seat 2: e0a9129e (small blind) folded on the Flop
Seat 3: b6ef8553 (big blind) won ($0.1)
Seat 4: cea9730b folded before Flop (didn't bet)
Seat 5: Hero folded before Flop (didn't bet)
Seat 6: 3e6e7b99 folded before Flop (didn't bet)


Poker Hand #RC3334601671: Hold'em No Limit ($0.02/$0.05) - 2025/02/17 21:47:49
Table 'RushAndCash636931' 6-max Seat #1 is the button
Seat 1: e89071f6 ($16.53 in chips)
Seat 2: 6d5fa70b ($5 in chips)
Seat 3: 787e1958 ($5.23 in chips)
Seat 4: a28ca95c ($24.21 in chips)
Seat 5: 63d14fd2 ($3.21 in chips)
Seat 6: Hero ($10.63 in chips)
6d5fa70b: posts small blind $0.02
787e1958: posts big blind $0.05
*** HOLE CARDS ***
Dealt to e89071f6 
Dealt to 6d5fa70b 
Dealt to 787e1958 
Dealt to a28ca95c 
Dealt to 63d14fd2 
Dealt to Hero [Ts 3h]
a28ca95c: folds
63d14fd2: folds
Hero: folds
e89071f6: raises $0.1 to $0.15
6d5fa70b: folds
787e1958: folds
Uncalled bet ($0.1) returned to e89071f6
*** SHOWDOWN ***
e89071f6 collected $0.12 from pot
*** SUMMARY ***
Total pot $0.12 | Rake $0 | Jackpot $0 | Bingo $0 | Fortune $0 | Tax $0
Seat 1: e89071f6 (button) collected ($0.12)
Seat 2: 6d5fa70b (small blind) folded before Flop
Seat 3: 787e1958 (big blind) folded before Flop
Seat 4: a28ca95c folded before Flop (didn't bet)
Seat 5: 63d14fd2 folded before Flop (didn't bet)
Seat 6: Hero folded before Flop (didn't bet)


Poker Hand #RC3334601505: Hold'em No Limit ($0.02/$0.05) - 2025/02/17 21:47:29
Table 'RushAndCash636765' 6-max Seat #1 is the button
Seat 1: Hero ($10.46 in chips)
Seat 2: 34df3734 ($5 in chips)
Seat 3: 15e6cce1 ($5.3 in chips)
Seat 4: 8e07c53 ($11.64 in chips)
Seat 5: af130c3f ($5 in chips)
Seat 6: df9e409d ($5.73 in chips)
34df3734: posts small blind $0.02
15e6cce1: posts big blind $0.05
*** HOLE CARDS ***
Dealt to Hero [Ad Kc]
Dealt to 34df3734 
Dealt to 15e6cce1 
Dealt to 8e07c53 
Dealt to af130c3f 
Dealt to df9e409d 
8e07c53: folds
af130c3f: raises $0.06 to $0.11
df9e409d: folds
Hero: raises $0.23 to $0.34
34df3734: folds
15e6cce1: folds
af130c3f: folds
Uncalled bet ($0.23) returned to Hero
*** SHOWDOWN ***
Hero collected $0.28 from pot
*** SUMMARY ***
Total pot $0.29 | Rake $0.01 | Jackpot $0 | Bingo $0 | Fortune $0 | Tax $0
Seat 1: Hero (button) collected ($0.28)
Seat 2: 34df3734 (small blind) folded before Flop
Seat 3: 15e6cce1 (big blind) folded before Flop
Seat 4: 8e07c53 folded before Flop (didn't bet)
Seat 5: af130c3f folded before Flop
Seat 6: df9e409d folded before Flop (didn't bet)


Poker Hand #RC3334601463: Hold'em No Limit ($0.02/$0.05) - 2025/02/17 21:47:24
Table 'RushAndCash636723' 6-max Seat #1 is the button
Seat 1: c723772e ($16.29 in chips)
Seat 2: 657ee1fc ($7.55 in chips)
Seat 3: 42fca4f9 ($13.9 in chips)
Seat 4: e297f049 ($6.13 in chips)
Seat 5: d916afa1 ($31.14 in chips)
Seat 6: Hero ($10.46 in chips)
657ee1fc: posts small blind $0.02
42fca4f9: posts big blind $0.05
*** HOLE CARDS ***
Dealt to c723772e 
Dealt to 657ee1fc 
Dealt to 42fca4f9 
Dealt to e297f049 
Dealt to d916afa1 
Dealt to Hero [6s Kc]
e297f049: folds
d916afa1: folds
Hero: folds
c723772e: raises $0.05 to $0.1
657ee1fc: folds
42fca4f9: folds
Uncalled bet ($0.05) returned to c723772e
*** SHOWDOWN ***
c723772e collected $0.12 from pot
*** SUMMARY ***
Total pot $0.12 | Rake $0 | Jackpot $0 | Bingo $0 | Fortune $0 | Tax $0
Seat 1: c723772e (button) collected ($0.12)
Seat 2: 657ee1fc (small blind) folded before Flop
Seat 3: 42fca4f9 (big blind) folded before Flop
Seat 4: e297f049 folded before Flop (didn't bet)
Seat 5: d916afa1 folded before Flop (didn't bet)
Seat 6: Hero folded before Flop (didn't bet)


Poker Hand #RC3334601438: Hold'em No Limit ($0.02/$0.05) - 2025/02/17 21:47:22
Table 'RushAndCash636698' 6-max Seat #1 is the button
Seat 1: 47b2c33d ($5.91 in chips)
Seat 2: Hero ($10.48 in chips)
Seat 3: 25f30dbe ($4.55 in chips)
Seat 4: ae4e82ab ($5.93 in chips)
Seat 5: 530477b2 ($5.11 in chips)
Seat 6: 50b3f230 ($6.24 in chips)
Hero: posts small blind $0.02
25f30dbe: posts big blind $0.05
*** HOLE CARDS ***
Dealt to 47b2c33d 
Dealt to Hero [3d Td]
Dealt to 25f30dbe 
Dealt to ae4e82ab 
Dealt to 530477b2 
Dealt to 50b3f230 
ae4e82ab: folds
530477b2: folds
50b3f230: folds
47b2c33d: folds
Hero: folds
Uncalled bet ($0.03) returned to 25f30dbe
*** SHOWDOWN ***
25f30dbe collected $0.04 from pot
*** SUMMARY ***
Total pot $0.04 | Rake $0 | Jackpot $0 | Bingo $0 | Fortune $0 | Tax $0
Seat 1: 47b2c33d (button) folded before Flop (didn't bet)
Seat 2: Hero (small blind) folded before Flop
Seat 3: 25f30dbe (big blind) collected ($0.04)
Seat 4: ae4e82ab folded before Flop (didn't bet)
Seat 5: 530477b2 folded before Flop (didn't bet)
Seat 6: 50b3f230 folded before Flop (didn't bet)


Poker Hand #RC3334601390: Hold'em No Limit ($0.02/$0.05) - 2025/02/17 21:47:17
Table 'RushAndCash636650' 6-max Seat #1 is the button
Seat 1: 3b216d1c ($7.72 in chips)
Seat 2: 5acd5e40 ($5 in chips)
Seat 3: d7a83a17 ($8.54 in chips)
Seat 4: b28541cc ($4.52 in chips)
Seat 5: 814edd7 ($6.44 in chips)
Seat 6: Hero ($10.48 in chips)
5acd5e40: posts small blind $0.02
d7a83a17: posts big blind $0.05
*** HOLE CARDS ***
Dealt to 3b216d1c 
Dealt to 5acd5e40 
Dealt to d7a83a17 
Dealt to b28541cc 
Dealt to 814edd7 
Dealt to Hero [9d Jd]
b28541cc: folds
814edd7: folds
Hero: folds
3b216d1c: raises $0.05 to $0.1
5acd5e40: folds
d7a83a17: calls $0.05
*** FLOP *** [Kd 6h 8s]
d7a83a17: checks
3b216d1c: checks
*** TURN *** [Kd 6h 8s] [Js]
d7a83a17: bets $0.16
3b216d1c: folds
Uncalled bet ($0.16) returned to d7a83a17
*** SHOWDOWN ***
d7a83a17 collected $0.21 from pot
*** SUMMARY ***
Total pot $0.22 | Rake $0.01 | Jackpot $0 | Bingo $0 | Fortune $0 | Tax $0
Board [Kd 6h 8s Js]
Seat 1: 3b216d1c (button) folded on the Turn
Seat 2: 5acd5e40 (small blind) folded before Flop
Seat 3: d7a83a17 (big blind) won ($0.21)
Seat 4: b28541cc folded before Flop (didn't bet)
Seat 5: 814edd7 folded before Flop (didn't bet)
Seat 6: Hero folded before Flop (didn't bet)


Poker Hand #RC3334601358: Hold'em No Limit ($0.02/$0.05) - 2025/02/17 21:47:13
Table 'RushAndCash636618' 6-max Seat #1 is the button
Seat 1: 4e53b23f ($5.28 in chips)
Seat 2: 92fd04c6 ($8.15 in chips)
Seat 3: Hero ($10.53 in chips)
Seat 4: 3bfcd529 ($10.37 in chips)
Seat 5: 53a8c2fd ($8.3 in chips)
Seat 6: 97942210 ($7.25 in chips)
92fd04c6: posts small blind $0.02
Hero: posts big blind $0.05
*** HOLE CARDS ***
Dealt to 4e53b23f 
Dealt to 92fd04c6 
Dealt to Hero [9c 7h]
Dealt to 3bfcd529 
Dealt to 53a8c2fd 
Dealt to 97942210 
3bfcd529: folds
53a8c2fd: raises $0.06 to $0.11
97942210: folds
4e53b23f: folds
92fd04c6: raises $0.29 to $0.4
Hero: folds
53a8c2fd: calls $0.29
*** FLOP *** [6s 2h Qs]
92fd04c6: bets $0.35
53a8c2fd: folds
Uncalled bet ($0.35) returned to 92fd04c6
*** SHOWDOWN ***
92fd04c6 collected $0.81 from pot
*** SUMMARY ***
Total pot $0.85 | Rake $0.04 | Jackpot $0 | Bingo $0 | Fortune $0 | Tax $0
Board [6s 2h Qs]
Seat 1: 4e53b23f (button) folded before Flop (didn't bet)
Seat 2: 92fd04c6 (small blind) won ($0.81)
Seat 3: Hero (big blind) folded before Flop
Seat 4: 3bfcd529 folded before Flop (didn't bet)
Seat 5: 53a8c2fd folded on the Flop
Seat 6: 97942210 folded before Flop (didn't bet)


Poker Hand #RC3334601326: Hold'em No Limit ($0.02/$0.05) - 2025/02/17 21:47:09
Table 'RushAndCash636586' 6-max Seat #1 is the button
Seat 1: 92fd04c6 ($8.15 in chips)
Seat 2: f8081566 ($7.27 in chips)
Seat 3: 53a8c2fd ($8.35 in chips)
Seat 4: fc77b046 ($12 in chips)
Seat 5: 720edd8b ($1.99 in chips)
Seat 6: Hero ($10.53 in chips)
f8081566: posts small blind $0.02
53a8c2fd: posts big blind $0.05
*** HOLE CARDS ***
Dealt to 92fd04c6 
Dealt to f8081566 
Dealt to 53a8c2fd 
Dealt to fc77b046 
Dealt to 720edd8b 
Dealt to Hero [9s Jc]
fc77b046: folds
720edd8b: raises $0.05 to $0.1
Hero: folds
92fd04c6: folds
f8081566: folds
53a8c2fd: folds
Uncalled bet ($0.05) returned to 720edd8b
*** SHOWDOWN ***
720edd8b collected $0.12 from pot
*** SUMMARY ***
Total pot $0.12 | Rake $0 | Jackpot $0 | Bingo $0 | Fortune $0 | Tax $0
Seat 1: 92fd04c6 (button) folded before Flop (didn't bet)
Seat 2: f8081566 (small blind) folded before Flop
Seat 3: 53a8c2fd (big blind) folded before Flop
Seat 4: fc77b046 folded before Flop (didn't bet)
Seat 5: 720edd8b collected ($0.12)
Seat 6: Hero folded before Flop (didn't bet)


Poker Hand #RC3334601251: Hold'em No Limit ($0.02/$0.05) - 2025/02/17 21:47:02
Table 'RushAndCash636511' 6-max Seat #1 is the button
Seat 1: Hero ($10.53 in chips)
Seat 2: c723772e ($16.24 in chips)
Seat 3: b02447b8 ($5 in chips)
Seat 4: c349b3b1 ($5 in chips)
Seat 5: 56cefdc9 ($10.77 in chips)
Seat 6: bf1b95ee ($4.58 in chips)
c723772e: posts small blind $0.02
b02447b8: posts big blind $0.05
*** HOLE CARDS ***
Dealt to Hero [Qh 9c]
Dealt to c723772e 
Dealt to b02447b8 
Dealt to c349b3b1 
Dealt to 56cefdc9 
Dealt to bf1b95ee 
c349b3b1: folds
56cefdc9: folds
bf1b95ee: folds
Hero: folds
c723772e: raises $0.05 to $0.1
b02447b8: folds
Uncalled bet ($0.05) returned to c723772e
*** SHOWDOWN ***
c723772e collected $0.1 from pot
*** SUMMARY ***
Total pot $0.1 | Rake $0 | Jackpot $0 | Bingo $0 | Fortune $0 | Tax $0
Seat 1: Hero (button) folded before Flop (didn't bet)
Seat 2: c723772e (small blind) collected ($0.1)
Seat 3: b02447b8 (big blind) folded before Flop
Seat 4: c349b3b1 folded before Flop (didn't bet)
Seat 5: 56cefdc9 folded before Flop (didn't bet)
Seat 6: bf1b95ee folded before Flop (didn't bet)


Poker Hand #RC3334601169: Hold'em No Limit ($0.02/$0.05) - 2025/02/17 21:46:53
Table 'RushAndCash636429' 6-max Seat #1 is the button
Seat 1: 39a65b3b ($5.06 in chips)
Seat 2: 89c4e71b ($5.12 in chips)
Seat 3: 1640de52 ($23.9 in chips)
Seat 4: 188c8947 ($5 in chips)
Seat 5: Hero ($10.53 in chips)
Seat 6: 34df3734 ($5.07 in chips)
89c4e71b: posts small blind $0.02
1640de52: posts big blind $0.05
*** HOLE CARDS ***
Dealt to 39a65b3b 
Dealt to 89c4e71b 
Dealt to 1640de52 
Dealt to 188c8947 
Dealt to Hero [9d 6s]
Dealt to 34df3734 
188c8947: folds
Hero: folds
34df3734: folds
39a65b3b: raises $0.07 to $0.12
89c4e71b: folds
1640de52: folds
Uncalled bet ($0.07) returned to 39a65b3b
*** SHOWDOWN ***
39a65b3b collected $0.12 from pot
*** SUMMARY ***
Total pot $0.12 | Rake $0 | Jackpot $0 | Bingo $0 | Fortune $0 | Tax $0
Seat 1: 39a65b3b (button) collected ($0.12)
Seat 2: 89c4e71b (small blind) folded before Flop
Seat 3: 1640de52 (big blind) folded before Flop
Seat 4: 188c8947 folded before Flop (didn't bet)
Seat 5: Hero folded before Flop (didn't bet)
Seat 6: 34df3734 folded before Flop (didn't bet)


Poker Hand #RC3334601139: Hold'em No Limit ($0.02/$0.05) - 2025/02/17 21:46:50
Table 'RushAndCash636399' 6-max Seat #1 is the button
Seat 1: 14d966a6 ($7.7 in chips)
Seat 2: 644e5259 ($5.18 in chips)
Seat 3: 628590b2 ($14.19 in chips)
Seat 4: Hero ($10.53 in chips)
Seat 5: c81ca578 ($5.09 in chips)
Seat 6: c565c977 ($5.33 in chips)
644e5259: posts small blind $0.02
628590b2: posts big blind $0.05
*** HOLE CARDS ***
Dealt to 14d966a6 
Dealt to 644e5259 
Dealt to 628590b2 
Dealt to Hero [3s 4s]
Dealt to c81ca578 
Dealt to c565c977 
Hero: folds
c81ca578: folds
c565c977: folds
14d966a6: raises $0.05 to $0.1
644e5259: calls $0.08
628590b2: calls $0.05
*** FLOP *** [6h Js Tc]
644e5259: bets $0.1
628590b2: folds
14d966a6: calls $0.1
*** TURN *** [6h Js Tc] [2d]
644e5259: bets $0.2
14d966a6: calls $0.2
*** RIVER *** [6h Js Tc 2d] [Ac]
644e5259: checks
14d966a6: bets $0.9
644e5259: folds
Uncalled bet ($0.9) returned to 14d966a6
*** SHOWDOWN ***
14d966a6 collected $0.86 from pot
*** SUMMARY ***
Total pot $0.9 | Rake $0.04 | Jackpot $0 | Bingo $0 | Fortune $0 | Tax $0
Board [6h Js Tc 2d Ac]
Seat 1: 14d966a6 (button) won ($0.86)
Seat 2: 644e5259 (small blind) folded on the River
Seat 3: 628590b2 (big blind) folded on the Flop
Seat 4: Hero folded before Flop (didn't bet)
Seat 5: c81ca578 folded before Flop (didn't bet)
Seat 6: c565c977 folded before Flop (didn't bet)


Poker Hand #RC3334601109: Hold'em No Limit ($0.02/$0.05) - 2025/02/17 21:46:47
Table 'RushAndCash636369' 6-max Seat #1 is the button
Seat 1: 43c437e9 ($5 in chips)
Seat 2: Hero ($10.55 in chips)
Seat 3: e20e5cfc ($6.22 in chips)
Seat 4: 869f5988 ($5.07 in chips)
Seat 5: f0600331 ($7.35 in chips)
Seat 6: 62156df3 ($7.81 in chips)
Hero: posts small blind $0.02
e20e5cfc: posts big blind $0.05
*** HOLE CARDS ***
Dealt to 43c437e9 
Dealt to Hero [4c 3s]
Dealt to e20e5cfc 
Dealt to 869f5988 
Dealt to f0600331 
Dealt to 62156df3 
869f5988: folds
f0600331: folds
62156df3: raises $0.06 to $0.11
43c437e9: folds
Hero: folds
e20e5cfc: folds
Uncalled bet ($0.06) returned to 62156df3
*** SHOWDOWN ***
62156df3 collected $0.12 from pot
*** SUMMARY ***
Total pot $0.12 | Rake $0 | Jackpot $0 | Bingo $0 | Fortune $0 | Tax $0
Seat 1: 43c437e9 (button) folded before Flop (didn't bet)
Seat 2: Hero (small blind) folded before Flop
Seat 3: e20e5cfc (big blind) folded before Flop
Seat 4: 869f5988 folded before Flop (didn't bet)
Seat 5: f0600331 folded before Flop (didn't bet)
Seat 6: 62156df3 collected ($0.12)


Poker Hand #RC3334601076: Hold'em No Limit ($0.02/$0.05) - 2025/02/17 21:46:43
Table 'RushAndCash636336' 6-max Seat #1 is the button
Seat 1: 9d687e0 ($3.61 in chips)
Seat 2: aadfce52 ($7.01 in chips)
Seat 3: b4c33f6c ($7.6 in chips)
Seat 4: 27baaa05 ($6.34 in chips)
Seat 5: fb8cc108 ($5.41 in chips)
Seat 6: Hero ($10.55 in chips)
aadfce52: posts small blind $0.02
b4c33f6c: posts big blind $0.05
*** HOLE CARDS ***
Dealt to 9d687e0 
Dealt to aadfce52 
Dealt to b4c33f6c 
Dealt to 27baaa05 
Dealt to fb8cc108 
Dealt to Hero [5d 6s]
27baaa05: folds
fb8cc108: raises $0.05 to $0.1
Hero: folds
9d687e0: folds
aadfce52: folds
b4c33f6c: folds
Uncalled bet ($0.05) returned to fb8cc108
*** SHOWDOWN ***
fb8cc108 collected $0.12 from pot
*** SUMMARY ***
Total pot $0.12 | Rake $0 | Jackpot $0 | Bingo $0 | Fortune $0 | Tax $0
Seat 1: 9d687e0 (button) folded before Flop (didn't bet)
Seat 2: aadfce52 (small blind) folded before Flop
Seat 3: b4c33f6c (big blind) folded before Flop
Seat 4: 27baaa05 folded before Flop (didn't bet)
Seat 5: fb8cc108 collected ($0.12)
Seat 6: Hero folded before Flop (didn't bet)


Poker Hand #RC3334601048: Hold'em No Limit ($0.02/$0.05) - 2025/02/17 21:46:40
Table 'RushAndCash636308' 6-max Seat #1 is the button
Seat 1: a34fb22a ($10.5 in chips)
Seat 2: 8d0bc73f ($8.13 in chips)
Seat 3: Hero ($10.6 in chips)
Seat 4: b386a385 ($5 in chips)
Seat 5: f56d4922 ($5.18 in chips)
Seat 6: c4483bd8 ($4.95 in chips)
8d0bc73f: posts small blind $0.02
Hero: posts big blind $0.05
*** HOLE CARDS ***
Dealt to a34fb22a 
Dealt to 8d0bc73f 
Dealt to Hero [5c 9c]
Dealt to b386a385 
Dealt to f56d4922 
Dealt to c4483bd8 
b386a385: raises $0.08 to $0.13
f56d4922: folds
c4483bd8: calls $0.13
a34fb22a: folds
8d0bc73f: folds
Hero: folds
*** FLOP *** [6h Jc 4c]
b386a385: bets $0.11
c4483bd8: folds
Uncalled bet ($0.11) returned to b386a385
*** SHOWDOWN ***
b386a385 collected $0.32 from pot
*** SUMMARY ***
Total pot $0.33 | Rake $0.01 | Jackpot $0 | Bingo $0 | Fortune $0 | Tax $0
Board [6h Jc 4c]
Seat 1: a34fb22a (button) folded before Flop (didn't bet)
Seat 2: 8d0bc73f (small blind) folded before Flop
Seat 3: Hero (big blind) folded before Flop
Seat 4: b386a385 won ($0.32)
Seat 5: f56d4922 folded before Flop (didn't bet)
Seat 6: c4483bd8 folded on the Flop


Poker Hand #RC3334601019: Hold'em No Limit ($0.02/$0.05) - 2025/02/17 21:46:36
Table 'RushAndCash636279' 6-max Seat #1 is the button
Seat 1: Hero ($10.6 in chips)
Seat 2: 510f8c9f ($10.83 in chips)
Seat 3: 72b3f81 ($6.03 in chips)
Seat 4: e183d966 ($6.87 in chips)
Seat 5: d3f9797 ($5.07 in chips)
Seat 6: 15fafcaa ($5.4 in chips)
510f8c9f: posts small blind $0.02
72b3f81: posts big blind $0.05
*** HOLE CARDS ***
Dealt to Hero [7c 5c]
Dealt to 510f8c9f 
Dealt to 72b3f81 
Dealt to e183d966 
Dealt to d3f9797 
Dealt to 15fafcaa 
e183d966: raises $0.1 to $0.15
d3f9797: folds
15fafcaa: folds
Hero: folds
510f8c9f: folds
72b3f81: folds
Uncalled bet ($0.1) returned to e183d966
*** SHOWDOWN ***
e183d966 collected $0.12 from pot
*** SUMMARY ***
Total pot $0.12 | Rake $0 | Jackpot $0 | Bingo $0 | Fortune $0 | Tax $0
Seat 1: Hero (button) folded before Flop (didn't bet)
Seat 2: 510f8c9f (small blind) folded before Flop
Seat 3: 72b3f81 (big blind) folded before Flop
Seat 4: e183d966 collected ($0.12)
Seat 5: d3f9797 folded before Flop (didn't bet)
Seat 6: 15fafcaa folded before Flop (didn't bet)


Poker Hand #RC3334600988: Hold'em No Limit ($0.02/$0.05) - 2025/02/17 21:46:33
Table 'RushAndCash636248' 6-max Seat #1 is the button
Seat 1: 35fb946f ($8.85 in chips)
Seat 2: Hero ($10.62 in chips)
Seat 3: b258f9f9 ($5.07 in chips)
Seat 4: a34fb22a ($10.5 in chips)
Seat 5: 116bb053 ($3.41 in chips)
Seat 6: ac140cb9 ($4.57 in chips)
Hero: posts small blind $0.02
b258f9f9: posts big blind $0.05
*** HOLE CARDS ***
Dealt to 35fb946f 
Dealt to Hero [2h Qh]
Dealt to b258f9f9 
Dealt to a34fb22a 
Dealt to 116bb053 
Dealt to ac140cb9 
a34fb22a: folds
116bb053: folds
ac140cb9: folds
35fb946f: folds
Hero: folds
Uncalled bet ($0.03) returned to b258f9f9
*** SHOWDOWN ***
b258f9f9 collected $0.04 from pot
*** SUMMARY ***
Total pot $0.04 | Rake $0 | Jackpot $0 | Bingo $0 | Fortune $0 | Tax $0
Seat 1: 35fb946f (button) folded before Flop (didn't bet)
Seat 2: Hero (small blind) folded before Flop
Seat 3: b258f9f9 (big blind) collected ($0.04)
Seat 4: a34fb22a folded before Flop (didn't bet)
Seat 5: 116bb053 folded before Flop (didn't bet)
Seat 6: ac140cb9 folded before Flop (didn't bet)


Poker Hand #RC3334600953: Hold'em No Limit ($0.02/$0.05) - 2025/02/17 21:46:29
Table 'RushAndCash636213' 6-max Seat #1 is the button
Seat 1: 89c4e71b ($5.1 in chips)
Seat 2: 5c08f408 ($5.11 in chips)
Seat 3: e183d966 ($6.92 in chips)
Seat 4: 718a09e5 ($5 in chips)
Seat 5: 62fdcc3c ($10.33 in chips)
Seat 6: Hero ($10.62 in chips)
5c08f408: posts small blind $0.02
e183d966: posts big blind $0.05
*** HOLE CARDS ***
Dealt to 89c4e71b 
Dealt to 5c08f408 
Dealt to e183d966 
Dealt to 718a09e5 
Dealt to 62fdcc3c 
Dealt to Hero [Ad 8c]
718a09e5: folds
62fdcc3c: folds
Hero: folds
89c4e71b: raises $0.07 to $0.12
5c08f408: folds
e183d966: folds
Uncalled bet ($0.07) returned to 89c4e71b
*** SHOWDOWN ***
89c4e71b collected $0.12 from pot
*** SUMMARY ***
Total pot $0.12 | Rake $0 | Jackpot $0 | Bingo $0 | Fortune $0 | Tax $0
Seat 1: 89c4e71b (button) collected ($0.12)
Seat 2: 5c08f408 (small blind) folded before Flop
Seat 3: e183d966 (big blind) folded before Flop
Seat 4: 718a09e5 folded before Flop (didn't bet)
Seat 5: 62fdcc3c folded before Flop (didn't bet)
Seat 6: Hero folded before Flop (didn't bet)


Poker Hand #RC3334600906: Hold'em No Limit ($0.02/$0.05) - 2025/02/17 21:46:24
Table 'RushAndCash636166' 6-max Seat #1 is the button
Seat 1: 787e1958 ($5.16 in chips)
Seat 2: b2069524 ($5.09 in chips)
Seat 3: 1a2d8f33 ($6.1 in chips)
Seat 4: 86fb354d ($17.47 in chips)
Seat 5: b87651f7 ($5.07 in chips)
Seat 6: Hero ($10.62 in chips)
b2069524: posts small blind $0.02
1a2d8f33: posts big blind $0.05
*** HOLE CARDS ***
Dealt to 787e1958 
Dealt to b2069524 
Dealt to 1a2d8f33 
Dealt to 86fb354d 
Dealt to b87651f7 
Dealt to Hero [9d 6c]
86fb354d: raises $0.1 to $0.15
b87651f7: folds
Hero: folds
787e1958: folds
b2069524: folds
1a2d8f33: calls $0.1
*** FLOP *** [5d 5c Tc]
1a2d8f33: checks
86fb354d: checks
*** TURN *** [5d 5c Tc] [2d]
1a2d8f33: bets $0.11
86fb354d: raises $0.41 to $0.52
1a2d8f33: calls $0.41
*** RIVER *** [5d 5c Tc 2d] [8c]
1a2d8f33: bets $1.5
86fb354d: calls $1.5
1a2d8f33: shows [8d 8s] (Eights Full over Fives)
86fb354d: shows [Ac Ts] (Pair of Tens and Pair of Fives)
*** SHOWDOWN ***
1a2d8f33 collected $4.14 from pot
*** SUMMARY ***
Total pot $4.36 | Rake $0.15 | Jackpot $0.07 | Bingo $0 | Fortune $0 | Tax $0
Board [5d 5c Tc 2d 8c]
Seat 1: 787e1958 (button) folded before Flop (didn't bet)
Seat 2: b2069524 (small blind) folded before Flop
Seat 3: 1a2d8f33 (big blind) showed [8d 8s] and won ($4.14) with Eights Full over Fives
Seat 4: 86fb354d showed [Ac Ts] and lost with Pair of Tens and Pair of Fives
Seat 5: b87651f7 folded before Flop (didn't bet)
Seat 6: Hero folded before Flop (didn't bet)


Poker Hand #RC3334600878: Hold'em No Limit ($0.02/$0.05) - 2025/02/17 21:46:20
Table 'RushAndCash636138' 6-max Seat #1 is the button
Seat 1: 86fb354d ($17.47 in chips)
Seat 2: 207d9345 ($17.38 in chips)
Seat 3: Hero ($10.67 in chips)
Seat 4: bfef046a ($8.53 in chips)
Seat 5: 9de4e6c3 ($5.75 in chips)
Seat 6: 93056ee9 ($10.72 in chips)
207d9345: posts small blind $0.02
Hero: posts big blind $0.05
*** HOLE CARDS ***
Dealt to 86fb354d 
Dealt to 207d9345 
Dealt to Hero [5s Jc]
Dealt to bfef046a 
Dealt to 9de4e6c3 
Dealt to 93056ee9 
bfef046a: folds
9de4e6c3: raises $0.05 to $0.1
93056ee9: folds
86fb354d: folds
207d9345: folds
Hero: folds
Uncalled bet ($0.05) returned to 9de4e6c3
*** SHOWDOWN ***
9de4e6c3 collected $0.12 from pot
*** SUMMARY ***
Total pot $0.12 | Rake $0 | Jackpot $0 | Bingo $0 | Fortune $0 | Tax $0
Seat 1: 86fb354d (button) folded before Flop (didn't bet)
Seat 2: 207d9345 (small blind) folded before Flop
Seat 3: Hero (big blind) folded before Flop
Seat 4: bfef046a folded before Flop (didn't bet)
Seat 5: 9de4e6c3 collected ($0.12)
Seat 6: 93056ee9 folded before Flop (didn't bet)


Poker Hand #RC3334600852: Hold'em No Limit ($0.02/$0.05) - 2025/02/17 21:46:17
Table 'RushAndCash636112' 6-max Seat #1 is the button
Seat 1: Hero ($10.67 in chips)
Seat 2: d47282a4 ($6.2 in chips)
Seat 3: f198691e ($5 in chips)
Seat 4: f9ae1394 ($5.2 in chips)
Seat 5: 42fca4f9 ($14.1 in chips)
Seat 6: 820e1571 ($5 in chips)
d47282a4: posts small blind $0.02
f198691e: posts big blind $0.05
*** HOLE CARDS ***
Dealt to Hero [3s Ts]
Dealt to d47282a4 
Dealt to f198691e 
Dealt to f9ae1394 
Dealt to 42fca4f9 
Dealt to 820e1571 
f9ae1394: raises $0.05 to $0.1
42fca4f9: folds
820e1571: folds
Hero: folds
d47282a4: folds
f198691e: folds
Uncalled bet ($0.05) returned to f9ae1394
*** SHOWDOWN ***
f9ae1394 collected $0.12 from pot
*** SUMMARY ***
Total pot $0.12 | Rake $0 | Jackpot $0 | Bingo $0 | Fortune $0 | Tax $0
Seat 1: Hero (button) folded before Flop (didn't bet)
Seat 2: d47282a4 (small blind) folded before Flop
Seat 3: f198691e (big blind) folded before Flop
Seat 4: f9ae1394 collected ($0.12)
Seat 5: 42fca4f9 folded before Flop (didn't bet)
Seat 6: 820e1571 folded before Flop (didn't bet)


Poker Hand #RC3334600825: Hold'em No Limit ($0.02/$0.05) - 2025/02/17 21:46:14
Table 'RushAndCash636085' 6-max Seat #1 is the button
Seat 1: fc77b046 ($12.07 in chips)
Seat 2: dfc02c40 ($6.02 in chips)
Seat 3: 1662188f ($5.88 in chips)
Seat 4: d58b99ca ($48.8 in chips)
Seat 5: Hero ($10.67 in chips)
Seat 6: 167e28c4 ($8.09 in chips)
dfc02c40: posts small blind $0.02
1662188f: posts big blind $0.05
*** HOLE CARDS ***
Dealt to fc77b046 
Dealt to dfc02c40 
Dealt to 1662188f 
Dealt to d58b99ca 
Dealt to Hero [4d 8d]
Dealt to 167e28c4 
d58b99ca: folds
Hero: folds
167e28c4: folds
fc77b046: folds
dfc02c40: raises $0.08 to $0.13
1662188f: folds
Uncalled bet ($0.08) returned to dfc02c40
*** SHOWDOWN ***
dfc02c40 collected $0.1 from pot
*** SUMMARY ***
Total pot $0.1 | Rake $0 | Jackpot $0 | Bingo $0 | Fortune $0 | Tax $0
Seat 1: fc77b046 (button) folded before Flop (didn't bet)
Seat 2: dfc02c40 (small blind) collected ($0.1)
Seat 3: 1662188f (big blind) folded before Flop
Seat 4: d58b99ca folded before Flop (didn't bet)
Seat 5: Hero folded before Flop (didn't bet)
Seat 6: 167e28c4 folded before Flop (didn't bet)


Poker Hand #RC3334600799: Hold'em No Limit ($0.02/$0.05) - 2025/02/17 21:46:11
Table 'RushAndCash636059' 6-max Seat #1 is the button
Seat 1: 63239640 ($2.28 in chips)
Seat 2: Hero ($10.69 in chips)
Seat 3: c9f8ff1c ($5.91 in chips)
Seat 4: 4305bf97 ($6.4 in chips)
Seat 5: 9013f95e ($10.57 in chips)
Seat 6: 9f09d482 ($11.82 in chips)
Hero: posts small blind $0.02
c9f8ff1c: posts big blind $0.05
*** HOLE CARDS ***
Dealt to 63239640 
Dealt to Hero [7d 9c]
Dealt to c9f8ff1c 
Dealt to 4305bf97 
Dealt to 9013f95e 
Dealt to 9f09d482 
4305bf97: folds
9013f95e: calls $0.05
9f09d482: folds
63239640: folds
Hero: folds
c9f8ff1c: checks
*** FLOP *** [8c Ts 6d]
c9f8ff1c: checks
9013f95e: bets $0.05
c9f8ff1c: calls $0.05
*** TURN *** [8c Ts 6d] [5s]
c9f8ff1c: checks
9013f95e: bets $0.17
c9f8ff1c: folds
Uncalled bet ($0.17) returned to 9013f95e
*** SHOWDOWN ***
9013f95e collected $0.21 from pot
*** SUMMARY ***
Total pot $0.22 | Rake $0.01 | Jackpot $0 | Bingo $0 | Fortune $0 | Tax $0
Board [8c Ts 6d 5s]
Seat 1: 63239640 (button) folded before Flop (didn't bet)
Seat 2: Hero (small blind) folded before Flop
Seat 3: c9f8ff1c (big blind) folded on the Turn
Seat 4: 4305bf97 folded before Flop (didn't bet)
Seat 5: 9013f95e won ($0.21)
Seat 6: 9f09d482 folded before Flop (didn't bet)


Poker Hand #RC3334600771: Hold'em No Limit ($0.02/$0.05) - 2025/02/17 21:46:08
Table 'RushAndCash636031' 6-max Seat #1 is the button
Seat 1: 30d19f6e ($5 in chips)
Seat 2: Hero ($10.71 in chips)
Seat 3: c9e4cf57 ($6.02 in chips)
Seat 4: 50cbaebe ($7.89 in chips)
Seat 5: c42477a8 ($5 in chips)
Seat 6: 8cef9d5b ($6.32 in chips)
Hero: posts small blind $0.02
c9e4cf57: posts big blind $0.05
*** HOLE CARDS ***
Dealt to 30d19f6e 
Dealt to Hero [6c Td]
Dealt to c9e4cf57 
Dealt to 50cbaebe 
Dealt to c42477a8 
Dealt to 8cef9d5b 
50cbaebe: folds
c42477a8: calls $0.05
8cef9d5b: folds
30d19f6e: calls $0.05
Hero: folds
c9e4cf57: checks
*** FLOP *** [3d 9c 9s]
c9e4cf57: checks
c42477a8: checks
30d19f6e: checks
*** TURN *** [3d 9c 9s] [7c]
c9e4cf57: checks
c42477a8: checks
30d19f6e: checks
*** RIVER *** [3d 9c 9s 7c] [Jh]
c9e4cf57: checks
c42477a8: bets $0.06
30d19f6e: calls $0.06
c9e4cf57: folds
c42477a8: shows [8s Ks] (Pair of Nines)
30d19f6e: shows [4h 4d] (Pair of Nines and Pair of Fours)
*** SHOWDOWN ***
30d19f6e collected $0.28 from pot
*** SUMMARY ***
Total pot $0.29 | Rake $0.01 | Jackpot $0 | Bingo $0 | Fortune $0 | Tax $0
Board [3d 9c 9s 7c Jh]
Seat 1: 30d19f6e (button) showed [4h 4d] and won ($0.28) with Pair of Nines and Pair of Fours
Seat 2: Hero (small blind) folded before Flop
Seat 3: c9e4cf57 (big blind) folded on the River
Seat 4: 50cbaebe folded before Flop (didn't bet)
Seat 5: c42477a8 showed [8s Ks] and lost with Pair of Nines
Seat 6: 8cef9d5b folded before Flop (didn't bet)


Poker Hand #RC3334600744: Hold'em No Limit ($0.02/$0.05) - 2025/02/17 21:46:04
Table 'RushAndCash636004' 6-max Seat #1 is the button
Seat 1: 5dca9e3f ($5 in chips)
Seat 2: 9436c62d ($4.95 in chips)
Seat 3: 84ffd782 ($5.68 in chips)
Seat 4: 1e474bac ($5 in chips)
Seat 5: 64b39229 ($5.09 in chips)
Seat 6: Hero ($10.71 in chips)
9436c62d: posts small blind $0.02
84ffd782: posts big blind $0.05
*** HOLE CARDS ***
Dealt to 5dca9e3f 
Dealt to 9436c62d 
Dealt to 84ffd782 
Dealt to 1e474bac 
Dealt to 64b39229 
Dealt to Hero [Kc 5h]
1e474bac: raises $0.05 to $0.1
64b39229: calls $0.1
Hero: folds
5dca9e3f: raises $0.4 to $0.5
9436c62d: folds
84ffd782: folds
1e474bac: calls $0.4
64b39229: calls $0.4
*** FLOP *** [3c 5c 8h]
1e474bac: checks
64b39229: checks
5dca9e3f: checks
*** TURN *** [3c 5c 8h] [3d]
1e474bac: checks
64b39229: bets $0.52
5dca9e3f: folds
1e474bac: folds
Uncalled bet ($0.52) returned to 64b39229
*** SHOWDOWN ***
64b39229 collected $1.43 from pot
*** SUMMARY ***
Total pot $1.57 | Rake $0.07 | Jackpot $0.07 | Bingo $0 | Fortune $0 | Tax $0
Board [3c 5c 8h 3d]
Seat 1: 5dca9e3f (button) folded on the Turn
Seat 2: 9436c62d (small blind) folded before Flop
Seat 3: 84ffd782 (big blind) folded before Flop
Seat 4: 1e474bac folded on the Turn
Seat 5: 64b39229 won ($1.43)
Seat 6: Hero folded before Flop (didn't bet)


Poker Hand #RC3334600404: Hold'em No Limit ($0.02/$0.05) - 2025/02/17 21:45:24
Table 'RushAndCash635664' 6-max Seat #1 is the button
Seat 1: 486aa946 ($4.4 in chips)
Seat 2: 46fb98 ($6.48 in chips)
Seat 3: f85679bb ($5.12 in chips)
Seat 4: Hero ($11.01 in chips)
Seat 5: ddd8fec4 ($5.28 in chips)
Seat 6: ac6c5037 ($7.2 in chips)
46fb98: posts small blind $0.02
f85679bb: posts big blind $0.05
*** HOLE CARDS ***
Dealt to 486aa946 
Dealt to 46fb98 
Dealt to f85679bb 
Dealt to Hero [7d 7h]
Dealt to ddd8fec4 
Dealt to ac6c5037 
Hero: raises $0.05 to $0.1
ddd8fec4: folds
ac6c5037: raises $0.2 to $0.3
486aa946: folds
46fb98: folds
f85679bb: folds
Hero: calls $0.2
*** FLOP *** [Tc 3s Qc]
Hero: checks
ac6c5037: bets $0.17
Hero: folds
Uncalled bet ($0.17) returned to ac6c5037
*** SHOWDOWN ***
ac6c5037 collected $0.64 from pot
*** SUMMARY ***
Total pot $0.67 | Rake $0.03 | Jackpot $0 | Bingo $0 | Fortune $0 | Tax $0
Board [Tc 3s Qc]
Seat 1: 486aa946 (button) folded before Flop (didn't bet)
Seat 2: 46fb98 (small blind) folded before Flop
Seat 3: f85679bb (big blind) folded before Flop
Seat 4: Hero folded on the Flop
Seat 5: ddd8fec4 folded before Flop (didn't bet)
Seat 6: ac6c5037 won ($0.64)


Poker Hand #RC3334600378: Hold'em No Limit ($0.02/$0.05) - 2025/02/17 21:45:21
Table 'RushAndCash635638' 6-max Seat #1 is the button
Seat 1: 911dbc6d ($2.81 in chips)
Seat 2: da5282f0 ($5.02 in chips)
Seat 3: 656af102 ($7.11 in chips)
Seat 4: c9decf4f ($5.04 in chips)
Seat 5: cf150da4 ($5.94 in chips)
Seat 6: Hero ($11.01 in chips)
da5282f0: posts small blind $0.02
656af102: posts big blind $0.05
*** HOLE CARDS ***
Dealt to 911dbc6d 
Dealt to da5282f0 
Dealt to 656af102 
Dealt to c9decf4f 
Dealt to cf150da4 
Dealt to Hero [2s 3d]
c9decf4f: folds
cf150da4: raises $0.05 to $0.1
Hero: folds
911dbc6d: raises $0.05 to $0.15
da5282f0: folds
656af102: folds
cf150da4: calls $0.05
*** FLOP *** [8h 2c As]
cf150da4: checks
911dbc6d: bets $0.19
cf150da4: folds
Uncalled bet ($0.19) returned to 911dbc6d
*** SHOWDOWN ***
911dbc6d collected $0.36 from pot
*** SUMMARY ***
Total pot $0.37 | Rake $0.01 | Jackpot $0 | Bingo $0 | Fortune $0 | Tax $0
Board [8h 2c As]
Seat 1: 911dbc6d (button) won ($0.36)
Seat 2: da5282f0 (small blind) folded before Flop
Seat 3: 656af102 (big blind) folded before Flop
Seat 4: c9decf4f folded before Flop (didn't bet)
Seat 5: cf150da4 folded on the Flop
Seat 6: Hero folded before Flop (didn't bet)


Poker Hand #RC3334600259: Hold'em No Limit ($0.02/$0.05) - 2025/02/17 21:45:08
Table 'RushAndCash635519' 6-max Seat #1 is the button
Seat 1: bfef046a ($8.34 in chips)
Seat 2: df1d9475 ($5.82 in chips)
Seat 3: Hero ($11.06 in chips)
Seat 4: a25931dc ($6.18 in chips)
Seat 5: fd4703e3 ($1.46 in chips)
Seat 6: ef7b5599 ($37.25 in chips)
df1d9475: posts small blind $0.02
Hero: posts big blind $0.05
*** HOLE CARDS ***
Dealt to bfef046a 
Dealt to df1d9475 
Dealt to Hero [Js 9h]
Dealt to a25931dc 
Dealt to fd4703e3 
Dealt to ef7b5599 
a25931dc: folds
fd4703e3: raises $0.1 to $0.15
ef7b5599: folds
bfef046a: folds
df1d9475: folds
Hero: folds
Uncalled bet ($0.1) returned to fd4703e3
*** SHOWDOWN ***
fd4703e3 collected $0.12 from pot
*** SUMMARY ***
Total pot $0.12 | Rake $0 | Jackpot $0 | Bingo $0 | Fortune $0 | Tax $0
Seat 1: bfef046a (button) folded before Flop (didn't bet)
Seat 2: df1d9475 (small blind) folded before Flop
Seat 3: Hero (big blind) folded before Flop
Seat 4: a25931dc folded before Flop (didn't bet)
Seat 5: fd4703e3 collected ($0.12)
Seat 6: ef7b5599 folded before Flop (didn't bet)


Poker Hand #RC3334600067: Hold'em No Limit ($0.02/$0.05) - 2025/02/17 21:44:47
Table 'RushAndCash635327' 6-max Seat #1 is the button
Seat 1: a25931dc ($6.02 in chips)
Seat 2: 89c4e71b ($5.07 in chips)
Seat 3: ab43c8b8 ($8.97 in chips)
Seat 4: 8cef9d5b ($5.67 in chips)
Seat 5: d3671a33 ($5.58 in chips)
Seat 6: Hero ($11.16 in chips)
89c4e71b: posts small blind $0.02
ab43c8b8: posts big blind $0.05
*** HOLE CARDS ***
Dealt to a25931dc 
Dealt to 89c4e71b 
Dealt to ab43c8b8 
Dealt to 8cef9d5b 
Dealt to d3671a33 
Dealt to Hero [Ac Jh]
8cef9d5b: folds
d3671a33: folds
Hero: raises $0.05 to $0.1
a25931dc: raises $0.21 to $0.31
89c4e71b: folds
ab43c8b8: folds
Hero: folds
Uncalled bet ($0.21) returned to a25931dc
*** SHOWDOWN ***
a25931dc collected $0.26 from pot
*** SUMMARY ***
Total pot $0.27 | Rake $0.01 | Jackpot $0 | Bingo $0 | Fortune $0 | Tax $0
Seat 1: a25931dc (button) collected ($0.26)
Seat 2: 89c4e71b (small blind) folded before Flop
Seat 3: ab43c8b8 (big blind) folded before Flop
Seat 4: 8cef9d5b folded before Flop (didn't bet)
Seat 5: d3671a33 folded before Flop (didn't bet)
Seat 6: Hero folded before Flop


Poker Hand #RC3334600006: Hold'em No Limit ($0.02/$0.05) - 2025/02/17 21:44:40
Table 'RushAndCash635266' 6-max Seat #1 is the button
Seat 1: Hero ($11.16 in chips)
Seat 2: c4483bd8 ($4.72 in chips)
Seat 3: f9ae1394 ($5 in chips)
Seat 4: 381c6d82 ($23.18 in chips)
Seat 5: cc91d9ca ($9.35 in chips)
Seat 6: 4afebef ($5.75 in chips)
c4483bd8: posts small blind $0.02
f9ae1394: posts big blind $0.05
*** HOLE CARDS ***
Dealt to Hero [2c 9c]
Dealt to c4483bd8 
Dealt to f9ae1394 
Dealt to 381c6d82 
Dealt to cc91d9ca 
Dealt to 4afebef 
381c6d82: folds
cc91d9ca: folds
4afebef: folds
Hero: folds
c4483bd8: raises $0.05 to $0.1
f9ae1394: calls $0.05
*** FLOP *** [2s 5s As]
c4483bd8: checks
f9ae1394: checks
*** TURN *** [2s 5s As] [9s]
c4483bd8: checks
f9ae1394: bets $0.1
c4483bd8: calls $0.1
*** RIVER *** [2s 5s As 9s] [Kd]
c4483bd8: checks
f9ae1394: checks
c4483bd8: shows [Tc Ks] (Ace High Flush)
f9ae1394: shows [7d Td] (Ace-High)
*** SHOWDOWN ***
c4483bd8 collected $0.38 from pot
*** SUMMARY ***
Total pot $0.4 | Rake $0.02 | Jackpot $0 | Bingo $0 | Fortune $0 | Tax $0
Board [2s 5s As 9s Kd]
Seat 1: Hero (button) folded before Flop (didn't bet)
Seat 2: c4483bd8 (small blind) showed [Tc Ks] and won ($0.38) with Ace High Flush
Seat 3: f9ae1394 (big blind) showed [7d Td] and lost with Ace-High
Seat 4: 381c6d82 folded before Flop (didn't bet)
Seat 5: cc91d9ca folded before Flop (didn't bet)
Seat 6: 4afebef folded before Flop (didn't bet)


Poker Hand #RC3334599867: Hold'em No Limit ($0.02/$0.05) - 2025/02/17 21:44:24
Table 'RushAndCash635127' 6-max Seat #1 is the button
Seat 1: Hero ($11.26 in chips)
Seat 2: ccabd9d2 ($4.51 in chips)
Seat 3: a4461af6 ($11.47 in chips)
Seat 4: 2fe6d4e9 ($5.64 in chips)
Seat 5: 89bcbb95 ($9.98 in chips)
Seat 6: f6efd55a ($9.9 in chips)
ccabd9d2: posts small blind $0.02
a4461af6: posts big blind $0.05
*** HOLE CARDS ***
Dealt to Hero [3d 3h]
Dealt to ccabd9d2 
Dealt to a4461af6 
Dealt to 2fe6d4e9 
Dealt to 89bcbb95 
Dealt to f6efd55a 
2fe6d4e9: folds
89bcbb95: folds
f6efd55a: folds
Hero: raises $0.05 to $0.1
ccabd9d2: raises $0.4 to $0.5
a4461af6: raises $0.55 to $1.05
Hero: folds
ccabd9d2: folds
Uncalled bet ($0.55) returned to a4461af6
*** SHOWDOWN ***
a4461af6 collected $1.05 from pot
*** SUMMARY ***
Total pot $1.1 | Rake $0.05 | Jackpot $0 | Bingo $0 | Fortune $0 | Tax $0
Seat 1: Hero (button) folded before Flop
Seat 2: ccabd9d2 (small blind) folded before Flop
Seat 3: a4461af6 (big blind) collected ($1.05)
Seat 4: 2fe6d4e9 folded before Flop (didn't bet)
Seat 5: 89bcbb95 folded before Flop (didn't bet)
Seat 6: f6efd55a folded before Flop (didn't bet)


Poker Hand #RC3334599841: Hold'em No Limit ($0.02/$0.05) - 2025/02/17 21:44:21
Table 'RushAndCash635101' 6-max Seat #1 is the button
Seat 1: a75d2a3b ($4.23 in chips)
Seat 2: d49c6b7d ($5 in chips)
Seat 3: 3db4c32a ($5.29 in chips)
Seat 4: cbfc1dd3 ($5 in chips)
Seat 5: 30b5f3ab ($6.3 in chips)
Seat 6: Hero ($11.26 in chips)
d49c6b7d: posts small blind $0.02
3db4c32a: posts big blind $0.05
*** HOLE CARDS ***
Dealt to a75d2a3b 
Dealt to d49c6b7d 
Dealt to 3db4c32a 
Dealt to cbfc1dd3 
Dealt to 30b5f3ab 
Dealt to Hero [9h 4s]
cbfc1dd3: raises $0.05 to $0.1
30b5f3ab: folds
Hero: folds
a75d2a3b: folds
d49c6b7d: folds
3db4c32a: folds
Uncalled bet ($0.05) returned to cbfc1dd3
*** SHOWDOWN ***
cbfc1dd3 collected $0.12 from pot
*** SUMMARY ***
Total pot $0.12 | Rake $0 | Jackpot $0 | Bingo $0 | Fortune $0 | Tax $0
Seat 1: a75d2a3b (button) folded before Flop (didn't bet)
Seat 2: d49c6b7d (small blind) folded before Flop
Seat 3: 3db4c32a (big blind) folded before Flop
Seat 4: cbfc1dd3 collected ($0.12)
Seat 5: 30b5f3ab folded before Flop (didn't bet)
Seat 6: Hero folded before Flop (didn't bet)


Poker Hand #RC3334599802: Hold'em No Limit ($0.02/$0.05) - 2025/02/17 21:44:17
Table 'RushAndCash635062' 6-max Seat #1 is the button
Seat 1: 8c3789e ($6.18 in chips)
Seat 2: c6e11d19 ($5 in chips)
Seat 3: Hero ($11.31 in chips)
Seat 4: 421a6d95 ($5.61 in chips)
Seat 5: ddd8fec4 ($5.14 in chips)
Seat 6: 46fb98 ($6.53 in chips)
c6e11d19: posts small blind $0.02
Hero: posts big blind $0.05
*** HOLE CARDS ***
Dealt to 8c3789e 
Dealt to c6e11d19 
Dealt to Hero [3d 6s]
Dealt to 421a6d95 
Dealt to ddd8fec4 
Dealt to 46fb98 
421a6d95: folds
ddd8fec4: raises $0.05 to $0.1
46fb98: folds
8c3789e: folds
c6e11d19: folds
Hero: folds
Uncalled bet ($0.05) returned to ddd8fec4
*** SHOWDOWN ***
ddd8fec4 collected $0.12 from pot
*** SUMMARY ***
Total pot $0.12 | Rake $0 | Jackpot $0 | Bingo $0 | Fortune $0 | Tax $0
Seat 1: 8c3789e (button) folded before Flop (didn't bet)
Seat 2: c6e11d19 (small blind) folded before Flop
Seat 3: Hero (big blind) folded before Flop
Seat 4: 421a6d95 folded before Flop (didn't bet)
Seat 5: ddd8fec4 collected ($0.12)
Seat 6: 46fb98 folded before Flop (didn't bet)


Poker Hand #RC3334599764: Hold'em No Limit ($0.02/$0.05) - 2025/02/17 21:44:13
Table 'RushAndCash635024' 6-max Seat #1 is the button
Seat 1: 19259657 ($5.31 in chips)
Seat 2: cef157c0 ($3.91 in chips)
Seat 3: 72b3f81 ($5.89 in chips)
Seat 4: Hero ($11.31 in chips)
Seat 5: 83b423c8 ($5.2 in chips)
Seat 6: 56cefdc9 ($10.65 in chips)
cef157c0: posts small blind $0.02
72b3f81: posts big blind $0.05
*** HOLE CARDS ***
Dealt to 19259657 
Dealt to cef157c0 
Dealt to 72b3f81 
Dealt to Hero [4s 8c]
Dealt to 83b423c8 
Dealt to 56cefdc9 
Hero: folds
83b423c8: folds
56cefdc9: folds
19259657: raises $0.08 to $0.13
cef157c0: folds
72b3f81: folds
Uncalled bet ($0.08) returned to 19259657
*** SHOWDOWN ***
19259657 collected $0.12 from pot
*** SUMMARY ***
Total pot $0.12 | Rake $0 | Jackpot $0 | Bingo $0 | Fortune $0 | Tax $0
Seat 1: 19259657 (button) collected ($0.12)
Seat 2: cef157c0 (small blind) folded before Flop
Seat 3: 72b3f81 (big blind) folded before Flop
Seat 4: Hero folded before Flop (didn't bet)
Seat 5: 83b423c8 folded before Flop (didn't bet)
Seat 6: 56cefdc9 folded before Flop (didn't bet)


Poker Hand #RC3334599714: Hold'em No Limit ($0.02/$0.05) - 2025/02/17 21:44:07
Table 'RushAndCash634974' 6-max Seat #1 is the button
Seat 1: 64b39229 ($5.3 in chips)
Seat 2: Hero ($11.33 in chips)
Seat 3: 5c980949 ($7.75 in chips)
Seat 4: d606d9 ($8.3 in chips)
Seat 5: a3b43a4c ($6.86 in chips)
Seat 6: c42477a8 ($5 in chips)
Hero: posts small blind $0.02
5c980949: posts big blind $0.05
*** HOLE CARDS ***
Dealt to 64b39229 
Dealt to Hero [Ad 4c]
Dealt to 5c980949 
Dealt to d606d9 
Dealt to a3b43a4c 
Dealt to c42477a8 
d606d9: folds
a3b43a4c: folds
c42477a8: folds
64b39229: folds
Hero: folds
Uncalled bet ($0.03) returned to 5c980949
*** SHOWDOWN ***
5c980949 collected $0.04 from pot
*** SUMMARY ***
Total pot $0.04 | Rake $0 | Jackpot $0 | Bingo $0 | Fortune $0 | Tax $0
Seat 1: 64b39229 (button) folded before Flop (didn't bet)
Seat 2: Hero (small blind) folded before Flop
Seat 3: 5c980949 (big blind) collected ($0.04)
Seat 4: d606d9 folded before Flop (didn't bet)
Seat 5: a3b43a4c folded before Flop (didn't bet)
Seat 6: c42477a8 folded before Flop (didn't bet)


Poker Hand #RC3334599686: Hold'em No Limit ($0.02/$0.05) - 2025/02/17 21:44:04
Table 'RushAndCash634946' 6-max Seat #1 is the button
Seat 1: 1e76a4d8 ($7.16 in chips)
Seat 2: e4aeeb30 ($6.09 in chips)
Seat 3: ae52b2e0 ($5.94 in chips)
Seat 4: Hero ($11.33 in chips)
Seat 5: 53a8c2fd ($9.52 in chips)
Seat 6: 56b9b8a5 ($5.42 in chips)
e4aeeb30: posts small blind $0.02
ae52b2e0: posts big blind $0.05
*** HOLE CARDS ***
Dealt to 1e76a4d8 
Dealt to e4aeeb30 
Dealt to ae52b2e0 
Dealt to Hero [4h Qs]
Dealt to 53a8c2fd 
Dealt to 56b9b8a5 
Hero: folds
53a8c2fd: raises $0.06 to $0.11
56b9b8a5: folds
1e76a4d8: folds
e4aeeb30: folds
ae52b2e0: folds
Uncalled bet ($0.06) returned to 53a8c2fd
*** SHOWDOWN ***
53a8c2fd collected $0.12 from pot
*** SUMMARY ***
Total pot $0.12 | Rake $0 | Jackpot $0 | Bingo $0 | Fortune $0 | Tax $0
Seat 1: 1e76a4d8 (button) folded before Flop (didn't bet)
Seat 2: e4aeeb30 (small blind) folded before Flop
Seat 3: ae52b2e0 (big blind) folded before Flop
Seat 4: Hero folded before Flop (didn't bet)
Seat 5: 53a8c2fd collected ($0.12)
Seat 6: 56b9b8a5 folded before Flop (didn't bet)


Poker Hand #RC3334599644: Hold'em No Limit ($0.02/$0.05) - 2025/02/17 21:44:00
Table 'RushAndCash634904' 6-max Seat #1 is the button
Seat 1: 218dd9df ($7.55 in chips)
Seat 2: 57ba5aec ($5 in chips)
Seat 3: Hero ($11.38 in chips)
Seat 4: f6f5ad07 ($5 in chips)
Seat 5: 5f0ff48e ($5.33 in chips)
Seat 6: 8f3a3c0a ($28.47 in chips)
57ba5aec: posts small blind $0.02
Hero: posts big blind $0.05
*** HOLE CARDS ***
Dealt to 218dd9df 
Dealt to 57ba5aec 
Dealt to Hero [6h 9c]
Dealt to f6f5ad07 
Dealt to 5f0ff48e 
Dealt to 8f3a3c0a 
f6f5ad07: folds
5f0ff48e: raises $0.08 to $0.13
8f3a3c0a: folds
218dd9df: folds
57ba5aec: folds
Hero: folds
Uncalled bet ($0.08) returned to 5f0ff48e
*** SHOWDOWN ***
5f0ff48e collected $0.12 from pot
*** SUMMARY ***
Total pot $0.12 | Rake $0 | Jackpot $0 | Bingo $0 | Fortune $0 | Tax $0
Seat 1: 218dd9df (button) folded before Flop (didn't bet)
Seat 2: 57ba5aec (small blind) folded before Flop
Seat 3: Hero (big blind) folded before Flop
Seat 4: f6f5ad07 folded before Flop (didn't bet)
Seat 5: 5f0ff48e collected ($0.12)
Seat 6: 8f3a3c0a folded before Flop (didn't bet)


Poker Hand #RC3334599309: Hold'em No Limit ($0.02/$0.05) - 2025/02/17 21:43:20
Table 'RushAndCash634569' 6-max Seat #1 is the button
Seat 1: 38005dc9 ($3.3 in chips)
Seat 2: 80c22e34 ($7.58 in chips)
Seat 3: 8c8bf19e ($5 in chips)
Seat 4: 81f29d91 ($5.03 in chips)
Seat 5: Hero ($11.17 in chips)
Seat 6: 8858e1f1 ($7.53 in chips)
80c22e34: posts small blind $0.02
8c8bf19e: posts big blind $0.05
*** HOLE CARDS ***
Dealt to 38005dc9 
Dealt to 80c22e34 
Dealt to 8c8bf19e 
Dealt to 81f29d91 
Dealt to Hero [Kc Ad]
Dealt to 8858e1f1 
81f29d91: folds
Hero: raises $0.05 to $0.1
8858e1f1: folds
38005dc9: folds
80c22e34: folds
8c8bf19e: calls $0.05
*** FLOP *** [3d Th Jd]
8c8bf19e: checks
Hero: checks
*** TURN *** [3d Th Jd] [8c]
8c8bf19e: bets $0.11
Hero: calls $0.11
*** RIVER *** [3d Th Jd 8c] [3s]
8c8bf19e: checks
Hero: checks
8c8bf19e: shows [6d Kd] (Pair of Treys)
Hero: shows [Kc Ad] (Pair of Treys)
*** SHOWDOWN ***
Hero collected $0.42 from pot
*** SUMMARY ***
Total pot $0.44 | Rake $0.02 | Jackpot $0 | Bingo $0 | Fortune $0 | Tax $0
Board [3d Th Jd 8c 3s]
Seat 1: 38005dc9 (button) folded before Flop (didn't bet)
Seat 2: 80c22e34 (small blind) folded before Flop
Seat 3: 8c8bf19e (big blind) showed [6d Kd] and lost with Pair of Treys
Seat 4: 81f29d91 folded before Flop (didn't bet)
Seat 5: Hero showed [Kc Ad] and won ($0.42) with Pair of Treys
Seat 6: 8858e1f1 folded before Flop (didn't bet)


Poker Hand #RC3334599287: Hold'em No Limit ($0.02/$0.05) - 2025/02/17 21:43:17
Table 'RushAndCash634547' 6-max Seat #1 is the button
Seat 1: Hero ($11.17 in chips)
Seat 2: 1606744a ($7.29 in chips)
Seat 3: b66c51bb ($5.69 in chips)
Seat 4: 22a3f0e8 ($6.72 in chips)
Seat 5: 5a37a767 ($7.65 in chips)
Seat 6: 6008538 ($3.53 in chips)
1606744a: posts small blind $0.02
b66c51bb: posts big blind $0.05
*** HOLE CARDS ***
Dealt to Hero [2s 6h]
Dealt to 1606744a 
Dealt to b66c51bb 
Dealt to 22a3f0e8 
Dealt to 5a37a767 
Dealt to 6008538 
22a3f0e8: raises $0.05 to $0.1
5a37a767: folds
6008538: folds
Hero: folds
1606744a: folds
b66c51bb: folds
Uncalled bet ($0.05) returned to 22a3f0e8
*** SHOWDOWN ***
22a3f0e8 collected $0.12 from pot
*** SUMMARY ***
Total pot $0.12 | Rake $0 | Jackpot $0 | Bingo $0 | Fortune $0 | Tax $0
Seat 1: Hero (button) folded before Flop (didn't bet)
Seat 2: 1606744a (small blind) folded before Flop
Seat 3: b66c51bb (big blind) folded before Flop
Seat 4: 22a3f0e8 collected ($0.12)
Seat 5: 5a37a767 folded before Flop (didn't bet)
Seat 6: 6008538 folded before Flop (didn't bet)


Poker Hand #RC3334599254: Hold'em No Limit ($0.02/$0.05) - 2025/02/17 21:43:13
Table 'RushAndCash634514' 6-max Seat #1 is the button
Seat 1: 94cb065d ($9.7 in chips)
Seat 2: c723772e ($15.66 in chips)
Seat 3: b9b43bc0 ($5.19 in chips)
Seat 4: a3b43a4c ($6.76 in chips)
Seat 5: Hero ($11.17 in chips)
Seat 6: 5e2a2694 ($5.09 in chips)
c723772e: posts small blind $0.02
b9b43bc0: posts big blind $0.05
*** HOLE CARDS ***
Dealt to 94cb065d 
Dealt to c723772e 
Dealt to b9b43bc0 
Dealt to a3b43a4c 
Dealt to Hero [Qh 4s]
Dealt to 5e2a2694 
a3b43a4c: folds
Hero: folds
5e2a2694: folds
94cb065d: folds
c723772e: folds
Uncalled bet ($0.03) returned to b9b43bc0
*** SHOWDOWN ***
b9b43bc0 collected $0.04 from pot
*** SUMMARY ***
Total pot $0.04 | Rake $0 | Jackpot $0 | Bingo $0 | Fortune $0 | Tax $0
Seat 1: 94cb065d (button) folded before Flop (didn't bet)
Seat 2: c723772e (small blind) folded before Flop
Seat 3: b9b43bc0 (big blind) collected ($0.04)
Seat 4: a3b43a4c folded before Flop (didn't bet)
Seat 5: Hero folded before Flop (didn't bet)
Seat 6: 5e2a2694 folded before Flop (didn't bet)


Poker Hand #RC3334599227: Hold'em No Limit ($0.02/$0.05) - 2025/02/17 21:43:10
Table 'RushAndCash634487' 6-max Seat #1 is the button
Seat 1: 4e3c3196 ($31.62 in chips)
Seat 2: Hero ($11.19 in chips)
Seat 3: 5f1cdd27 ($6.43 in chips)
Seat 4: efee9c46 ($5.32 in chips)
Seat 5: 4de437bd ($3.61 in chips)
Seat 6: b00277eb ($5 in chips)
Hero: posts small blind $0.02
5f1cdd27: posts big blind $0.05
*** HOLE CARDS ***
Dealt to 4e3c3196 
Dealt to Hero [6s Jd]
Dealt to 5f1cdd27 
Dealt to efee9c46 
Dealt to 4de437bd 
Dealt to b00277eb 
efee9c46: folds
4de437bd: folds
b00277eb: folds
4e3c3196: folds
Hero: folds
Uncalled bet ($0.03) returned to 5f1cdd27
*** SHOWDOWN ***
5f1cdd27 collected $0.04 from pot
*** SUMMARY ***
Total pot $0.04 | Rake $0 | Jackpot $0 | Bingo $0 | Fortune $0 | Tax $0
Seat 1: 4e3c3196 (button) folded before Flop (didn't bet)
Seat 2: Hero (small blind) folded before Flop
Seat 3: 5f1cdd27 (big blind) collected ($0.04)
Seat 4: efee9c46 folded before Flop (didn't bet)
Seat 5: 4de437bd folded before Flop (didn't bet)
Seat 6: b00277eb folded before Flop (didn't bet)


Poker Hand #RC3334599200: Hold'em No Limit ($0.02/$0.05) - 2025/02/17 21:43:07
Table 'RushAndCash634460' 6-max Seat #1 is the button
Seat 1: 81b0c107 ($7.46 in chips)
Seat 2: fd236f26 ($5.75 in chips)
Seat 3: 9b2f2428 ($5.07 in chips)
Seat 4: dfc02c40 ($5.85 in chips)
Seat 5: Hero ($11.19 in chips)
Seat 6: ff01bdba ($10.47 in chips)
fd236f26: posts small blind $0.02
9b2f2428: posts big blind $0.05
*** HOLE CARDS ***
Dealt to 81b0c107 
Dealt to fd236f26 
Dealt to 9b2f2428 
Dealt to dfc02c40 
Dealt to Hero [Kh 3c]
Dealt to ff01bdba 
dfc02c40: folds
Hero: folds
ff01bdba: folds
81b0c107: raises $0.06 to $0.11
fd236f26: folds
9b2f2428: calls $0.06
*** FLOP *** [4c 9d 2s]
9b2f2428: checks
81b0c107: checks
*** TURN *** [4c 9d 2s] [Ah]
9b2f2428: bets $0.17
81b0c107: calls $0.17
*** RIVER *** [4c 9d 2s Ah] [6s]
9b2f2428: checks
81b0c107: bets $0.7
9b2f2428: folds
Uncalled bet ($0.7) returned to 81b0c107
*** SHOWDOWN ***
81b0c107 collected $0.56 from pot
*** SUMMARY ***
Total pot $0.58 | Rake $0.02 | Jackpot $0 | Bingo $0 | Fortune $0 | Tax $0
Board [4c 9d 2s Ah 6s]
Seat 1: 81b0c107 (button) won ($0.56)
Seat 2: fd236f26 (small blind) folded before Flop
Seat 3: 9b2f2428 (big blind) folded on the River
Seat 4: dfc02c40 folded before Flop (didn't bet)
Seat 5: Hero folded before Flop (didn't bet)
Seat 6: ff01bdba folded before Flop (didn't bet)


Poker Hand #RC3334599162: Hold'em No Limit ($0.02/$0.05) - 2025/02/17 21:43:02
Table 'RushAndCash634422' 6-max Seat #1 is the button
Seat 1: c59158f3 ($5.88 in chips)
Seat 2: 319021b1 ($5.09 in chips)
Seat 3: 1b6c31ec ($10 in chips)
Seat 4: Hero ($11.19 in chips)
Seat 5: fa7bb2c5 ($8.55 in chips)
Seat 6: 718a09e5 ($5 in chips)
319021b1: posts small blind $0.02
1b6c31ec: posts big blind $0.05
*** HOLE CARDS ***
Dealt to c59158f3 
Dealt to 319021b1 
Dealt to 1b6c31ec 
Dealt to Hero [6c 7s]
Dealt to fa7bb2c5 
Dealt to 718a09e5 
Hero: folds
fa7bb2c5: folds
718a09e5: folds
c59158f3: folds
319021b1: folds
Uncalled bet ($0.03) returned to 1b6c31ec
*** SHOWDOWN ***
1b6c31ec collected $0.04 from pot
*** SUMMARY ***
Total pot $0.04 | Rake $0 | Jackpot $0 | Bingo $0 | Fortune $0 | Tax $0
Seat 1: c59158f3 (button) folded before Flop (didn't bet)
Seat 2: 319021b1 (small blind) folded before Flop
Seat 3: 1b6c31ec (big blind) collected ($0.04)
Seat 4: Hero folded before Flop (didn't bet)
Seat 5: fa7bb2c5 folded before Flop (didn't bet)
Seat 6: 718a09e5 folded before Flop (didn't bet)


Poker Hand #RC3334599121: Hold'em No Limit ($0.02/$0.05) - 2025/02/17 21:42:57
Table 'RushAndCash634381' 6-max Seat #1 is the button
Seat 1: 8858e1f1 ($7.48 in chips)
Seat 2: 598d859f ($15.79 in chips)
Seat 3: c723772e ($15.71 in chips)
Seat 4: Hero ($11.19 in chips)
Seat 5: d58b99ca ($34.87 in chips)
Seat 6: b182414a ($4.61 in chips)
598d859f: posts small blind $0.02
c723772e: posts big blind $0.05
*** HOLE CARDS ***
Dealt to 8858e1f1 
Dealt to 598d859f 
Dealt to c723772e 
Dealt to Hero [Qs 5s]
Dealt to d58b99ca 
Dealt to b182414a 
Hero: folds
d58b99ca: folds
b182414a: folds
8858e1f1: raises $0.06 to $0.11
598d859f: folds
c723772e: folds
Uncalled bet ($0.06) returned to 8858e1f1
*** SHOWDOWN ***
8858e1f1 collected $0.12 from pot
*** SUMMARY ***
Total pot $0.12 | Rake $0 | Jackpot $0 | Bingo $0 | Fortune $0 | Tax $0
Seat 1: 8858e1f1 (button) collected ($0.12)
Seat 2: 598d859f (small blind) folded before Flop
Seat 3: c723772e (big blind) folded before Flop
Seat 4: Hero folded before Flop (didn't bet)
Seat 5: d58b99ca folded before Flop (didn't bet)
Seat 6: b182414a folded before Flop (didn't bet)


Poker Hand #RC3334598572: Hold'em No Limit ($0.02/$0.05) - 2025/02/17 21:41:52
Table 'RushAndCash633832' 6-max Seat #1 is the button
Seat 1: Hero ($14.35 in chips)
Seat 2: 7615146e ($5.39 in chips)
Seat 3: 417901d6 ($6.21 in chips)
Seat 4: 8b7080d0 ($5.98 in chips)
Seat 5: d58b99ca ($31.74 in chips)
Seat 6: 44527b96 ($7.46 in chips)
7615146e: posts small blind $0.02
417901d6: posts big blind $0.05
*** HOLE CARDS ***
Dealt to Hero [Kd Ad]
Dealt to 7615146e 
Dealt to 417901d6 
Dealt to 8b7080d0 
Dealt to d58b99ca 
Dealt to 44527b96 
8b7080d0: folds
d58b99ca: raises $0.07 to $0.12
44527b96: calls $0.12
Hero: raises $0.54 to $0.66
7615146e: folds
417901d6: folds
d58b99ca: raises $0.64 to $1.3
44527b96: folds
Hero: calls $0.64
*** FLOP *** [Ts 9d Jd]
d58b99ca: bets $0.56
Hero: calls $0.56
*** TURN *** [Ts 9d Jd] [7c]
d58b99ca: checks
Hero: bets $1.3
d58b99ca: calls $1.3
*** RIVER *** [Ts 9d Jd 7c] [4h]
d58b99ca: checks
Hero: checks
d58b99ca: shows [Qh Qs] (Pair of Queens)
Hero: shows [Kd Ad] (Ace-High)
*** SHOWDOWN ***
d58b99ca collected $6.29 from pot
*** SUMMARY ***
Total pot $6.51 | Rake $0.15 | Jackpot $0.07 | Bingo $0 | Fortune $0 | Tax $0
Board [Ts 9d Jd 7c 4h]
Seat 1: Hero (button) showed [Kd Ad] and lost with Ace-High
Seat 2: 7615146e (small blind) folded before Flop
Seat 3: 417901d6 (big blind) folded before Flop
Seat 4: 8b7080d0 folded before Flop (didn't bet)
Seat 5: d58b99ca showed [Qh Qs] and won ($6.29) with Pair of Queens
Seat 6: 44527b96 folded before Flop


Poker Hand #RC3334598292: Hold'em No Limit ($0.02/$0.05) - 2025/02/17 21:41:19
Table 'RushAndCash633552' 6-max Seat #1 is the button
Seat 1: edbb0bb6 ($6.07 in chips)
Seat 2: fd055f75 ($5.63 in chips)
Seat 3: Hero ($14.45 in chips)
Seat 4: 656af102 ($7 in chips)
Seat 5: 8507bdad ($9.47 in chips)
Seat 6: 35fb946f ($8.83 in chips)
fd055f75: posts small blind $0.02
Hero: posts big blind $0.05
*** HOLE CARDS ***
Dealt to edbb0bb6 
Dealt to fd055f75 
Dealt to Hero [Ad 4d]
Dealt to 656af102 
Dealt to 8507bdad 
Dealt to 35fb946f 
656af102: folds
8507bdad: raises $0.05 to $0.1
35fb946f: folds
edbb0bb6: folds
fd055f75: folds
Hero: calls $0.05
*** FLOP *** [Jc 8c Td]
Hero: checks
8507bdad: checks
*** TURN *** [Jc 8c Td] [Qc]
Hero: checks
8507bdad: checks
*** RIVER *** [Jc 8c Td Qc] [8d]
Hero: checks
8507bdad: checks
Hero: shows [Ad 4d] (Pair of Eights)
8507bdad: shows [6c 6s] (Pair of Eights and Pair of Sixes)
*** SHOWDOWN ***
8507bdad collected $0.21 from pot
*** SUMMARY ***
Total pot $0.22 | Rake $0.01 | Jackpot $0 | Bingo $0 | Fortune $0 | Tax $0
Board [Jc 8c Td Qc 8d]
Seat 1: edbb0bb6 (button) folded before Flop (didn't bet)
Seat 2: fd055f75 (small blind) folded before Flop
Seat 3: Hero (big blind) showed [Ad 4d] and lost with Pair of Eights
Seat 4: 656af102 folded before Flop (didn't bet)
Seat 5: 8507bdad showed [6c 6s] and won ($0.21) with Pair of Eights and Pair of Sixes
Seat 6: 35fb946f folded before Flop (didn't bet)


Poker Hand #RC3334598150: Hold'em No Limit ($0.02/$0.05) - 2025/02/17 21:41:04
Table 'RushAndCash633410' 6-max Seat #1 is the button
Seat 1: 110fdc96 ($5 in chips)
Seat 2: 92fa3d91 ($6.97 in chips)
Seat 3: bcb971d3 ($6.21 in chips)
Seat 4: Hero ($14.55 in chips)
Seat 5: 7b0814a4 ($4.38 in chips)
Seat 6: d037279c ($6.98 in chips)
92fa3d91: posts small blind $0.02
bcb971d3: posts big blind $0.05
*** HOLE CARDS ***
Dealt to 110fdc96 
Dealt to 92fa3d91 
Dealt to bcb971d3 
Dealt to Hero [Tc Ac]
Dealt to 7b0814a4 
Dealt to d037279c 
Hero: raises $0.05 to $0.1
7b0814a4: calls $0.1
d037279c: folds
110fdc96: raises $0.45 to $0.55
92fa3d91: folds
bcb971d3: folds
Hero: folds
7b0814a4: folds
Uncalled bet ($0.45) returned to 110fdc96
*** SHOWDOWN ***
110fdc96 collected $0.36 from pot
*** SUMMARY ***
Total pot $0.37 | Rake $0.01 | Jackpot $0 | Bingo $0 | Fortune $0 | Tax $0
Seat 1: 110fdc96 (button) collected ($0.36)
Seat 2: 92fa3d91 (small blind) folded before Flop
Seat 3: bcb971d3 (big blind) folded before Flop
Seat 4: Hero folded before Flop
Seat 5: 7b0814a4 folded before Flop
Seat 6: d037279c folded before Flop (didn't bet)


Poker Hand #RC3334597808: Hold'em No Limit ($0.02/$0.05) - 2025/02/17 21:40:25
Table 'RushAndCash633068' 6-max Seat #1 is the button
Seat 1: d47282a4 ($6.55 in chips)
Seat 2: Hero ($14.75 in chips)
Seat 3: 2b8c1076 ($7.21 in chips)
Seat 4: 83b423c8 ($5 in chips)
Seat 5: 92fa3d91 ($6.74 in chips)
Seat 6: b74983a1 ($6.42 in chips)
Hero: posts small blind $0.02
2b8c1076: posts big blind $0.05
*** HOLE CARDS ***
Dealt to d47282a4 
Dealt to Hero [Qs Kc]
Dealt to 2b8c1076 
Dealt to 83b423c8 
Dealt to 92fa3d91 
Dealt to b74983a1 
83b423c8: folds
92fa3d91: raises $0.07 to $0.12
b74983a1: folds
d47282a4: folds
Hero: calls $0.1
2b8c1076: folds
*** FLOP *** [3h 3d 9d]
Hero: checks
92fa3d91: bets $0.08
Hero: calls $0.08
*** TURN *** [3h 3d 9d] [6h]
Hero: checks
92fa3d91: checks
*** RIVER *** [3h 3d 9d 6h] [7s]
Hero: checks
92fa3d91: checks
Hero: shows [Qs Kc] (Pair of Treys)
92fa3d91: shows [Qh Ad] (Pair of Treys)
*** SHOWDOWN ***
92fa3d91 collected $0.43 from pot
*** SUMMARY ***
Total pot $0.45 | Rake $0.02 | Jackpot $0 | Bingo $0 | Fortune $0 | Tax $0
Board [3h 3d 9d 6h 7s]
Seat 1: d47282a4 (button) folded before Flop (didn't bet)
Seat 2: Hero (small blind) showed [Qs Kc] and lost with Pair of Treys
Seat 3: 2b8c1076 (big blind) folded before Flop
Seat 4: 83b423c8 folded before Flop (didn't bet)
Seat 5: 92fa3d91 showed [Qh Ad] and won ($0.43) with Pair of Treys
Seat 6: b74983a1 folded before Flop (didn't bet)


Poker Hand #RC3334597780: Hold'em No Limit ($0.02/$0.05) - 2025/02/17 21:40:22
Table 'RushAndCash633040' 6-max Seat #1 is the button
Seat 1: 577aa3d3 ($9.66 in chips)
Seat 2: e2f39c8c ($5.02 in chips)
Seat 3: 4a2c171f ($6.4 in chips)
Seat 4: 9b09147b ($5.08 in chips)
Seat 5: Hero ($14.75 in chips)
Seat 6: 62156df3 ($7.66 in chips)
e2f39c8c: posts small blind $0.02
4a2c171f: posts big blind $0.05
*** HOLE CARDS ***
Dealt to 577aa3d3 
Dealt to e2f39c8c 
Dealt to 4a2c171f 
Dealt to 9b09147b 
Dealt to Hero [Jh 5c]
Dealt to 62156df3 
9b09147b: folds
Hero: folds
62156df3: folds
577aa3d3: folds
e2f39c8c: folds
Uncalled bet ($0.03) returned to 4a2c171f
*** SHOWDOWN ***
4a2c171f collected $0.04 from pot
*** SUMMARY ***
Total pot $0.04 | Rake $0 | Jackpot $0 | Bingo $0 | Fortune $0 | Tax $0
Seat 1: 577aa3d3 (button) folded before Flop (didn't bet)
Seat 2: e2f39c8c (small blind) folded before Flop
Seat 3: 4a2c171f (big blind) collected ($0.04)
Seat 4: 9b09147b folded before Flop (didn't bet)
Seat 5: Hero folded before Flop (didn't bet)
Seat 6: 62156df3 folded before Flop (didn't bet)


Poker Hand #RC3334597752: Hold'em No Limit ($0.02/$0.05) - 2025/02/17 21:40:19
Table 'RushAndCash633012' 6-max Seat #1 is the button
Seat 1: 4afebef ($5.91 in chips)
Seat 2: Hero ($14.77 in chips)
Seat 3: ef7b5599 ($36.8 in chips)
Seat 4: c723772e ($10.95 in chips)
Seat 5: 67aeeaf2 ($10.38 in chips)
Seat 6: aeb50acd ($11.24 in chips)
Hero: posts small blind $0.02
ef7b5599: posts big blind $0.05
*** HOLE CARDS ***
Dealt to 4afebef 
Dealt to Hero [4h 6c]
Dealt to ef7b5599 
Dealt to c723772e 
Dealt to 67aeeaf2 
Dealt to aeb50acd 
c723772e: folds
67aeeaf2: folds
aeb50acd: raises $0.09 to $0.14
4afebef: folds
Hero: folds
ef7b5599: calls $0.09
*** FLOP *** [8h Jh 9s]
ef7b5599: checks
aeb50acd: checks
*** TURN *** [8h Jh 9s] [Ks]
ef7b5599: checks
aeb50acd: bets $0.23
ef7b5599: raises $0.26 to $0.49
aeb50acd: calls $0.26
*** RIVER *** [8h Jh 9s Ks] [7h]
ef7b5599: checks
aeb50acd: checks
ef7b5599: shows [8d Kd] (Pair of Kings and Pair of Eights)
aeb50acd: shows [Qc Kh] (Pair of Kings)
*** SHOWDOWN ***
ef7b5599 collected $1.22 from pot
*** SUMMARY ***
Total pot $1.28 | Rake $0.06 | Jackpot $0 | Bingo $0 | Fortune $0 | Tax $0
Board [8h Jh 9s Ks 7h]
Seat 1: 4afebef (button) folded before Flop (didn't bet)
Seat 2: Hero (small blind) folded before Flop
Seat 3: ef7b5599 (big blind) showed [8d Kd] and won ($1.22) with Pair of Kings and Pair of Eights
Seat 4: c723772e folded before Flop (didn't bet)
Seat 5: 67aeeaf2 folded before Flop (didn't bet)
Seat 6: aeb50acd showed [Qc Kh] and lost with Pair of Kings


Poker Hand #RC3334597723: Hold'em No Limit ($0.02/$0.05) - 2025/02/17 21:40:16
Table 'RushAndCash632983' 6-max Seat #1 is the button
Seat 1: cc91d9ca ($10.07 in chips)
Seat 2: 7fe74cc5 ($8.05 in chips)
Seat 3: Hero ($14.82 in chips)
Seat 4: edcc4eda ($5 in chips)
Seat 5: 93a9dba6 ($5.64 in chips)
Seat 6: b9ae439d ($6.25 in chips)
7fe74cc5: posts small blind $0.02
Hero: posts big blind $0.05
*** HOLE CARDS ***
Dealt to cc91d9ca 
Dealt to 7fe74cc5 
Dealt to Hero [3c 7s]
Dealt to edcc4eda 
Dealt to 93a9dba6 
Dealt to b9ae439d 
edcc4eda: folds
93a9dba6: raises $0.08 to $0.13
b9ae439d: folds
cc91d9ca: folds
7fe74cc5: folds
Hero: folds
Uncalled bet ($0.08) returned to 93a9dba6
*** SHOWDOWN ***
93a9dba6 collected $0.12 from pot
*** SUMMARY ***
Total pot $0.12 | Rake $0 | Jackpot $0 | Bingo $0 | Fortune $0 | Tax $0
Seat 1: cc91d9ca (button) folded before Flop (didn't bet)
Seat 2: 7fe74cc5 (small blind) folded before Flop
Seat 3: Hero (big blind) folded before Flop
Seat 4: edcc4eda folded before Flop (didn't bet)
Seat 5: 93a9dba6 collected ($0.12)
Seat 6: b9ae439d folded before Flop (didn't bet)


Poker Hand #RC3334597692: Hold'em No Limit ($0.02/$0.05) - 2025/02/17 21:40:13
Table 'RushAndCash632952' 6-max Seat #1 is the button
Seat 1: Hero ($14.82 in chips)
Seat 2: fa7bb2c5 ($8.28 in chips)
Seat 3: cb987116 ($4.87 in chips)
Seat 4: ad31dea3 ($4.49 in chips)
Seat 5: d691d846 ($3.97 in chips)
Seat 6: 9b09147b ($5.08 in chips)
fa7bb2c5: posts small blind $0.02
cb987116: posts big blind $0.05
*** HOLE CARDS ***
Dealt to Hero [9d Qs]
Dealt to fa7bb2c5 
Dealt to cb987116 
Dealt to ad31dea3 
Dealt to d691d846 
Dealt to 9b09147b 
ad31dea3: raises $0.05 to $0.1
d691d846: folds
9b09147b: folds
Hero: folds
fa7bb2c5: folds
cb987116: calls $0.05
*** FLOP *** [Ad Qh 3s]
cb987116: checks
ad31dea3: bets $0.08
cb987116: calls $0.08
*** TURN *** [Ad Qh 3s] [9h]
cb987116: checks
ad31dea3: checks
*** RIVER *** [Ad Qh 3s 9h] [Qc]
cb987116: checks
ad31dea3: bets $0.18
cb987116: calls $0.18
ad31dea3: shows [7s 6s] (Pair of Queens)
cb987116: shows [8s Ah] (Pair of Aces and Pair of Queens)
*** SHOWDOWN ***
cb987116 collected $0.71 from pot
*** SUMMARY ***
Total pot $0.74 | Rake $0.03 | Jackpot $0 | Bingo $0 | Fortune $0 | Tax $0
Board [Ad Qh 3s 9h Qc]
Seat 1: Hero (button) folded before Flop (didn't bet)
Seat 2: fa7bb2c5 (small blind) folded before Flop
Seat 3: cb987116 (big blind) showed [8s Ah] and won ($0.71) with Pair of Aces and Pair of Queens
Seat 4: ad31dea3 showed [7s 6s] and lost with Pair of Queens
Seat 5: d691d846 folded before Flop (didn't bet)
Seat 6: 9b09147b folded before Flop (didn't bet)


Poker Hand #RC3334597664: Hold'em No Limit ($0.02/$0.05) - 2025/02/17 21:40:10
Table 'RushAndCash632924' 6-max Seat #1 is the button
Seat 1: beffcf8a ($5.07 in chips)
Seat 2: Hero ($14.84 in chips)
Seat 3: 2808c418 ($5.21 in chips)
Seat 4: 5ac336e3 ($5.35 in chips)
Seat 5: b39a93ce ($5.56 in chips)
Seat 6: f1fc05db ($4.88 in chips)
Hero: posts small blind $0.02
2808c418: posts big blind $0.05
*** HOLE CARDS ***
Dealt to beffcf8a 
Dealt to Hero [2h 9s]
Dealt to 2808c418 
Dealt to 5ac336e3 
Dealt to b39a93ce 
Dealt to f1fc05db 
5ac336e3: folds
b39a93ce: folds
f1fc05db: folds
beffcf8a: folds
Hero: folds
Uncalled bet ($0.03) returned to 2808c418
*** SHOWDOWN ***
2808c418 collected $0.04 from pot
*** SUMMARY ***
Total pot $0.04 | Rake $0 | Jackpot $0 | Bingo $0 | Fortune $0 | Tax $0
Seat 1: beffcf8a (button) folded before Flop (didn't bet)
Seat 2: Hero (small blind) folded before Flop
Seat 3: 2808c418 (big blind) collected ($0.04)
Seat 4: 5ac336e3 folded before Flop (didn't bet)
Seat 5: b39a93ce folded before Flop (didn't bet)
Seat 6: f1fc05db folded before Flop (didn't bet)


Poker Hand #RC3334597637: Hold'em No Limit ($0.02/$0.05) - 2025/02/17 21:40:06
Table 'RushAndCash632897' 6-max Seat #1 is the button
Seat 1: Hero ($14.84 in chips)
Seat 2: e3cc36cb ($9.94 in chips)
Seat 3: 9788125b ($5.74 in chips)
Seat 4: 1abd7272 ($5.19 in chips)
Seat 5: 88068d2c ($5.49 in chips)
Seat 6: ef8af083 ($5 in chips)
e3cc36cb: posts small blind $0.02
9788125b: posts big blind $0.05
*** HOLE CARDS ***
Dealt to Hero [Qs 6d]
Dealt to e3cc36cb 
Dealt to 9788125b 
Dealt to 1abd7272 
Dealt to 88068d2c 
Dealt to ef8af083 
1abd7272: folds
88068d2c: raises $0.1 to $0.15
ef8af083: folds
Hero: folds
e3cc36cb: folds
9788125b: folds
Uncalled bet ($0.1) returned to 88068d2c
*** SHOWDOWN ***
88068d2c collected $0.12 from pot
*** SUMMARY ***
Total pot $0.12 | Rake $0 | Jackpot $0 | Bingo $0 | Fortune $0 | Tax $0
Seat 1: Hero (button) folded before Flop (didn't bet)
Seat 2: e3cc36cb (small blind) folded before Flop
Seat 3: 9788125b (big blind) folded before Flop
Seat 4: 1abd7272 folded before Flop (didn't bet)
Seat 5: 88068d2c collected ($0.12)
Seat 6: ef8af083 folded before Flop (didn't bet)


Poker Hand #RC3334597608: Hold'em No Limit ($0.02/$0.05) - 2025/02/17 21:40:03
Table 'RushAndCash632868' 6-max Seat #1 is the button
Seat 1: 51b01079 ($5 in chips)
Seat 2: 44a9f3f0 ($8.23 in chips)
Seat 3: b72def64 ($5 in chips)
Seat 4: e3cc36cb ($9.94 in chips)
Seat 5: bc8371cb ($5.11 in chips)
Seat 6: Hero ($14.84 in chips)
44a9f3f0: posts small blind $0.02
b72def64: posts big blind $0.05
*** HOLE CARDS ***
Dealt to 51b01079 
Dealt to 44a9f3f0 
Dealt to b72def64 
Dealt to e3cc36cb 
Dealt to bc8371cb 
Dealt to Hero [5d Kd]
e3cc36cb: folds
bc8371cb: folds
Hero: folds
51b01079: raises $0.08 to $0.13
44a9f3f0: raises $0.47 to $0.6
b72def64: folds
51b01079: folds
Uncalled bet ($0.47) returned to 44a9f3f0
*** SHOWDOWN ***
44a9f3f0 collected $0.3 from pot
*** SUMMARY ***
Total pot $0.31 | Rake $0.01 | Jackpot $0 | Bingo $0 | Fortune $0 | Tax $0
Seat 1: 51b01079 (button) folded before Flop
Seat 2: 44a9f3f0 (small blind) collected ($0.3)
Seat 3: b72def64 (big blind) folded before Flop
Seat 4: e3cc36cb folded before Flop (didn't bet)
Seat 5: bc8371cb folded before Flop (didn't bet)
Seat 6: Hero folded before Flop (didn't bet)


Poker Hand #RC3334597348: Hold'em No Limit ($0.02/$0.05) - 2025/02/17 21:39:31
Table 'RushAndCash632608' 6-max Seat #1 is the button
Seat 1: 827649ff ($5.72 in chips)
Seat 2: 8072ab30 ($5.34 in chips)
Seat 3: Hero ($14.94 in chips)
Seat 4: c6e11d19 ($5.57 in chips)
Seat 5: bc8371cb ($5 in chips)
Seat 6: fec3d78d ($4.29 in chips)
8072ab30: posts small blind $0.02
Hero: posts big blind $0.05
*** HOLE CARDS ***
Dealt to 827649ff 
Dealt to 8072ab30 
Dealt to Hero [Th Kc]
Dealt to c6e11d19 
Dealt to bc8371cb 
Dealt to fec3d78d 
c6e11d19: folds
bc8371cb: raises $0.05 to $0.1
fec3d78d: folds
827649ff: folds
8072ab30: folds
Hero: calls $0.05
*** FLOP *** [As 9c 4s]
Hero: checks
bc8371cb: checks
*** TURN *** [As 9c 4s] [Qd]
Hero: checks
bc8371cb: checks
*** RIVER *** [As 9c 4s Qd] [7s]
Hero: checks
bc8371cb: checks
Hero: shows [Th Kc] (Ace-High)
bc8371cb: shows [6d 6h] (Pair of Sixes)
*** SHOWDOWN ***
bc8371cb collected $0.21 from pot
*** SUMMARY ***
Total pot $0.22 | Rake $0.01 | Jackpot $0 | Bingo $0 | Fortune $0 | Tax $0
Board [As 9c 4s Qd 7s]
Seat 1: 827649ff (button) folded before Flop (didn't bet)
Seat 2: 8072ab30 (small blind) folded before Flop
Seat 3: Hero (big blind) showed [Th Kc] and lost with Ace-High
Seat 4: c6e11d19 folded before Flop (didn't bet)
Seat 5: bc8371cb showed [6d 6h] and won ($0.21) with Pair of Sixes
Seat 6: fec3d78d folded before Flop (didn't bet)


Poker Hand #RC3334597323: Hold'em No Limit ($0.02/$0.05) - 2025/02/17 21:39:28
Table 'RushAndCash632583' 6-max Seat #1 is the button
Seat 1: 97942210 ($8.09 in chips)
Seat 2: e4385e67 ($5 in chips)
Seat 3: 19259657 ($5.65 in chips)
Seat 4: Hero ($14.94 in chips)
Seat 5: e183d966 ($6.69 in chips)
Seat 6: 56b9b8a5 ($5.14 in chips)
e4385e67: posts small blind $0.02
19259657: posts big blind $0.05
*** HOLE CARDS ***
Dealt to 97942210 
Dealt to e4385e67 
Dealt to 19259657 
Dealt to Hero [Jd 2s]
Dealt to e183d966 
Dealt to 56b9b8a5 
Hero: folds
e183d966: folds
56b9b8a5: folds
97942210: folds
e4385e67: raises $0.1 to $0.15
19259657: folds
Uncalled bet ($0.1) returned to e4385e67
*** SHOWDOWN ***
e4385e67 collected $0.1 from pot
*** SUMMARY ***
Total pot $0.1 | Rake $0 | Jackpot $0 | Bingo $0 | Fortune $0 | Tax $0
Seat 1: 97942210 (button) folded before Flop (didn't bet)
Seat 2: e4385e67 (small blind) collected ($0.1)
Seat 3: 19259657 (big blind) folded before Flop
Seat 4: Hero folded before Flop (didn't bet)
Seat 5: e183d966 folded before Flop (didn't bet)
Seat 6: 56b9b8a5 folded before Flop (didn't bet)


Poker Hand #RC3334597300: Hold'em No Limit ($0.02/$0.05) - 2025/02/17 21:39:25
Table 'RushAndCash632560' 6-max Seat #1 is the button
Seat 1: bd394772 ($6.65 in chips)
Seat 2: 3e3946b0 ($5.21 in chips)
Seat 3: c59158f3 ($5.83 in chips)
Seat 4: Hero ($14.94 in chips)
Seat 5: 3f6d99d0 ($4.37 in chips)
Seat 6: 2808c418 ($5.21 in chips)
3e3946b0: posts small blind $0.02
c59158f3: posts big blind $0.05
*** HOLE CARDS ***
Dealt to bd394772 
Dealt to 3e3946b0 
Dealt to c59158f3 
Dealt to Hero [4s 6h]
Dealt to 3f6d99d0 
Dealt to 2808c418 
Hero: folds
3f6d99d0: folds
2808c418: folds
bd394772: raises $0.08 to $0.13
3e3946b0: folds
c59158f3: calls $0.08
*** FLOP *** [5s Kc 7d]
c59158f3: checks
bd394772: bets $0.09
c59158f3: calls $0.09
*** TURN *** [5s Kc 7d] [4d]
c59158f3: checks
bd394772: checks
*** RIVER *** [5s Kc 7d 4d] [Ah]
c59158f3: bets $0.28
bd394772: folds
Uncalled bet ($0.28) returned to c59158f3
*** SHOWDOWN ***
c59158f3 collected $0.44 from pot
*** SUMMARY ***
Total pot $0.46 | Rake $0.02 | Jackpot $0 | Bingo $0 | Fortune $0 | Tax $0
Board [5s Kc 7d 4d Ah]
Seat 1: bd394772 (button) folded on the River
Seat 2: 3e3946b0 (small blind) folded before Flop
Seat 3: c59158f3 (big blind) won ($0.44)
Seat 4: Hero folded before Flop (didn't bet)
Seat 5: 3f6d99d0 folded before Flop (didn't bet)
Seat 6: 2808c418 folded before Flop (didn't bet)


Poker Hand #RC3334597266: Hold'em No Limit ($0.02/$0.05) - 2025/02/17 21:39:21
Table 'RushAndCash632526' 6-max Seat #1 is the button
Seat 1: 2ec306f3 ($5.13 in chips)
Seat 2: c3ca6759 ($5.16 in chips)
Seat 3: ac140cb9 ($3.36 in chips)
Seat 4: c32ddf74 ($3.68 in chips)
Seat 5: Hero ($14.94 in chips)
Seat 6: e3cc36cb ($9.97 in chips)
c3ca6759: posts small blind $0.02
ac140cb9: posts big blind $0.05
*** HOLE CARDS ***
Dealt to 2ec306f3 
Dealt to c3ca6759 
Dealt to ac140cb9 
Dealt to c32ddf74 
Dealt to Hero [9d Th]
Dealt to e3cc36cb 
c32ddf74: calls $0.05
Hero: folds
e3cc36cb: folds
2ec306f3: folds
c3ca6759: folds
ac140cb9: raises $0.1 to $0.15
c32ddf74: calls $0.1
*** FLOP *** [2h Qh 9h]
ac140cb9: bets $0.16
c32ddf74: folds
Uncalled bet ($0.16) returned to ac140cb9
*** SHOWDOWN ***
ac140cb9 collected $0.31 from pot
*** SUMMARY ***
Total pot $0.32 | Rake $0.01 | Jackpot $0 | Bingo $0 | Fortune $0 | Tax $0
Board [2h Qh 9h]
Seat 1: 2ec306f3 (button) folded before Flop (didn't bet)
Seat 2: c3ca6759 (small blind) folded before Flop
Seat 3: ac140cb9 (big blind) won ($0.31)
Seat 4: c32ddf74 folded on the Flop
Seat 5: Hero folded before Flop (didn't bet)
Seat 6: e3cc36cb folded before Flop (didn't bet)


Poker Hand #RC3334597237: Hold'em No Limit ($0.02/$0.05) - 2025/02/17 21:39:17
Table 'RushAndCash632497' 6-max Seat #1 is the button
Seat 1: 577bd292 ($5.74 in chips)
Seat 2: 9fa2589a ($3.75 in chips)
Seat 3: 91ad3969 ($10.41 in chips)
Seat 4: edbb0bb6 ($6.19 in chips)
Seat 5: 4b71998b ($11.62 in chips)
Seat 6: Hero ($14.94 in chips)
9fa2589a: posts small blind $0.02
91ad3969: posts big blind $0.05
*** HOLE CARDS ***
Dealt to 577bd292 
Dealt to 9fa2589a 
Dealt to 91ad3969 
Dealt to edbb0bb6 
Dealt to 4b71998b 
Dealt to Hero [Kh 3c]
edbb0bb6: folds
4b71998b: raises $0.05 to $0.1
Hero: folds
577bd292: folds
9fa2589a: folds
91ad3969: folds
Uncalled bet ($0.05) returned to 4b71998b
*** SHOWDOWN ***
4b71998b collected $0.12 from pot
*** SUMMARY ***
Total pot $0.12 | Rake $0 | Jackpot $0 | Bingo $0 | Fortune $0 | Tax $0
Seat 1: 577bd292 (button) folded before Flop (didn't bet)
Seat 2: 9fa2589a (small blind) folded before Flop
Seat 3: 91ad3969 (big blind) folded before Flop
Seat 4: edbb0bb6 folded before Flop (didn't bet)
Seat 5: 4b71998b collected ($0.12)
Seat 6: Hero folded before Flop (didn't bet)


Poker Hand #RC3334597214: Hold'em No Limit ($0.02/$0.05) - 2025/02/17 21:39:14
Table 'RushAndCash632474' 6-max Seat #1 is the button
Seat 1: d691d846 ($4.19 in chips)
Seat 2: a2e9b4d8 ($5.3 in chips)
Seat 3: df9e409d ($2 in chips)
Seat 4: Hero ($14.94 in chips)
Seat 5: 44b5c3bb ($5.07 in chips)
Seat 6: fd5b33a8 ($7.61 in chips)
a2e9b4d8: posts small blind $0.02
df9e409d: posts big blind $0.05
*** HOLE CARDS ***
Dealt to d691d846 
Dealt to a2e9b4d8 
Dealt to df9e409d 
Dealt to Hero [Tc 8h]
Dealt to 44b5c3bb 
Dealt to fd5b33a8 
Hero: folds
44b5c3bb: folds
fd5b33a8: folds
d691d846: raises $0.05 to $0.1
a2e9b4d8: folds
df9e409d: calls $0.05
*** FLOP *** [2d 4s Jd]
df9e409d: bets $0.11
d691d846: folds
Uncalled bet ($0.11) returned to df9e409d
*** SHOWDOWN ***
df9e409d collected $0.21 from pot
*** SUMMARY ***
Total pot $0.22 | Rake $0.01 | Jackpot $0 | Bingo $0 | Fortune $0 | Tax $0
Board [2d 4s Jd]
Seat 1: d691d846 (button) folded on the Flop
Seat 2: a2e9b4d8 (small blind) folded before Flop
Seat 3: df9e409d (big blind) won ($0.21)
Seat 4: Hero folded before Flop (didn't bet)
Seat 5: 44b5c3bb folded before Flop (didn't bet)
Seat 6: fd5b33a8 folded before Flop (didn't bet)


Poker Hand #RC3334597168: Hold'em No Limit ($0.02/$0.05) - 2025/02/17 21:39:09
Table 'RushAndCash632428' 6-max Seat #1 is the button
Seat 1: 5b79005a ($5.69 in chips)
Seat 2: Hero ($14.96 in chips)
Seat 3: 573eb753 ($6.68 in chips)
Seat 4: f0600331 ($8.13 in chips)
Seat 5: eda8221f ($3.82 in chips)
Seat 6: 55fce4b5 ($4.79 in chips)
Hero: posts small blind $0.02
573eb753: posts big blind $0.05
*** HOLE CARDS ***
Dealt to 5b79005a 
Dealt to Hero [3c 8s]
Dealt to 573eb753 
Dealt to f0600331 
Dealt to eda8221f 
Dealt to 55fce4b5 
f0600331: folds
eda8221f: folds
55fce4b5: folds
5b79005a: folds
Hero: folds
Uncalled bet ($0.03) returned to 573eb753
*** SHOWDOWN ***
573eb753 collected $0.04 from pot
*** SUMMARY ***
Total pot $0.04 | Rake $0 | Jackpot $0 | Bingo $0 | Fortune $0 | Tax $0
Seat 1: 5b79005a (button) folded before Flop (didn't bet)
Seat 2: Hero (small blind) folded before Flop
Seat 3: 573eb753 (big blind) collected ($0.04)
Seat 4: f0600331 folded before Flop (didn't bet)
Seat 5: eda8221f folded before Flop (didn't bet)
Seat 6: 55fce4b5 folded before Flop (didn't bet)


Poker Hand #RC3334597134: Hold'em No Limit ($0.02/$0.05) - 2025/02/17 21:39:05
Table 'RushAndCash632394' 6-max Seat #1 is the button
Seat 1: d57e790f ($8.39 in chips)
Seat 2: 18767060 ($8.7 in chips)
Seat 3: 8196f154 ($5 in chips)
Seat 4: Hero ($14.96 in chips)
Seat 5: b6d5854b ($8.83 in chips)
Seat 6: 577bd292 ($5.74 in chips)
18767060: posts small blind $0.02
8196f154: posts big blind $0.05
*** HOLE CARDS ***
Dealt to d57e790f 
Dealt to 18767060 
Dealt to 8196f154 
Dealt to Hero [4s Js]
Dealt to b6d5854b 
Dealt to 577bd292 
Hero: folds
b6d5854b: raises $0.1 to $0.15
577bd292: folds
d57e790f: folds
18767060: folds
8196f154: folds
Uncalled bet ($0.1) returned to b6d5854b
*** SHOWDOWN ***
b6d5854b collected $0.12 from pot
*** SUMMARY ***
Total pot $0.12 | Rake $0 | Jackpot $0 | Bingo $0 | Fortune $0 | Tax $0
Seat 1: d57e790f (button) folded before Flop (didn't bet)
Seat 2: 18767060 (small blind) folded before Flop
Seat 3: 8196f154 (big blind) folded before Flop
Seat 4: Hero folded before Flop (didn't bet)
Seat 5: b6d5854b collected ($0.12)
Seat 6: 577bd292 folded before Flop (didn't bet)


Poker Hand #RC3334597086: Hold'em No Limit ($0.02/$0.05) - 2025/02/17 21:39:00
Table 'RushAndCash632346' 6-max Seat #1 is the button
Seat 1: 30d19f6e ($5.09 in chips)
Seat 2: 64b39229 ($5.5 in chips)
Seat 3: 5947e28d ($5.05 in chips)
Seat 4: f994138c ($9.29 in chips)
Seat 5: Hero ($14.96 in chips)
Seat 6: a8fd1cce ($4.41 in chips)
64b39229: posts small blind $0.02
5947e28d: posts big blind $0.05
*** HOLE CARDS ***
Dealt to 30d19f6e 
Dealt to 64b39229 
Dealt to 5947e28d 
Dealt to f994138c 
Dealt to Hero [Qs 8h]
Dealt to a8fd1cce 
f994138c: folds
Hero: folds
a8fd1cce: folds
30d19f6e: raises $0.09 to $0.14
64b39229: folds
5947e28d: calls $0.09
*** FLOP *** [6s Tc 6c]
5947e28d: checks
30d19f6e: bets $0.15
5947e28d: folds
Uncalled bet ($0.15) returned to 30d19f6e
*** SHOWDOWN ***
30d19f6e collected $0.29 from pot
*** SUMMARY ***
Total pot $0.3 | Rake $0.01 | Jackpot $0 | Bingo $0 | Fortune $0 | Tax $0
Board [6s Tc 6c]
Seat 1: 30d19f6e (button) won ($0.29)
Seat 2: 64b39229 (small blind) folded before Flop
Seat 3: 5947e28d (big blind) folded on the Flop
Seat 4: f994138c folded before Flop (didn't bet)
Seat 5: Hero folded before Flop (didn't bet)
Seat 6: a8fd1cce folded before Flop (didn't bet)


Poker Hand #RC3334597047: Hold'em No Limit ($0.02/$0.05) - 2025/02/17 21:38:56
Table 'RushAndCash632307' 6-max Seat #1 is the button
Seat 1: 38005dc9 ($4.29 in chips)
Seat 2: 1c0eec17 ($6.31 in chips)
Seat 3: 5466aa49 ($5.5 in chips)
Seat 4: 44527b96 ($6.24 in chips)
Seat 5: Hero ($14.96 in chips)
Seat 6: d917dee0 ($5 in chips)
1c0eec17: posts small blind $0.02
5466aa49: posts big blind $0.05
*** HOLE CARDS ***
Dealt to 38005dc9 
Dealt to 1c0eec17 
Dealt to 5466aa49 
Dealt to 44527b96 
Dealt to Hero [3s Kc]
Dealt to d917dee0 
44527b96: folds
Hero: folds
d917dee0: raises $0.12 to $0.17
38005dc9: folds
1c0eec17: folds
5466aa49: folds
Uncalled bet ($0.12) returned to d917dee0
*** SHOWDOWN ***
d917dee0 collected $0.12 from pot
*** SUMMARY ***
Total pot $0.12 | Rake $0 | Jackpot $0 | Bingo $0 | Fortune $0 | Tax $0
Seat 1: 38005dc9 (button) folded before Flop (didn't bet)
Seat 2: 1c0eec17 (small blind) folded before Flop
Seat 3: 5466aa49 (big blind) folded before Flop
Seat 4: 44527b96 folded before Flop (didn't bet)
Seat 5: Hero folded before Flop (didn't bet)
Seat 6: d917dee0 collected ($0.12)


Poker Hand #RC3334597017: Hold'em No Limit ($0.02/$0.05) - 2025/02/17 21:38:53
Table 'RushAndCash632277' 6-max Seat #1 is the button
Seat 1: Hero ($14.96 in chips)
Seat 2: 25f30dbe ($3.76 in chips)
Seat 3: b28541cc ($5.95 in chips)
Seat 4: 1662188f ($5.6 in chips)
Seat 5: 2808c418 ($5.21 in chips)
Seat 6: 8072ab30 ($5.07 in chips)
25f30dbe: posts small blind $0.02
b28541cc: posts big blind $0.05
*** HOLE CARDS ***
Dealt to Hero [4d 6s]
Dealt to 25f30dbe 
Dealt to b28541cc 
Dealt to 1662188f 
Dealt to 2808c418 
Dealt to 8072ab30 
1662188f: folds
2808c418: folds
8072ab30: folds
Hero: folds
25f30dbe: folds
Uncalled bet ($0.03) returned to b28541cc
*** SHOWDOWN ***
b28541cc collected $0.04 from pot
*** SUMMARY ***
Total pot $0.04 | Rake $0 | Jackpot $0 | Bingo $0 | Fortune $0 | Tax $0
Seat 1: Hero (button) folded before Flop (didn't bet)
Seat 2: 25f30dbe (small blind) folded before Flop
Seat 3: b28541cc (big blind) collected ($0.04)
Seat 4: 1662188f folded before Flop (didn't bet)
Seat 5: 2808c418 folded before Flop (didn't bet)
Seat 6: 8072ab30 folded before Flop (didn't bet)


Poker Hand #RC3334596830: Hold'em No Limit ($0.02/$0.05) - 2025/02/17 21:38:31
Table 'RushAndCash632090' 6-max Seat #1 is the button
Seat 1: 3a46e390 ($6.13 in chips)
Seat 2: c02adff2 ($5.3 in chips)
Seat 3: Hero ($15.06 in chips)
Seat 4: a32bdeef ($5.09 in chips)
Seat 5: 10cdb6a1 ($5.04 in chips)
Seat 6: 35fb946f ($9.15 in chips)
c02adff2: posts small blind $0.02
Hero: posts big blind $0.05
*** HOLE CARDS ***
Dealt to 3a46e390 
Dealt to c02adff2 
Dealt to Hero [Kh 9h]
Dealt to a32bdeef 
Dealt to 10cdb6a1 
Dealt to 35fb946f 
a32bdeef: folds
10cdb6a1: raises $0.05 to $0.1
35fb946f: folds
3a46e390: folds
c02adff2: folds
Hero: calls $0.05
*** FLOP *** [6s 8d 3d]
Hero: checks
10cdb6a1: bets $0.08
Hero: folds
Uncalled bet ($0.08) returned to 10cdb6a1
*** SHOWDOWN ***
10cdb6a1 collected $0.21 from pot
*** SUMMARY ***
Total pot $0.22 | Rake $0.01 | Jackpot $0 | Bingo $0 | Fortune $0 | Tax $0
Board [6s 8d 3d]
Seat 1: 3a46e390 (button) folded before Flop (didn't bet)
Seat 2: c02adff2 (small blind) folded before Flop
Seat 3: Hero (big blind) folded on the Flop
Seat 4: a32bdeef folded before Flop (didn't bet)
Seat 5: 10cdb6a1 won ($0.21)
Seat 6: 35fb946f folded before Flop (didn't bet)


Poker Hand #RC3334596800: Hold'em No Limit ($0.02/$0.05) - 2025/02/17 21:38:28
Table 'RushAndCash632060' 6-max Seat #1 is the button
Seat 1: 827649ff ($5.72 in chips)
Seat 2: Hero ($15.08 in chips)
Seat 3: 66981141 ($14.15 in chips)
Seat 4: 110fdc96 ($5.09 in chips)
Seat 5: 27baaa05 ($6.95 in chips)
Seat 6: a8c71cd6 ($5.11 in chips)
Hero: posts small blind $0.02
66981141: posts big blind $0.05
*** HOLE CARDS ***
Dealt to 827649ff 
Dealt to Hero [2s 6d]
Dealt to 66981141 
Dealt to 110fdc96 
Dealt to 27baaa05 
Dealt to a8c71cd6 
110fdc96: folds
27baaa05: folds
a8c71cd6: folds
827649ff: folds
Hero: folds
Uncalled bet ($0.03) returned to 66981141
*** SHOWDOWN ***
66981141 collected $0.04 from pot
*** SUMMARY ***
Total pot $0.04 | Rake $0 | Jackpot $0 | Bingo $0 | Fortune $0 | Tax $0
Seat 1: 827649ff (button) folded before Flop (didn't bet)
Seat 2: Hero (small blind) folded before Flop
Seat 3: 66981141 (big blind) collected ($0.04)
Seat 4: 110fdc96 folded before Flop (didn't bet)
Seat 5: 27baaa05 folded before Flop (didn't bet)
Seat 6: a8c71cd6 folded before Flop (didn't bet)


Poker Hand #RC3334596719: Hold'em No Limit ($0.02/$0.05) - 2025/02/17 21:38:19
Table 'RushAndCash631979' 6-max Seat #1 is the button
Seat 1: Hero ($15.08 in chips)
Seat 2: 47d6aff8 ($5.53 in chips)
Seat 3: 235dd2d1 ($16.32 in chips)
Seat 4: 1e290a15 ($12.22 in chips)
Seat 5: c62b7a0b ($22.23 in chips)
Seat 6: 5e166e9a ($10.25 in chips)
47d6aff8: posts small blind $0.02
235dd2d1: posts big blind $0.05
*** HOLE CARDS ***
Dealt to Hero [Ad 5s]
Dealt to 47d6aff8 
Dealt to 235dd2d1 
Dealt to 1e290a15 
Dealt to c62b7a0b 
Dealt to 5e166e9a 
1e290a15: folds
c62b7a0b: folds
5e166e9a: folds
Hero: folds
47d6aff8: folds
Uncalled bet ($0.03) returned to 235dd2d1
*** SHOWDOWN ***
235dd2d1 collected $0.04 from pot
*** SUMMARY ***
Total pot $0.04 | Rake $0 | Jackpot $0 | Bingo $0 | Fortune $0 | Tax $0
Seat 1: Hero (button) folded before Flop (didn't bet)
Seat 2: 47d6aff8 (small blind) folded before Flop
Seat 3: 235dd2d1 (big blind) collected ($0.04)
Seat 4: 1e290a15 folded before Flop (didn't bet)
Seat 5: c62b7a0b folded before Flop (didn't bet)
Seat 6: 5e166e9a folded before Flop (didn't bet)


Poker Hand #RC3334596693: Hold'em No Limit ($0.02/$0.05) - 2025/02/17 21:38:15
Table 'RushAndCash631953' 6-max Seat #1 is the button
Seat 1: fec3d78d ($4.7 in chips)
Seat 2: ac6c5037 ($8.45 in chips)
Seat 3: Hero ($15.13 in chips)
Seat 4: 5b015cd4 ($2.66 in chips)
Seat 5: b244c9b2 ($4.93 in chips)
Seat 6: 65ca9276 ($8.79 in chips)
ac6c5037: posts small blind $0.02
Hero: posts big blind $0.05
*** HOLE CARDS ***
Dealt to fec3d78d 
Dealt to ac6c5037 
Dealt to Hero [9c Th]
Dealt to 5b015cd4 
Dealt to b244c9b2 
Dealt to 65ca9276 
5b015cd4: folds
b244c9b2: folds
65ca9276: folds
fec3d78d: folds
ac6c5037: raises $0.05 to $0.1
Hero: folds
Uncalled bet ($0.05) returned to ac6c5037
*** SHOWDOWN ***
ac6c5037 collected $0.1 from pot
*** SUMMARY ***
Total pot $0.1 | Rake $0 | Jackpot $0 | Bingo $0 | Fortune $0 | Tax $0
Seat 1: fec3d78d (button) folded before Flop (didn't bet)
Seat 2: ac6c5037 (small blind) collected ($0.1)
Seat 3: Hero (big blind) folded before Flop
Seat 4: 5b015cd4 folded before Flop (didn't bet)
Seat 5: b244c9b2 folded before Flop (didn't bet)
Seat 6: 65ca9276 folded before Flop (didn't bet)


Poker Hand #RC3334596448: Hold'em No Limit ($0.02/$0.05) - 2025/02/17 21:37:45
Table 'RushAndCash631708' 6-max Seat #1 is the button
Seat 1: a9d8ced4 ($6.15 in chips)
Seat 2: f0600331 ($8.26 in chips)
Seat 3: 80c22e34 ($5 in chips)
Seat 4: Hero ($15.23 in chips)
Seat 5: a39b5beb ($6.38 in chips)
Seat 6: f56d4922 ($5.61 in chips)
f0600331: posts small blind $0.02
80c22e34: posts big blind $0.05
*** HOLE CARDS ***
Dealt to a9d8ced4 
Dealt to f0600331 
Dealt to 80c22e34 
Dealt to Hero [6h 6s]
Dealt to a39b5beb 
Dealt to f56d4922 
Hero: raises $0.05 to $0.1
a39b5beb: folds
f56d4922: folds
a9d8ced4: folds
f0600331: calls $0.08
80c22e34: calls $0.05
*** FLOP *** [2d 9d 9c]
f0600331: checks
80c22e34: bets $0.2
Hero: folds
f0600331: calls $0.2
*** TURN *** [2d 9d 9c] [3d]
f0600331: checks
80c22e34: bets $0.35
f0600331: folds
Uncalled bet ($0.35) returned to 80c22e34
*** SHOWDOWN ***
80c22e34 collected $0.67 from pot
*** SUMMARY ***
Total pot $0.7 | Rake $0.03 | Jackpot $0 | Bingo $0 | Fortune $0 | Tax $0
Board [2d 9d 9c 3d]
Seat 1: a9d8ced4 (button) folded before Flop (didn't bet)
Seat 2: f0600331 (small blind) folded on the Turn
Seat 3: 80c22e34 (big blind) won ($0.67)
Seat 4: Hero folded on the Flop
Seat 5: a39b5beb folded before Flop (didn't bet)
Seat 6: f56d4922 folded before Flop (didn't bet)


Poker Hand #RC3334596419: Hold'em No Limit ($0.02/$0.05) - 2025/02/17 21:37:42
Table 'RushAndCash631679' 6-max Seat #1 is the button
Seat 1: 229ec9a7 ($9.8 in chips)
Seat 2: 47d6aff8 ($5.6 in chips)
Seat 3: a4227633 ($6.05 in chips)
Seat 4: 62156df3 ($7.11 in chips)
Seat 5: 5f1cdd27 ($5.66 in chips)
Seat 6: Hero ($15.23 in chips)
47d6aff8: posts small blind $0.02
a4227633: posts big blind $0.05
*** HOLE CARDS ***
Dealt to 229ec9a7 
Dealt to 47d6aff8 
Dealt to a4227633 
Dealt to 62156df3 
Dealt to 5f1cdd27 
Dealt to Hero [3h Th]
62156df3: raises $0.05 to $0.1
5f1cdd27: folds
Hero: folds
229ec9a7: folds
47d6aff8: folds
a4227633: folds
Uncalled bet ($0.05) returned to 62156df3
*** SHOWDOWN ***
62156df3 collected $0.12 from pot
*** SUMMARY ***
Total pot $0.12 | Rake $0 | Jackpot $0 | Bingo $0 | Fortune $0 | Tax $0
Seat 1: 229ec9a7 (button) folded before Flop (didn't bet)
Seat 2: 47d6aff8 (small blind) folded before Flop
Seat 3: a4227633 (big blind) folded before Flop
Seat 4: 62156df3 collected ($0.12)
Seat 5: 5f1cdd27 folded before Flop (didn't bet)
Seat 6: Hero folded before Flop (didn't bet)


Poker Hand #RC3334596388: Hold'em No Limit ($0.02/$0.05) - 2025/02/17 21:37:39
Table 'RushAndCash631648' 6-max Seat #1 is the button
Seat 1: 4e3c3196 ($31.39 in chips)
Seat 2: c723772e ($11.48 in chips)
Seat 3: 62156df3 ($7.16 in chips)
Seat 4: Hero ($15.23 in chips)
Seat 5: 37bc5b77 ($5.07 in chips)
Seat 6: 726ab14e ($6.38 in chips)
c723772e: posts small blind $0.02
62156df3: posts big blind $0.05
*** HOLE CARDS ***
Dealt to 4e3c3196 
Dealt to c723772e 
Dealt to 62156df3 
Dealt to Hero [3d Tc]
Dealt to 37bc5b77 
Dealt to 726ab14e 
Hero: folds
37bc5b77: raises $0.08 to $0.13
726ab14e: folds
4e3c3196: folds
c723772e: folds
62156df3: folds
Uncalled bet ($0.08) returned to 37bc5b77
*** SHOWDOWN ***
37bc5b77 collected $0.12 from pot
*** SUMMARY ***
Total pot $0.12 | Rake $0 | Jackpot $0 | Bingo $0 | Fortune $0 | Tax $0
Seat 1: 4e3c3196 (button) folded before Flop (didn't bet)
Seat 2: c723772e (small blind) folded before Flop
Seat 3: 62156df3 (big blind) folded before Flop
Seat 4: Hero folded before Flop (didn't bet)
Seat 5: 37bc5b77 collected ($0.12)
Seat 6: 726ab14e folded before Flop (didn't bet)


Poker Hand #RC3334596064: Hold'em No Limit ($0.02/$0.05) - 2025/02/17 21:36:59
Table 'RushAndCash631324' 6-max Seat #1 is the button
Seat 1: 577aa3d3 ($9.45 in chips)
Seat 2: 726ab14e ($6.45 in chips)
Seat 3: 97d67e86 ($5.7 in chips)
Seat 4: ef8af083 ($5.26 in chips)
Seat 5: Hero ($15.33 in chips)
Seat 6: 75a97e80 ($5 in chips)
726ab14e: posts small blind $0.02
97d67e86: posts big blind $0.05
*** HOLE CARDS ***
Dealt to 577aa3d3 
Dealt to 726ab14e 
Dealt to 97d67e86 
Dealt to ef8af083 
Dealt to Hero [Ah Jc]
Dealt to 75a97e80 
ef8af083: folds
Hero: raises $0.05 to $0.1
75a97e80: calls $0.1
577aa3d3: folds
726ab14e: folds
97d67e86: calls $0.05
*** FLOP *** [Qs 9d 7h]
97d67e86: checks
Hero: checks
75a97e80: checks
*** TURN *** [Qs 9d 7h] [3d]
97d67e86: checks
Hero: checks
75a97e80: checks
*** RIVER *** [Qs 9d 7h 3d] [8s]
97d67e86: checks
Hero: checks
75a97e80: bets $0.32
97d67e86: folds
Hero: folds
Uncalled bet ($0.32) returned to 75a97e80
*** SHOWDOWN ***
75a97e80 collected $0.31 from pot
*** SUMMARY ***
Total pot $0.32 | Rake $0.01 | Jackpot $0 | Bingo $0 | Fortune $0 | Tax $0
Board [Qs 9d 7h 3d 8s]
Seat 1: 577aa3d3 (button) folded before Flop (didn't bet)
Seat 2: 726ab14e (small blind) folded before Flop
Seat 3: 97d67e86 (big blind) folded on the River
Seat 4: ef8af083 folded before Flop (didn't bet)
Seat 5: Hero folded on the River
Seat 6: 75a97e80 won ($0.31)


Poker Hand #RC3334595988: Hold'em No Limit ($0.02/$0.05) - 2025/02/17 21:36:50
Table 'RushAndCash631248' 6-max Seat #1 is the button
Seat 1: 851b8de6 ($5 in chips)
Seat 2: e17748e2 ($5 in chips)
Seat 3: 38005dc9 ($4.01 in chips)
Seat 4: Hero ($15.26 in chips)
Seat 5: 55e0d4fe ($7.86 in chips)
Seat 6: 3e3946b0 ($6.21 in chips)
e17748e2: posts small blind $0.02
38005dc9: posts big blind $0.05
*** HOLE CARDS ***
Dealt to 851b8de6 
Dealt to e17748e2 
Dealt to 38005dc9 
Dealt to Hero [9s Ts]
Dealt to 55e0d4fe 
Dealt to 3e3946b0 
Hero: raises $0.05 to $0.1
55e0d4fe: folds
3e3946b0: folds
851b8de6: folds
e17748e2: folds
38005dc9: folds
Uncalled bet ($0.05) returned to Hero
*** SHOWDOWN ***
Hero collected $0.12 from pot
*** SUMMARY ***
Total pot $0.12 | Rake $0 | Jackpot $0 | Bingo $0 | Fortune $0 | Tax $0
Seat 1: 851b8de6 (button) folded before Flop (didn't bet)
Seat 2: e17748e2 (small blind) folded before Flop
Seat 3: 38005dc9 (big blind) folded before Flop
Seat 4: Hero collected ($0.12)
Seat 5: 55e0d4fe folded before Flop (didn't bet)
Seat 6: 3e3946b0 folded before Flop (didn't bet)


Poker Hand #RC3334595958: Hold'em No Limit ($0.02/$0.05) - 2025/02/17 21:36:46
Table 'RushAndCash631218' 6-max Seat #1 is the button
Seat 1: 6008538 ($5.68 in chips)
Seat 2: 742ccfee ($1.82 in chips)
Seat 3: Hero ($15.31 in chips)
Seat 4: 44b5c3bb ($5 in chips)
Seat 5: dfc02c40 ($6.65 in chips)
Seat 6: 9fa2589a ($3.92 in chips)
742ccfee: posts small blind $0.02
Hero: posts big blind $0.05
*** HOLE CARDS ***
Dealt to 6008538 
Dealt to 742ccfee 
Dealt to Hero [7d 3h]
Dealt to 44b5c3bb 
Dealt to dfc02c40 
Dealt to 9fa2589a 
44b5c3bb: raises $0.08 to $0.13
dfc02c40: folds
9fa2589a: folds
6008538: folds
742ccfee: folds
Hero: folds
Uncalled bet ($0.08) returned to 44b5c3bb
*** SHOWDOWN ***
44b5c3bb collected $0.12 from pot
*** SUMMARY ***
Total pot $0.12 | Rake $0 | Jackpot $0 | Bingo $0 | Fortune $0 | Tax $0
Seat 1: 6008538 (button) folded before Flop (didn't bet)
Seat 2: 742ccfee (small blind) folded before Flop
Seat 3: Hero (big blind) folded before Flop
Seat 4: 44b5c3bb collected ($0.12)
Seat 5: dfc02c40 folded before Flop (didn't bet)
Seat 6: 9fa2589a folded before Flop (didn't bet)


Poker Hand #RC3334595797: Hold'em No Limit ($0.02/$0.05) - 2025/02/17 21:36:28
Table 'RushAndCash631057' 6-max Seat #1 is the button
Seat 1: fa30bfa7 ($5.11 in chips)
Seat 2: 8212253a ($5.53 in chips)
Seat 3: Hero ($15.29 in chips)
Seat 4: 27baaa05 ($7.25 in chips)
Seat 5: 4fa289e4 ($5.56 in chips)
Seat 6: c723772e ($11.78 in chips)
8212253a: posts small blind $0.02
Hero: posts big blind $0.05
*** HOLE CARDS ***
Dealt to fa30bfa7 
Dealt to 8212253a 
Dealt to Hero [Jc 5c]
Dealt to 27baaa05 
Dealt to 4fa289e4 
Dealt to c723772e 
27baaa05: folds
4fa289e4: folds
c723772e: folds
fa30bfa7: folds
8212253a: folds
Uncalled bet ($0.03) returned to Hero
*** SHOWDOWN ***
Hero collected $0.04 from pot
*** SUMMARY ***
Total pot $0.04 | Rake $0 | Jackpot $0 | Bingo $0 | Fortune $0 | Tax $0
Seat 1: fa30bfa7 (button) folded before Flop (didn't bet)
Seat 2: 8212253a (small blind) folded before Flop
Seat 3: Hero (big blind) collected ($0.04)
Seat 4: 27baaa05 folded before Flop (didn't bet)
Seat 5: 4fa289e4 folded before Flop (didn't bet)
Seat 6: c723772e folded before Flop (didn't bet)


Poker Hand #RC3334595622: Hold'em No Limit ($0.02/$0.05) - 2025/02/17 21:36:08
Table 'RushAndCash630882' 6-max Seat #1 is the button
Seat 1: 7f13dd41 ($4.68 in chips)
Seat 2: dcd4e05 ($2 in chips)
Seat 3: 65e854ab ($5.02 in chips)
Seat 4: 933f6ef1 ($4.76 in chips)
Seat 5: Hero ($15.39 in chips)
Seat 6: 4ebd5be6 ($5.82 in chips)
dcd4e05: posts small blind $0.02
65e854ab: posts big blind $0.05
*** HOLE CARDS ***
Dealt to 7f13dd41 
Dealt to dcd4e05 
Dealt to 65e854ab 
Dealt to 933f6ef1 
Dealt to Hero [Qs Kd]
Dealt to 4ebd5be6 
933f6ef1: folds
Hero: raises $0.05 to $0.1
4ebd5be6: folds
7f13dd41: calls $0.1
dcd4e05: calls $0.08
65e854ab: folds
*** FLOP *** [4d 5h 6d]
dcd4e05: checks
Hero: checks
7f13dd41: bets $0.24
dcd4e05: folds
Hero: folds
Uncalled bet ($0.24) returned to 7f13dd41
*** SHOWDOWN ***
7f13dd41 collected $0.34 from pot
*** SUMMARY ***
Total pot $0.35 | Rake $0.01 | Jackpot $0 | Bingo $0 | Fortune $0 | Tax $0
Board [4d 5h 6d]
Seat 1: 7f13dd41 (button) won ($0.34)
Seat 2: dcd4e05 (small blind) folded on the Flop
Seat 3: 65e854ab (big blind) folded before Flop
Seat 4: 933f6ef1 folded before Flop (didn't bet)
Seat 5: Hero folded on the Flop
Seat 6: 4ebd5be6 folded before Flop (didn't bet)


Poker Hand #RC3334595588: Hold'em No Limit ($0.02/$0.05) - 2025/02/17 21:36:04
Table 'RushAndCash630848' 6-max Seat #1 is the button
Seat 1: Hero ($15.39 in chips)
Seat 2: 8f3a3c0a ($14.31 in chips)
Seat 3: 46fb98 ($5 in chips)
Seat 4: 421a6d95 ($5 in chips)
Seat 5: bf7ff92b ($4.33 in chips)
Seat 6: 9e226e3b ($5 in chips)
8f3a3c0a: posts small blind $0.02
46fb98: posts big blind $0.05
*** HOLE CARDS ***
Dealt to Hero [9h Kc]
Dealt to 8f3a3c0a 
Dealt to 46fb98 
Dealt to 421a6d95 
Dealt to bf7ff92b 
Dealt to 9e226e3b 
421a6d95: folds
bf7ff92b: folds
9e226e3b: folds
Hero: folds
8f3a3c0a: folds
Uncalled bet ($0.03) returned to 46fb98
*** SHOWDOWN ***
46fb98 collected $0.04 from pot
*** SUMMARY ***
Total pot $0.04 | Rake $0 | Jackpot $0 | Bingo $0 | Fortune $0 | Tax $0
Seat 1: Hero (button) folded before Flop (didn't bet)
Seat 2: 8f3a3c0a (small blind) folded before Flop
Seat 3: 46fb98 (big blind) collected ($0.04)
Seat 4: 421a6d95 folded before Flop (didn't bet)
Seat 5: bf7ff92b folded before Flop (didn't bet)
Seat 6: 9e226e3b folded before Flop (didn't bet)


Poker Hand #RC3334595538: Hold'em No Limit ($0.02/$0.05) - 2025/02/17 21:35:58
Table 'RushAndCash630798' 6-max Seat #1 is the button
Seat 1: bcb971d3 ($5.47 in chips)
Seat 2: 66981141 ($14.29 in chips)
Seat 3: 59238e48 ($5 in chips)
Seat 4: c4483bd8 ($4.71 in chips)
Seat 5: edbb0bb6 ($5 in chips)
Seat 6: Hero ($15.39 in chips)
66981141: posts small blind $0.02
59238e48: posts big blind $0.05
*** HOLE CARDS ***
Dealt to bcb971d3 
Dealt to 66981141 
Dealt to 59238e48 
Dealt to c4483bd8 
Dealt to edbb0bb6 
Dealt to Hero [Ad 4d]
c4483bd8: raises $0.05 to $0.1
edbb0bb6: folds
Hero: folds
bcb971d3: folds
66981141: folds
59238e48: folds
Uncalled bet ($0.05) returned to c4483bd8
*** SHOWDOWN ***
c4483bd8 collected $0.12 from pot
*** SUMMARY ***
Total pot $0.12 | Rake $0 | Jackpot $0 | Bingo $0 | Fortune $0 | Tax $0
Seat 1: bcb971d3 (button) folded before Flop (didn't bet)
Seat 2: 66981141 (small blind) folded before Flop
Seat 3: 59238e48 (big blind) folded before Flop
Seat 4: c4483bd8 collected ($0.12)
Seat 5: edbb0bb6 folded before Flop (didn't bet)
Seat 6: Hero folded before Flop (didn't bet)


Poker Hand #RC3334595510: Hold'em No Limit ($0.02/$0.05) - 2025/02/17 21:35:55
Table 'RushAndCash630770' 6-max Seat #1 is the button
Seat 1: 87d5083b ($21.52 in chips)
Seat 2: c7c4cf03 ($5.4 in chips)
Seat 3: 100d4f9e ($4.98 in chips)
Seat 4: Hero ($15.39 in chips)
Seat 5: 2642904 ($5.14 in chips)
Seat 6: f6b7f191 ($5.74 in chips)
c7c4cf03: posts small blind $0.02
100d4f9e: posts big blind $0.05
*** HOLE CARDS ***
Dealt to 87d5083b 
Dealt to c7c4cf03 
Dealt to 100d4f9e 
Dealt to Hero [Td 7d]
Dealt to 2642904 
Dealt to f6b7f191 
Hero: folds
2642904: folds
f6b7f191: calls $0.05
87d5083b: folds
c7c4cf03: folds
100d4f9e: checks
*** FLOP *** [As 4c 5d]
100d4f9e: checks
f6b7f191: checks
*** TURN *** [As 4c 5d] [Ac]
100d4f9e: checks
f6b7f191: checks
*** RIVER *** [As 4c 5d Ac] [9d]
100d4f9e: checks
f6b7f191: bets $0.09
100d4f9e: calls $0.09
f6b7f191: shows [Ks Kc] (Pair of Aces and Pair of Kings)
100d4f9e: shows [5h 4s] (Pair of Aces and Pair of Fives)
*** SHOWDOWN ***
f6b7f191 collected $0.29 from pot
*** SUMMARY ***
Total pot $0.3 | Rake $0.01 | Jackpot $0 | Bingo $0 | Fortune $0 | Tax $0
Board [As 4c 5d Ac 9d]
Seat 1: 87d5083b (button) folded before Flop (didn't bet)
Seat 2: c7c4cf03 (small blind) folded before Flop
Seat 3: 100d4f9e (big blind) showed [5h 4s] and lost with Pair of Aces and Pair of Fives
Seat 4: Hero folded before Flop (didn't bet)
Seat 5: 2642904 folded before Flop (didn't bet)
Seat 6: f6b7f191 showed [Ks Kc] and won ($0.29) with Pair of Aces and Pair of Kings


Poker Hand #RC3334595483: Hold'em No Limit ($0.02/$0.05) - 2025/02/17 21:35:52
Table 'RushAndCash630743' 6-max Seat #1 is the button
Seat 1: 911dbc6d ($2.99 in chips)
Seat 2: Hero ($15.41 in chips)
Seat 3: 2b8c1076 ($5.27 in chips)
Seat 4: fea7bb48 ($8.87 in chips)
Seat 5: 1e290a15 ($11.24 in chips)
Seat 6: 486aa946 ($4.56 in chips)
Hero: posts small blind $0.02
2b8c1076: posts big blind $0.05
*** HOLE CARDS ***
Dealt to 911dbc6d 
Dealt to Hero [3h Ks]
Dealt to 2b8c1076 
Dealt to fea7bb48 
Dealt to 1e290a15 
Dealt to 486aa946 
fea7bb48: folds
1e290a15: folds
486aa946: folds
911dbc6d: folds
Hero: folds
Uncalled bet ($0.03) returned to 2b8c1076
*** SHOWDOWN ***
2b8c1076 collected $0.04 from pot
*** SUMMARY ***
Total pot $0.04 | Rake $0 | Jackpot $0 | Bingo $0 | Fortune $0 | Tax $0
Seat 1: 911dbc6d (button) folded before Flop (didn't bet)
Seat 2: Hero (small blind) folded before Flop
Seat 3: 2b8c1076 (big blind) collected ($0.04)
Seat 4: fea7bb48 folded before Flop (didn't bet)
Seat 5: 1e290a15 folded before Flop (didn't bet)
Seat 6: 486aa946 folded before Flop (didn't bet)


Poker Hand #RC3334595459: Hold'em No Limit ($0.02/$0.05) - 2025/02/17 21:35:48
Table 'RushAndCash630719' 6-max Seat #1 is the button
Seat 1: e3559a7e ($4.63 in chips)
Seat 2: Hero ($15.43 in chips)
Seat 3: bc8371cb ($5.75 in chips)
Seat 4: e5dc0403 ($5.14 in chips)
Seat 5: 493e7626 ($5.11 in chips)
Seat 6: e2d5acdf ($5 in chips)
Hero: posts small blind $0.02
bc8371cb: posts big blind $0.05
*** HOLE CARDS ***
Dealt to e3559a7e 
Dealt to Hero [3h Qs]
Dealt to bc8371cb 
Dealt to e5dc0403 
Dealt to 493e7626 
Dealt to e2d5acdf 
e5dc0403: folds
493e7626: folds
e2d5acdf: folds
e3559a7e: folds
Hero: folds
Uncalled bet ($0.03) returned to bc8371cb
*** SHOWDOWN ***
bc8371cb collected $0.04 from pot
*** SUMMARY ***
Total pot $0.04 | Rake $0 | Jackpot $0 | Bingo $0 | Fortune $0 | Tax $0
Seat 1: e3559a7e (button) folded before Flop (didn't bet)
Seat 2: Hero (small blind) folded before Flop
Seat 3: bc8371cb (big blind) collected ($0.04)
Seat 4: e5dc0403 folded before Flop (didn't bet)
Seat 5: 493e7626 folded before Flop (didn't bet)
Seat 6: e2d5acdf folded before Flop (didn't bet)


Poker Hand #RC3334595429: Hold'em No Limit ($0.02/$0.05) - 2025/02/17 21:35:45
Table 'RushAndCash630689' 6-max Seat #1 is the button
Seat 1: a5be70d9 ($13.57 in chips)
Seat 2: 67b2dab9 ($8.69 in chips)
Seat 3: 143ede8b ($11.29 in chips)
Seat 4: 493e7626 ($5.11 in chips)
Seat 5: 577aa3d3 ($9.54 in chips)
Seat 6: Hero ($15.43 in chips)
67b2dab9: posts small blind $0.02
143ede8b: posts big blind $0.05
*** HOLE CARDS ***
Dealt to a5be70d9 
Dealt to 67b2dab9 
Dealt to 143ede8b 
Dealt to 493e7626 
Dealt to 577aa3d3 
Dealt to Hero [5s 8h]
493e7626: folds
577aa3d3: folds
Hero: folds
a5be70d9: raises $0.08 to $0.13
67b2dab9: folds
143ede8b: calls $0.08
*** FLOP *** [Kc Js 7h]
143ede8b: checks
a5be70d9: checks
*** TURN *** [Kc Js 7h] [8d]
143ede8b: checks
a5be70d9: checks
*** RIVER *** [Kc Js 7h 8d] [Ad]
143ede8b: checks
a5be70d9: bets $0.1
143ede8b: folds
Uncalled bet ($0.1) returned to a5be70d9
*** SHOWDOWN ***
a5be70d9 collected $0.27 from pot
*** SUMMARY ***
Total pot $0.28 | Rake $0.01 | Jackpot $0 | Bingo $0 | Fortune $0 | Tax $0
Board [Kc Js 7h 8d Ad]
Seat 1: a5be70d9 (button) won ($0.27)
Seat 2: 67b2dab9 (small blind) folded before Flop
Seat 3: 143ede8b (big blind) folded on the River
Seat 4: 493e7626 folded before Flop (didn't bet)
Seat 5: 577aa3d3 folded before Flop (didn't bet)
Seat 6: Hero folded before Flop (didn't bet)


Poker Hand #RC3334595358: Hold'em No Limit ($0.02/$0.05) - 2025/02/17 21:35:36
Table 'RushAndCash630618' 6-max Seat #1 is the button
Seat 1: e7a0ba42 ($26.84 in chips)
Seat 2: 9c3abcbf ($15.92 in chips)
Seat 3: Hero ($15.48 in chips)
Seat 4: ee3fdfd8 ($5 in chips)
Seat 5: e6ee1d7f ($5.09 in chips)
Seat 6: e7c4d687 ($3.61 in chips)
9c3abcbf: posts small blind $0.02
Hero: posts big blind $0.05
*** HOLE CARDS ***
Dealt to e7a0ba42 
Dealt to 9c3abcbf 
Dealt to Hero [9c 5h]
Dealt to ee3fdfd8 
Dealt to e6ee1d7f 
Dealt to e7c4d687 
ee3fdfd8: raises $0.05 to $0.1
e6ee1d7f: raises $0.24 to $0.34
e7c4d687: folds
e7a0ba42: folds
9c3abcbf: folds
Hero: folds
ee3fdfd8: calls $0.24
*** FLOP *** [8s Qd 2s]
ee3fdfd8: checks
e6ee1d7f: bets $0.25
ee3fdfd8: folds
Uncalled bet ($0.25) returned to e6ee1d7f
*** SHOWDOWN ***
e6ee1d7f collected $0.72 from pot
*** SUMMARY ***
Total pot $0.75 | Rake $0.03 | Jackpot $0 | Bingo $0 | Fortune $0 | Tax $0
Board [8s Qd 2s]
Seat 1: e7a0ba42 (button) folded before Flop (didn't bet)
Seat 2: 9c3abcbf (small blind) folded before Flop
Seat 3: Hero (big blind) folded before Flop
Seat 4: ee3fdfd8 folded on the Flop
Seat 5: e6ee1d7f won ($0.72)
Seat 6: e7c4d687 folded before Flop (didn't bet)


Poker Hand #RC3334595335: Hold'em No Limit ($0.02/$0.05) - 2025/02/17 21:35:33
Table 'RushAndCash630595' 6-max Seat #1 is the button
Seat 1: b10195a2 ($5 in chips)
Seat 2: a363f4b ($3.84 in chips)
Seat 3: 5ea9f27c ($5 in chips)
Seat 4: Hero ($15.48 in chips)
Seat 5: 83d04f0d ($7.58 in chips)
Seat 6: c04eb337 ($6.03 in chips)
a363f4b: posts small blind $0.02
5ea9f27c: posts big blind $0.05
*** HOLE CARDS ***
Dealt to b10195a2 
Dealt to a363f4b 
Dealt to 5ea9f27c 
Dealt to Hero [3d Kh]
Dealt to 83d04f0d 
Dealt to c04eb337 
Hero: folds
83d04f0d: folds
c04eb337: raises $0.06 to $0.11
b10195a2: folds
a363f4b: folds
5ea9f27c: folds
Uncalled bet ($0.06) returned to c04eb337
*** SHOWDOWN ***
c04eb337 collected $0.12 from pot
*** SUMMARY ***
Total pot $0.12 | Rake $0 | Jackpot $0 | Bingo $0 | Fortune $0 | Tax $0
Seat 1: b10195a2 (button) folded before Flop (didn't bet)
Seat 2: a363f4b (small blind) folded before Flop
Seat 3: 5ea9f27c (big blind) folded before Flop
Seat 4: Hero folded before Flop (didn't bet)
Seat 5: 83d04f0d folded before Flop (didn't bet)
Seat 6: c04eb337 collected ($0.12)


Poker Hand #RC3334595309: Hold'em No Limit ($0.02/$0.05) - 2025/02/17 21:35:30
Table 'RushAndCash630569' 6-max Seat #1 is the button
Seat 1: b2f44cb6 ($10.97 in chips)
Seat 2: bebd931c ($4.43 in chips)
Seat 3: 6d5fa70b ($5.61 in chips)
Seat 4: 27baaa05 ($7.08 in chips)
Seat 5: Hero ($15.48 in chips)
Seat 6: b86c29aa ($9.75 in chips)
bebd931c: posts small blind $0.02
6d5fa70b: posts big blind $0.05
*** HOLE CARDS ***
Dealt to b2f44cb6 
Dealt to bebd931c 
Dealt to 6d5fa70b 
Dealt to 27baaa05 
Dealt to Hero [2s 6d]
Dealt to b86c29aa 
27baaa05: folds
Hero: folds
b86c29aa: folds
b2f44cb6: raises $0.05 to $0.1
bebd931c: folds
6d5fa70b: raises $0.36 to $0.46
b2f44cb6: folds
Uncalled bet ($0.36) returned to 6d5fa70b
*** SHOWDOWN ***
6d5fa70b collected $0.21 from pot
*** SUMMARY ***
Total pot $0.22 | Rake $0.01 | Jackpot $0 | Bingo $0 | Fortune $0 | Tax $0
Seat 1: b2f44cb6 (button) folded before Flop
Seat 2: bebd931c (small blind) folded before Flop
Seat 3: 6d5fa70b (big blind) collected ($0.21)
Seat 4: 27baaa05 folded before Flop (didn't bet)
Seat 5: Hero folded before Flop (didn't bet)
Seat 6: b86c29aa folded before Flop (didn't bet)


Poker Hand #RC3334595285: Hold'em No Limit ($0.02/$0.05) - 2025/02/17 21:35:27
Table 'RushAndCash630545' 6-max Seat #1 is the button
Seat 1: 10b5ea2f ($12.5 in chips)
Seat 2: 49b4f33a ($12.87 in chips)
Seat 3: 7d310fdd ($5.19 in chips)
Seat 4: 6c7828d3 ($5.39 in chips)
Seat 5: Hero ($15.48 in chips)
Seat 6: 33554b00 ($5.07 in chips)
49b4f33a: posts small blind $0.02
7d310fdd: posts big blind $0.05
*** HOLE CARDS ***
Dealt to 10b5ea2f 
Dealt to 49b4f33a 
Dealt to 7d310fdd 
Dealt to 6c7828d3 
Dealt to Hero [9c Ks]
Dealt to 33554b00 
6c7828d3: folds
Hero: folds
33554b00: folds
10b5ea2f: raises $0.08 to $0.13
49b4f33a: raises $0.38 to $0.51
7d310fdd: folds
10b5ea2f: folds
Uncalled bet ($0.38) returned to 49b4f33a
*** SHOWDOWN ***
49b4f33a collected $0.3 from pot
*** SUMMARY ***
Total pot $0.31 | Rake $0.01 | Jackpot $0 | Bingo $0 | Fortune $0 | Tax $0
Seat 1: 10b5ea2f (button) folded before Flop
Seat 2: 49b4f33a (small blind) collected ($0.3)
Seat 3: 7d310fdd (big blind) folded before Flop
Seat 4: 6c7828d3 folded before Flop (didn't bet)
Seat 5: Hero folded before Flop (didn't bet)
Seat 6: 33554b00 folded before Flop (didn't bet)


Poker Hand #RC3334595260: Hold'em No Limit ($0.02/$0.05) - 2025/02/17 21:35:23
Table 'RushAndCash630520' 6-max Seat #1 is the button
Seat 1: Hero ($15.48 in chips)
Seat 2: a223d3ca ($5.12 in chips)
Seat 3: eb1bbc7a ($6.01 in chips)
Seat 4: 6c7828d3 ($5.39 in chips)
Seat 5: 35fae52e ($5.13 in chips)
Seat 6: 3c76a91d ($8.93 in chips)
a223d3ca: posts small blind $0.02
eb1bbc7a: posts big blind $0.05
*** HOLE CARDS ***
Dealt to Hero [2s 3s]
Dealt to a223d3ca 
Dealt to eb1bbc7a 
Dealt to 6c7828d3 
Dealt to 35fae52e 
Dealt to 3c76a91d 
6c7828d3: folds
35fae52e: folds
3c76a91d: folds
Hero: folds
a223d3ca: raises $0.08 to $0.13
eb1bbc7a: calls $0.08
*** FLOP *** [4s As 3d]
a223d3ca: checks
eb1bbc7a: bets $0.09
a223d3ca: folds
Uncalled bet ($0.09) returned to eb1bbc7a
*** SHOWDOWN ***
eb1bbc7a collected $0.25 from pot
*** SUMMARY ***
Total pot $0.26 | Rake $0.01 | Jackpot $0 | Bingo $0 | Fortune $0 | Tax $0
Board [4s As 3d]
Seat 1: Hero (button) folded before Flop (didn't bet)
Seat 2: a223d3ca (small blind) folded on the Flop
Seat 3: eb1bbc7a (big blind) won ($0.25)
Seat 4: 6c7828d3 folded before Flop (didn't bet)
Seat 5: 35fae52e folded before Flop (didn't bet)
Seat 6: 3c76a91d folded before Flop (didn't bet)


Poker Hand #RC3334595235: Hold'em No Limit ($0.02/$0.05) - 2025/02/17 21:35:20
Table 'RushAndCash630495' 6-max Seat #1 is the button
Seat 1: Hero ($15.48 in chips)
Seat 2: 1b6c31ec ($8.75 in chips)
Seat 3: bd394772 ($7.29 in chips)
Seat 4: 35016d48 ($5.39 in chips)
Seat 5: 86b969db ($5.31 in chips)
Seat 6: 258a2071 ($7.92 in chips)
1b6c31ec: posts small blind $0.02
bd394772: posts big blind $0.05
*** HOLE CARDS ***
Dealt to Hero [Js 4s]
Dealt to 1b6c31ec 
Dealt to bd394772 
Dealt to 35016d48 
Dealt to 86b969db 
Dealt to 258a2071 
35016d48: raises $0.08 to $0.13
86b969db: raises $0.25 to $0.38
258a2071: folds
Hero: folds
1b6c31ec: folds
bd394772: folds
35016d48: calls $0.25
*** FLOP *** [Jc 9d 3c]
35016d48: checks
86b969db: bets $0.42
35016d48: folds
Uncalled bet ($0.42) returned to 86b969db
*** SHOWDOWN ***
86b969db collected $0.79 from pot
*** SUMMARY ***
Total pot $0.83 | Rake $0.04 | Jackpot $0 | Bingo $0 | Fortune $0 | Tax $0
Board [Jc 9d 3c]
Seat 1: Hero (button) folded before Flop (didn't bet)
Seat 2: 1b6c31ec (small blind) folded before Flop
Seat 3: bd394772 (big blind) folded before Flop
Seat 4: 35016d48 folded on the Flop
Seat 5: 86b969db won ($0.79)
Seat 6: 258a2071 folded before Flop (didn't bet)


Poker Hand #RC3334595208: Hold'em No Limit ($0.02/$0.05) - 2025/02/17 21:35:16
Table 'RushAndCash630468' 6-max Seat #1 is the button
Seat 1: 56b9b8a5 ($5.2 in chips)
Seat 2: Hero ($15.5 in chips)
Seat 3: eed867f5 ($9.08 in chips)
Seat 4: 9b2eb25 ($5 in chips)
Seat 5: e97b3270 ($22.34 in chips)
Seat 6: cf150da4 ($5.68 in chips)
Hero: posts small blind $0.02
eed867f5: posts big blind $0.05
*** HOLE CARDS ***
Dealt to 56b9b8a5 
Dealt to Hero [2s 8s]
Dealt to eed867f5 
Dealt to 9b2eb25 
Dealt to e97b3270 
Dealt to cf150da4 
9b2eb25: folds
e97b3270: folds
cf150da4: folds
56b9b8a5: folds
Hero: folds
Uncalled bet ($0.03) returned to eed867f5
*** SHOWDOWN ***
eed867f5 collected $0.04 from pot
*** SUMMARY ***
Total pot $0.04 | Rake $0 | Jackpot $0 | Bingo $0 | Fortune $0 | Tax $0
Seat 1: 56b9b8a5 (button) folded before Flop (didn't bet)
Seat 2: Hero (small blind) folded before Flop
Seat 3: eed867f5 (big blind) collected ($0.04)
Seat 4: 9b2eb25 folded before Flop (didn't bet)
Seat 5: e97b3270 folded before Flop (didn't bet)
Seat 6: cf150da4 folded before Flop (didn't bet)


Poker Hand #RC3334595010: Hold'em No Limit ($0.02/$0.05) - 2025/02/17 21:34:53
Table 'RushAndCash630270' 6-max Seat #1 is the button
Seat 1: d691d846 ($3.81 in chips)
Seat 2: 8d0bc73f ($10.32 in chips)
Seat 3: c7471beb ($5 in chips)
Seat 4: Hero ($15.39 in chips)
Seat 5: 58623097 ($5 in chips)
Seat 6: f9d64f1a ($5.59 in chips)
8d0bc73f: posts small blind $0.02
c7471beb: posts big blind $0.05
*** HOLE CARDS ***
Dealt to d691d846 
Dealt to 8d0bc73f 
Dealt to c7471beb 
Dealt to Hero [9s Ts]
Dealt to 58623097 
Dealt to f9d64f1a 
Hero: raises $0.05 to $0.1
58623097: folds
f9d64f1a: folds
d691d846: folds
8d0bc73f: folds
c7471beb: calls $0.05
*** FLOP *** [Jh Qd 8s]
c7471beb: checks
Hero: bets $0.12
c7471beb: folds
Uncalled bet ($0.12) returned to Hero
*** SHOWDOWN ***
Hero collected $0.21 from pot
*** SUMMARY ***
Total pot $0.22 | Rake $0.01 | Jackpot $0 | Bingo $0 | Fortune $0 | Tax $0
Board [Jh Qd 8s]
Seat 1: d691d846 (button) folded before Flop (didn't bet)
Seat 2: 8d0bc73f (small blind) folded before Flop
Seat 3: c7471beb (big blind) folded on the Flop
Seat 4: Hero won ($0.21)
Seat 5: 58623097 folded before Flop (didn't bet)
Seat 6: f9d64f1a folded before Flop (didn't bet)


Poker Hand #RC3334594955: Hold'em No Limit ($0.02/$0.05) - 2025/02/17 21:34:47
Table 'RushAndCash630215' 6-max Seat #1 is the button
Seat 1: 994faa22 ($10.45 in chips)
Seat 2: Hero ($15.41 in chips)
Seat 3: 45d33c76 ($8.43 in chips)
Seat 4: 42065dde ($5.7 in chips)
Seat 5: dbf5f543 ($7.39 in chips)
Seat 6: 48912120 ($6.57 in chips)
Hero: posts small blind $0.02
45d33c76: posts big blind $0.05
*** HOLE CARDS ***
Dealt to 994faa22 
Dealt to Hero [Tc Jh]
Dealt to 45d33c76 
Dealt to 42065dde 
Dealt to dbf5f543 
Dealt to 48912120 
42065dde: folds
dbf5f543: folds
48912120: folds
994faa22: raises $0.05 to $0.1
Hero: folds
45d33c76: folds
Uncalled bet ($0.05) returned to 994faa22
*** SHOWDOWN ***
994faa22 collected $0.12 from pot
*** SUMMARY ***
Total pot $0.12 | Rake $0 | Jackpot $0 | Bingo $0 | Fortune $0 | Tax $0
Seat 1: 994faa22 (button) collected ($0.12)
Seat 2: Hero (small blind) folded before Flop
Seat 3: 45d33c76 (big blind) folded before Flop
Seat 4: 42065dde folded before Flop (didn't bet)
Seat 5: dbf5f543 folded before Flop (didn't bet)
Seat 6: 48912120 folded before Flop (didn't bet)


Poker Hand #RC3334594916: Hold'em No Limit ($0.02/$0.05) - 2025/02/17 21:34:42
Table 'RushAndCash630176' 6-max Seat #1 is the button
Seat 1: Hero ($15.41 in chips)
Seat 2: a8c71cd6 ($5.16 in chips)
Seat 3: 719071b8 ($5.26 in chips)
Seat 4: 577bd292 ($5.92 in chips)
Seat 5: 8c8bf19e ($5 in chips)
Seat 6: 8c3789e ($6.16 in chips)
a8c71cd6: posts small blind $0.02
719071b8: posts big blind $0.05
*** HOLE CARDS ***
Dealt to Hero [2d 8h]
Dealt to a8c71cd6 
Dealt to 719071b8 
Dealt to 577bd292 
Dealt to 8c8bf19e 
Dealt to 8c3789e 
577bd292: folds
8c8bf19e: folds
8c3789e: folds
Hero: folds
a8c71cd6: folds
Uncalled bet ($0.03) returned to 719071b8
*** SHOWDOWN ***
719071b8 collected $0.04 from pot
*** SUMMARY ***
Total pot $0.04 | Rake $0 | Jackpot $0 | Bingo $0 | Fortune $0 | Tax $0
Seat 1: Hero (button) folded before Flop (didn't bet)
Seat 2: a8c71cd6 (small blind) folded before Flop
Seat 3: 719071b8 (big blind) collected ($0.04)
Seat 4: 577bd292 folded before Flop (didn't bet)
Seat 5: 8c8bf19e folded before Flop (didn't bet)
Seat 6: 8c3789e folded before Flop (didn't bet)


Poker Hand #RC3334564648: Hold'em No Limit ($0.02/$0.05) - 2025/02/17 21:34:09
Table 'RushAndCash629908' 6-max Seat #1 is the button
Seat 1: c6e11d19 ($5.47 in chips)
Seat 2: 9590c0df ($5.8 in chips)
Seat 3: 994faa22 ($10.62 in chips)
Seat 4: dda0a24a ($5 in chips)
Seat 5: b262f9e1 ($8.38 in chips)
Seat 6: Hero ($15.75 in chips)
9590c0df: posts small blind $0.02
994faa22: posts big blind $0.05
*** HOLE CARDS ***
Dealt to c6e11d19 
Dealt to 9590c0df 
Dealt to 994faa22 
Dealt to dda0a24a 
Dealt to b262f9e1 
Dealt to Hero [7d 7c]
dda0a24a: folds
b262f9e1: raises $0.1 to $0.15
Hero: calls $0.15
c6e11d19: folds
9590c0df: folds
994faa22: folds
*** FLOP *** [8s 8h 4d]
b262f9e1: bets $0.19
Hero: calls $0.19
*** TURN *** [8s 8h 4d] [5d]
b262f9e1: bets $0.38
Hero: folds
Uncalled bet ($0.38) returned to b262f9e1
*** SHOWDOWN ***
b262f9e1 collected $0.72 from pot
*** SUMMARY ***
Total pot $0.75 | Rake $0.03 | Jackpot $0 | Bingo $0 | Fortune $0 | Tax $0
Board [8s 8h 4d 5d]
Seat 1: c6e11d19 (button) folded before Flop (didn't bet)
Seat 2: 9590c0df (small blind) folded before Flop
Seat 3: 994faa22 (big blind) folded before Flop
Seat 4: dda0a24a folded before Flop (didn't bet)
Seat 5: b262f9e1 won ($0.72)
Seat 6: Hero folded on the Turn


Poker Hand #RC3334564606: Hold'em No Limit ($0.02/$0.05) - 2025/02/17 21:34:04
Table 'RushAndCash629866' 6-max Seat #1 is the button
Seat 1: b2f44cb6 ($10.9 in chips)
Seat 2: a363f4b ($4.11 in chips)
Seat 3: 89bcbb95 ($9.66 in chips)
Seat 4: fb8cc108 ($5 in chips)
Seat 5: Hero ($15.75 in chips)
Seat 6: 2f650001 ($5.46 in chips)
a363f4b: posts small blind $0.02
89bcbb95: posts big blind $0.05
*** HOLE CARDS ***
Dealt to b2f44cb6 
Dealt to a363f4b 
Dealt to 89bcbb95 
Dealt to fb8cc108 
Dealt to Hero [Ts 7d]
Dealt to 2f650001 
fb8cc108: raises $0.05 to $0.1
Hero: folds
2f650001: folds
b2f44cb6: folds
a363f4b: folds
89bcbb95: calls $0.05
*** FLOP *** [Th 8s Tc]
89bcbb95: checks
fb8cc108: checks
*** TURN *** [Th 8s Tc] [7c]
89bcbb95: checks
fb8cc108: checks
*** RIVER *** [Th 8s Tc 7c] [Kc]
89bcbb95: bets $0.17
fb8cc108: folds
Uncalled bet ($0.17) returned to 89bcbb95
*** SHOWDOWN ***
89bcbb95 collected $0.21 from pot
*** SUMMARY ***
Total pot $0.22 | Rake $0.01 | Jackpot $0 | Bingo $0 | Fortune $0 | Tax $0
Board [Th 8s Tc 7c Kc]
Seat 1: b2f44cb6 (button) folded before Flop (didn't bet)
Seat 2: a363f4b (small blind) folded before Flop
Seat 3: 89bcbb95 (big blind) won ($0.21)
Seat 4: fb8cc108 folded on the River
Seat 5: Hero folded before Flop (didn't bet)
Seat 6: 2f650001 folded before Flop (didn't bet)


Poker Hand #RC3334564578: Hold'em No Limit ($0.02/$0.05) - 2025/02/17 21:34:01
Table 'RushAndCash629838' 6-max Seat #1 is the button
Seat 1: e97b3270 ($22.36 in chips)
Seat 2: a664c86a ($5.2 in chips)
Seat 3: 95096c6a ($10.05 in chips)
Seat 4: 18491af ($6.7 in chips)
Seat 5: 5466aa49 ($5.37 in chips)
Seat 6: Hero ($15.75 in chips)
a664c86a: posts small blind $0.02
95096c6a: posts big blind $0.05
*** HOLE CARDS ***
Dealt to e97b3270 
Dealt to a664c86a 
Dealt to 95096c6a 
Dealt to 18491af 
Dealt to 5466aa49 
Dealt to Hero [Th Qd]
18491af: raises $0.05 to $0.1
5466aa49: folds
Hero: folds
e97b3270: folds
a664c86a: calls $0.08
95096c6a: folds
*** FLOP *** [Td 6s 7h]
a664c86a: checks
18491af: bets $0.13
a664c86a: folds
Uncalled bet ($0.13) returned to 18491af
*** SHOWDOWN ***
18491af collected $0.24 from pot
*** SUMMARY ***
Total pot $0.25 | Rake $0.01 | Jackpot $0 | Bingo $0 | Fortune $0 | Tax $0
Board [Td 6s 7h]
Seat 1: e97b3270 (button) folded before Flop (didn't bet)
Seat 2: a664c86a (small blind) folded on the Flop
Seat 3: 95096c6a (big blind) folded before Flop
Seat 4: 18491af won ($0.24)
Seat 5: 5466aa49 folded before Flop (didn't bet)
Seat 6: Hero folded before Flop (didn't bet)


Poker Hand #RC3334564554: Hold'em No Limit ($0.02/$0.05) - 2025/02/17 21:33:57
Table 'RushAndCash629814' 6-max Seat #1 is the button
Seat 1: fea7bb48 ($7.45 in chips)
Seat 2: dad15618 ($1.9 in chips)
Seat 3: Hero ($15.8 in chips)
Seat 4: b39a93ce ($5 in chips)
Seat 5: e97b3270 ($22.36 in chips)
Seat 6: e4385e67 ($5.15 in chips)
dad15618: posts small blind $0.02
Hero: posts big blind $0.05
*** HOLE CARDS ***
Dealt to fea7bb48 
Dealt to dad15618 
Dealt to Hero [4h 2d]
Dealt to b39a93ce 
Dealt to e97b3270 
Dealt to e4385e67 
b39a93ce: folds
e97b3270: folds
e4385e67: folds
fea7bb48: folds
dad15618: raises $0.1 to $0.15
Hero: folds
Uncalled bet ($0.1) returned to dad15618
*** SHOWDOWN ***
dad15618 collected $0.1 from pot
*** SUMMARY ***
Total pot $0.1 | Rake $0 | Jackpot $0 | Bingo $0 | Fortune $0 | Tax $0
Seat 1: fea7bb48 (button) folded before Flop (didn't bet)
Seat 2: dad15618 (small blind) collected ($0.1)
Seat 3: Hero (big blind) folded before Flop
Seat 4: b39a93ce folded before Flop (didn't bet)
Seat 5: e97b3270 folded before Flop (didn't bet)
Seat 6: e4385e67 folded before Flop (didn't bet)


Poker Hand #RC3334564515: Hold'em No Limit ($0.02/$0.05) - 2025/02/17 21:33:53
Table 'RushAndCash629775' 6-max Seat #1 is the button
Seat 1: 34028f01 ($9.37 in chips)
Seat 2: d47282a4 ($3.72 in chips)
Seat 3: a664c86a ($5.25 in chips)
Seat 4: 9f70f94d ($8.84 in chips)
Seat 5: Hero ($15.8 in chips)
Seat 6: ed18a71b ($5.87 in chips)
d47282a4: posts small blind $0.02
a664c86a: posts big blind $0.05
*** HOLE CARDS ***
Dealt to 34028f01 
Dealt to d47282a4 
Dealt to a664c86a 
Dealt to 9f70f94d 
Dealt to Hero [2c 6c]
Dealt to ed18a71b 
9f70f94d: folds
Hero: folds
ed18a71b: folds
34028f01: folds
d47282a4: raises $0.1 to $0.15
a664c86a: folds
Uncalled bet ($0.1) returned to d47282a4
*** SHOWDOWN ***
d47282a4 collected $0.1 from pot
*** SUMMARY ***
Total pot $0.1 | Rake $0 | Jackpot $0 | Bingo $0 | Fortune $0 | Tax $0
Seat 1: 34028f01 (button) folded before Flop (didn't bet)
Seat 2: d47282a4 (small blind) collected ($0.1)
Seat 3: a664c86a (big blind) folded before Flop
Seat 4: 9f70f94d folded before Flop (didn't bet)
Seat 5: Hero folded before Flop (didn't bet)
Seat 6: ed18a71b folded before Flop (didn't bet)


Poker Hand #RC3334564378: Hold'em No Limit ($0.02/$0.05) - 2025/02/17 21:33:37
Table 'RushAndCash629638' 6-max Seat #1 is the button
Seat 1: dedffe42 ($3.44 in chips)
Seat 2: Hero ($15.9 in chips)
Seat 3: d916afa1 ($20.7 in chips)
Seat 4: 3e301744 ($11.89 in chips)
Seat 5: beffcf8a ($5.54 in chips)
Seat 6: 6c1c4416 ($12.27 in chips)
Hero: posts small blind $0.02
d916afa1: posts big blind $0.05
*** HOLE CARDS ***
Dealt to dedffe42 
Dealt to Hero [Jh Kh]
Dealt to d916afa1 
Dealt to 3e301744 
Dealt to beffcf8a 
Dealt to 6c1c4416 
3e301744: folds
beffcf8a: folds
6c1c4416: folds
dedffe42: raises $0.05 to $0.1
Hero: calls $0.08
d916afa1: calls $0.05
*** FLOP *** [3c 4h 7d]
Hero: checks
d916afa1: checks
dedffe42: bets $0.1
Hero: folds
d916afa1: folds
Uncalled bet ($0.1) returned to dedffe42
*** SHOWDOWN ***
dedffe42 collected $0.29 from pot
*** SUMMARY ***
Total pot $0.3 | Rake $0.01 | Jackpot $0 | Bingo $0 | Fortune $0 | Tax $0
Board [3c 4h 7d]
Seat 1: dedffe42 (button) won ($0.29)
Seat 2: Hero (small blind) folded on the Flop
Seat 3: d916afa1 (big blind) folded on the Flop
Seat 4: 3e301744 folded before Flop (didn't bet)
Seat 5: beffcf8a folded before Flop (didn't bet)
Seat 6: 6c1c4416 folded before Flop (didn't bet)


Poker Hand #RC3334564351: Hold'em No Limit ($0.02/$0.05) - 2025/02/17 21:33:34
Table 'RushAndCash629611' 6-max Seat #1 is the button
Seat 1: f43eaf15 ($8.72 in chips)
Seat 2: fd5b33a8 ($5.56 in chips)
Seat 3: Hero ($15.95 in chips)
Seat 4: 8862e1e9 ($5.9 in chips)
Seat 5: e17748e2 ($5 in chips)
Seat 6: ff01bdba ($5.07 in chips)
fd5b33a8: posts small blind $0.02
Hero: posts big blind $0.05
*** HOLE CARDS ***
Dealt to f43eaf15 
Dealt to fd5b33a8 
Dealt to Hero [3h Ad]
Dealt to 8862e1e9 
Dealt to e17748e2 
Dealt to ff01bdba 
8862e1e9: folds
e17748e2: folds
ff01bdba: raises $0.1 to $0.15
f43eaf15: calls $0.15
fd5b33a8: folds
Hero: folds
*** FLOP *** [8s 8c 4d]
ff01bdba: bets $0.19
f43eaf15: calls $0.19
*** TURN *** [8s 8c 4d] [8d]
ff01bdba: bets $0.25
f43eaf15: folds
Uncalled bet ($0.25) returned to ff01bdba
*** SHOWDOWN ***
ff01bdba collected $0.72 from pot
*** SUMMARY ***
Total pot $0.75 | Rake $0.03 | Jackpot $0 | Bingo $0 | Fortune $0 | Tax $0
Board [8s 8c 4d 8d]
Seat 1: f43eaf15 (button) folded on the Turn
Seat 2: fd5b33a8 (small blind) folded before Flop
Seat 3: Hero (big blind) folded before Flop
Seat 4: 8862e1e9 folded before Flop (didn't bet)
Seat 5: e17748e2 folded before Flop (didn't bet)
Seat 6: ff01bdba won ($0.72)


Poker Hand #RC3334564324: Hold'em No Limit ($0.02/$0.05) - 2025/02/17 21:33:31
Table 'RushAndCash629584' 6-max Seat #1 is the button
Seat 1: 35fb946f ($9.71 in chips)
Seat 2: 5c8c19b7 ($13.78 in chips)
Seat 3: 57a66aa7 ($7.93 in chips)
Seat 4: 2b6ba85b ($4.33 in chips)
Seat 5: Hero ($15.95 in chips)
Seat 6: 6608ec00 ($5 in chips)
5c8c19b7: posts small blind $0.02
57a66aa7: posts big blind $0.05
*** HOLE CARDS ***
Dealt to 35fb946f 
Dealt to 5c8c19b7 
Dealt to 57a66aa7 
Dealt to 2b6ba85b 
Dealt to Hero [Jd 9h]
Dealt to 6608ec00 
2b6ba85b: raises $0.08 to $0.13
Hero: folds
6608ec00: folds
35fb946f: folds
5c8c19b7: calls $0.11
57a66aa7: folds
*** FLOP *** [Ts 5d 6h]
5c8c19b7: checks
2b6ba85b: bets $0.11
5c8c19b7: calls $0.11
*** TURN *** [Ts 5d 6h] [6c]
5c8c19b7: checks
2b6ba85b: checks
*** RIVER *** [Ts 5d 6h 6c] [4h]
5c8c19b7: checks
2b6ba85b: checks
5c8c19b7: shows [Qc Ah] (Pair of Sixes)
2b6ba85b: shows [2h 2d] (Pair of Sixes and Pair of Twos)
*** SHOWDOWN ***
2b6ba85b collected $0.51 from pot
*** SUMMARY ***
Total pot $0.53 | Rake $0.02 | Jackpot $0 | Bingo $0 | Fortune $0 | Tax $0
Board [Ts 5d 6h 6c 4h]
Seat 1: 35fb946f (button) folded before Flop (didn't bet)
Seat 2: 5c8c19b7 (small blind) showed [Qc Ah] and lost with Pair of Sixes
Seat 3: 57a66aa7 (big blind) folded before Flop
Seat 4: 2b6ba85b showed [2h 2d] and won ($0.51) with Pair of Sixes and Pair of Twos
Seat 5: Hero folded before Flop (didn't bet)
Seat 6: 6608ec00 folded before Flop (didn't bet)


Poker Hand #RC3334564292: Hold'em No Limit ($0.02/$0.05) - 2025/02/17 21:33:27
Table 'RushAndCash629552' 6-max Seat #1 is the button
Seat 1: Hero ($15.95 in chips)
Seat 2: b6d5854b ($4.73 in chips)
Seat 3: 5ac336e3 ($5.33 in chips)
Seat 4: 95d29c49 ($7.73 in chips)
Seat 5: 9604af2 ($6.35 in chips)
Seat 6: aa2d17c0 ($8.47 in chips)
b6d5854b: posts small blind $0.02
5ac336e3: posts big blind $0.05
*** HOLE CARDS ***
Dealt to Hero [6h Ac]
Dealt to b6d5854b 
Dealt to 5ac336e3 
Dealt to 95d29c49 
Dealt to 9604af2 
Dealt to aa2d17c0 
95d29c49: folds
9604af2: folds
aa2d17c0: folds
Hero: folds
b6d5854b: raises $0.08 to $0.13
5ac336e3: calls $0.08
*** FLOP *** [Ks 7h Ah]
b6d5854b: bets $0.18
5ac336e3: folds
Uncalled bet ($0.18) returned to b6d5854b
*** SHOWDOWN ***
b6d5854b collected $0.25 from pot
*** SUMMARY ***
Total pot $0.26 | Rake $0.01 | Jackpot $0 | Bingo $0 | Fortune $0 | Tax $0
Board [Ks 7h Ah]
Seat 1: Hero (button) folded before Flop (didn't bet)
Seat 2: b6d5854b (small blind) won ($0.25)
Seat 3: 5ac336e3 (big blind) folded on the Flop
Seat 4: 95d29c49 folded before Flop (didn't bet)
Seat 5: 9604af2 folded before Flop (didn't bet)
Seat 6: aa2d17c0 folded before Flop (didn't bet)


Poker Hand #RC3334564261: Hold'em No Limit ($0.02/$0.05) - 2025/02/17 21:33:24
Table 'RushAndCash629521' 6-max Seat #1 is the button
Seat 1: Hero ($15.95 in chips)
Seat 2: f0463362 ($5 in chips)
Seat 3: 53a8c2fd ($10.61 in chips)
Seat 4: 15125d65 ($14.9 in chips)
Seat 5: c04eb337 ($6.42 in chips)
Seat 6: a61c94e4 ($7.13 in chips)
f0463362: posts small blind $0.02
53a8c2fd: posts big blind $0.05
*** HOLE CARDS ***
Dealt to Hero [5h 4d]
Dealt to f0463362 
Dealt to 53a8c2fd 
Dealt to 15125d65 
Dealt to c04eb337 
Dealt to a61c94e4 
15125d65: folds
c04eb337: raises $0.06 to $0.11
a61c94e4: folds
Hero: folds
f0463362: folds
53a8c2fd: folds
Uncalled bet ($0.06) returned to c04eb337
*** SHOWDOWN ***
c04eb337 collected $0.12 from pot
*** SUMMARY ***
Total pot $0.12 | Rake $0 | Jackpot $0 | Bingo $0 | Fortune $0 | Tax $0
Seat 1: Hero (button) folded before Flop (didn't bet)
Seat 2: f0463362 (small blind) folded before Flop
Seat 3: 53a8c2fd (big blind) folded before Flop
Seat 4: 15125d65 folded before Flop (didn't bet)
Seat 5: c04eb337 collected ($0.12)
Seat 6: a61c94e4 folded before Flop (didn't bet)


Poker Hand #RC3334564236: Hold'em No Limit ($0.02/$0.05) - 2025/02/17 21:33:21
Table 'RushAndCash629496' 6-max Seat #1 is the button
Seat 1: 8e07c53 ($6.1 in chips)
Seat 2: d897e841 ($5.39 in chips)
Seat 3: 92fa3d91 ($6.59 in chips)
Seat 4: Hero ($15.95 in chips)
Seat 5: e76863c8 ($5.45 in chips)
Seat 6: 99df5763 ($4.79 in chips)
d897e841: posts small blind $0.02
92fa3d91: posts big blind $0.05
*** HOLE CARDS ***
Dealt to 8e07c53 
Dealt to d897e841 
Dealt to 92fa3d91 
Dealt to Hero [Tc 7s]
Dealt to e76863c8 
Dealt to 99df5763 
Hero: folds
e76863c8: folds
99df5763: raises $0.07 to $0.12
8e07c53: raises $0.21 to $0.33
d897e841: folds
92fa3d91: folds
99df5763: calls $0.21
*** FLOP *** [8c 4h Js]
99df5763: checks
8e07c53: bets $0.25
99df5763: folds
Uncalled bet ($0.25) returned to 8e07c53
*** SHOWDOWN ***
8e07c53 collected $0.7 from pot
*** SUMMARY ***
Total pot $0.73 | Rake $0.03 | Jackpot $0 | Bingo $0 | Fortune $0 | Tax $0
Board [8c 4h Js]
Seat 1: 8e07c53 (button) won ($0.7)
Seat 2: d897e841 (small blind) folded before Flop
Seat 3: 92fa3d91 (big blind) folded before Flop
Seat 4: Hero folded before Flop (didn't bet)
Seat 5: e76863c8 folded before Flop (didn't bet)
Seat 6: 99df5763 folded on the Flop


Poker Hand #RC3334564195: Hold'em No Limit ($0.02/$0.05) - 2025/02/17 21:33:17
Table 'RushAndCash629455' 6-max Seat #1 is the button
Seat 1: eb1bbc7a ($6.26 in chips)
Seat 2: 3bfcd529 ($5.15 in chips)
Seat 3: 15141573 ($5.47 in chips)
Seat 4: Hero ($15.95 in chips)
Seat 5: 15fafcaa ($5.29 in chips)
Seat 6: f4ed7f83 ($5 in chips)
3bfcd529: posts small blind $0.02
15141573: posts big blind $0.05
*** HOLE CARDS ***
Dealt to eb1bbc7a 
Dealt to 3bfcd529 
Dealt to 15141573 
Dealt to Hero [7s As]
Dealt to 15fafcaa 
Dealt to f4ed7f83 
Hero: folds
15fafcaa: folds
f4ed7f83: folds
eb1bbc7a: folds
3bfcd529: folds
Uncalled bet ($0.03) returned to 15141573
*** SHOWDOWN ***
15141573 collected $0.04 from pot
*** SUMMARY ***
Total pot $0.04 | Rake $0 | Jackpot $0 | Bingo $0 | Fortune $0 | Tax $0
Seat 1: eb1bbc7a (button) folded before Flop (didn't bet)
Seat 2: 3bfcd529 (small blind) folded before Flop
Seat 3: 15141573 (big blind) collected ($0.04)
Seat 4: Hero folded before Flop (didn't bet)
Seat 5: 15fafcaa folded before Flop (didn't bet)
Seat 6: f4ed7f83 folded before Flop (didn't bet)


Poker Hand #RC3334564165: Hold'em No Limit ($0.02/$0.05) - 2025/02/17 21:33:13
Table 'RushAndCash629425' 6-max Seat #1 is the button
Seat 1: fea7bb48 ($7.59 in chips)
Seat 2: f4ed7f83 ($5 in chips)
Seat 3: 4238ab48 ($7.62 in chips)
Seat 4: 598d859f ($15.74 in chips)
Seat 5: 15fafcaa ($5.29 in chips)
Seat 6: Hero ($15.95 in chips)
f4ed7f83: posts small blind $0.02
4238ab48: posts big blind $0.05
*** HOLE CARDS ***
Dealt to fea7bb48 
Dealt to f4ed7f83 
Dealt to 4238ab48 
Dealt to 598d859f 
Dealt to 15fafcaa 
Dealt to Hero [6d 2h]
598d859f: raises $0.08 to $0.13
15fafcaa: folds
Hero: folds
fea7bb48: folds
f4ed7f83: folds
4238ab48: folds
Uncalled bet ($0.08) returned to 598d859f
*** SHOWDOWN ***
598d859f collected $0.12 from pot
*** SUMMARY ***
Total pot $0.12 | Rake $0 | Jackpot $0 | Bingo $0 | Fortune $0 | Tax $0
Seat 1: fea7bb48 (button) folded before Flop (didn't bet)
Seat 2: f4ed7f83 (small blind) folded before Flop
Seat 3: 4238ab48 (big blind) folded before Flop
Seat 4: 598d859f collected ($0.12)
Seat 5: 15fafcaa folded before Flop (didn't bet)
Seat 6: Hero folded before Flop (didn't bet)


Poker Hand #RC3334564138: Hold'em No Limit ($0.02/$0.05) - 2025/02/17 21:33:10
Table 'RushAndCash629398' 6-max Seat #1 is the button
Seat 1: 66981141 ($13.02 in chips)
Seat 2: 4c9f897a ($6.06 in chips)
Seat 3: 50b3f230 ($5.07 in chips)
Seat 4: c2080d6e ($6.09 in chips)
Seat 5: Hero ($15.95 in chips)
Seat 6: 8e93231a ($6.36 in chips)
4c9f897a: posts small blind $0.02
50b3f230: posts big blind $0.05
*** HOLE CARDS ***
Dealt to 66981141 
Dealt to 4c9f897a 
Dealt to 50b3f230 
Dealt to c2080d6e 
Dealt to Hero [4d 6d]
Dealt to 8e93231a 
c2080d6e: folds
Hero: folds
8e93231a: folds
66981141: folds
4c9f897a: folds
Uncalled bet ($0.03) returned to 50b3f230
*** SHOWDOWN ***
50b3f230 collected $0.04 from pot
*** SUMMARY ***
Total pot $0.04 | Rake $0 | Jackpot $0 | Bingo $0 | Fortune $0 | Tax $0
Seat 1: 66981141 (button) folded before Flop (didn't bet)
Seat 2: 4c9f897a (small blind) folded before Flop
Seat 3: 50b3f230 (big blind) collected ($0.04)
Seat 4: c2080d6e folded before Flop (didn't bet)
Seat 5: Hero folded before Flop (didn't bet)
Seat 6: 8e93231a folded before Flop (didn't bet)


Poker Hand #RC3334564111: Hold'em No Limit ($0.02/$0.05) - 2025/02/17 21:33:07
Table 'RushAndCash629371' 6-max Seat #1 is the button
Seat 1: 56d81d8 ($5.61 in chips)
Seat 2: Hero ($15.97 in chips)
Seat 3: a25931dc ($5.49 in chips)
Seat 4: e5fa3450 ($5.97 in chips)
Seat 5: 8212253a ($5.27 in chips)
Seat 6: 43c437e9 ($18.5 in chips)
Hero: posts small blind $0.02
a25931dc: posts big blind $0.05
*** HOLE CARDS ***
Dealt to 56d81d8 
Dealt to Hero [4s 9d]
Dealt to a25931dc 
Dealt to e5fa3450 
Dealt to 8212253a 
Dealt to 43c437e9 
e5fa3450: folds
8212253a: folds
43c437e9: folds
56d81d8: raises $0.13 to $0.18
Hero: folds
a25931dc: folds
Uncalled bet ($0.13) returned to 56d81d8
*** SHOWDOWN ***
56d81d8 collected $0.12 from pot
*** SUMMARY ***
Total pot $0.12 | Rake $0 | Jackpot $0 | Bingo $0 | Fortune $0 | Tax $0
Seat 1: 56d81d8 (button) collected ($0.12)
Seat 2: Hero (small blind) folded before Flop
Seat 3: a25931dc (big blind) folded before Flop
Seat 4: e5fa3450 folded before Flop (didn't bet)
Seat 5: 8212253a folded before Flop (didn't bet)
Seat 6: 43c437e9 folded before Flop (didn't bet)


Poker Hand #RC3334564071: Hold'em No Limit ($0.02/$0.05) - 2025/02/17 21:33:02
Table 'RushAndCash629331' 6-max Seat #1 is the button
Seat 1: 381c6d82 ($15.29 in chips)
Seat 2: 5e3616df ($5.07 in chips)
Seat 3: 3d537b07 ($5.38 in chips)
Seat 4: 189fa0ee ($6.11 in chips)
Seat 5: Hero ($15.97 in chips)
Seat 6: a61c94e4 ($7.02 in chips)
5e3616df: posts small blind $0.02
3d537b07: posts big blind $0.05
*** HOLE CARDS ***
Dealt to 381c6d82 
Dealt to 5e3616df 
Dealt to 3d537b07 
Dealt to 189fa0ee 
Dealt to Hero [Jh 7h]
Dealt to a61c94e4 
189fa0ee: folds
Hero: folds
a61c94e4: folds
381c6d82: folds
5e3616df: raises $0.1 to $0.15
3d537b07: raises $0.35 to $0.5
5e3616df: calls $0.35
*** FLOP *** [Js 7d 2h]
5e3616df: checks
3d537b07: bets $0.4
5e3616df: raises $0.9 to $1.3
3d537b07: calls $0.9
*** TURN *** [Js 7d 2h] [6s]
5e3616df: checks
3d537b07: checks
*** RIVER *** [Js 7d 2h 6s] [6h]
5e3616df: bets $3.27 and is all-in
3d537b07: calls $3.27
5e3616df: shows [3d 4d] (Pair of Sixes)
3d537b07: shows [Ad Jd] (Pair of Jacks and Pair of Sixes)
*** SHOWDOWN ***
3d537b07 collected $9.92 from pot
*** SUMMARY ***
Total pot $10.14 | Rake $0.15 | Jackpot $0.07 | Bingo $0 | Fortune $0 | Tax $0
Board [Js 7d 2h 6s 6h]
Seat 1: 381c6d82 (button) folded before Flop (didn't bet)
Seat 2: 5e3616df (small blind) showed [3d 4d] and lost with Pair of Sixes
Seat 3: 3d537b07 (big blind) showed [Ad Jd] and won ($9.92) with Pair of Jacks and Pair of Sixes
Seat 4: 189fa0ee folded before Flop (didn't bet)
Seat 5: Hero folded before Flop (didn't bet)
Seat 6: a61c94e4 folded before Flop (didn't bet)


Poker Hand #RC3334563904: Hold'em No Limit ($0.02/$0.05) - 2025/02/17 21:32:42
Table 'RushAndCash629164' 6-max Seat #1 is the button
Seat 1: 50b3f230 ($5 in chips)
Seat 2: a4bd9290 ($6.19 in chips)
Seat 3: Hero ($16.07 in chips)
Seat 4: 189fa0ee ($6 in chips)
Seat 5: ae52b2e0 ($5.87 in chips)
Seat 6: 56b9b8a5 ($5.13 in chips)
a4bd9290: posts small blind $0.02
Hero: posts big blind $0.05
*** HOLE CARDS ***
Dealt to 50b3f230 
Dealt to a4bd9290 
Dealt to Hero [9d Kc]
Dealt to 189fa0ee 
Dealt to ae52b2e0 
Dealt to 56b9b8a5 
189fa0ee: raises $0.05 to $0.1
ae52b2e0: folds
56b9b8a5: folds
50b3f230: folds
a4bd9290: folds
Hero: calls $0.05
*** FLOP *** [2h 4d Ts]
Hero: checks
189fa0ee: bets $0.08
Hero: folds
Uncalled bet ($0.08) returned to 189fa0ee
*** SHOWDOWN ***
189fa0ee collected $0.21 from pot
*** SUMMARY ***
Total pot $0.22 | Rake $0.01 | Jackpot $0 | Bingo $0 | Fortune $0 | Tax $0
Board [2h 4d Ts]
Seat 1: 50b3f230 (button) folded before Flop (didn't bet)
Seat 2: a4bd9290 (small blind) folded before Flop
Seat 3: Hero (big blind) folded on the Flop
Seat 4: 189fa0ee won ($0.21)
Seat 5: ae52b2e0 folded before Flop (didn't bet)
Seat 6: 56b9b8a5 folded before Flop (didn't bet)


Poker Hand #RC3334563512: Hold'em No Limit ($0.02/$0.05) - 2025/02/17 21:31:55
Table 'RushAndCash628772' 6-max Seat #1 is the button
Seat 1: 9c1c8cec ($3.72 in chips)
Seat 2: c3883bcf ($6.25 in chips)
Seat 3: Hero ($17.18 in chips)
Seat 4: fad81e68 ($6.79 in chips)
Seat 5: fb6c913 ($9.04 in chips)
Seat 6: 6ab3ea38 ($5 in chips)
c3883bcf: posts small blind $0.02
Hero: posts big blind $0.05
*** HOLE CARDS ***
Dealt to 9c1c8cec 
Dealt to c3883bcf 
Dealt to Hero [Ks 9s]
Dealt to fad81e68 
Dealt to fb6c913 
Dealt to 6ab3ea38 
fad81e68: folds
fb6c913: folds
6ab3ea38: folds
9c1c8cec: raises $0.08 to $0.13
c3883bcf: folds
Hero: calls $0.08
*** FLOP *** [9c Kd 6d]
Hero: checks
9c1c8cec: bets $0.14
Hero: calls $0.14
*** TURN *** [9c Kd 6d] [3d]
Hero: checks
9c1c8cec: bets $0.28
Hero: calls $0.28
*** RIVER *** [9c Kd 6d 3d] [Jc]
Hero: checks
9c1c8cec: bets $0.56
Hero: calls $0.56
9c1c8cec: shows [6s 6h] (Three Sixes)
Hero: shows [Ks 9s] (Pair of Kings and Pair of Nines)
*** SHOWDOWN ***
9c1c8cec collected $2.07 from pot
*** SUMMARY ***
Total pot $2.24 | Rake $0.1 | Jackpot $0.07 | Bingo $0 | Fortune $0 | Tax $0
Board [9c Kd 6d 3d Jc]
Seat 1: 9c1c8cec (button) showed [6s 6h] and won ($2.07) with Three Sixes
Seat 2: c3883bcf (small blind) folded before Flop
Seat 3: Hero (big blind) showed [Ks 9s] and lost with Pair of Kings and Pair of Nines
Seat 4: fad81e68 folded before Flop (didn't bet)
Seat 5: fb6c913 folded before Flop (didn't bet)
Seat 6: 6ab3ea38 folded before Flop (didn't bet)


Poker Hand #RC3334563448: Hold'em No Limit ($0.02/$0.05) - 2025/02/17 21:31:48
Table 'RushAndCash628708' 6-max Seat #1 is the button
Seat 1: a664c86a ($4.58 in chips)
Seat 2: f23a8d23 ($5.61 in chips)
Seat 3: e2e9e4d1 ($7.9 in chips)
Seat 4: b0c3ff95 ($10.77 in chips)
Seat 5: Hero ($17.18 in chips)
Seat 6: c35cd20e ($5 in chips)
f23a8d23: posts small blind $0.02
e2e9e4d1: posts big blind $0.05
*** HOLE CARDS ***
Dealt to a664c86a 
Dealt to f23a8d23 
Dealt to e2e9e4d1 
Dealt to b0c3ff95 
Dealt to Hero [9d Jh]
Dealt to c35cd20e 
b0c3ff95: folds
Hero: folds
c35cd20e: raises $0.08 to $0.13
a664c86a: folds
f23a8d23: folds
e2e9e4d1: folds
Uncalled bet ($0.08) returned to c35cd20e
*** SHOWDOWN ***
c35cd20e collected $0.12 from pot
*** SUMMARY ***
Total pot $0.12 | Rake $0 | Jackpot $0 | Bingo $0 | Fortune $0 | Tax $0
Seat 1: a664c86a (button) folded before Flop (didn't bet)
Seat 2: f23a8d23 (small blind) folded before Flop
Seat 3: e2e9e4d1 (big blind) folded before Flop
Seat 4: b0c3ff95 folded before Flop (didn't bet)
Seat 5: Hero folded before Flop (didn't bet)
Seat 6: c35cd20e collected ($0.12)


Poker Hand #RC3334563407: Hold'em No Limit ($0.02/$0.05) - 2025/02/17 21:31:43
Table 'RushAndCash628667' 6-max Seat #1 is the button
Seat 1: Hero ($17.18 in chips)
Seat 2: 6e22a6c1 ($6.67 in chips)
Seat 3: 65ca9276 ($10.57 in chips)
Seat 4: 37bc5b77 ($5 in chips)
Seat 5: 27b4c2a6 ($5 in chips)
Seat 6: ead6cfaf ($5.18 in chips)
6e22a6c1: posts small blind $0.02
65ca9276: posts big blind $0.05
*** HOLE CARDS ***
Dealt to Hero [6d Td]
Dealt to 6e22a6c1 
Dealt to 65ca9276 
Dealt to 37bc5b77 
Dealt to 27b4c2a6 
Dealt to ead6cfaf 
37bc5b77: folds
27b4c2a6: folds
ead6cfaf: folds
Hero: folds
6e22a6c1: raises $0.05 to $0.1
65ca9276: folds
Uncalled bet ($0.05) returned to 6e22a6c1
*** SHOWDOWN ***
6e22a6c1 collected $0.1 from pot
*** SUMMARY ***
Total pot $0.1 | Rake $0 | Jackpot $0 | Bingo $0 | Fortune $0 | Tax $0
Seat 1: Hero (button) folded before Flop (didn't bet)
Seat 2: 6e22a6c1 (small blind) collected ($0.1)
Seat 3: 65ca9276 (big blind) folded before Flop
Seat 4: 37bc5b77 folded before Flop (didn't bet)
Seat 5: 27b4c2a6 folded before Flop (didn't bet)
Seat 6: ead6cfaf folded before Flop (didn't bet)


Poker Hand #RC3334563376: Hold'em No Limit ($0.02/$0.05) - 2025/02/17 21:31:39
Table 'RushAndCash628636' 6-max Seat #1 is the button
Seat 1: Hero ($17.18 in chips)
Seat 2: c35cd20e ($5 in chips)
Seat 3: 7fe74cc5 ($9.54 in chips)
Seat 4: 90bbba9f ($5 in chips)
Seat 5: 91ad3969 ($8.53 in chips)
Seat 6: c3bb6a23 ($6.56 in chips)
c35cd20e: posts small blind $0.02
7fe74cc5: posts big blind $0.05
*** HOLE CARDS ***
Dealt to Hero [2c Qd]
Dealt to c35cd20e 
Dealt to 7fe74cc5 
Dealt to 90bbba9f 
Dealt to 91ad3969 
Dealt to c3bb6a23 
90bbba9f: folds
91ad3969: folds
c3bb6a23: folds
Hero: folds
c35cd20e: folds
Uncalled bet ($0.03) returned to 7fe74cc5
*** SHOWDOWN ***
7fe74cc5 collected $0.04 from pot
*** SUMMARY ***
Total pot $0.04 | Rake $0 | Jackpot $0 | Bingo $0 | Fortune $0 | Tax $0
Seat 1: Hero (button) folded before Flop (didn't bet)
Seat 2: c35cd20e (small blind) folded before Flop
Seat 3: 7fe74cc5 (big blind) collected ($0.04)
Seat 4: 90bbba9f folded before Flop (didn't bet)
Seat 5: 91ad3969 folded before Flop (didn't bet)
Seat 6: c3bb6a23 folded before Flop (didn't bet)


Poker Hand #RC3334563334: Hold'em No Limit ($0.02/$0.05) - 2025/02/17 21:31:34
Table 'RushAndCash628594' 6-max Seat #1 is the button
Seat 1: 5c8c19b7 ($13.84 in chips)
Seat 2: Hero ($17.2 in chips)
Seat 3: 5a37a767 ($7.73 in chips)
Seat 4: 1941fa92 ($1.96 in chips)
Seat 5: 2bfd1d0c ($10.96 in chips)
Seat 6: a19fb924 ($7.02 in chips)
Hero: posts small blind $0.02
5a37a767: posts big blind $0.05
*** HOLE CARDS ***
Dealt to 5c8c19b7 
Dealt to Hero [4s 9h]
Dealt to 5a37a767 
Dealt to 1941fa92 
Dealt to 2bfd1d0c 
Dealt to a19fb924 
1941fa92: folds
2bfd1d0c: folds
a19fb924: folds
5c8c19b7: raises $0.08 to $0.13
Hero: folds
5a37a767: folds
Uncalled bet ($0.08) returned to 5c8c19b7
*** SHOWDOWN ***
5c8c19b7 collected $0.12 from pot
*** SUMMARY ***
Total pot $0.12 | Rake $0 | Jackpot $0 | Bingo $0 | Fortune $0 | Tax $0
Seat 1: 5c8c19b7 (button) collected ($0.12)
Seat 2: Hero (small blind) folded before Flop
Seat 3: 5a37a767 (big blind) folded before Flop
Seat 4: 1941fa92 folded before Flop (didn't bet)
Seat 5: 2bfd1d0c folded before Flop (didn't bet)
Seat 6: a19fb924 folded before Flop (didn't bet)


Poker Hand #RC3334563293: Hold'em No Limit ($0.02/$0.05) - 2025/02/17 21:31:29
Table 'RushAndCash628553' 6-max Seat #1 is the button
Seat 1: 6de2662f ($6.34 in chips)
Seat 2: Hero ($17.22 in chips)
Seat 3: ab43c8b8 ($9.08 in chips)
Seat 4: 8d7c8253 ($5.67 in chips)
Seat 5: 9590c0df ($5.47 in chips)
Seat 6: 9013f95e ($9.03 in chips)
Hero: posts small blind $0.02
ab43c8b8: posts big blind $0.05
*** HOLE CARDS ***
Dealt to 6de2662f 
Dealt to Hero [Th 3d]
Dealt to ab43c8b8 
Dealt to 8d7c8253 
Dealt to 9590c0df 
Dealt to 9013f95e 
8d7c8253: folds
9590c0df: raises $0.05 to $0.1
9013f95e: folds
6de2662f: folds
Hero: folds
ab43c8b8: folds
Uncalled bet ($0.05) returned to 9590c0df
*** SHOWDOWN ***
9590c0df collected $0.12 from pot
*** SUMMARY ***
Total pot $0.12 | Rake $0 | Jackpot $0 | Bingo $0 | Fortune $0 | Tax $0
Seat 1: 6de2662f (button) folded before Flop (didn't bet)
Seat 2: Hero (small blind) folded before Flop
Seat 3: ab43c8b8 (big blind) folded before Flop
Seat 4: 8d7c8253 folded before Flop (didn't bet)
Seat 5: 9590c0df collected ($0.12)
Seat 6: 9013f95e folded before Flop (didn't bet)


Poker Hand #RC3334563252: Hold'em No Limit ($0.02/$0.05) - 2025/02/17 21:31:24
Table 'RushAndCash628512' 6-max Seat #1 is the button
Seat 1: 4ec50768 ($5.08 in chips)
Seat 2: 2d23be58 ($5.02 in chips)
Seat 3: a3e1ffe ($5.48 in chips)
Seat 4: 62fdcc3c ($5.07 in chips)
Seat 5: Hero ($17.22 in chips)
Seat 6: 8d0bc73f ($10.57 in chips)
2d23be58: posts small blind $0.02
a3e1ffe: posts big blind $0.05
*** HOLE CARDS ***
Dealt to 4ec50768 
Dealt to 2d23be58 
Dealt to a3e1ffe 
Dealt to 62fdcc3c 
Dealt to Hero [2s Jc]
Dealt to 8d0bc73f 
62fdcc3c: folds
Hero: folds
8d0bc73f: folds
4ec50768: raises $0.06 to $0.11
2d23be58: raises $0.29 to $0.4
a3e1ffe: folds
4ec50768: folds
Uncalled bet ($0.29) returned to 2d23be58
*** SHOWDOWN ***
2d23be58 collected $0.26 from pot
*** SUMMARY ***
Total pot $0.27 | Rake $0.01 | Jackpot $0 | Bingo $0 | Fortune $0 | Tax $0
Seat 1: 4ec50768 (button) folded before Flop
Seat 2: 2d23be58 (small blind) collected ($0.26)
Seat 3: a3e1ffe (big blind) folded before Flop
Seat 4: 62fdcc3c folded before Flop (didn't bet)
Seat 5: Hero folded before Flop (didn't bet)
Seat 6: 8d0bc73f folded before Flop (didn't bet)


Poker Hand #RC3334563220: Hold'em No Limit ($0.02/$0.05) - 2025/02/17 21:31:21
Table 'RushAndCash628480' 6-max Seat #1 is the button
Seat 1: Hero ($17.22 in chips)
Seat 2: 9dd1ff39 ($5.13 in chips)
Seat 3: de38466f ($3.67 in chips)
Seat 4: 167e28c4 ($10.56 in chips)
Seat 5: 493727d2 ($10.93 in chips)
Seat 6: 34a123ac ($8.4 in chips)
9dd1ff39: posts small blind $0.02
de38466f: posts big blind $0.05
*** HOLE CARDS ***
Dealt to Hero [2h Ts]
Dealt to 9dd1ff39 
Dealt to de38466f 
Dealt to 167e28c4 
Dealt to 493727d2 
Dealt to 34a123ac 
167e28c4: raises $0.05 to $0.1
493727d2: folds
34a123ac: raises $0.19 to $0.29
Hero: folds
9dd1ff39: raises $0.55 to $0.84
de38466f: folds
167e28c4: folds
34a123ac: calls $0.55
*** FLOP *** [Qc 6h 3h]
9dd1ff39: checks
34a123ac: checks
*** TURN *** [Qc 6h 3h] [Jd]
9dd1ff39: checks
34a123ac: bets $0.96
9dd1ff39: calls $0.96
*** RIVER *** [Qc 6h 3h Jd] [8d]
9dd1ff39: checks
34a123ac: bets $4.95
9dd1ff39: folds
Uncalled bet ($4.95) returned to 34a123ac
*** SHOWDOWN ***
34a123ac collected $3.53 from pot
*** SUMMARY ***
Total pot $3.75 | Rake $0.15 | Jackpot $0.07 | Bingo $0 | Fortune $0 | Tax $0
Board [Qc 6h 3h Jd 8d]
Seat 1: Hero (button) folded before Flop (didn't bet)
Seat 2: 9dd1ff39 (small blind) folded on the River
Seat 3: de38466f (big blind) folded before Flop
Seat 4: 167e28c4 folded before Flop
Seat 5: 493727d2 folded before Flop (didn't bet)
Seat 6: 34a123ac won ($3.53)


Poker Hand #RC3334563183: Hold'em No Limit ($0.02/$0.05) - 2025/02/17 21:31:17
Table 'RushAndCash628443' 6-max Seat #1 is the button
Seat 1: d897e841 ($5 in chips)
Seat 2: 650e9dc7 ($11.05 in chips)
Seat 3: bacb67c8 ($7.24 in chips)
Seat 4: Hero ($17.22 in chips)
Seat 5: 7c8b3964 ($9.34 in chips)
Seat 6: d04ecf ($5.2 in chips)
650e9dc7: posts small blind $0.02
bacb67c8: posts big blind $0.05
*** HOLE CARDS ***
Dealt to d897e841 
Dealt to 650e9dc7 
Dealt to bacb67c8 
Dealt to Hero [8s 5d]
Dealt to 7c8b3964 
Dealt to d04ecf 
Hero: folds
7c8b3964: folds
d04ecf: raises $0.05 to $0.1
d897e841: raises $0.14 to $0.24
650e9dc7: folds
bacb67c8: folds
d04ecf: calls $0.14
*** FLOP *** [3s Td Qc]
d04ecf: checks
d897e841: bets $0.28
d04ecf: folds
Uncalled bet ($0.28) returned to d897e841
*** SHOWDOWN ***
d897e841 collected $0.53 from pot
*** SUMMARY ***
Total pot $0.55 | Rake $0.02 | Jackpot $0 | Bingo $0 | Fortune $0 | Tax $0
Board [3s Td Qc]
Seat 1: d897e841 (button) won ($0.53)
Seat 2: 650e9dc7 (small blind) folded before Flop
Seat 3: bacb67c8 (big blind) folded before Flop
Seat 4: Hero folded before Flop (didn't bet)
Seat 5: 7c8b3964 folded before Flop (didn't bet)
Seat 6: d04ecf folded on the Flop


Poker Hand #RC3334563102: Hold'em No Limit ($0.02/$0.05) - 2025/02/17 21:31:07
Table 'RushAndCash628362' 6-max Seat #1 is the button
Seat 1: 961414b1 ($8.5 in chips)
Seat 2: Hero ($17.24 in chips)
Seat 3: 9acb7e4c ($6.7 in chips)
Seat 4: f56d4922 ($5.61 in chips)
Seat 5: ea7a7ae0 ($5.05 in chips)
Seat 6: 167e28c4 ($10.63 in chips)
Hero: posts small blind $0.02
9acb7e4c: posts big blind $0.05
*** HOLE CARDS ***
Dealt to 961414b1 
Dealt to Hero [3h 7s]
Dealt to 9acb7e4c 
Dealt to f56d4922 
Dealt to ea7a7ae0 
Dealt to 167e28c4 
f56d4922: folds
ea7a7ae0: folds
167e28c4: folds
961414b1: calls $0.05
Hero: folds
9acb7e4c: checks
*** FLOP *** [Qs 6c Jc]
9acb7e4c: checks
961414b1: checks
*** TURN *** [Qs 6c Jc] [3s]
9acb7e4c: bets $0.06
961414b1: folds
Uncalled bet ($0.06) returned to 9acb7e4c
*** SHOWDOWN ***
9acb7e4c collected $0.12 from pot
*** SUMMARY ***
Total pot $0.12 | Rake $0 | Jackpot $0 | Bingo $0 | Fortune $0 | Tax $0
Board [Qs 6c Jc 3s]
Seat 1: 961414b1 (button) folded on the Turn
Seat 2: Hero (small blind) folded before Flop
Seat 3: 9acb7e4c (big blind) won ($0.12)
Seat 4: f56d4922 folded before Flop (didn't bet)
Seat 5: ea7a7ae0 folded before Flop (didn't bet)
Seat 6: 167e28c4 folded before Flop (didn't bet)


Poker Hand #RC3334562914: Hold'em No Limit ($0.02/$0.05) - 2025/02/17 21:30:46
Table 'RushAndCash628174' 6-max Seat #1 is the button
Seat 1: dbb7a28 ($11.37 in chips)
Seat 2: b4cd57cf ($5.19 in chips)
Seat 3: Hero ($17.37 in chips)
Seat 4: 180915b9 ($5.81 in chips)
Seat 5: f0463362 ($5.17 in chips)
Seat 6: d9b23a5b ($5.04 in chips)
b4cd57cf: posts small blind $0.02
Hero: posts big blind $0.05
*** HOLE CARDS ***
Dealt to dbb7a28 
Dealt to b4cd57cf 
Dealt to Hero [Th Qd]
Dealt to 180915b9 
Dealt to f0463362 
Dealt to d9b23a5b 
180915b9: folds
f0463362: folds
d9b23a5b: folds
dbb7a28: folds
b4cd57cf: raises $0.08 to $0.13
Hero: calls $0.08
*** FLOP *** [4c 7h 8s]
b4cd57cf: bets $0.06
Hero: folds
Uncalled bet ($0.06) returned to b4cd57cf
*** SHOWDOWN ***
b4cd57cf collected $0.25 from pot
*** SUMMARY ***
Total pot $0.26 | Rake $0.01 | Jackpot $0 | Bingo $0 | Fortune $0 | Tax $0
Board [4c 7h 8s]
Seat 1: dbb7a28 (button) folded before Flop (didn't bet)
Seat 2: b4cd57cf (small blind) won ($0.25)
Seat 3: Hero (big blind) folded on the Flop
Seat 4: 180915b9 folded before Flop (didn't bet)
Seat 5: f0463362 folded before Flop (didn't bet)
Seat 6: d9b23a5b folded before Flop (didn't bet)


Poker Hand #RC3334562887: Hold'em No Limit ($0.02/$0.05) - 2025/02/17 21:30:43
Table 'RushAndCash628147' 6-max Seat #1 is the button
Seat 1: 3bfcd529 ($5.16 in chips)
Seat 2: ef8af083 ($5.28 in chips)
Seat 3: d47282a4 ($3.42 in chips)
Seat 4: 71ee6520 ($5.82 in chips)
Seat 5: e76863c8 ($6.8 in chips)
Seat 6: Hero ($17.37 in chips)
ef8af083: posts small blind $0.02
d47282a4: posts big blind $0.05
*** HOLE CARDS ***
Dealt to 3bfcd529 
Dealt to ef8af083 
Dealt to d47282a4 
Dealt to 71ee6520 
Dealt to e76863c8 
Dealt to Hero [Ks 2c]
71ee6520: folds
e76863c8: folds
Hero: folds
3bfcd529: folds
ef8af083: folds
Uncalled bet ($0.03) returned to d47282a4
*** SHOWDOWN ***
d47282a4 collected $0.04 from pot
*** SUMMARY ***
Total pot $0.04 | Rake $0 | Jackpot $0 | Bingo $0 | Fortune $0 | Tax $0
Seat 1: 3bfcd529 (button) folded before Flop (didn't bet)
Seat 2: ef8af083 (small blind) folded before Flop
Seat 3: d47282a4 (big blind) collected ($0.04)
Seat 4: 71ee6520 folded before Flop (didn't bet)
Seat 5: e76863c8 folded before Flop (didn't bet)
Seat 6: Hero folded before Flop (didn't bet)


Poker Hand #RC3334562852: Hold'em No Limit ($0.02/$0.05) - 2025/02/17 21:30:39
Table 'RushAndCash628112' 6-max Seat #1 is the button
Seat 1: 4ebd5be6 ($5.12 in chips)
Seat 2: dad15618 ($3.87 in chips)
Seat 3: f4ed7f83 ($5.16 in chips)
Seat 4: Hero ($17.37 in chips)
Seat 5: c3883bcf ($5.52 in chips)
Seat 6: 2f650001 ($4.75 in chips)
dad15618: posts small blind $0.02
f4ed7f83: posts big blind $0.05
*** HOLE CARDS ***
Dealt to 4ebd5be6 
Dealt to dad15618 
Dealt to f4ed7f83 
Dealt to Hero [Kh 2h]
Dealt to c3883bcf 
Dealt to 2f650001 
Hero: folds
c3883bcf: folds
2f650001: folds
4ebd5be6: raises $0.06 to $0.11
dad15618: folds
f4ed7f83: folds
Uncalled bet ($0.06) returned to 4ebd5be6
*** SHOWDOWN ***
4ebd5be6 collected $0.12 from pot
*** SUMMARY ***
Total pot $0.12 | Rake $0 | Jackpot $0 | Bingo $0 | Fortune $0 | Tax $0
Seat 1: 4ebd5be6 (button) collected ($0.12)
Seat 2: dad15618 (small blind) folded before Flop
Seat 3: f4ed7f83 (big blind) folded before Flop
Seat 4: Hero folded before Flop (didn't bet)
Seat 5: c3883bcf folded before Flop (didn't bet)
Seat 6: 2f650001 folded before Flop (didn't bet)


Poker Hand #RC3334562773: Hold'em No Limit ($0.02/$0.05) - 2025/02/17 21:30:30
Table 'RushAndCash628033' 6-max Seat #1 is the button
Seat 1: 381c6d82 ($15.05 in chips)
Seat 2: c4483bd8 ($5.16 in chips)
Seat 3: fd5b33a8 ($5.64 in chips)
Seat 4: d32546a5 ($7.12 in chips)
Seat 5: Hero ($17.37 in chips)
Seat 6: cc8de981 ($9.89 in chips)
Cash Drop to Pot : total $0.5 
c4483bd8: posts small blind $0.02
fd5b33a8: posts big blind $0.05
*** HOLE CARDS ***
Dealt to 381c6d82 
Dealt to c4483bd8 
Dealt to fd5b33a8 
Dealt to d32546a5 
Dealt to Hero [7c 4d]
Dealt to cc8de981 
d32546a5: folds
Hero: folds
cc8de981: calls $0.05
381c6d82: calls $0.05
c4483bd8: calls $0.03
fd5b33a8: checks
*** FLOP *** [3c Ah Td]
c4483bd8: checks
fd5b33a8: checks
cc8de981: checks
381c6d82: checks
*** TURN *** [3c Ah Td] [2d]
c4483bd8: bets $0.24
fd5b33a8: folds
cc8de981: calls $0.24
381c6d82: folds
*** RIVER *** [3c Ah Td 2d] [8c]
c4483bd8: checks
cc8de981: checks
c4483bd8: shows [5c Qh] (Ace-High)
cc8de981: shows [3s 6d] (Pair of Treys)
*** SHOWDOWN ***
cc8de981 collected $1.13 from pot
*** SUMMARY ***
Total pot $1.18 | Rake $0.05 | Jackpot $0 | Bingo $0 | Fortune $0 | Tax $0
Board [3c Ah Td 2d 8c]
Seat 1: 381c6d82 (button) folded on the Turn
Seat 2: c4483bd8 (small blind) showed [5c Qh] and lost with Ace-High
Seat 3: fd5b33a8 (big blind) folded on the Turn
Seat 4: d32546a5 folded before Flop (didn't bet)
Seat 5: Hero folded before Flop (didn't bet)
Seat 6: cc8de981 showed [3s 6d] and won ($1.13) with Pair of Treys


Poker Hand #RC3334562733: Hold'em No Limit ($0.02/$0.05) - 2025/02/17 21:30:25
Table 'RushAndCash627993' 6-max Seat #1 is the button
Seat 1: b0c3ff95 ($10.4 in chips)
Seat 2: af7760fa ($5 in chips)
Seat 3: 8212253a ($5.29 in chips)
Seat 4: a28ca95c ($27.7 in chips)
Seat 5: Hero ($17.37 in chips)
Seat 6: 22643080 ($6.96 in chips)
af7760fa: posts small blind $0.02
8212253a: posts big blind $0.05
*** HOLE CARDS ***
Dealt to b0c3ff95 
Dealt to af7760fa 
Dealt to 8212253a 
Dealt to a28ca95c 
Dealt to Hero [7d 2s]
Dealt to 22643080 
a28ca95c: folds
Hero: folds
22643080: folds
b0c3ff95: folds
af7760fa: raises $0.1 to $0.15
8212253a: folds
Uncalled bet ($0.1) returned to af7760fa
*** SHOWDOWN ***
af7760fa collected $0.1 from pot
*** SUMMARY ***
Total pot $0.1 | Rake $0 | Jackpot $0 | Bingo $0 | Fortune $0 | Tax $0
Seat 1: b0c3ff95 (button) folded before Flop (didn't bet)
Seat 2: af7760fa (small blind) collected ($0.1)
Seat 3: 8212253a (big blind) folded before Flop
Seat 4: a28ca95c folded before Flop (didn't bet)
Seat 5: Hero folded before Flop (didn't bet)
Seat 6: 22643080 folded before Flop (didn't bet)


Poker Hand #RC3334562707: Hold'em No Limit ($0.02/$0.05) - 2025/02/17 21:30:22
Table 'RushAndCash627967' 6-max Seat #1 is the button
Seat 1: fcc3c3cc ($11.05 in chips)
Seat 2: Hero ($17.39 in chips)
Seat 3: 1e2c3e8b ($5.09 in chips)
Seat 4: c7c4cf03 ($5 in chips)
Seat 5: 22643080 ($6.96 in chips)
Seat 6: fad81e68 ($6.89 in chips)
Hero: posts small blind $0.02
1e2c3e8b: posts big blind $0.05
*** HOLE CARDS ***
Dealt to fcc3c3cc 
Dealt to Hero [6c 4c]
Dealt to 1e2c3e8b 
Dealt to c7c4cf03 
Dealt to 22643080 
Dealt to fad81e68 
c7c4cf03: raises $0.08 to $0.13
22643080: folds
fad81e68: folds
fcc3c3cc: calls $0.13
Hero: folds
1e2c3e8b: calls $0.08
*** FLOP *** [8c 2d 3d]
1e2c3e8b: checks
c7c4cf03: bets $0.31
fcc3c3cc: folds
1e2c3e8b: folds
Uncalled bet ($0.31) returned to c7c4cf03
*** SHOWDOWN ***
c7c4cf03 collected $0.39 from pot
*** SUMMARY ***
Total pot $0.41 | Rake $0.02 | Jackpot $0 | Bingo $0 | Fortune $0 | Tax $0
Board [8c 2d 3d]
Seat 1: fcc3c3cc (button) folded on the Flop
Seat 2: Hero (small blind) folded before Flop
Seat 3: 1e2c3e8b (big blind) folded on the Flop
Seat 4: c7c4cf03 won ($0.39)
Seat 5: 22643080 folded before Flop (didn't bet)
Seat 6: fad81e68 folded before Flop (didn't bet)


Poker Hand #RC3334562540: Hold'em No Limit ($0.02/$0.05) - 2025/02/17 21:30:01
Table 'RushAndCash627800' 6-max Seat #1 is the button
Seat 1: 3f6d99d0 ($4.93 in chips)
Seat 2: 6ab3ea38 ($5.07 in chips)
Seat 3: 191b60c1 ($7.98 in chips)
Seat 4: Hero ($17.32 in chips)
Seat 5: 3ed1e77f ($5.97 in chips)
Seat 6: 53a8c2fd ($10.1 in chips)
6ab3ea38: posts small blind $0.02
191b60c1: posts big blind $0.05
*** HOLE CARDS ***
Dealt to 3f6d99d0 
Dealt to 6ab3ea38 
Dealt to 191b60c1 
Dealt to Hero [8d 9d]
Dealt to 3ed1e77f 
Dealt to 53a8c2fd 
Hero: raises $0.05 to $0.1
3ed1e77f: folds
53a8c2fd: folds
3f6d99d0: folds
6ab3ea38: folds
191b60c1: folds
Uncalled bet ($0.05) returned to Hero
*** SHOWDOWN ***
Hero collected $0.12 from pot
*** SUMMARY ***
Total pot $0.12 | Rake $0 | Jackpot $0 | Bingo $0 | Fortune $0 | Tax $0
Seat 1: 3f6d99d0 (button) folded before Flop (didn't bet)
Seat 2: 6ab3ea38 (small blind) folded before Flop
Seat 3: 191b60c1 (big blind) folded before Flop
Seat 4: Hero collected ($0.12)
Seat 5: 3ed1e77f folded before Flop (didn't bet)
Seat 6: 53a8c2fd folded before Flop (didn't bet)


Poker Hand #RC3334562503: Hold'em No Limit ($0.02/$0.05) - 2025/02/17 21:29:56
Table 'RushAndCash627763' 6-max Seat #1 is the button
Seat 1: 77d77e59 ($5.3 in chips)
Seat 2: db0f0c64 ($5.8 in chips)
Seat 3: 3db4c32a ($6.09 in chips)
Seat 4: c607d475 ($4.56 in chips)
Seat 5: Hero ($17.32 in chips)
Seat 6: cc8de981 ($9.92 in chips)
db0f0c64: posts small blind $0.02
3db4c32a: posts big blind $0.05
*** HOLE CARDS ***
Dealt to 77d77e59 
Dealt to db0f0c64 
Dealt to 3db4c32a 
Dealt to c607d475 
Dealt to Hero [9s 4c]
Dealt to cc8de981 
c607d475: folds
Hero: folds
cc8de981: folds
77d77e59: folds
db0f0c64: folds
Uncalled bet ($0.03) returned to 3db4c32a
*** SHOWDOWN ***
3db4c32a collected $0.04 from pot
*** SUMMARY ***
Total pot $0.04 | Rake $0 | Jackpot $0 | Bingo $0 | Fortune $0 | Tax $0
Seat 1: 77d77e59 (button) folded before Flop (didn't bet)
Seat 2: db0f0c64 (small blind) folded before Flop
Seat 3: 3db4c32a (big blind) collected ($0.04)
Seat 4: c607d475 folded before Flop (didn't bet)
Seat 5: Hero folded before Flop (didn't bet)
Seat 6: cc8de981 folded before Flop (didn't bet)


Poker Hand #RC3334562475: Hold'em No Limit ($0.02/$0.05) - 2025/02/17 21:29:53
Table 'RushAndCash627735' 6-max Seat #1 is the button
Seat 1: 81004403 ($5.23 in chips)
Seat 2: eb1bbc7a ($4.85 in chips)
Seat 3: Hero ($17.37 in chips)
Seat 4: 8507bdad ($7.62 in chips)
Seat 5: c806dd25 ($12.65 in chips)
Seat 6: b74983a1 ($5.28 in chips)
eb1bbc7a: posts small blind $0.02
Hero: posts big blind $0.05
*** HOLE CARDS ***
Dealt to 81004403 
Dealt to eb1bbc7a 
Dealt to Hero [5s Ac]
Dealt to 8507bdad 
Dealt to c806dd25 
Dealt to b74983a1 
8507bdad: folds
c806dd25: raises $0.1 to $0.15
b74983a1: folds
81004403: calls $0.15
eb1bbc7a: calls $0.13
Hero: folds
*** FLOP *** [7h 6s Ks]
eb1bbc7a: checks
c806dd25: bets $0.38
81004403: folds
eb1bbc7a: calls $0.38
*** TURN *** [7h 6s Ks] [4s]
eb1bbc7a: checks
c806dd25: bets $1.07
eb1bbc7a: calls $1.07
*** RIVER *** [7h 6s Ks 4s] [Th]
eb1bbc7a: checks
c806dd25: checks
eb1bbc7a: shows [7s 7d] (Three Sevens)
c806dd25: shows [Jd As] (Ace-High)
*** SHOWDOWN ***
eb1bbc7a collected $3.18 from pot
*** SUMMARY ***
Total pot $3.4 | Rake $0.15 | Jackpot $0.07 | Bingo $0 | Fortune $0 | Tax $0
Board [7h 6s Ks 4s Th]
Seat 1: 81004403 (button) folded on the Flop
Seat 2: eb1bbc7a (small blind) showed [7s 7d] and won ($3.18) with Three Sevens
Seat 3: Hero (big blind) folded before Flop
Seat 4: 8507bdad folded before Flop (didn't bet)
Seat 5: c806dd25 showed [Jd As] and lost with Ace-High
Seat 6: b74983a1 folded before Flop (didn't bet)


Poker Hand #RC3334562427: Hold'em No Limit ($0.02/$0.05) - 2025/02/17 21:29:48
Table 'RushAndCash627687' 6-max Seat #1 is the button
Seat 1: 1fa8537 ($9.35 in chips)
Seat 2: 9b7148f5 ($9.61 in chips)
Seat 3: b45be298 ($2.3 in chips)
Seat 4: f23a8d23 ($5 in chips)
Seat 5: 25f30dbe ($3.9 in chips)
Seat 6: Hero ($17.37 in chips)
9b7148f5: posts small blind $0.02
b45be298: posts big blind $0.05
*** HOLE CARDS ***
Dealt to 1fa8537 
Dealt to 9b7148f5 
Dealt to b45be298 
Dealt to f23a8d23 
Dealt to 25f30dbe 
Dealt to Hero [6d 2c]
f23a8d23: folds
25f30dbe: folds
Hero: folds
1fa8537: folds
9b7148f5: raises $0.08 to $0.13
b45be298: folds
Uncalled bet ($0.08) returned to 9b7148f5
*** SHOWDOWN ***
9b7148f5 collected $0.1 from pot
*** SUMMARY ***
Total pot $0.1 | Rake $0 | Jackpot $0 | Bingo $0 | Fortune $0 | Tax $0
Seat 1: 1fa8537 (button) folded before Flop (didn't bet)
Seat 2: 9b7148f5 (small blind) collected ($0.1)
Seat 3: b45be298 (big blind) folded before Flop
Seat 4: f23a8d23 folded before Flop (didn't bet)
Seat 5: 25f30dbe folded before Flop (didn't bet)
Seat 6: Hero folded before Flop (didn't bet)


Poker Hand #RC3334562384: Hold'em No Limit ($0.02/$0.05) - 2025/02/17 21:29:43
Table 'RushAndCash627644' 6-max Seat #1 is the button
Seat 1: Hero ($17.37 in chips)
Seat 2: fa30bfa7 ($5.65 in chips)
Seat 3: fb6c913 ($9.11 in chips)
Seat 4: 4ebd5be6 ($4.82 in chips)
Seat 5: e8a5680c ($5.44 in chips)
Seat 6: d3671a33 ($4.79 in chips)
fa30bfa7: posts small blind $0.02
fb6c913: posts big blind $0.05
*** HOLE CARDS ***
Dealt to Hero [As 7c]
Dealt to fa30bfa7 
Dealt to fb6c913 
Dealt to 4ebd5be6 
Dealt to e8a5680c 
Dealt to d3671a33 
4ebd5be6: folds
e8a5680c: raises $0.05 to $0.1
d3671a33: folds
Hero: folds
fa30bfa7: raises $0.3 to $0.4
fb6c913: folds
e8a5680c: calls $0.3
*** FLOP *** [Kc Td Th]
fa30bfa7: checks
e8a5680c: bets $0.43
fa30bfa7: calls $0.43
*** TURN *** [Kc Td Th] [7d]
fa30bfa7: checks
e8a5680c: bets $1.14
fa30bfa7: folds
Uncalled bet ($1.14) returned to e8a5680c
*** SHOWDOWN ***
e8a5680c collected $1.56 from pot
*** SUMMARY ***
Total pot $1.71 | Rake $0.08 | Jackpot $0.07 | Bingo $0 | Fortune $0 | Tax $0
Board [Kc Td Th 7d]
Seat 1: Hero (button) folded before Flop (didn't bet)
Seat 2: fa30bfa7 (small blind) folded on the Turn
Seat 3: fb6c913 (big blind) folded before Flop
Seat 4: 4ebd5be6 folded before Flop (didn't bet)
Seat 5: e8a5680c won ($1.56)
Seat 6: d3671a33 folded before Flop (didn't bet)


Poker Hand #RC3334562134: Hold'em No Limit ($0.02/$0.05) - 2025/02/17 21:29:15
Table 'RushAndCash627394' 6-max Seat #1 is the button
Seat 1: 76135c78 ($12.89 in chips)
Seat 2: 5466aa49 ($5.94 in chips)
Seat 3: Hero ($17.23 in chips)
Seat 4: 3d537b07 ($4.9 in chips)
Seat 5: ca3e77e4 ($5 in chips)
Seat 6: bebd931c ($4.67 in chips)
5466aa49: posts small blind $0.02
Hero: posts big blind $0.05
*** HOLE CARDS ***
Dealt to 76135c78 
Dealt to 5466aa49 
Dealt to Hero [Kc 6c]
Dealt to 3d537b07 
Dealt to ca3e77e4 
Dealt to bebd931c 
3d537b07: folds
ca3e77e4: raises $0.08 to $0.13
bebd931c: folds
76135c78: folds
5466aa49: folds
Hero: calls $0.08
*** FLOP *** [7h 8s 5d]
Hero: checks
ca3e77e4: checks
*** TURN *** [7h 8s 5d] [4h]
Hero: bets $0.22
ca3e77e4: folds
Uncalled bet ($0.22) returned to Hero
*** SHOWDOWN ***
Hero collected $0.27 from pot
*** SUMMARY ***
Total pot $0.28 | Rake $0.01 | Jackpot $0 | Bingo $0 | Fortune $0 | Tax $0
Board [7h 8s 5d 4h]
Seat 1: 76135c78 (button) folded before Flop (didn't bet)
Seat 2: 5466aa49 (small blind) folded before Flop
Seat 3: Hero (big blind) won ($0.27)
Seat 4: 3d537b07 folded before Flop (didn't bet)
Seat 5: ca3e77e4 folded on the Turn
Seat 6: bebd931c folded before Flop (didn't bet)


Poker Hand #RC3334562100: Hold'em No Limit ($0.02/$0.05) - 2025/02/17 21:29:10
Table 'RushAndCash627360' 6-max Seat #1 is the button
Seat 1: 45d33c76 ($9.81 in chips)
Seat 2: e4307ed2 ($5.71 in chips)
Seat 3: 8cf3ad10 ($7.29 in chips)
Seat 4: 598d859f ($14.74 in chips)
Seat 5: 27b4c2a6 ($5.28 in chips)
Seat 6: Hero ($17.23 in chips)
e4307ed2: posts small blind $0.02
8cf3ad10: posts big blind $0.05
*** HOLE CARDS ***
Dealt to 45d33c76 
Dealt to e4307ed2 
Dealt to 8cf3ad10 
Dealt to 598d859f 
Dealt to 27b4c2a6 
Dealt to Hero [Qc 7c]
598d859f: folds
27b4c2a6: raises $0.08 to $0.13
Hero: folds
45d33c76: calls $0.13
e4307ed2: folds
8cf3ad10: folds
*** FLOP *** [Kh 7d Ac]
27b4c2a6: bets $0.14
45d33c76: folds
Uncalled bet ($0.14) returned to 27b4c2a6
*** SHOWDOWN ***
27b4c2a6 collected $0.31 from pot
*** SUMMARY ***
Total pot $0.33 | Rake $0.02 | Jackpot $0 | Bingo $0 | Fortune $0 | Tax $0
Board [Kh 7d Ac]
Seat 1: 45d33c76 (button) folded on the Flop
Seat 2: e4307ed2 (small blind) folded before Flop
Seat 3: 8cf3ad10 (big blind) folded before Flop
Seat 4: 598d859f folded before Flop (didn't bet)
Seat 5: 27b4c2a6 won ($0.31)
Seat 6: Hero folded before Flop (didn't bet)


Poker Hand #RC3334562069: Hold'em No Limit ($0.02/$0.05) - 2025/02/17 21:29:06
Table 'RushAndCash627329' 6-max Seat #1 is the button
Seat 1: 7d310fdd ($5 in chips)
Seat 2: 826a79b4 ($7.16 in chips)
Seat 3: 34498263 ($5.54 in chips)
Seat 4: 14d03752 ($7.6 in chips)
Seat 5: Hero ($17.23 in chips)
Seat 6: ad943a18 ($5 in chips)
826a79b4: posts small blind $0.02
34498263: posts big blind $0.05
*** HOLE CARDS ***
Dealt to 7d310fdd 
Dealt to 826a79b4 
Dealt to 34498263 
Dealt to 14d03752 
Dealt to Hero [9c Qd]
Dealt to ad943a18 
14d03752: raises $0.08 to $0.13
Hero: folds
ad943a18: folds
7d310fdd: folds
826a79b4: folds
34498263: calls $0.08
*** FLOP *** [8h 2s 3h]
34498263: checks
14d03752: bets $0.22
34498263: calls $0.22
*** TURN *** [8h 2s 3h] [Td]
34498263: checks
14d03752: bets $0.54
34498263: raises $0.71 to $1.25
14d03752: folds
Uncalled bet ($0.71) returned to 34498263
*** SHOWDOWN ***
34498263 collected $1.65 from pot
*** SUMMARY ***
Total pot $1.8 | Rake $0.08 | Jackpot $0.07 | Bingo $0 | Fortune $0 | Tax $0
Board [8h 2s 3h Td]
Seat 1: 7d310fdd (button) folded before Flop (didn't bet)
Seat 2: 826a79b4 (small blind) folded before Flop
Seat 3: 34498263 (big blind) won ($1.65)
Seat 4: 14d03752 folded on the Turn
Seat 5: Hero folded before Flop (didn't bet)
Seat 6: ad943a18 folded before Flop (didn't bet)


Poker Hand #RC3334561818: Hold'em No Limit ($0.02/$0.05) - 2025/02/17 21:28:35
Table 'RushAndCash627078' 6-max Seat #1 is the button
Seat 1: Hero ($17.07 in chips)
Seat 2: 7dd18ea7 ($13.1 in chips)
Seat 3: ceaf3b1d ($5.77 in chips)
Seat 4: ccabd9d2 ($5.42 in chips)
Seat 5: af7760fa ($5 in chips)
Seat 6: 7df4712d ($11.83 in chips)
7dd18ea7: posts small blind $0.02
ceaf3b1d: posts big blind $0.05
*** HOLE CARDS ***
Dealt to Hero [Ts Th]
Dealt to 7dd18ea7 
Dealt to ceaf3b1d 
Dealt to ccabd9d2 
Dealt to af7760fa 
Dealt to 7df4712d 
ccabd9d2: folds
af7760fa: raises $0.05 to $0.1
7df4712d: folds
Hero: calls $0.1
7dd18ea7: folds
ceaf3b1d: folds
*** FLOP *** [As Td Jh]
af7760fa: checks
Hero: bets $0.14
af7760fa: folds
Uncalled bet ($0.14) returned to Hero
*** SHOWDOWN ***
Hero collected $0.26 from pot
*** SUMMARY ***
Total pot $0.27 | Rake $0.01 | Jackpot $0 | Bingo $0 | Fortune $0 | Tax $0
Board [As Td Jh]
Seat 1: Hero (button) won ($0.26)
Seat 2: 7dd18ea7 (small blind) folded before Flop
Seat 3: ceaf3b1d (big blind) folded before Flop
Seat 4: ccabd9d2 folded before Flop (didn't bet)
Seat 5: af7760fa folded on the Flop
Seat 6: 7df4712d folded before Flop (didn't bet)


Poker Hand #RC3334561669: Hold'em No Limit ($0.02/$0.05) - 2025/02/17 21:28:17
Table 'RushAndCash626929' 6-max Seat #1 is the button
Seat 1: 34df3734 ($5 in chips)
Seat 2: e8e7349a ($5.19 in chips)
Seat 3: 573eb753 ($6.49 in chips)
Seat 4: f18b40b7 ($6.84 in chips)
Seat 5: ba806aaa ($2.89 in chips)
Seat 6: Hero ($17 in chips)
e8e7349a: posts small blind $0.02
573eb753: posts big blind $0.05
*** HOLE CARDS ***
Dealt to 34df3734 
Dealt to e8e7349a 
Dealt to 573eb753 
Dealt to f18b40b7 
Dealt to ba806aaa 
Dealt to Hero [7s 7d]
f18b40b7: folds
ba806aaa: folds
Hero: raises $0.05 to $0.1
34df3734: folds
e8e7349a: folds
573eb753: folds
Uncalled bet ($0.05) returned to Hero
*** SHOWDOWN ***
Hero collected $0.12 from pot
*** SUMMARY ***
Total pot $0.12 | Rake $0 | Jackpot $0 | Bingo $0 | Fortune $0 | Tax $0
Seat 1: 34df3734 (button) folded before Flop (didn't bet)
Seat 2: e8e7349a (small blind) folded before Flop
Seat 3: 573eb753 (big blind) folded before Flop
Seat 4: f18b40b7 folded before Flop (didn't bet)
Seat 5: ba806aaa folded before Flop (didn't bet)
Seat 6: Hero collected ($0.12)


Poker Hand #RC3334561633: Hold'em No Limit ($0.02/$0.05) - 2025/02/17 21:28:13
Table 'RushAndCash626893' 6-max Seat #1 is the button
Seat 1: a4bd9290 ($6.28 in chips)
Seat 2: 1095926a ($5.45 in chips)
Seat 3: 4b71998b ($11.37 in chips)
Seat 4: 67aeeaf2 ($9.74 in chips)
Seat 5: b48f0b59 ($5.07 in chips)
Seat 6: Hero ($16.93 in chips)
1095926a: posts small blind $0.02
4b71998b: posts big blind $0.05
*** HOLE CARDS ***
Dealt to a4bd9290 
Dealt to 1095926a 
Dealt to 4b71998b 
Dealt to 67aeeaf2 
Dealt to b48f0b59 
Dealt to Hero [4c 5h]
67aeeaf2: folds
b48f0b59: folds
Hero: folds
a4bd9290: raises $0.06 to $0.11
1095926a: folds
4b71998b: folds
Uncalled bet ($0.06) returned to a4bd9290
*** SHOWDOWN ***
a4bd9290 collected $0.12 from pot
*** SUMMARY ***
Total pot $0.12 | Rake $0 | Jackpot $0 | Bingo $0 | Fortune $0 | Tax $0
Seat 1: a4bd9290 (button) collected ($0.12)
Seat 2: 1095926a (small blind) folded before Flop
Seat 3: 4b71998b (big blind) folded before Flop
Seat 4: 67aeeaf2 folded before Flop (didn't bet)
Seat 5: b48f0b59 folded before Flop (didn't bet)
Seat 6: Hero folded before Flop (didn't bet)


Poker Hand #RC3334561606: Hold'em No Limit ($0.02/$0.05) - 2025/02/17 21:28:10
Table 'RushAndCash626866' 6-max Seat #1 is the button
Seat 1: 94b22b92 ($7.05 in chips)
Seat 2: 516da84c ($3.93 in chips)
Seat 3: Hero ($16.98 in chips)
Seat 4: ad943a18 ($5 in chips)
Seat 5: 80c22e34 ($5.72 in chips)
Seat 6: ceaf3b1d ($5.79 in chips)
516da84c: posts small blind $0.02
Hero: posts big blind $0.05
*** HOLE CARDS ***
Dealt to 94b22b92 
Dealt to 516da84c 
Dealt to Hero [5h 6c]
Dealt to ad943a18 
Dealt to 80c22e34 
Dealt to ceaf3b1d 
ad943a18: folds
80c22e34: folds
ceaf3b1d: folds
94b22b92: raises $0.08 to $0.13
516da84c: folds
Hero: folds
Uncalled bet ($0.08) returned to 94b22b92
*** SHOWDOWN ***
94b22b92 collected $0.12 from pot
*** SUMMARY ***
Total pot $0.12 | Rake $0 | Jackpot $0 | Bingo $0 | Fortune $0 | Tax $0
Seat 1: 94b22b92 (button) collected ($0.12)
Seat 2: 516da84c (small blind) folded before Flop
Seat 3: Hero (big blind) folded before Flop
Seat 4: ad943a18 folded before Flop (didn't bet)
Seat 5: 80c22e34 folded before Flop (didn't bet)
Seat 6: ceaf3b1d folded before Flop (didn't bet)


Poker Hand #RC3334561582: Hold'em No Limit ($0.02/$0.05) - 2025/02/17 21:28:07
Table 'RushAndCash626842' 6-max Seat #1 is the button
Seat 1: ac56502f ($4.39 in chips)
Seat 2: Hero ($17 in chips)
Seat 3: c3bb6a23 ($5 in chips)
Seat 4: ec0e24ed ($5.48 in chips)
Seat 5: ff65d17f ($2.35 in chips)
Seat 6: f43eaf15 ($8.96 in chips)
Hero: posts small blind $0.02
c3bb6a23: posts big blind $0.05
*** HOLE CARDS ***
Dealt to ac56502f 
Dealt to Hero [7d 9c]
Dealt to c3bb6a23 
Dealt to ec0e24ed 
Dealt to ff65d17f 
Dealt to f43eaf15 
ec0e24ed: raises $0.08 to $0.13
ff65d17f: folds
f43eaf15: folds
ac56502f: folds
Hero: folds
c3bb6a23: calls $0.08
*** FLOP *** [8s Jc 9h]
c3bb6a23: checks
ec0e24ed: bets $0.05
c3bb6a23: raises $0.25 to $0.3
ec0e24ed: calls $0.25
*** TURN *** [8s Jc 9h] [6s]
c3bb6a23: bets $0.68
ec0e24ed: calls $0.68
*** RIVER *** [8s Jc 9h 6s] [Js]
c3bb6a23: bets $0.56
ec0e24ed: calls $0.56
c3bb6a23: shows [Qh Th] (Queens-High Straight)
ec0e24ed: shows [Jh Kc] (Three Jacks)
*** SHOWDOWN ***
c3bb6a23 collected $3.14 from pot
*** SUMMARY ***
Total pot $3.36 | Rake $0.15 | Jackpot $0.07 | Bingo $0 | Fortune $0 | Tax $0
Board [8s Jc 9h 6s Js]
Seat 1: ac56502f (button) folded before Flop (didn't bet)
Seat 2: Hero (small blind) folded before Flop
Seat 3: c3bb6a23 (big blind) showed [Qh Th] and won ($3.14) with Queens-High Straight
Seat 4: ec0e24ed showed [Jh Kc] and lost with Three Jacks
Seat 5: ff65d17f folded before Flop (didn't bet)
Seat 6: f43eaf15 folded before Flop (didn't bet)


Poker Hand #RC3334561552: Hold'em No Limit ($0.02/$0.05) - 2025/02/17 21:28:04
Table 'RushAndCash626812' 6-max Seat #1 is the button
Seat 1: 53a8c2fd ($10.21 in chips)
Seat 2: a4bd9290 ($6.3 in chips)
Seat 3: Hero ($17.05 in chips)
Seat 4: e7a0ba42 ($21.68 in chips)
Seat 5: 3b85f8e6 ($13.26 in chips)
Seat 6: 19259657 ($6.43 in chips)
a4bd9290: posts small blind $0.02
Hero: posts big blind $0.05
*** HOLE CARDS ***
Dealt to 53a8c2fd 
Dealt to a4bd9290 
Dealt to Hero [3h 5d]
Dealt to e7a0ba42 
Dealt to 3b85f8e6 
Dealt to 19259657 
e7a0ba42: folds
3b85f8e6: folds
19259657: folds
53a8c2fd: folds
a4bd9290: folds
Uncalled bet ($0.03) returned to Hero
*** SHOWDOWN ***
Hero collected $0.04 from pot
*** SUMMARY ***
Total pot $0.04 | Rake $0 | Jackpot $0 | Bingo $0 | Fortune $0 | Tax $0
Seat 1: 53a8c2fd (button) folded before Flop (didn't bet)
Seat 2: a4bd9290 (small blind) folded before Flop
Seat 3: Hero (big blind) collected ($0.04)
Seat 4: e7a0ba42 folded before Flop (didn't bet)
Seat 5: 3b85f8e6 folded before Flop (didn't bet)
Seat 6: 19259657 folded before Flop (didn't bet)


Poker Hand #RC3334561522: Hold'em No Limit ($0.02/$0.05) - 2025/02/17 21:28:00
Table 'RushAndCash626782' 6-max Seat #1 is the button
Seat 1: c7c4cf03 ($5.11 in chips)
Seat 2: 8ec32764 ($5 in chips)
Seat 3: 32d40ce0 ($6.45 in chips)
Seat 4: Hero ($17.05 in chips)
Seat 5: 53a8c2fd ($10.21 in chips)
Seat 6: dcd4e05 ($1.34 in chips)
8ec32764: posts small blind $0.02
32d40ce0: posts big blind $0.05
*** HOLE CARDS ***
Dealt to c7c4cf03 
Dealt to 8ec32764 
Dealt to 32d40ce0 
Dealt to Hero [9d 4h]
Dealt to 53a8c2fd 
Dealt to dcd4e05 
Hero: folds
53a8c2fd: folds
dcd4e05: folds
c7c4cf03: raises $0.05 to $0.1
8ec32764: folds
32d40ce0: folds
Uncalled bet ($0.05) returned to c7c4cf03
*** SHOWDOWN ***
c7c4cf03 collected $0.12 from pot
*** SUMMARY ***
Total pot $0.12 | Rake $0 | Jackpot $0 | Bingo $0 | Fortune $0 | Tax $0
Seat 1: c7c4cf03 (button) collected ($0.12)
Seat 2: 8ec32764 (small blind) folded before Flop
Seat 3: 32d40ce0 (big blind) folded before Flop
Seat 4: Hero folded before Flop (didn't bet)
Seat 5: 53a8c2fd folded before Flop (didn't bet)
Seat 6: dcd4e05 folded before Flop (didn't bet)


Poker Hand #RC3334561496: Hold'em No Limit ($0.02/$0.05) - 2025/02/17 21:27:57
Table 'RushAndCash626756' 6-max Seat #1 is the button
Seat 1: Hero ($17.05 in chips)
Seat 2: e20e5cfc ($5.3 in chips)
Seat 3: 9c3abcbf ($15.94 in chips)
Seat 4: 1ff264f7 ($5.02 in chips)
Seat 5: 7cf365ea ($4.66 in chips)
Seat 6: bc8371cb ($7.47 in chips)
e20e5cfc: posts small blind $0.02
9c3abcbf: posts big blind $0.05
*** HOLE CARDS ***
Dealt to Hero [4d 5h]
Dealt to e20e5cfc 
Dealt to 9c3abcbf 
Dealt to 1ff264f7 
Dealt to 7cf365ea 
Dealt to bc8371cb 
1ff264f7: folds
7cf365ea: folds
bc8371cb: folds
Hero: folds
e20e5cfc: folds
Uncalled bet ($0.03) returned to 9c3abcbf
*** SHOWDOWN ***
9c3abcbf collected $0.04 from pot
*** SUMMARY ***
Total pot $0.04 | Rake $0 | Jackpot $0 | Bingo $0 | Fortune $0 | Tax $0
Seat 1: Hero (button) folded before Flop (didn't bet)
Seat 2: e20e5cfc (small blind) folded before Flop
Seat 3: 9c3abcbf (big blind) collected ($0.04)
Seat 4: 1ff264f7 folded before Flop (didn't bet)
Seat 5: 7cf365ea folded before Flop (didn't bet)
Seat 6: bc8371cb folded before Flop (didn't bet)


Poker Hand #RC3334561470: Hold'em No Limit ($0.02/$0.05) - 2025/02/17 21:27:54
Table 'RushAndCash626730' 6-max Seat #1 is the button
Seat 1: 2ffae4a2 ($13.37 in chips)
Seat 2: 6be17d4e ($6.08 in chips)
Seat 3: 3b85f8e6 ($13.33 in chips)
Seat 4: Hero ($17.05 in chips)
Seat 5: f52f15b4 ($1.52 in chips)
Seat 6: 679a8f7 ($8.25 in chips)
6be17d4e: posts small blind $0.02
3b85f8e6: posts big blind $0.05
*** HOLE CARDS ***
Dealt to 2ffae4a2 
Dealt to 6be17d4e 
Dealt to 3b85f8e6 
Dealt to Hero [9s 5d]
Dealt to f52f15b4 
Dealt to 679a8f7 
Hero: folds
f52f15b4: raises $1.47 to $1.52 and is all-in
679a8f7: folds
2ffae4a2: folds
6be17d4e: folds
3b85f8e6: folds
Uncalled bet ($1.47) returned to f52f15b4
*** SHOWDOWN ***
f52f15b4 collected $0.12 from pot
*** SUMMARY ***
Total pot $0.12 | Rake $0 | Jackpot $0 | Bingo $0 | Fortune $0 | Tax $0
Seat 1: 2ffae4a2 (button) folded before Flop (didn't bet)
Seat 2: 6be17d4e (small blind) folded before Flop
Seat 3: 3b85f8e6 (big blind) folded before Flop
Seat 4: Hero folded before Flop (didn't bet)
Seat 5: f52f15b4 collected ($0.12)
Seat 6: 679a8f7 folded before Flop (didn't bet)


Poker Hand #RC3334561443: Hold'em No Limit ($0.02/$0.05) - 2025/02/17 21:27:51
Table 'RushAndCash626703' 6-max Seat #1 is the button
Seat 1: 5466aa49 ($5.82 in chips)
Seat 2: 87d5083b ($22.98 in chips)
Seat 3: d03e7668 ($5.64 in chips)
Seat 4: Hero ($17.05 in chips)
Seat 5: 80c22e34 ($5.79 in chips)
Seat 6: eb1bbc7a ($5.32 in chips)
87d5083b: posts small blind $0.02
d03e7668: posts big blind $0.05
*** HOLE CARDS ***
Dealt to 5466aa49 
Dealt to 87d5083b 
Dealt to d03e7668 
Dealt to Hero [8c 2h]
Dealt to 80c22e34 
Dealt to eb1bbc7a 
Hero: folds
80c22e34: folds
eb1bbc7a: folds
5466aa49: folds
87d5083b: folds
Uncalled bet ($0.03) returned to d03e7668
*** SHOWDOWN ***
d03e7668 collected $0.04 from pot
*** SUMMARY ***
Total pot $0.04 | Rake $0 | Jackpot $0 | Bingo $0 | Fortune $0 | Tax $0
Seat 1: 5466aa49 (button) folded before Flop (didn't bet)
Seat 2: 87d5083b (small blind) folded before Flop
Seat 3: d03e7668 (big blind) collected ($0.04)
Seat 4: Hero folded before Flop (didn't bet)
Seat 5: 80c22e34 folded before Flop (didn't bet)
Seat 6: eb1bbc7a folded before Flop (didn't bet)


Poker Hand #RC3334561414: Hold'em No Limit ($0.02/$0.05) - 2025/02/17 21:27:47
Table 'RushAndCash626674' 6-max Seat #1 is the button
Seat 1: a05dd313 ($4.72 in chips)
Seat 2: Hero ($17.07 in chips)
Seat 3: c62b7a0b ($22.33 in chips)
Seat 4: 180915b9 ($5.81 in chips)
Seat 5: 7aca7e93 ($5.26 in chips)
Seat 6: ee3fdfd8 ($5 in chips)
Hero: posts small blind $0.02
c62b7a0b: posts big blind $0.05
*** HOLE CARDS ***
Dealt to a05dd313 
Dealt to Hero [Ts 6s]
Dealt to c62b7a0b 
Dealt to 180915b9 
Dealt to 7aca7e93 
Dealt to ee3fdfd8 
180915b9: folds
7aca7e93: folds
ee3fdfd8: folds
a05dd313: raises $0.07 to $0.12
Hero: folds
c62b7a0b: folds
Uncalled bet ($0.07) returned to a05dd313
*** SHOWDOWN ***
a05dd313 collected $0.12 from pot
*** SUMMARY ***
Total pot $0.12 | Rake $0 | Jackpot $0 | Bingo $0 | Fortune $0 | Tax $0
Seat 1: a05dd313 (button) collected ($0.12)
Seat 2: Hero (small blind) folded before Flop
Seat 3: c62b7a0b (big blind) folded before Flop
Seat 4: 180915b9 folded before Flop (didn't bet)
Seat 5: 7aca7e93 folded before Flop (didn't bet)
Seat 6: ee3fdfd8 folded before Flop (didn't bet)


Poker Hand #RC3334561388: Hold'em No Limit ($0.02/$0.05) - 2025/02/17 21:27:44
Table 'RushAndCash626648' 6-max Seat #1 is the button
Seat 1: 1606744a ($5.4 in chips)
Seat 2: 742ccfee ($1.87 in chips)
Seat 3: Hero ($17.12 in chips)
Seat 4: 1941fa92 ($2.23 in chips)
Seat 5: afceb40a ($2.75 in chips)
Seat 6: f1be594d ($5.17 in chips)
742ccfee: posts small blind $0.02
Hero: posts big blind $0.05
*** HOLE CARDS ***
Dealt to 1606744a 
Dealt to 742ccfee 
Dealt to Hero [2h 7h]
Dealt to 1941fa92 
Dealt to afceb40a 
Dealt to f1be594d 
1941fa92: folds
afceb40a: folds
f1be594d: folds
1606744a: raises $0.08 to $0.13
742ccfee: calls $0.11
Hero: folds
*** FLOP *** [Qc 6s Jc]
742ccfee: checks
1606744a: checks
*** TURN *** [Qc 6s Jc] [2d]
742ccfee: checks
1606744a: checks
*** RIVER *** [Qc 6s Jc 2d] [3s]
742ccfee: checks
1606744a: checks
742ccfee: shows [Jd Ad] (Pair of Jacks)
1606744a: shows [9s 9d] (Pair of Nines)
*** SHOWDOWN ***
742ccfee collected $0.3 from pot
*** SUMMARY ***
Total pot $0.31 | Rake $0.01 | Jackpot $0 | Bingo $0 | Fortune $0 | Tax $0
Board [Qc 6s Jc 2d 3s]
Seat 1: 1606744a (button) showed [9s 9d] and lost with Pair of Nines
Seat 2: 742ccfee (small blind) showed [Jd Ad] and won ($0.3) with Pair of Jacks
Seat 3: Hero (big blind) folded before Flop
Seat 4: 1941fa92 folded before Flop (didn't bet)
Seat 5: afceb40a folded before Flop (didn't bet)
Seat 6: f1be594d folded before Flop (didn't bet)


Poker Hand #RC3334561362: Hold'em No Limit ($0.02/$0.05) - 2025/02/17 21:27:41
Table 'RushAndCash626622' 6-max Seat #1 is the button
Seat 1: Hero ($17.12 in chips)
Seat 2: 42fca4f9 ($10.42 in chips)
Seat 3: c806dd25 ($12.34 in chips)
Seat 4: 207d9345 ($21.72 in chips)
Seat 5: aa2d17c0 ($6.07 in chips)
Seat 6: 19259657 ($6.36 in chips)
42fca4f9: posts small blind $0.02
c806dd25: posts big blind $0.05
*** HOLE CARDS ***
Dealt to Hero [Ks 9c]
Dealt to 42fca4f9 
Dealt to c806dd25 
Dealt to 207d9345 
Dealt to aa2d17c0 
Dealt to 19259657 
207d9345: raises $0.06 to $0.11
aa2d17c0: folds
19259657: folds
Hero: folds
42fca4f9: folds
c806dd25: folds
Uncalled bet ($0.06) returned to 207d9345
*** SHOWDOWN ***
207d9345 collected $0.12 from pot
*** SUMMARY ***
Total pot $0.12 | Rake $0 | Jackpot $0 | Bingo $0 | Fortune $0 | Tax $0
Seat 1: Hero (button) folded before Flop (didn't bet)
Seat 2: 42fca4f9 (small blind) folded before Flop
Seat 3: c806dd25 (big blind) folded before Flop
Seat 4: 207d9345 collected ($0.12)
Seat 5: aa2d17c0 folded before Flop (didn't bet)
Seat 6: 19259657 folded before Flop (didn't bet)


Poker Hand #RC3334561332: Hold'em No Limit ($0.02/$0.05) - 2025/02/17 21:27:37
Table 'RushAndCash626592' 6-max Seat #1 is the button
Seat 1: e6aa09ff ($5.03 in chips)
Seat 2: 22643080 ($7.13 in chips)
Seat 3: e3b51b04 ($11.7 in chips)
Seat 4: 573eb753 ($6.6 in chips)
Seat 5: 3ff27d73 ($7.67 in chips)
Seat 6: Hero ($17.12 in chips)
22643080: posts small blind $0.02
e3b51b04: posts big blind $0.05
*** HOLE CARDS ***
Dealt to e6aa09ff 
Dealt to 22643080 
Dealt to e3b51b04 
Dealt to 573eb753 
Dealt to 3ff27d73 
Dealt to Hero [5s 9s]
573eb753: folds
3ff27d73: folds
Hero: folds
e6aa09ff: folds
22643080: folds
Uncalled bet ($0.03) returned to e3b51b04
*** SHOWDOWN ***
e3b51b04 collected $0.04 from pot
*** SUMMARY ***
Total pot $0.04 | Rake $0 | Jackpot $0 | Bingo $0 | Fortune $0 | Tax $0
Seat 1: e6aa09ff (button) folded before Flop (didn't bet)
Seat 2: 22643080 (small blind) folded before Flop
Seat 3: e3b51b04 (big blind) collected ($0.04)
Seat 4: 573eb753 folded before Flop (didn't bet)
Seat 5: 3ff27d73 folded before Flop (didn't bet)
Seat 6: Hero folded before Flop (didn't bet)


Poker Hand #RC3334561302: Hold'em No Limit ($0.02/$0.05) - 2025/02/17 21:27:34
Table 'RushAndCash626562' 6-max Seat #1 is the button
Seat 1: e4d8df1d ($8.34 in chips)
Seat 2: Hero ($17.14 in chips)
Seat 3: 820e1571 ($5.16 in chips)
Seat 4: 83d04f0d ($3.68 in chips)
Seat 5: 5947e28d ($5 in chips)
Seat 6: 4f7979c7 ($6.22 in chips)
Hero: posts small blind $0.02
820e1571: posts big blind $0.05
*** HOLE CARDS ***
Dealt to e4d8df1d 
Dealt to Hero [4s Qc]
Dealt to 820e1571 
Dealt to 83d04f0d 
Dealt to 5947e28d 
Dealt to 4f7979c7 
83d04f0d: raises $0.05 to $0.1
5947e28d: folds
4f7979c7: folds
e4d8df1d: folds
Hero: folds
820e1571: calls $0.05
*** FLOP *** [9c Ad 6d]
820e1571: bets $0.05
83d04f0d: raises $0.24 to $0.29
820e1571: calls $0.24
*** TURN *** [9c Ad 6d] [Qh]
820e1571: checks
83d04f0d: bets $0.6
820e1571: calls $0.6
*** RIVER *** [9c Ad 6d Qh] [4h]
820e1571: checks
83d04f0d: bets $2
820e1571: folds
Uncalled bet ($2) returned to 83d04f0d
*** SHOWDOWN ***
83d04f0d collected $1.84 from pot
*** SUMMARY ***
Total pot $2 | Rake $0.09 | Jackpot $0.07 | Bingo $0 | Fortune $0 | Tax $0
Board [9c Ad 6d Qh 4h]
Seat 1: e4d8df1d (button) folded before Flop (didn't bet)
Seat 2: Hero (small blind) folded before Flop
Seat 3: 820e1571 (big blind) folded on the River
Seat 4: 83d04f0d won ($1.84)
Seat 5: 5947e28d folded before Flop (didn't bet)
Seat 6: 4f7979c7 folded before Flop (didn't bet)


Poker Hand #RC3334561274: Hold'em No Limit ($0.02/$0.05) - 2025/02/17 21:27:31
Table 'RushAndCash626534' 6-max Seat #1 is the button
Seat 1: Hero ($17.14 in chips)
Seat 2: cda83b9b ($5 in chips)
Seat 3: edcc4eda ($5.01 in chips)
Seat 4: e5c03448 ($4.64 in chips)
Seat 5: 65ca9276 ($10.33 in chips)
Seat 6: 577aa3d3 ($9.19 in chips)
cda83b9b: posts small blind $0.02
edcc4eda: posts big blind $0.05
*** HOLE CARDS ***
Dealt to Hero [2h Ks]
Dealt to cda83b9b 
Dealt to edcc4eda 
Dealt to e5c03448 
Dealt to 65ca9276 
Dealt to 577aa3d3 
e5c03448: folds
65ca9276: folds
577aa3d3: folds
Hero: folds
cda83b9b: folds
Uncalled bet ($0.03) returned to edcc4eda
*** SHOWDOWN ***
edcc4eda collected $0.04 from pot
*** SUMMARY ***
Total pot $0.04 | Rake $0 | Jackpot $0 | Bingo $0 | Fortune $0 | Tax $0
Seat 1: Hero (button) folded before Flop (didn't bet)
Seat 2: cda83b9b (small blind) folded before Flop
Seat 3: edcc4eda (big blind) collected ($0.04)
Seat 4: e5c03448 folded before Flop (didn't bet)
Seat 5: 65ca9276 folded before Flop (didn't bet)
Seat 6: 577aa3d3 folded before Flop (didn't bet)


Poker Hand #RC3334560802: Hold'em No Limit ($0.02/$0.05) - 2025/02/17 21:26:34
Table 'RushAndCash626062' 6-max Seat #1 is the button
Seat 1: a9d8ced4 ($5.09 in chips)
Seat 2: Hero ($16.86 in chips)
Seat 3: a0f1665c ($5.42 in chips)
Seat 4: b282789b ($12 in chips)
Seat 5: 577aa3d3 ($9.44 in chips)
Seat 6: ead6cfaf ($5.07 in chips)
Hero: posts small blind $0.02
a0f1665c: posts big blind $0.05
*** HOLE CARDS ***
Dealt to a9d8ced4 
Dealt to Hero [Kc Jc]
Dealt to a0f1665c 
Dealt to b282789b 
Dealt to 577aa3d3 
Dealt to ead6cfaf 
b282789b: folds
577aa3d3: raises $0.06 to $0.11
ead6cfaf: folds
a9d8ced4: folds
Hero: calls $0.09
a0f1665c: folds
*** FLOP *** [Ks 9h 4d]
Hero: checks
577aa3d3: checks
*** TURN *** [Ks 9h 4d] [5c]
Hero: checks
577aa3d3: checks
*** RIVER *** [Ks 9h 4d 5c] [6s]
Hero: bets $0.14
577aa3d3: calls $0.14
Hero: shows [Kc Jc] (Pair of Kings)
577aa3d3: shows [Td As] (Ace-High)
*** SHOWDOWN ***
Hero collected $0.53 from pot
*** SUMMARY ***
Total pot $0.55 | Rake $0.02 | Jackpot $0 | Bingo $0 | Fortune $0 | Tax $0
Board [Ks 9h 4d 5c 6s]
Seat 1: a9d8ced4 (button) folded before Flop (didn't bet)
Seat 2: Hero (small blind) showed [Kc Jc] and won ($0.53) with Pair of Kings
Seat 3: a0f1665c (big blind) folded before Flop
Seat 4: b282789b folded before Flop (didn't bet)
Seat 5: 577aa3d3 showed [Td As] and lost with Ace-High
Seat 6: ead6cfaf folded before Flop (didn't bet)


Poker Hand #RC3334560618: Hold'em No Limit ($0.02/$0.05) - 2025/02/17 21:26:13
Table 'RushAndCash625878' 6-max Seat #1 is the button
Seat 1: dfc02c40 ($6.05 in chips)
Seat 2: a9d8ced4 ($5 in chips)
Seat 3: Hero ($16.96 in chips)
Seat 4: c4311617 ($5.44 in chips)
Seat 5: 6ab3ea38 ($5 in chips)
Seat 6: a62694fc ($9.78 in chips)
a9d8ced4: posts small blind $0.02
Hero: posts big blind $0.05
*** HOLE CARDS ***
Dealt to dfc02c40 
Dealt to a9d8ced4 
Dealt to Hero [Jc Qh]
Dealt to c4311617 
Dealt to 6ab3ea38 
Dealt to a62694fc 
c4311617: folds
6ab3ea38: folds
a62694fc: folds
dfc02c40: folds
a9d8ced4: raises $0.05 to $0.1
Hero: calls $0.05
*** FLOP *** [Ad 8c 5c]
a9d8ced4: bets $0.09
Hero: folds
Uncalled bet ($0.09) returned to a9d8ced4
*** SHOWDOWN ***
a9d8ced4 collected $0.19 from pot
*** SUMMARY ***
Total pot $0.2 | Rake $0.01 | Jackpot $0 | Bingo $0 | Fortune $0 | Tax $0
Board [Ad 8c 5c]
Seat 1: dfc02c40 (button) folded before Flop (didn't bet)
Seat 2: a9d8ced4 (small blind) won ($0.19)
Seat 3: Hero (big blind) folded on the Flop
Seat 4: c4311617 folded before Flop (didn't bet)
Seat 5: 6ab3ea38 folded before Flop (didn't bet)
Seat 6: a62694fc folded before Flop (didn't bet)


Poker Hand #RC3334560589: Hold'em No Limit ($0.02/$0.05) - 2025/02/17 21:26:09
Table 'RushAndCash625849' 6-max Seat #1 is the button
Seat 1: 35016d48 ($5 in chips)
Seat 2: 5337265e ($7.87 in chips)
Seat 3: f1be594d ($5 in chips)
Seat 4: 8012317b ($11.06 in chips)
Seat 5: b0d0d63c ($12.64 in chips)
Seat 6: Hero ($16.96 in chips)
5337265e: posts small blind $0.02
f1be594d: posts big blind $0.05
*** HOLE CARDS ***
Dealt to 35016d48 
Dealt to 5337265e 
Dealt to f1be594d 
Dealt to 8012317b 
Dealt to b0d0d63c 
Dealt to Hero [3h Th]
8012317b: folds
b0d0d63c: folds
Hero: folds
35016d48: folds
5337265e: raises $0.05 to $0.1
f1be594d: folds
Uncalled bet ($0.05) returned to 5337265e
*** SHOWDOWN ***
5337265e collected $0.1 from pot
*** SUMMARY ***
Total pot $0.1 | Rake $0 | Jackpot $0 | Bingo $0 | Fortune $0 | Tax $0
Seat 1: 35016d48 (button) folded before Flop (didn't bet)
Seat 2: 5337265e (small blind) collected ($0.1)
Seat 3: f1be594d (big blind) folded before Flop
Seat 4: 8012317b folded before Flop (didn't bet)
Seat 5: b0d0d63c folded before Flop (didn't bet)
Seat 6: Hero folded before Flop (didn't bet)


Poker Hand #RC3334560515: Hold'em No Limit ($0.02/$0.05) - 2025/02/17 21:25:59
Table 'RushAndCash625775' 6-max Seat #1 is the button
Seat 1: 20c536f4 ($3.42 in chips)
Seat 2: be2b264b ($6.03 in chips)
Seat 3: 4305bf97 ($5.69 in chips)
Seat 4: 59a05aa0 ($3.47 in chips)
Seat 5: Hero ($16.96 in chips)
Seat 6: e7c4d687 ($5.5 in chips)
be2b264b: posts small blind $0.02
4305bf97: posts big blind $0.05
*** HOLE CARDS ***
Dealt to 20c536f4 
Dealt to be2b264b 
Dealt to 4305bf97 
Dealt to 59a05aa0 
Dealt to Hero [Jd Ts]
Dealt to e7c4d687 
59a05aa0: raises $0.05 to $0.1
Hero: folds
e7c4d687: raises $0.27 to $0.37
20c536f4: folds
be2b264b: folds
4305bf97: folds
59a05aa0: calls $0.27
*** FLOP *** [8d 5h 2s]
59a05aa0: checks
e7c4d687: bets $0.41
59a05aa0: folds
Uncalled bet ($0.41) returned to e7c4d687
*** SHOWDOWN ***
e7c4d687 collected $0.77 from pot
*** SUMMARY ***
Total pot $0.81 | Rake $0.04 | Jackpot $0 | Bingo $0 | Fortune $0 | Tax $0
Board [8d 5h 2s]
Seat 1: 20c536f4 (button) folded before Flop (didn't bet)
Seat 2: be2b264b (small blind) folded before Flop
Seat 3: 4305bf97 (big blind) folded before Flop
Seat 4: 59a05aa0 folded on the Flop
Seat 5: Hero folded before Flop (didn't bet)
Seat 6: e7c4d687 won ($0.77)


Poker Hand #RC3334559976: Hold'em No Limit ($0.02/$0.05) - 2025/02/17 21:24:55
Table 'RushAndCash625236' 6-max Seat #1 is the button
Seat 1: 3c76a91d ($10.55 in chips)
Seat 2: 56d81d8 ($5.22 in chips)
Seat 3: be2b264b ($5.84 in chips)
Seat 4: d201e5fe ($9.08 in chips)
Seat 5: f71501ed ($5.02 in chips)
Seat 6: Hero ($17.14 in chips)
56d81d8: posts small blind $0.02
be2b264b: posts big blind $0.05
*** HOLE CARDS ***
Dealt to 3c76a91d 
Dealt to 56d81d8 
Dealt to be2b264b 
Dealt to d201e5fe 
Dealt to f71501ed 
Dealt to Hero [Jh Jd]
d201e5fe: folds
f71501ed: folds
Hero: raises $0.05 to $0.1
3c76a91d: folds
56d81d8: folds
be2b264b: calls $0.05
*** FLOP *** [Kc 6d 9c]
be2b264b: checks
Hero: checks
*** TURN *** [Kc 6d 9c] [As]
be2b264b: checks
Hero: bets $0.08
be2b264b: calls $0.08
*** RIVER *** [Kc 6d 9c As] [6h]
be2b264b: checks
Hero: checks
be2b264b: shows [3h Ah] (Pair of Aces and Pair of Sixes)
Hero: shows [Jh Jd] (Pair of Jacks and Pair of Sixes)
*** SHOWDOWN ***
be2b264b collected $0.37 from pot
*** SUMMARY ***
Total pot $0.38 | Rake $0.01 | Jackpot $0 | Bingo $0 | Fortune $0 | Tax $0
Board [Kc 6d 9c As 6h]
Seat 1: 3c76a91d (button) folded before Flop (didn't bet)
Seat 2: 56d81d8 (small blind) folded before Flop
Seat 3: be2b264b (big blind) showed [3h Ah] and won ($0.37) with Pair of Aces and Pair of Sixes
Seat 4: d201e5fe folded before Flop (didn't bet)
Seat 5: f71501ed folded before Flop (didn't bet)
Seat 6: Hero showed [Jh Jd] and lost with Pair of Jacks and Pair of Sixes


Poker Hand #RC3334559948: Hold'em No Limit ($0.02/$0.05) - 2025/02/17 21:24:52
Table 'RushAndCash625208' 6-max Seat #1 is the button
Seat 1: 22e7e468 ($5 in chips)
Seat 2: 657ee1fc ($5.06 in chips)
Seat 3: 100d4f9e ($5.1 in chips)
Seat 4: f6efd55a ($10.08 in chips)
Seat 5: Hero ($17.14 in chips)
Seat 6: 235dd2d1 ($7.05 in chips)
657ee1fc: posts small blind $0.02
100d4f9e: posts big blind $0.05
*** HOLE CARDS ***
Dealt to 22e7e468 
Dealt to 657ee1fc 
Dealt to 100d4f9e 
Dealt to f6efd55a 
Dealt to Hero [Js 4c]
Dealt to 235dd2d1 
f6efd55a: calls $0.05
Hero: folds
235dd2d1: folds
22e7e468: folds
657ee1fc: folds
100d4f9e: checks
*** FLOP *** [Th Kd Ah]
100d4f9e: checks
f6efd55a: bets $0.1
100d4f9e: folds
Uncalled bet ($0.1) returned to f6efd55a
*** SHOWDOWN ***
f6efd55a collected $0.12 from pot
*** SUMMARY ***
Total pot $0.12 | Rake $0 | Jackpot $0 | Bingo $0 | Fortune $0 | Tax $0
Board [Th Kd Ah]
Seat 1: 22e7e468 (button) folded before Flop (didn't bet)
Seat 2: 657ee1fc (small blind) folded before Flop
Seat 3: 100d4f9e (big blind) folded on the Flop
Seat 4: f6efd55a won ($0.12)
Seat 5: Hero folded before Flop (didn't bet)
Seat 6: 235dd2d1 folded before Flop (didn't bet)


Poker Hand #RC3334559924: Hold'em No Limit ($0.02/$0.05) - 2025/02/17 21:24:49
Table 'RushAndCash625184' 6-max Seat #1 is the button
Seat 1: c4311617 ($5.47 in chips)
Seat 2: 381c6d82 ($9.9 in chips)
Seat 3: Hero ($17.19 in chips)
Seat 4: e390e48e ($9.24 in chips)
Seat 5: aa08a1c ($5.57 in chips)
Seat 6: f6efd55a ($10.08 in chips)
381c6d82: posts small blind $0.02
Hero: posts big blind $0.05
*** HOLE CARDS ***
Dealt to c4311617 
Dealt to 381c6d82 
Dealt to Hero [Kd 8s]
Dealt to e390e48e 
Dealt to aa08a1c 
Dealt to f6efd55a 
e390e48e: folds
aa08a1c: folds
f6efd55a: folds
c4311617: raises $0.05 to $0.1
381c6d82: folds
Hero: folds
Uncalled bet ($0.05) returned to c4311617
*** SHOWDOWN ***
c4311617 collected $0.12 from pot
*** SUMMARY ***
Total pot $0.12 | Rake $0 | Jackpot $0 | Bingo $0 | Fortune $0 | Tax $0
Seat 1: c4311617 (button) collected ($0.12)
Seat 2: 381c6d82 (small blind) folded before Flop
Seat 3: Hero (big blind) folded before Flop
Seat 4: e390e48e folded before Flop (didn't bet)
Seat 5: aa08a1c folded before Flop (didn't bet)
Seat 6: f6efd55a folded before Flop (didn't bet)


Poker Hand #RC3334559894: Hold'em No Limit ($0.02/$0.05) - 2025/02/17 21:24:45
Table 'RushAndCash625154' 6-max Seat #1 is the button
Seat 1: c723772e ($6.95 in chips)
Seat 2: Hero ($17.21 in chips)
Seat 3: 95e89c51 ($6.11 in chips)
Seat 4: 6ab3ea38 ($5.07 in chips)
Seat 5: 63d14fd2 ($2.91 in chips)
Seat 6: 945593bf ($17.16 in chips)
Hero: posts small blind $0.02
95e89c51: posts big blind $0.05
*** HOLE CARDS ***
Dealt to c723772e 
Dealt to Hero [7d 2c]
Dealt to 95e89c51 
Dealt to 6ab3ea38 
Dealt to 63d14fd2 
Dealt to 945593bf 
6ab3ea38: folds
63d14fd2: folds
945593bf: folds
c723772e: raises $0.05 to $0.1
Hero: folds
95e89c51: raises $0.05 to $0.15
c723772e: calls $0.05
*** FLOP *** [Jd 3h 7h]
95e89c51: bets $0.05
c723772e: calls $0.05
*** TURN *** [Jd 3h 7h] [As]
95e89c51: bets $0.05
c723772e: calls $0.05
*** RIVER *** [Jd 3h 7h As] [8h]
95e89c51: bets $0.05
c723772e: raises $0.31 to $0.36
95e89c51: folds
Uncalled bet ($0.31) returned to c723772e
*** SHOWDOWN ***
c723772e collected $0.59 from pot
*** SUMMARY ***
Total pot $0.62 | Rake $0.03 | Jackpot $0 | Bingo $0 | Fortune $0 | Tax $0
Board [Jd 3h 7h As 8h]
Seat 1: c723772e (button) won ($0.59)
Seat 2: Hero (small blind) folded before Flop
Seat 3: 95e89c51 (big blind) folded on the River
Seat 4: 6ab3ea38 folded before Flop (didn't bet)
Seat 5: 63d14fd2 folded before Flop (didn't bet)
Seat 6: 945593bf folded before Flop (didn't bet)


Poker Hand #RC3334559870: Hold'em No Limit ($0.02/$0.05) - 2025/02/17 21:24:42
Table 'RushAndCash625130' 6-max Seat #1 is the button
Seat 1: 143ede8b ($11.26 in chips)
Seat 2: 3e3946b0 ($6.03 in chips)
Seat 3: 94cb065d ($7.37 in chips)
Seat 4: 5381eb4c ($8.39 in chips)
Seat 5: 5947e28d ($5.04 in chips)
Seat 6: Hero ($17.21 in chips)
3e3946b0: posts small blind $0.02
94cb065d: posts big blind $0.05
*** HOLE CARDS ***
Dealt to 143ede8b 
Dealt to 3e3946b0 
Dealt to 94cb065d 
Dealt to 5381eb4c 
Dealt to 5947e28d 
Dealt to Hero [Js 4s]
5381eb4c: folds
5947e28d: folds
Hero: folds
143ede8b: raises $0.07 to $0.12
3e3946b0: folds
94cb065d: folds
Uncalled bet ($0.07) returned to 143ede8b
*** SHOWDOWN ***
143ede8b collected $0.12 from pot
*** SUMMARY ***
Total pot $0.12 | Rake $0 | Jackpot $0 | Bingo $0 | Fortune $0 | Tax $0
Seat 1: 143ede8b (button) collected ($0.12)
Seat 2: 3e3946b0 (small blind) folded before Flop
Seat 3: 94cb065d (big blind) folded before Flop
Seat 4: 5381eb4c folded before Flop (didn't bet)
Seat 5: 5947e28d folded before Flop (didn't bet)
Seat 6: Hero folded before Flop (didn't bet)


Poker Hand #RC3334559833: Hold'em No Limit ($0.02/$0.05) - 2025/02/17 21:24:37
Table 'RushAndCash625093' 6-max Seat #1 is the button
Seat 1: 5a37a767 ($6.62 in chips)
Seat 2: d737deb4 ($5.16 in chips)
Seat 3: d916afa1 ($22.45 in chips)
Seat 4: a9eb9f38 ($5.71 in chips)
Seat 5: Hero ($17.21 in chips)
Seat 6: 7fe74cc5 ($10.01 in chips)
d737deb4: posts small blind $0.02
d916afa1: posts big blind $0.05
*** HOLE CARDS ***
Dealt to 5a37a767 
Dealt to d737deb4 
Dealt to d916afa1 
Dealt to a9eb9f38 
Dealt to Hero [Js Tc]
Dealt to 7fe74cc5 
a9eb9f38: folds
Hero: folds
7fe74cc5: folds
5a37a767: raises $0.08 to $0.13
d737deb4: folds
d916afa1: calls $0.08
*** FLOP *** [4c Qc Ts]
d916afa1: checks
5a37a767: checks
*** TURN *** [4c Qc Ts] [Jc]
d916afa1: bets $0.1
5a37a767: folds
Uncalled bet ($0.1) returned to d916afa1
*** SHOWDOWN ***
d916afa1 collected $0.27 from pot
*** SUMMARY ***
Total pot $0.28 | Rake $0.01 | Jackpot $0 | Bingo $0 | Fortune $0 | Tax $0
Board [4c Qc Ts Jc]
Seat 1: 5a37a767 (button) folded on the Turn
Seat 2: d737deb4 (small blind) folded before Flop
Seat 3: d916afa1 (big blind) won ($0.27)
Seat 4: a9eb9f38 folded before Flop (didn't bet)
Seat 5: Hero folded before Flop (didn't bet)
Seat 6: 7fe74cc5 folded before Flop (didn't bet)


Poker Hand #RC3334559802: Hold'em No Limit ($0.02/$0.05) - 2025/02/17 21:24:33
Table 'RushAndCash625062' 6-max Seat #1 is the button
Seat 1: 66981141 ($11.09 in chips)
Seat 2: d9558276 ($5.05 in chips)
Seat 3: 381c6d82 ($9.95 in chips)
Seat 4: 89bcbb95 ($8.8 in chips)
Seat 5: 55630016 ($8.47 in chips)
Seat 6: Hero ($17.21 in chips)
d9558276: posts small blind $0.02
381c6d82: posts big blind $0.05
*** HOLE CARDS ***
Dealt to 66981141 
Dealt to d9558276 
Dealt to 381c6d82 
Dealt to 89bcbb95 
Dealt to 55630016 
Dealt to Hero [Jd 4h]
89bcbb95: folds
55630016: folds
Hero: folds
66981141: raises $0.1 to $0.15
d9558276: folds
381c6d82: folds
Uncalled bet ($0.1) returned to 66981141
*** SHOWDOWN ***
66981141 collected $0.12 from pot
*** SUMMARY ***
Total pot $0.12 | Rake $0 | Jackpot $0 | Bingo $0 | Fortune $0 | Tax $0
Seat 1: 66981141 (button) collected ($0.12)
Seat 2: d9558276 (small blind) folded before Flop
Seat 3: 381c6d82 (big blind) folded before Flop
Seat 4: 89bcbb95 folded before Flop (didn't bet)
Seat 5: 55630016 folded before Flop (didn't bet)
Seat 6: Hero folded before Flop (didn't bet)


Poker Hand #RC3334559675: Hold'em No Limit ($0.02/$0.05) - 2025/02/17 21:24:18
Table 'RushAndCash624935' 6-max Seat #1 is the button
Seat 1: ae4e82ab ($5.26 in chips)
Seat 2: ab43c8b8 ($8.96 in chips)
Seat 3: 711af4a4 ($17.56 in chips)
Seat 4: fad81e68 ($7.04 in chips)
Seat 5: Hero ($17.14 in chips)
Seat 6: 8d31c727 ($12.52 in chips)
ab43c8b8: posts small blind $0.02
711af4a4: posts big blind $0.05
*** HOLE CARDS ***
Dealt to ae4e82ab 
Dealt to ab43c8b8 
Dealt to 711af4a4 
Dealt to fad81e68 
Dealt to Hero [Qs Kh]
Dealt to 8d31c727 
fad81e68: folds
Hero: raises $0.05 to $0.1
8d31c727: folds
ae4e82ab: folds
ab43c8b8: folds
711af4a4: folds
Uncalled bet ($0.05) returned to Hero
*** SHOWDOWN ***
Hero collected $0.12 from pot
*** SUMMARY ***
Total pot $0.12 | Rake $0 | Jackpot $0 | Bingo $0 | Fortune $0 | Tax $0
Seat 1: ae4e82ab (button) folded before Flop (didn't bet)
Seat 2: ab43c8b8 (small blind) folded before Flop
Seat 3: 711af4a4 (big blind) folded before Flop
Seat 4: fad81e68 folded before Flop (didn't bet)
Seat 5: Hero collected ($0.12)
Seat 6: 8d31c727 folded before Flop (didn't bet)


Poker Hand #RC3334559650: Hold'em No Limit ($0.02/$0.05) - 2025/02/17 21:24:14
Table 'RushAndCash624910' 6-max Seat #1 is the button
Seat 1: Hero ($17.14 in chips)
Seat 2: e7a0ba42 ($18.73 in chips)
Seat 3: 9fa2589a ($4.97 in chips)
Seat 4: 3b8489a7 ($5.12 in chips)
Seat 5: b3aefb75 ($9.91 in chips)
Seat 6: 8858e1f1 ($6.76 in chips)
e7a0ba42: posts small blind $0.02
9fa2589a: posts big blind $0.05
*** HOLE CARDS ***
Dealt to Hero [As 6c]
Dealt to e7a0ba42 
Dealt to 9fa2589a 
Dealt to 3b8489a7 
Dealt to b3aefb75 
Dealt to 8858e1f1 
3b8489a7: folds
b3aefb75: folds
8858e1f1: folds
Hero: folds
e7a0ba42: raises $0.06 to $0.11
9fa2589a: folds
Uncalled bet ($0.06) returned to e7a0ba42
*** SHOWDOWN ***
e7a0ba42 collected $0.1 from pot
*** SUMMARY ***
Total pot $0.1 | Rake $0 | Jackpot $0 | Bingo $0 | Fortune $0 | Tax $0
Seat 1: Hero (button) folded before Flop (didn't bet)
Seat 2: e7a0ba42 (small blind) collected ($0.1)
Seat 3: 9fa2589a (big blind) folded before Flop
Seat 4: 3b8489a7 folded before Flop (didn't bet)
Seat 5: b3aefb75 folded before Flop (didn't bet)
Seat 6: 8858e1f1 folded before Flop (didn't bet)


Poker Hand #RC3334559618: Hold'em No Limit ($0.02/$0.05) - 2025/02/17 21:24:11
Table 'RushAndCash624878' 6-max Seat #1 is the button
Seat 1: ec0e24ed ($5.35 in chips)
Seat 2: 76135c78 ($11.88 in chips)
Seat 3: d04ecf ($4.6 in chips)
Seat 4: fea7bb48 ($5 in chips)
Seat 5: Hero ($17.14 in chips)
Seat 6: 21bff972 ($5.88 in chips)
76135c78: posts small blind $0.02
d04ecf: posts big blind $0.05
*** HOLE CARDS ***
Dealt to ec0e24ed 
Dealt to 76135c78 
Dealt to d04ecf 
Dealt to fea7bb48 
Dealt to Hero [7d Jh]
Dealt to 21bff972 
fea7bb48: raises $0.1 to $0.15
Hero: folds
21bff972: folds
ec0e24ed: folds
76135c78: folds
d04ecf: folds
Uncalled bet ($0.1) returned to fea7bb48
*** SHOWDOWN ***
fea7bb48 collected $0.12 from pot
*** SUMMARY ***
Total pot $0.12 | Rake $0 | Jackpot $0 | Bingo $0 | Fortune $0 | Tax $0
Seat 1: ec0e24ed (button) folded before Flop (didn't bet)
Seat 2: 76135c78 (small blind) folded before Flop
Seat 3: d04ecf (big blind) folded before Flop
Seat 4: fea7bb48 collected ($0.12)
Seat 5: Hero folded before Flop (didn't bet)
Seat 6: 21bff972 folded before Flop (didn't bet)


Poker Hand #RC3334559592: Hold'em No Limit ($0.02/$0.05) - 2025/02/17 21:24:07
Table 'RushAndCash624852' 6-max Seat #1 is the button
Seat 1: Hero ($17.14 in chips)
Seat 2: b282789b ($11.75 in chips)
Seat 3: 73a8db79 ($5 in chips)
Seat 4: 2ae4e16 ($3.95 in chips)
Seat 5: 8507bdad ($10.13 in chips)
Seat 6: 8d31c727 ($12.52 in chips)
b282789b: posts small blind $0.02
73a8db79: posts big blind $0.05
*** HOLE CARDS ***
Dealt to Hero [8c Kd]
Dealt to b282789b 
Dealt to 73a8db79 
Dealt to 2ae4e16 
Dealt to 8507bdad 
Dealt to 8d31c727 
2ae4e16: folds
8507bdad: folds
8d31c727: folds
Hero: folds
b282789b: raises $0.1 to $0.15
73a8db79: calls $0.1
*** FLOP *** [8d Ac 9c]
b282789b: checks
73a8db79: checks
*** TURN *** [8d Ac 9c] [Kc]
b282789b: bets $0.15
73a8db79: folds
Uncalled bet ($0.15) returned to b282789b
*** SHOWDOWN ***
b282789b collected $0.29 from pot
*** SUMMARY ***
Total pot $0.3 | Rake $0.01 | Jackpot $0 | Bingo $0 | Fortune $0 | Tax $0
Board [8d Ac 9c Kc]
Seat 1: Hero (button) folded before Flop (didn't bet)
Seat 2: b282789b (small blind) won ($0.29)
Seat 3: 73a8db79 (big blind) folded on the Turn
Seat 4: 2ae4e16 folded before Flop (didn't bet)
Seat 5: 8507bdad folded before Flop (didn't bet)
Seat 6: 8d31c727 folded before Flop (didn't bet)


Poker Hand #RC3334559406: Hold'em No Limit ($0.02/$0.05) - 2025/02/17 21:23:43
Table 'RushAndCash624666' 6-max Seat #1 is the button
Seat 1: 8507bdad ($9.98 in chips)
Seat 2: Hero ($17.25 in chips)
Seat 3: a0f1665c ($5.66 in chips)
Seat 4: 9604af2 ($7.33 in chips)
Seat 5: 8f9fd8b1 ($13.47 in chips)
Seat 6: e967023b ($4.66 in chips)
Hero: posts small blind $0.02
a0f1665c: posts big blind $0.05
*** HOLE CARDS ***
Dealt to 8507bdad 
Dealt to Hero [5c 5s]
Dealt to a0f1665c 
Dealt to 9604af2 
Dealt to 8f9fd8b1 
Dealt to e967023b 
9604af2: folds
8f9fd8b1: folds
e967023b: folds
8507bdad: raises $0.06 to $0.11
Hero: calls $0.09
a0f1665c: folds
*** FLOP *** [8d Ks Td]
Hero: checks
8507bdad: checks
*** TURN *** [8d Ks Td] [6h]
Hero: checks
8507bdad: bets $0.11
Hero: folds
Uncalled bet ($0.11) returned to 8507bdad
*** SHOWDOWN ***
8507bdad collected $0.26 from pot
*** SUMMARY ***
Total pot $0.27 | Rake $0.01 | Jackpot $0 | Bingo $0 | Fortune $0 | Tax $0
Board [8d Ks Td 6h]
Seat 1: 8507bdad (button) won ($0.26)
Seat 2: Hero (small blind) folded on the Turn
Seat 3: a0f1665c (big blind) folded before Flop
Seat 4: 9604af2 folded before Flop (didn't bet)
Seat 5: 8f9fd8b1 folded before Flop (didn't bet)
Seat 6: e967023b folded before Flop (didn't bet)


Poker Hand #RC3334559381: Hold'em No Limit ($0.02/$0.05) - 2025/02/17 21:23:40
Table 'RushAndCash624641' 6-max Seat #1 is the button
Seat 1: 866d801a ($5 in chips)
Seat 2: ad943a18 ($5.05 in chips)
Seat 3: 22a3f0e8 ($6.32 in chips)
Seat 4: Hero ($17.25 in chips)
Seat 5: 2ffae4a2 ($13.33 in chips)
Seat 6: 7df4712d ($13.68 in chips)
ad943a18: posts small blind $0.02
22a3f0e8: posts big blind $0.05
*** HOLE CARDS ***
Dealt to 866d801a 
Dealt to ad943a18 
Dealt to 22a3f0e8 
Dealt to Hero [Jc 7h]
Dealt to 2ffae4a2 
Dealt to 7df4712d 
Hero: folds
2ffae4a2: folds
7df4712d: folds
866d801a: raises $0.06 to $0.11
ad943a18: folds
22a3f0e8: folds
Uncalled bet ($0.06) returned to 866d801a
*** SHOWDOWN ***
866d801a collected $0.12 from pot
*** SUMMARY ***
Total pot $0.12 | Rake $0 | Jackpot $0 | Bingo $0 | Fortune $0 | Tax $0
Seat 1: 866d801a (button) collected ($0.12)
Seat 2: ad943a18 (small blind) folded before Flop
Seat 3: 22a3f0e8 (big blind) folded before Flop
Seat 4: Hero folded before Flop (didn't bet)
Seat 5: 2ffae4a2 folded before Flop (didn't bet)
Seat 6: 7df4712d folded before Flop (didn't bet)


Poker Hand #RC3334559358: Hold'em No Limit ($0.02/$0.05) - 2025/02/17 21:23:37
Table 'RushAndCash624618' 6-max Seat #1 is the button
Seat 1: e1132427 ($7.66 in chips)
Seat 2: fad81e68 ($7.21 in chips)
Seat 3: Hero ($17.3 in chips)
Seat 4: c9e4cf57 ($5.21 in chips)
Seat 5: ac56502f ($5 in chips)
Seat 6: 14d03752 ($7.51 in chips)
fad81e68: posts small blind $0.02
Hero: posts big blind $0.05
*** HOLE CARDS ***
Dealt to e1132427 
Dealt to fad81e68 
Dealt to Hero [2d Js]
Dealt to c9e4cf57 
Dealt to ac56502f 
Dealt to 14d03752 
c9e4cf57: folds
ac56502f: folds
14d03752: folds
e1132427: folds
fad81e68: raises $0.1 to $0.15
Hero: folds
Uncalled bet ($0.1) returned to fad81e68
*** SHOWDOWN ***
fad81e68 collected $0.1 from pot
*** SUMMARY ***
Total pot $0.1 | Rake $0 | Jackpot $0 | Bingo $0 | Fortune $0 | Tax $0
Seat 1: e1132427 (button) folded before Flop (didn't bet)
Seat 2: fad81e68 (small blind) collected ($0.1)
Seat 3: Hero (big blind) folded before Flop
Seat 4: c9e4cf57 folded before Flop (didn't bet)
Seat 5: ac56502f folded before Flop (didn't bet)
Seat 6: 14d03752 folded before Flop (didn't bet)


Poker Hand #RC3334559083: Hold'em No Limit ($0.02/$0.05) - 2025/02/17 21:23:02
Table 'RushAndCash624343' 6-max Seat #1 is the button
Seat 1: 3b85f8e6 ($14.61 in chips)
Seat 2: 697412e ($5.35 in chips)
Seat 3: fad81e68 ($7.1 in chips)
Seat 4: 2b8b2921 ($9 in chips)
Seat 5: Hero ($17.4 in chips)
Seat 6: 143ede8b ($11.26 in chips)
697412e: posts small blind $0.02
fad81e68: posts big blind $0.05
*** HOLE CARDS ***
Dealt to 3b85f8e6 
Dealt to 697412e 
Dealt to fad81e68 
Dealt to 2b8b2921 
Dealt to Hero [7h 6h]
Dealt to 143ede8b 
2b8b2921: folds
Hero: raises $0.05 to $0.1
143ede8b: folds
3b85f8e6: folds
697412e: folds
fad81e68: calls $0.05
*** FLOP *** [2c 4c 5c]
fad81e68: checks
Hero: checks
*** TURN *** [2c 4c 5c] [Jc]
fad81e68: checks
Hero: checks
*** RIVER *** [2c 4c 5c Jc] [Jd]
fad81e68: bets $0.08
Hero: folds
Uncalled bet ($0.08) returned to fad81e68
*** SHOWDOWN ***
fad81e68 collected $0.21 from pot
*** SUMMARY ***
Total pot $0.22 | Rake $0.01 | Jackpot $0 | Bingo $0 | Fortune $0 | Tax $0
Board [2c 4c 5c Jc Jd]
Seat 1: 3b85f8e6 (button) folded before Flop (didn't bet)
Seat 2: 697412e (small blind) folded before Flop
Seat 3: fad81e68 (big blind) won ($0.21)
Seat 4: 2b8b2921 folded before Flop (didn't bet)
Seat 5: Hero folded on the River
Seat 6: 143ede8b folded before Flop (didn't bet)


Poker Hand #RC3334559058: Hold'em No Limit ($0.02/$0.05) - 2025/02/17 21:22:59
Table 'RushAndCash624318' 6-max Seat #1 is the button
Seat 1: 40bb6be1 ($5.1 in chips)
Seat 2: 6d5fa70b ($5 in chips)
Seat 3: Hero ($17.45 in chips)
Seat 4: 593fbe03 ($3.2 in chips)
Seat 5: 656af102 ($7.47 in chips)
Seat 6: b7bd1225 ($8.06 in chips)
6d5fa70b: posts small blind $0.02
Hero: posts big blind $0.05
*** HOLE CARDS ***
Dealt to 40bb6be1 
Dealt to 6d5fa70b 
Dealt to Hero [2h Qh]
Dealt to 593fbe03 
Dealt to 656af102 
Dealt to b7bd1225 
593fbe03: folds
656af102: folds
b7bd1225: raises $0.07 to $0.12
40bb6be1: folds
6d5fa70b: folds
Hero: folds
Uncalled bet ($0.07) returned to b7bd1225
*** SHOWDOWN ***
b7bd1225 collected $0.12 from pot
*** SUMMARY ***
Total pot $0.12 | Rake $0 | Jackpot $0 | Bingo $0 | Fortune $0 | Tax $0
Seat 1: 40bb6be1 (button) folded before Flop (didn't bet)
Seat 2: 6d5fa70b (small blind) folded before Flop
Seat 3: Hero (big blind) folded before Flop
Seat 4: 593fbe03 folded before Flop (didn't bet)
Seat 5: 656af102 folded before Flop (didn't bet)
Seat 6: b7bd1225 collected ($0.12)


Poker Hand #RC3334559032: Hold'em No Limit ($0.02/$0.05) - 2025/02/17 21:22:56
Table 'RushAndCash624292' 6-max Seat #1 is the button
Seat 1: 75a97e80 ($7.21 in chips)
Seat 2: 8d31c727 ($12.54 in chips)
Seat 3: b8c09f2 ($6.76 in chips)
Seat 4: Hero ($17.45 in chips)
Seat 5: 14d03752 ($7.56 in chips)
Seat 6: cda83b9b ($6.69 in chips)
8d31c727: posts small blind $0.02
b8c09f2: posts big blind $0.05
*** HOLE CARDS ***
Dealt to 75a97e80 
Dealt to 8d31c727 
Dealt to b8c09f2 
Dealt to Hero [9s Qs]
Dealt to 14d03752 
Dealt to cda83b9b 
Hero: folds
14d03752: raises $0.05 to $0.1
cda83b9b: folds
75a97e80: folds
8d31c727: folds
b8c09f2: folds
Uncalled bet ($0.05) returned to 14d03752
*** SHOWDOWN ***
14d03752 collected $0.12 from pot
*** SUMMARY ***
Total pot $0.12 | Rake $0 | Jackpot $0 | Bingo $0 | Fortune $0 | Tax $0
Seat 1: 75a97e80 (button) folded before Flop (didn't bet)
Seat 2: 8d31c727 (small blind) folded before Flop
Seat 3: b8c09f2 (big blind) folded before Flop
Seat 4: Hero folded before Flop (didn't bet)
Seat 5: 14d03752 collected ($0.12)
Seat 6: cda83b9b folded before Flop (didn't bet)


Poker Hand #RC3334559007: Hold'em No Limit ($0.02/$0.05) - 2025/02/17 21:22:53
Table 'RushAndCash624267' 6-max Seat #1 is the button
Seat 1: ca3e77e4 ($2.93 in chips)
Seat 2: Hero ($17.47 in chips)
Seat 3: 93a9dba6 ($5 in chips)
Seat 4: 2c90d915 ($5.64 in chips)
Seat 5: fd5b33a8 ($5.37 in chips)
Seat 6: 375be35a ($5 in chips)
Hero: posts small blind $0.02
93a9dba6: posts big blind $0.05
*** HOLE CARDS ***
Dealt to ca3e77e4 
Dealt to Hero [Qd 5h]
Dealt to 93a9dba6 
Dealt to 2c90d915 
Dealt to fd5b33a8 
Dealt to 375be35a 
2c90d915: raises $0.08 to $0.13
fd5b33a8: folds
375be35a: folds
ca3e77e4: folds
Hero: folds
93a9dba6: calls $0.08
*** FLOP *** [Jd Ac 7s]
93a9dba6: checks
2c90d915: bets $0.19
93a9dba6: calls $0.19
*** TURN *** [Jd Ac 7s] [Kh]
93a9dba6: checks
2c90d915: checks
*** RIVER *** [Jd Ac 7s Kh] [6c]
93a9dba6: bets $4.68 and is all-in
2c90d915: folds
Uncalled bet ($4.68) returned to 93a9dba6
*** SHOWDOWN ***
93a9dba6 collected $0.63 from pot
*** SUMMARY ***
Total pot $0.66 | Rake $0.03 | Jackpot $0 | Bingo $0 | Fortune $0 | Tax $0
Board [Jd Ac 7s Kh 6c]
Seat 1: ca3e77e4 (button) folded before Flop (didn't bet)
Seat 2: Hero (small blind) folded before Flop
Seat 3: 93a9dba6 (big blind) won ($0.63)
Seat 4: 2c90d915 folded on the River
Seat 5: fd5b33a8 folded before Flop (didn't bet)
Seat 6: 375be35a folded before Flop (didn't bet)


Poker Hand #RC3334558982: Hold'em No Limit ($0.02/$0.05) - 2025/02/17 21:22:49
Table 'RushAndCash624242' 6-max Seat #1 is the button
Seat 1: ccabd9d2 ($4.55 in chips)
Seat 2: 95e89c51 ($5.51 in chips)
Seat 3: Hero ($17.52 in chips)
Seat 4: b05c1b36 ($3.74 in chips)
Seat 5: a19fb924 ($7.48 in chips)
Seat 6: a63aa4b7 ($17.28 in chips)
95e89c51: posts small blind $0.02
Hero: posts big blind $0.05
*** HOLE CARDS ***
Dealt to ccabd9d2 
Dealt to 95e89c51 
Dealt to Hero [Th 3d]
Dealt to b05c1b36 
Dealt to a19fb924 
Dealt to a63aa4b7 
b05c1b36: raises $0.05 to $0.1
a19fb924: calls $0.1
a63aa4b7: folds
ccabd9d2: folds
95e89c51: calls $0.08
Hero: folds
*** FLOP *** [Qs 6d Tc]
95e89c51: bets $0.05
b05c1b36: calls $0.05
a19fb924: calls $0.05
*** TURN *** [Qs 6d Tc] [8h]
95e89c51: bets $0.05
b05c1b36: calls $0.05
a19fb924: calls $0.05
*** RIVER *** [Qs 6d Tc 8h] [4d]
95e89c51: bets $0.05
b05c1b36: folds
a19fb924: calls $0.05
95e89c51: shows [5d 5s] (Pair of Fives)
a19fb924: shows [Jh Kc] (King-High)
*** SHOWDOWN ***
95e89c51 collected $0.72 from pot
*** SUMMARY ***
Total pot $0.75 | Rake $0.03 | Jackpot $0 | Bingo $0 | Fortune $0 | Tax $0
Board [Qs 6d Tc 8h 4d]
Seat 1: ccabd9d2 (button) folded before Flop (didn't bet)
Seat 2: 95e89c51 (small blind) showed [5d 5s] and won ($0.72) with Pair of Fives
Seat 3: Hero (big blind) folded before Flop
Seat 4: b05c1b36 folded on the River
Seat 5: a19fb924 showed [Jh Kc] and lost with King-High
Seat 6: a63aa4b7 folded before Flop (didn't bet)


Poker Hand #RC3334558825: Hold'em No Limit ($0.02/$0.05) - 2025/02/17 21:22:28
Table 'RushAndCash624085' 6-max Seat #1 is the button
Seat 1: Hero ($17.62 in chips)
Seat 2: c04eb337 ($5.09 in chips)
Seat 3: 95e89c51 ($5.4 in chips)
Seat 4: 83ea4f15 ($4.69 in chips)
Seat 5: e44002e9 ($5.62 in chips)
Seat 6: 395482a9 ($10.17 in chips)
c04eb337: posts small blind $0.02
95e89c51: posts big blind $0.05
*** HOLE CARDS ***
Dealt to Hero [Jd 9d]
Dealt to c04eb337 
Dealt to 95e89c51 
Dealt to 83ea4f15 
Dealt to e44002e9 
Dealt to 395482a9 
83ea4f15: folds
e44002e9: folds
395482a9: folds
Hero: raises $0.05 to $0.1
c04eb337: folds
95e89c51: raises $0.3 to $0.4
Hero: folds
Uncalled bet ($0.3) returned to 95e89c51
*** SHOWDOWN ***
95e89c51 collected $0.21 from pot
*** SUMMARY ***
Total pot $0.22 | Rake $0.01 | Jackpot $0 | Bingo $0 | Fortune $0 | Tax $0
Seat 1: Hero (button) folded before Flop
Seat 2: c04eb337 (small blind) folded before Flop
Seat 3: 95e89c51 (big blind) collected ($0.21)
Seat 4: 83ea4f15 folded before Flop (didn't bet)
Seat 5: e44002e9 folded before Flop (didn't bet)
Seat 6: 395482a9 folded before Flop (didn't bet)


Poker Hand #RC3334558802: Hold'em No Limit ($0.02/$0.05) - 2025/02/17 21:22:25
Table 'RushAndCash624062' 6-max Seat #1 is the button
Seat 1: c7c4cf03 ($5 in chips)
Seat 2: Hero ($17.64 in chips)
Seat 3: be2b264b ($5.17 in chips)
Seat 4: 38a4c833 ($5.02 in chips)
Seat 5: e44002e9 ($5.62 in chips)
Seat 6: a93f76f9 ($5.07 in chips)
Hero: posts small blind $0.02
be2b264b: posts big blind $0.05
*** HOLE CARDS ***
Dealt to c7c4cf03 
Dealt to Hero [7h 8c]
Dealt to be2b264b 
Dealt to 38a4c833 
Dealt to e44002e9 
Dealt to a93f76f9 
38a4c833: raises $0.05 to $0.1
e44002e9: folds
a93f76f9: folds
c7c4cf03: folds
Hero: folds
be2b264b: folds
Uncalled bet ($0.05) returned to 38a4c833
*** SHOWDOWN ***
38a4c833 collected $0.12 from pot
*** SUMMARY ***
Total pot $0.12 | Rake $0 | Jackpot $0 | Bingo $0 | Fortune $0 | Tax $0
Seat 1: c7c4cf03 (button) folded before Flop (didn't bet)
Seat 2: Hero (small blind) folded before Flop
Seat 3: be2b264b (big blind) folded before Flop
Seat 4: 38a4c833 collected ($0.12)
Seat 5: e44002e9 folded before Flop (didn't bet)
Seat 6: a93f76f9 folded before Flop (didn't bet)


Poker Hand #RC3334558778: Hold'em No Limit ($0.02/$0.05) - 2025/02/17 21:22:22
Table 'RushAndCash624038' 6-max Seat #1 is the button
Seat 1: fc77b046 ($6.85 in chips)
Seat 2: 530477b2 ($5.07 in chips)
Seat 3: 473117d5 ($5 in chips)
Seat 4: Hero ($17.64 in chips)
Seat 5: c35cd20e ($5 in chips)
Seat 6: cd53b3fd ($5.17 in chips)
530477b2: posts small blind $0.02
473117d5: posts big blind $0.05
*** HOLE CARDS ***
Dealt to fc77b046 
Dealt to 530477b2 
Dealt to 473117d5 
Dealt to Hero [Kh 9c]
Dealt to c35cd20e 
Dealt to cd53b3fd 
Hero: folds
c35cd20e: folds
cd53b3fd: folds
fc77b046: raises $0.07 to $0.12
530477b2: folds
473117d5: folds
Uncalled bet ($0.07) returned to fc77b046
*** SHOWDOWN ***
fc77b046 collected $0.12 from pot
*** SUMMARY ***
Total pot $0.12 | Rake $0 | Jackpot $0 | Bingo $0 | Fortune $0 | Tax $0
Seat 1: fc77b046 (button) collected ($0.12)
Seat 2: 530477b2 (small blind) folded before Flop
Seat 3: 473117d5 (big blind) folded before Flop
Seat 4: Hero folded before Flop (didn't bet)
Seat 5: c35cd20e folded before Flop (didn't bet)
Seat 6: cd53b3fd folded before Flop (didn't bet)


Poker Hand #RC3334558749: Hold'em No Limit ($0.02/$0.05) - 2025/02/17 21:22:18
Table 'RushAndCash624009' 6-max Seat #1 is the button
Seat 1: Hero ($17.64 in chips)
Seat 2: c4311617 ($5.23 in chips)
Seat 3: 877b03ec ($5 in chips)
Seat 4: 75077557 ($6.64 in chips)
Seat 5: 95096c6a ($5.28 in chips)
Seat 6: cd53b3fd ($5.17 in chips)
c4311617: posts small blind $0.02
877b03ec: posts big blind $0.05
*** HOLE CARDS ***
Dealt to Hero [5d Kh]
Dealt to c4311617 
Dealt to 877b03ec 
Dealt to 75077557 
Dealt to 95096c6a 
Dealt to cd53b3fd 
75077557: folds
95096c6a: folds
cd53b3fd: folds
Hero: folds
c4311617: raises $0.1 to $0.15
877b03ec: calls $0.1
*** FLOP *** [9c Qc Tc]
c4311617: checks
877b03ec: bets $0.11
c4311617: folds
Uncalled bet ($0.11) returned to 877b03ec
*** SHOWDOWN ***
877b03ec collected $0.29 from pot
*** SUMMARY ***
Total pot $0.3 | Rake $0.01 | Jackpot $0 | Bingo $0 | Fortune $0 | Tax $0
Board [9c Qc Tc]
Seat 1: Hero (button) folded before Flop (didn't bet)
Seat 2: c4311617 (small blind) folded on the Flop
Seat 3: 877b03ec (big blind) won ($0.29)
Seat 4: 75077557 folded before Flop (didn't bet)
Seat 5: 95096c6a folded before Flop (didn't bet)
Seat 6: cd53b3fd folded before Flop (didn't bet)


Poker Hand #RC3334558426: Hold'em No Limit ($0.02/$0.05) - 2025/02/17 21:21:40
Table 'RushAndCash623686' 6-max Seat #1 is the button
Seat 1: 3bfcd529 ($5.18 in chips)
Seat 2: 4190d158 ($5.88 in chips)
Seat 3: e1132427 ($5.01 in chips)
Seat 4: Hero ($17.48 in chips)
Seat 5: a8c71cd6 ($5.17 in chips)
Seat 6: 22643080 ($7 in chips)
4190d158: posts small blind $0.02
e1132427: posts big blind $0.05
*** HOLE CARDS ***
Dealt to 3bfcd529 
Dealt to 4190d158 
Dealt to e1132427 
Dealt to Hero [9c 9d]
Dealt to a8c71cd6 
Dealt to 22643080 
Hero: raises $0.05 to $0.1
a8c71cd6: folds
22643080: calls $0.1
3bfcd529: folds
4190d158: folds
e1132427: folds
*** FLOP *** [6c 3c Ks]
Hero: checks
22643080: checks
*** TURN *** [6c 3c Ks] [5d]
Hero: checks
22643080: checks
*** RIVER *** [6c 3c Ks 5d] [7h]
Hero: bets $0.14
22643080: folds
Uncalled bet ($0.14) returned to Hero
*** SHOWDOWN ***
Hero collected $0.26 from pot
*** SUMMARY ***
Total pot $0.27 | Rake $0.01 | Jackpot $0 | Bingo $0 | Fortune $0 | Tax $0
Board [6c 3c Ks 5d 7h]
Seat 1: 3bfcd529 (button) folded before Flop (didn't bet)
Seat 2: 4190d158 (small blind) folded before Flop
Seat 3: e1132427 (big blind) folded before Flop
Seat 4: Hero won ($0.26)
Seat 5: a8c71cd6 folded before Flop (didn't bet)
Seat 6: 22643080 folded on the River


Poker Hand #RC3334558378: Hold'em No Limit ($0.02/$0.05) - 2025/02/17 21:21:34
Table 'RushAndCash623638' 6-max Seat #1 is the button
Seat 1: 44a9f3f0 ($5.03 in chips)
Seat 2: 19259657 ($6.02 in chips)
Seat 3: f51515ac ($5.37 in chips)
Seat 4: 677c4b25 ($9.28 in chips)
Seat 5: ead6cfaf ($5 in chips)
Seat 6: Hero ($17.48 in chips)
19259657: posts small blind $0.02
f51515ac: posts big blind $0.05
*** HOLE CARDS ***
Dealt to 44a9f3f0 
Dealt to 19259657 
Dealt to f51515ac 
Dealt to 677c4b25 
Dealt to ead6cfaf 
Dealt to Hero [Ac 7h]
677c4b25: raises $0.06 to $0.11
ead6cfaf: folds
Hero: folds
44a9f3f0: folds
19259657: folds
f51515ac: folds
Uncalled bet ($0.06) returned to 677c4b25
*** SHOWDOWN ***
677c4b25 collected $0.12 from pot
*** SUMMARY ***
Total pot $0.12 | Rake $0 | Jackpot $0 | Bingo $0 | Fortune $0 | Tax $0
Seat 1: 44a9f3f0 (button) folded before Flop (didn't bet)
Seat 2: 19259657 (small blind) folded before Flop
Seat 3: f51515ac (big blind) folded before Flop
Seat 4: 677c4b25 collected ($0.12)
Seat 5: ead6cfaf folded before Flop (didn't bet)
Seat 6: Hero folded before Flop (didn't bet)


Poker Hand #RC3334558350: Hold'em No Limit ($0.02/$0.05) - 2025/02/17 21:21:31
Table 'RushAndCash623610' 6-max Seat #1 is the button
Seat 1: fcc3c3cc ($12.44 in chips)
Seat 2: 726ab14e ($5 in chips)
Seat 3: ba806aaa ($1.44 in chips)
Seat 4: fcfd355a ($5.43 in chips)
Seat 5: 95096c6a ($5.35 in chips)
Seat 6: Hero ($17.48 in chips)
726ab14e: posts small blind $0.02
ba806aaa: posts big blind $0.05
*** HOLE CARDS ***
Dealt to fcc3c3cc 
Dealt to 726ab14e 
Dealt to ba806aaa 
Dealt to fcfd355a 
Dealt to 95096c6a 
Dealt to Hero [2d As]
fcfd355a: folds
95096c6a: folds
Hero: folds
fcc3c3cc: folds
726ab14e: folds
Uncalled bet ($0.03) returned to ba806aaa
*** SHOWDOWN ***
ba806aaa collected $0.04 from pot
*** SUMMARY ***
Total pot $0.04 | Rake $0 | Jackpot $0 | Bingo $0 | Fortune $0 | Tax $0
Seat 1: fcc3c3cc (button) folded before Flop (didn't bet)
Seat 2: 726ab14e (small blind) folded before Flop
Seat 3: ba806aaa (big blind) collected ($0.04)
Seat 4: fcfd355a folded before Flop (didn't bet)
Seat 5: 95096c6a folded before Flop (didn't bet)
Seat 6: Hero folded before Flop (didn't bet)


Poker Hand #RC3334558323: Hold'em No Limit ($0.02/$0.05) - 2025/02/17 21:21:28
Table 'RushAndCash623583' 6-max Seat #1 is the button
Seat 1: 8f77797e ($5.7 in chips)
Seat 2: 1e76a4d8 ($6.1 in chips)
Seat 3: Hero ($17.53 in chips)
Seat 4: 2ffae4a2 ($13.51 in chips)
Seat 5: 381c6d82 ($5.75 in chips)
Seat 6: 27baaa05 ($7.98 in chips)
1e76a4d8: posts small blind $0.02
Hero: posts big blind $0.05
*** HOLE CARDS ***
Dealt to 8f77797e 
Dealt to 1e76a4d8 
Dealt to Hero [8c Ts]
Dealt to 2ffae4a2 
Dealt to 381c6d82 
Dealt to 27baaa05 
2ffae4a2: folds
381c6d82: folds
27baaa05: folds
8f77797e: folds
1e76a4d8: raises $0.1 to $0.15
Hero: folds
Uncalled bet ($0.1) returned to 1e76a4d8
*** SHOWDOWN ***
1e76a4d8 collected $0.1 from pot
*** SUMMARY ***
Total pot $0.1 | Rake $0 | Jackpot $0 | Bingo $0 | Fortune $0 | Tax $0
Seat 1: 8f77797e (button) folded before Flop (didn't bet)
Seat 2: 1e76a4d8 (small blind) collected ($0.1)
Seat 3: Hero (big blind) folded before Flop
Seat 4: 2ffae4a2 folded before Flop (didn't bet)
Seat 5: 381c6d82 folded before Flop (didn't bet)
Seat 6: 27baaa05 folded before Flop (didn't bet)


Poker Hand #RC3334558286: Hold'em No Limit ($0.02/$0.05) - 2025/02/17 21:21:23
Table 'RushAndCash623546' 6-max Seat #1 is the button
Seat 1: 7a24974a ($5.14 in chips)
Seat 2: 207d9345 ($22.01 in chips)
Seat 3: e4fd27d ($24.17 in chips)
Seat 4: 711af4a4 ($10.48 in chips)
Seat 5: Hero ($17.53 in chips)
Seat 6: 1e290a15 ($11 in chips)
207d9345: posts small blind $0.02
e4fd27d: posts big blind $0.05
*** HOLE CARDS ***
Dealt to 7a24974a 
Dealt to 207d9345 
Dealt to e4fd27d 
Dealt to 711af4a4 
Dealt to Hero [3c Kd]
Dealt to 1e290a15 
711af4a4: folds
Hero: folds
1e290a15: raises $0.07 to $0.12
7a24974a: folds
207d9345: folds
e4fd27d: folds
Uncalled bet ($0.07) returned to 1e290a15
*** SHOWDOWN ***
1e290a15 collected $0.12 from pot
*** SUMMARY ***
Total pot $0.12 | Rake $0 | Jackpot $0 | Bingo $0 | Fortune $0 | Tax $0
Seat 1: 7a24974a (button) folded before Flop (didn't bet)
Seat 2: 207d9345 (small blind) folded before Flop
Seat 3: e4fd27d (big blind) folded before Flop
Seat 4: 711af4a4 folded before Flop (didn't bet)
Seat 5: Hero folded before Flop (didn't bet)
Seat 6: 1e290a15 collected ($0.12)


Poker Hand #RC3334557999: Hold'em No Limit ($0.02/$0.05) - 2025/02/17 21:20:45
Table 'RushAndCash623259' 6-max Seat #1 is the button
Seat 1: 6d5fa70b ($5.08 in chips)
Seat 2: Hero ($17.44 in chips)
Seat 3: 36443158 ($4.95 in chips)
Seat 4: bfe94c7c ($5 in chips)
Seat 5: 9f70f94d ($6.76 in chips)
Seat 6: a2123cbe ($9.9 in chips)
Hero: posts small blind $0.02
36443158: posts big blind $0.05
*** HOLE CARDS ***
Dealt to 6d5fa70b 
Dealt to Hero [6h 6d]
Dealt to 36443158 
Dealt to bfe94c7c 
Dealt to 9f70f94d 
Dealt to a2123cbe 
bfe94c7c: folds
9f70f94d: folds
a2123cbe: folds
6d5fa70b: folds
Hero: calls $0.03
36443158: checks
*** FLOP *** [Ah Kc 5h]
Hero: checks
36443158: checks
*** TURN *** [Ah Kc 5h] [7h]
Hero: checks
36443158: checks
*** RIVER *** [Ah Kc 5h 7h] [Jh]
Hero: bets $0.05
36443158: calls $0.05
Hero: shows [6h 6d] (Ace High Flush)
36443158: shows [Jd 5c] (Pair of Jacks and Pair of Fives)
*** SHOWDOWN ***
Hero collected $0.19 from pot
*** SUMMARY ***
Total pot $0.2 | Rake $0.01 | Jackpot $0 | Bingo $0 | Fortune $0 | Tax $0
Board [Ah Kc 5h 7h Jh]
Seat 1: 6d5fa70b (button) folded before Flop (didn't bet)
Seat 2: Hero (small blind) showed [6h 6d] and won ($0.19) with Ace High Flush
Seat 3: 36443158 (big blind) showed [Jd 5c] and lost with Pair of Jacks and Pair of Fives
Seat 4: bfe94c7c folded before Flop (didn't bet)
Seat 5: 9f70f94d folded before Flop (didn't bet)
Seat 6: a2123cbe folded before Flop (didn't bet)


Poker Hand #RC3334557547: Hold'em No Limit ($0.02/$0.05) - 2025/02/17 21:19:48
Table 'RushAndCash622807' 6-max Seat #1 is the button
Seat 1: b0ee20aa ($21.72 in chips)
Seat 2: 62156df3 ($6.71 in chips)
Seat 3: b39a93ce ($5.8 in chips)
Seat 4: 7c65d0bd ($5.07 in chips)
Seat 5: Hero ($16.9 in chips)
Seat 6: e89f6814 ($4.04 in chips)
62156df3: posts small blind $0.02
b39a93ce: posts big blind $0.05
*** HOLE CARDS ***
Dealt to b0ee20aa 
Dealt to 62156df3 
Dealt to b39a93ce 
Dealt to 7c65d0bd 
Dealt to Hero [Ac 8c]
Dealt to e89f6814 
7c65d0bd: folds
Hero: raises $0.05 to $0.1
e89f6814: folds
b0ee20aa: folds
62156df3: folds
b39a93ce: calls $0.05
*** FLOP *** [Qc 4c 7d]
b39a93ce: checks
Hero: checks
*** TURN *** [Qc 4c 7d] [Td]
b39a93ce: bets $0.17
Hero: calls $0.17
*** RIVER *** [Qc 4c 7d Td] [7c]
b39a93ce: bets $0.3
Hero: raises $0.88 to $1.18
b39a93ce: folds
Uncalled bet ($0.88) returned to Hero
*** SHOWDOWN ***
Hero collected $1.11 from pot
*** SUMMARY ***
Total pot $1.16 | Rake $0.05 | Jackpot $0 | Bingo $0 | Fortune $0 | Tax $0
Board [Qc 4c 7d Td 7c]
Seat 1: b0ee20aa (button) folded before Flop (didn't bet)
Seat 2: 62156df3 (small blind) folded before Flop
Seat 3: b39a93ce (big blind) folded on the River
Seat 4: 7c65d0bd folded before Flop (didn't bet)
Seat 5: Hero won ($1.11)
Seat 6: e89f6814 folded before Flop (didn't bet)


Poker Hand #RC3334557412: Hold'em No Limit ($0.02/$0.05) - 2025/02/17 21:19:31
Table 'RushAndCash622672' 6-max Seat #1 is the button
Seat 1: Hero ($16.74 in chips)
Seat 2: c51d95f9 ($5.16 in chips)
Seat 3: 926bb191 ($5.38 in chips)
Seat 4: c24b20b9 ($12.33 in chips)
Seat 5: 62fdcc3c ($5 in chips)
Seat 6: 69c3afd2 ($5.02 in chips)
c51d95f9: posts small blind $0.02
926bb191: posts big blind $0.05
*** HOLE CARDS ***
Dealt to Hero [Qs Qd]
Dealt to c51d95f9 
Dealt to 926bb191 
Dealt to c24b20b9 
Dealt to 62fdcc3c 
Dealt to 69c3afd2 
c24b20b9: folds
62fdcc3c: raises $0.05 to $0.1
69c3afd2: folds
Hero: raises $0.22 to $0.32
c51d95f9: folds
926bb191: folds
62fdcc3c: folds
Uncalled bet ($0.22) returned to Hero
*** SHOWDOWN ***
Hero collected $0.26 from pot
*** SUMMARY ***
Total pot $0.27 | Rake $0.01 | Jackpot $0 | Bingo $0 | Fortune $0 | Tax $0
Seat 1: Hero (button) collected ($0.26)
Seat 2: c51d95f9 (small blind) folded before Flop
Seat 3: 926bb191 (big blind) folded before Flop
Seat 4: c24b20b9 folded before Flop (didn't bet)
Seat 5: 62fdcc3c folded before Flop
Seat 6: 69c3afd2 folded before Flop (didn't bet)


Poker Hand #RC3334557387: Hold'em No Limit ($0.02/$0.05) - 2025/02/17 21:19:27
Table 'RushAndCash622647' 6-max Seat #1 is the button
Seat 1: a730170a ($5 in chips)
Seat 2: ce1cdeb ($10.29 in chips)
Seat 3: Hero ($16.79 in chips)
Seat 4: c585480d ($7.33 in chips)
Seat 5: 93a6c244 ($14.77 in chips)
Seat 6: 610144dc ($4.89 in chips)
ce1cdeb: posts small blind $0.02
Hero: posts big blind $0.05
*** HOLE CARDS ***
Dealt to a730170a 
Dealt to ce1cdeb 
Dealt to Hero [7c 5h]
Dealt to c585480d 
Dealt to 93a6c244 
Dealt to 610144dc 
c585480d: folds
93a6c244: folds
610144dc: folds
a730170a: folds
ce1cdeb: raises $0.1 to $0.15
Hero: folds
Uncalled bet ($0.1) returned to ce1cdeb
*** SHOWDOWN ***
ce1cdeb collected $0.1 from pot
*** SUMMARY ***
Total pot $0.1 | Rake $0 | Jackpot $0 | Bingo $0 | Fortune $0 | Tax $0
Seat 1: a730170a (button) folded before Flop (didn't bet)
Seat 2: ce1cdeb (small blind) collected ($0.1)
Seat 3: Hero (big blind) folded before Flop
Seat 4: c585480d folded before Flop (didn't bet)
Seat 5: 93a6c244 folded before Flop (didn't bet)
Seat 6: 610144dc folded before Flop (didn't bet)


Poker Hand #RC3334557349: Hold'em No Limit ($0.02/$0.05) - 2025/02/17 21:19:23
Table 'RushAndCash622609' 6-max Seat #1 is the button
Seat 1: 8cf3ad10 ($7.14 in chips)
Seat 2: d0d9ce45 ($2.76 in chips)
Seat 3: 93056ee9 ($7.45 in chips)
Seat 4: Hero ($16.79 in chips)
Seat 5: aa08a1c ($5.14 in chips)
Seat 6: 356c5079 ($5.83 in chips)
d0d9ce45: posts small blind $0.02
93056ee9: posts big blind $0.05
*** HOLE CARDS ***
Dealt to 8cf3ad10 
Dealt to d0d9ce45 
Dealt to 93056ee9 
Dealt to Hero [9h 3c]
Dealt to aa08a1c 
Dealt to 356c5079 
Hero: folds
aa08a1c: folds
356c5079: raises $0.05 to $0.1
8cf3ad10: folds
d0d9ce45: calls $0.08
93056ee9: folds
*** FLOP *** [Ts 7d 5s]
d0d9ce45: checks
356c5079: checks
*** TURN *** [Ts 7d 5s] [9c]
d0d9ce45: checks
356c5079: bets $0.19
d0d9ce45: folds
Uncalled bet ($0.19) returned to 356c5079
*** SHOWDOWN ***
356c5079 collected $0.24 from pot
*** SUMMARY ***
Total pot $0.25 | Rake $0.01 | Jackpot $0 | Bingo $0 | Fortune $0 | Tax $0
Board [Ts 7d 5s 9c]
Seat 1: 8cf3ad10 (button) folded before Flop (didn't bet)
Seat 2: d0d9ce45 (small blind) folded on the Turn
Seat 3: 93056ee9 (big blind) folded before Flop
Seat 4: Hero folded before Flop (didn't bet)
Seat 5: aa08a1c folded before Flop (didn't bet)
Seat 6: 356c5079 won ($0.24)


Poker Hand #RC3334557304: Hold'em No Limit ($0.02/$0.05) - 2025/02/17 21:19:17
Table 'RushAndCash622564' 6-max Seat #1 is the button
Seat 1: 35016d48 ($5.23 in chips)
Seat 2: 3ed7af69 ($0.91 in chips)
Seat 3: 8a5a4b28 ($1.74 in chips)
Seat 4: 4f7979c7 ($4.97 in chips)
Seat 5: 90c3e611 ($5.9 in chips)
Seat 6: Hero ($16.79 in chips)
3ed7af69: posts small blind $0.02
8a5a4b28: posts big blind $0.05
*** HOLE CARDS ***
Dealt to 35016d48 
Dealt to 3ed7af69 
Dealt to 8a5a4b28 
Dealt to 4f7979c7 
Dealt to 90c3e611 
Dealt to Hero [Ks 9s]
4f7979c7: folds
90c3e611: raises $0.08 to $0.13
Hero: folds
35016d48: folds
3ed7af69: folds
8a5a4b28: folds
Uncalled bet ($0.08) returned to 90c3e611
*** SHOWDOWN ***
90c3e611 collected $0.12 from pot
*** SUMMARY ***
Total pot $0.12 | Rake $0 | Jackpot $0 | Bingo $0 | Fortune $0 | Tax $0
Seat 1: 35016d48 (button) folded before Flop (didn't bet)
Seat 2: 3ed7af69 (small blind) folded before Flop
Seat 3: 8a5a4b28 (big blind) folded before Flop
Seat 4: 4f7979c7 folded before Flop (didn't bet)
Seat 5: 90c3e611 collected ($0.12)
Seat 6: Hero folded before Flop (didn't bet)


Poker Hand #RC3334557275: Hold'em No Limit ($0.02/$0.05) - 2025/02/17 21:19:13
Table 'RushAndCash622535' 6-max Seat #1 is the button
Seat 1: 8974621f ($4.84 in chips)
Seat 2: f0600331 ($5.84 in chips)
Seat 3: 64b39229 ($5.14 in chips)
Seat 4: ee3fdfd8 ($5 in chips)
Seat 5: ec767863 ($5.59 in chips)
Seat 6: Hero ($16.79 in chips)
f0600331: posts small blind $0.02
64b39229: posts big blind $0.05
*** HOLE CARDS ***
Dealt to 8974621f 
Dealt to f0600331 
Dealt to 64b39229 
Dealt to ee3fdfd8 
Dealt to ec767863 
Dealt to Hero [Qd 3h]
ee3fdfd8: folds
ec767863: folds
Hero: folds
8974621f: folds
f0600331: folds
Uncalled bet ($0.03) returned to 64b39229
*** SHOWDOWN ***
64b39229 collected $0.04 from pot
*** SUMMARY ***
Total pot $0.04 | Rake $0 | Jackpot $0 | Bingo $0 | Fortune $0 | Tax $0
Seat 1: 8974621f (button) folded before Flop (didn't bet)
Seat 2: f0600331 (small blind) folded before Flop
Seat 3: 64b39229 (big blind) collected ($0.04)
Seat 4: ee3fdfd8 folded before Flop (didn't bet)
Seat 5: ec767863 folded before Flop (didn't bet)
Seat 6: Hero folded before Flop (didn't bet)


Poker Hand #RC3334557165: Hold'em No Limit ($0.02/$0.05) - 2025/02/17 21:18:59
Table 'RushAndCash622425' 6-max Seat #1 is the button
Seat 1: a25931dc ($4.75 in chips)
Seat 2: f52f15b4 ($3.96 in chips)
Seat 3: 9bddfdba ($5.02 in chips)
Seat 4: Hero ($16.72 in chips)
Seat 5: 5fd404ad ($5.89 in chips)
Seat 6: 395482a9 ($6.28 in chips)
f52f15b4: posts small blind $0.02
9bddfdba: posts big blind $0.05
*** HOLE CARDS ***
Dealt to a25931dc 
Dealt to f52f15b4 
Dealt to 9bddfdba 
Dealt to Hero [Ad Jh]
Dealt to 5fd404ad 
Dealt to 395482a9 
Hero: raises $0.05 to $0.1
5fd404ad: folds
395482a9: folds
a25931dc: folds
f52f15b4: folds
9bddfdba: folds
Uncalled bet ($0.05) returned to Hero
*** SHOWDOWN ***
Hero collected $0.12 from pot
*** SUMMARY ***
Total pot $0.12 | Rake $0 | Jackpot $0 | Bingo $0 | Fortune $0 | Tax $0
Seat 1: a25931dc (button) folded before Flop (didn't bet)
Seat 2: f52f15b4 (small blind) folded before Flop
Seat 3: 9bddfdba (big blind) folded before Flop
Seat 4: Hero collected ($0.12)
Seat 5: 5fd404ad folded before Flop (didn't bet)
Seat 6: 395482a9 folded before Flop (didn't bet)


Poker Hand #RC3334557102: Hold'em No Limit ($0.02/$0.05) - 2025/02/17 21:18:51
Table 'RushAndCash622362' 6-max Seat #1 is the button
Seat 1: a375b232 ($5 in chips)
Seat 2: 24aff26b ($11.7 in chips)
Seat 3: 4e53b23f ($5.2 in chips)
Seat 4: 5e166e9a ($8.88 in chips)
Seat 5: 12cda2e0 ($22.05 in chips)
Seat 6: Hero ($16.65 in chips)
24aff26b: posts small blind $0.02
4e53b23f: posts big blind $0.05
*** HOLE CARDS ***
Dealt to a375b232 
Dealt to 24aff26b 
Dealt to 4e53b23f 
Dealt to 5e166e9a 
Dealt to 12cda2e0 
Dealt to Hero [Ad Ts]
5e166e9a: folds
12cda2e0: folds
Hero: raises $0.05 to $0.1
a375b232: folds
24aff26b: folds
4e53b23f: folds
Uncalled bet ($0.05) returned to Hero
*** SHOWDOWN ***
Hero collected $0.12 from pot
*** SUMMARY ***
Total pot $0.12 | Rake $0 | Jackpot $0 | Bingo $0 | Fortune $0 | Tax $0
Seat 1: a375b232 (button) folded before Flop (didn't bet)
Seat 2: 24aff26b (small blind) folded before Flop
Seat 3: 4e53b23f (big blind) folded before Flop
Seat 4: 5e166e9a folded before Flop (didn't bet)
Seat 5: 12cda2e0 folded before Flop (didn't bet)
Seat 6: Hero collected ($0.12)


Poker Hand #RC3334557080: Hold'em No Limit ($0.02/$0.05) - 2025/02/17 21:18:48
Table 'RushAndCash622340' 6-max Seat #1 is the button
Seat 1: f72bf77b ($5 in chips)
Seat 2: Hero ($16.67 in chips)
Seat 3: 15fafcaa ($5 in chips)
Seat 4: 82c6ccfb ($4.18 in chips)
Seat 5: 5ddfff80 ($4.93 in chips)
Seat 6: fd5b33a8 ($5 in chips)
Hero: posts small blind $0.02
15fafcaa: posts big blind $0.05
*** HOLE CARDS ***
Dealt to f72bf77b 
Dealt to Hero [9d 4c]
Dealt to 15fafcaa 
Dealt to 82c6ccfb 
Dealt to 5ddfff80 
Dealt to fd5b33a8 
82c6ccfb: raises $0.05 to $0.1
5ddfff80: folds
fd5b33a8: folds
f72bf77b: folds
Hero: folds
15fafcaa: calls $0.05
*** FLOP *** [Ad 7h 2d]
15fafcaa: checks
82c6ccfb: bets $0.17
15fafcaa: calls $0.17
*** TURN *** [Ad 7h 2d] [Qc]
15fafcaa: checks
82c6ccfb: bets $0.42
15fafcaa: calls $0.42
*** RIVER *** [Ad 7h 2d Qc] [Ts]
15fafcaa: checks
82c6ccfb: checks
15fafcaa: shows [Ac 9s] (Pair of Aces)
82c6ccfb: shows [Jh Qs] (Pair of Queens)
*** SHOWDOWN ***
15fafcaa collected $1.33 from pot
*** SUMMARY ***
Total pot $1.4 | Rake $0.07 | Jackpot $0 | Bingo $0 | Fortune $0 | Tax $0
Board [Ad 7h 2d Qc Ts]
Seat 1: f72bf77b (button) folded before Flop (didn't bet)
Seat 2: Hero (small blind) folded before Flop
Seat 3: 15fafcaa (big blind) showed [Ac 9s] and won ($1.33) with Pair of Aces
Seat 4: 82c6ccfb showed [Jh Qs] and lost with Pair of Queens
Seat 5: 5ddfff80 folded before Flop (didn't bet)
Seat 6: fd5b33a8 folded before Flop (didn't bet)


Poker Hand #RC3334557058: Hold'em No Limit ($0.02/$0.05) - 2025/02/17 21:18:44
Table 'RushAndCash622318' 6-max Seat #1 is the button
Seat 1: Hero ($16.67 in chips)
Seat 2: b3aefb75 ($10.23 in chips)
Seat 3: d0d9ce45 ($2.86 in chips)
Seat 4: ab08c5da ($4.06 in chips)
Seat 5: 9c1c8cec ($4.77 in chips)
Seat 6: 3cda1c52 ($5.35 in chips)
b3aefb75: posts small blind $0.02
d0d9ce45: posts big blind $0.05
*** HOLE CARDS ***
Dealt to Hero [3c Kc]
Dealt to b3aefb75 
Dealt to d0d9ce45 
Dealt to ab08c5da 
Dealt to 9c1c8cec 
Dealt to 3cda1c52 
ab08c5da: folds
9c1c8cec: folds
3cda1c52: folds
Hero: folds
b3aefb75: raises $0.08 to $0.13
d0d9ce45: folds
Uncalled bet ($0.08) returned to b3aefb75
*** SHOWDOWN ***
b3aefb75 collected $0.1 from pot
*** SUMMARY ***
Total pot $0.1 | Rake $0 | Jackpot $0 | Bingo $0 | Fortune $0 | Tax $0
Seat 1: Hero (button) folded before Flop (didn't bet)
Seat 2: b3aefb75 (small blind) collected ($0.1)
Seat 3: d0d9ce45 (big blind) folded before Flop
Seat 4: ab08c5da folded before Flop (didn't bet)
Seat 5: 9c1c8cec folded before Flop (didn't bet)
Seat 6: 3cda1c52 folded before Flop (didn't bet)


Poker Hand #RC3334557035: Hold'em No Limit ($0.02/$0.05) - 2025/02/17 21:18:41
Table 'RushAndCash622295' 6-max Seat #1 is the button
Seat 1: Hero ($16.6 in chips)
Seat 2: a8c71cd6 ($5.02 in chips)
Seat 3: 4f7979c7 ($5.11 in chips)
Seat 4: 2ae4e16 ($3.86 in chips)
Seat 5: ef7b5599 ($35.39 in chips)
Seat 6: dc06a4b8 ($13.13 in chips)
a8c71cd6: posts small blind $0.02
4f7979c7: posts big blind $0.05
*** HOLE CARDS ***
Dealt to Hero [6s 4h]
Dealt to a8c71cd6 
Dealt to 4f7979c7 
Dealt to 2ae4e16 
Dealt to ef7b5599 
Dealt to dc06a4b8 
2ae4e16: folds
ef7b5599: folds
dc06a4b8: raises $0.07 to $0.12
Hero: folds
a8c71cd6: folds
4f7979c7: calls $0.07
*** FLOP *** [9s Ac Tc]
4f7979c7: checks
dc06a4b8: bets $0.1
4f7979c7: folds
Uncalled bet ($0.1) returned to dc06a4b8
*** SHOWDOWN ***
dc06a4b8 collected $0.25 from pot
*** SUMMARY ***
Total pot $0.26 | Rake $0.01 | Jackpot $0 | Bingo $0 | Fortune $0 | Tax $0
Board [9s Ac Tc]
Seat 1: Hero (button) folded before Flop (didn't bet)
Seat 2: a8c71cd6 (small blind) folded before Flop
Seat 3: 4f7979c7 (big blind) folded on the Flop
Seat 4: 2ae4e16 folded before Flop (didn't bet)
Seat 5: ef7b5599 folded before Flop (didn't bet)
Seat 6: dc06a4b8 won ($0.25)


Poker Hand #RC3334557008: Hold'em No Limit ($0.02/$0.05) - 2025/02/17 21:18:38
Table 'RushAndCash622268' 6-max Seat #1 is the button
Seat 1: b4bc5ab5 ($5 in chips)
Seat 2: 5c8c19b7 ($13.92 in chips)
Seat 3: db0f0c64 ($5.15 in chips)
Seat 4: f72bf77b ($5 in chips)
Seat 5: 8ed17f8c ($11.58 in chips)
Seat 6: Hero ($16.6 in chips)
5c8c19b7: posts small blind $0.02
db0f0c64: posts big blind $0.05
*** HOLE CARDS ***
Dealt to b4bc5ab5 
Dealt to 5c8c19b7 
Dealt to db0f0c64 
Dealt to f72bf77b 
Dealt to 8ed17f8c 
Dealt to Hero [Qh 4s]
f72bf77b: folds
8ed17f8c: folds
Hero: folds
b4bc5ab5: folds
5c8c19b7: raises $0.1 to $0.15
db0f0c64: calls $0.1
*** FLOP *** [4c 5h 8s]
5c8c19b7: checks
db0f0c64: bets $0.15
5c8c19b7: calls $0.15
*** TURN *** [4c 5h 8s] [6d]
5c8c19b7: checks
db0f0c64: bets $0.45
5c8c19b7: calls $0.45
*** RIVER *** [4c 5h 8s 6d] [Kd]
5c8c19b7: checks
db0f0c64: checks
5c8c19b7: shows [Ah 7d] (Eights-High Straight)
db0f0c64: shows [8h 9s] (Pair of Eights)
*** SHOWDOWN ***
5c8c19b7 collected $1.36 from pot
*** SUMMARY ***
Total pot $1.5 | Rake $0.07 | Jackpot $0.07 | Bingo $0 | Fortune $0 | Tax $0
Board [4c 5h 8s 6d Kd]
Seat 1: b4bc5ab5 (button) folded before Flop (didn't bet)
Seat 2: 5c8c19b7 (small blind) showed [Ah 7d] and won ($1.36) with Eights-High Straight
Seat 3: db0f0c64 (big blind) showed [8h 9s] and lost with Pair of Eights
Seat 4: f72bf77b folded before Flop (didn't bet)
Seat 5: 8ed17f8c folded before Flop (didn't bet)
Seat 6: Hero folded before Flop (didn't bet)


Poker Hand #RC3334556950: Hold'em No Limit ($0.02/$0.05) - 2025/02/17 21:18:31
Table 'RushAndCash622210' 6-max Seat #1 is the button
Seat 1: fedfe7c6 ($14.54 in chips)
Seat 2: c6158c9d ($5.16 in chips)
Seat 3: Hero ($16.65 in chips)
Seat 4: e6ee1d7f ($6.29 in chips)
Seat 5: 57d6169c ($6.36 in chips)
Seat 6: ab01942e ($4.61 in chips)
c6158c9d: posts small blind $0.02
Hero: posts big blind $0.05
*** HOLE CARDS ***
Dealt to fedfe7c6 
Dealt to c6158c9d 
Dealt to Hero [5s Js]
Dealt to e6ee1d7f 
Dealt to 57d6169c 
Dealt to ab01942e 
e6ee1d7f: folds
57d6169c: folds
ab01942e: folds
fedfe7c6: folds
c6158c9d: folds
Uncalled bet ($0.03) returned to Hero
*** SHOWDOWN ***
Hero collected $0.04 from pot
*** SUMMARY ***
Total pot $0.04 | Rake $0 | Jackpot $0 | Bingo $0 | Fortune $0 | Tax $0
Seat 1: fedfe7c6 (button) folded before Flop (didn't bet)
Seat 2: c6158c9d (small blind) folded before Flop
Seat 3: Hero (big blind) collected ($0.04)
Seat 4: e6ee1d7f folded before Flop (didn't bet)
Seat 5: 57d6169c folded before Flop (didn't bet)
Seat 6: ab01942e folded before Flop (didn't bet)


Poker Hand #RC3334556660: Hold'em No Limit ($0.02/$0.05) - 2025/02/17 21:17:54
Table 'RushAndCash621920' 6-max Seat #1 is the button
Seat 1: ab01942e ($4.71 in chips)
Seat 2: Hero ($16.51 in chips)
Seat 3: 90c3e611 ($5.71 in chips)
Seat 4: 43a05b2c ($5 in chips)
Seat 5: e89f6814 ($3.68 in chips)
Seat 6: 5c980949 ($6.93 in chips)
Hero: posts small blind $0.02
90c3e611: posts big blind $0.05
*** HOLE CARDS ***
Dealt to ab01942e 
Dealt to Hero [Qh Ac]
Dealt to 90c3e611 
Dealt to 43a05b2c 
Dealt to e89f6814 
Dealt to 5c980949 
43a05b2c: folds
e89f6814: folds
5c980949: folds
ab01942e: raises $0.05 to $0.1
Hero: raises $0.32 to $0.42
90c3e611: folds
ab01942e: folds
Uncalled bet ($0.32) returned to Hero
*** SHOWDOWN ***
Hero collected $0.24 from pot
*** SUMMARY ***
Total pot $0.25 | Rake $0.01 | Jackpot $0 | Bingo $0 | Fortune $0 | Tax $0
Seat 1: ab01942e (button) folded before Flop
Seat 2: Hero (small blind) collected ($0.24)
Seat 3: 90c3e611 (big blind) folded before Flop
Seat 4: 43a05b2c folded before Flop (didn't bet)
Seat 5: e89f6814 folded before Flop (didn't bet)
Seat 6: 5c980949 folded before Flop (didn't bet)


Poker Hand #RC3334556616: Hold'em No Limit ($0.02/$0.05) - 2025/02/17 21:17:48
Table 'RushAndCash621876' 6-max Seat #1 is the button
Seat 1: bacb67c8 ($7.58 in chips)
Seat 2: a730170a ($5 in chips)
Seat 3: fa30bfa7 ($5.05 in chips)
Seat 4: fa499268 ($7.05 in chips)
Seat 5: 35fb946f ($6.35 in chips)
Seat 6: Hero ($16.51 in chips)
a730170a: posts small blind $0.02
fa30bfa7: posts big blind $0.05
*** HOLE CARDS ***
Dealt to bacb67c8 
Dealt to a730170a 
Dealt to fa30bfa7 
Dealt to fa499268 
Dealt to 35fb946f 
Dealt to Hero [Js Qd]
fa499268: raises $0.08 to $0.13
35fb946f: folds
Hero: folds
bacb67c8: folds
a730170a: raises $0.24 to $0.37
fa30bfa7: folds
fa499268: raises $1.13 to $1.5
a730170a: folds
Uncalled bet ($1.13) returned to fa499268
*** SHOWDOWN ***
fa499268 collected $0.75 from pot
*** SUMMARY ***
Total pot $0.79 | Rake $0.04 | Jackpot $0 | Bingo $0 | Fortune $0 | Tax $0
Seat 1: bacb67c8 (button) folded before Flop (didn't bet)
Seat 2: a730170a (small blind) folded before Flop
Seat 3: fa30bfa7 (big blind) folded before Flop
Seat 4: fa499268 collected ($0.75)
Seat 5: 35fb946f folded before Flop (didn't bet)
Seat 6: Hero folded before Flop (didn't bet)


Poker Hand #RC3334556583: Hold'em No Limit ($0.02/$0.05) - 2025/02/17 21:17:44
Table 'RushAndCash621843' 6-max Seat #1 is the button
Seat 1: b62e02b ($5.07 in chips)
Seat 2: 14d966a6 ($5.35 in chips)
Seat 3: a05482e7 ($5.27 in chips)
Seat 4: Hero ($16.44 in chips)
Seat 5: 57a66aa7 ($5.41 in chips)
Seat 6: e20e5cfc ($5.97 in chips)
14d966a6: posts small blind $0.02
a05482e7: posts big blind $0.05
*** HOLE CARDS ***
Dealt to b62e02b 
Dealt to 14d966a6 
Dealt to a05482e7 
Dealt to Hero [Td 8h]
Dealt to 57a66aa7 
Dealt to e20e5cfc 
Hero: folds
57a66aa7: folds
e20e5cfc: folds
b62e02b: folds
14d966a6: folds
Uncalled bet ($0.03) returned to a05482e7
*** SHOWDOWN ***
a05482e7 collected $0.04 from pot
*** SUMMARY ***
Total pot $0.04 | Rake $0 | Jackpot $0 | Bingo $0 | Fortune $0 | Tax $0
Seat 1: b62e02b (button) folded before Flop (didn't bet)
Seat 2: 14d966a6 (small blind) folded before Flop
Seat 3: a05482e7 (big blind) collected ($0.04)
Seat 4: Hero folded before Flop (didn't bet)
Seat 5: 57a66aa7 folded before Flop (didn't bet)
Seat 6: e20e5cfc folded before Flop (didn't bet)


Poker Hand #RC3334556541: Hold'em No Limit ($0.02/$0.05) - 2025/02/17 21:17:39
Table 'RushAndCash621801' 6-max Seat #1 is the button
Seat 1: d6f5b483 ($9.47 in chips)
Seat 2: ae0cde3d ($6.44 in chips)
Seat 3: Hero ($16.49 in chips)
Seat 4: 9604af2 ($8.16 in chips)
Seat 5: 9013f95e ($12.44 in chips)
Seat 6: a05dd313 ($4.39 in chips)
ae0cde3d: posts small blind $0.02
Hero: posts big blind $0.05
*** HOLE CARDS ***
Dealt to d6f5b483 
Dealt to ae0cde3d 
Dealt to Hero [5d 6s]
Dealt to 9604af2 
Dealt to 9013f95e 
Dealt to a05dd313 
9604af2: folds
9013f95e: folds
a05dd313: folds
d6f5b483: folds
ae0cde3d: folds
Uncalled bet ($0.03) returned to Hero
*** SHOWDOWN ***
Hero collected $0.04 from pot
*** SUMMARY ***
Total pot $0.04 | Rake $0 | Jackpot $0 | Bingo $0 | Fortune $0 | Tax $0
Seat 1: d6f5b483 (button) folded before Flop (didn't bet)
Seat 2: ae0cde3d (small blind) folded before Flop
Seat 3: Hero (big blind) collected ($0.04)
Seat 4: 9604af2 folded before Flop (didn't bet)
Seat 5: 9013f95e folded before Flop (didn't bet)
Seat 6: a05dd313 folded before Flop (didn't bet)


Poker Hand #RC3334556373: Hold'em No Limit ($0.02/$0.05) - 2025/02/17 21:17:18
Table 'RushAndCash621633' 6-max Seat #1 is the button
Seat 1: 94cb065d ($6.61 in chips)
Seat 2: 3b85f8e6 ($8.89 in chips)
Seat 3: ae0cde3d ($6.54 in chips)
Seat 4: c096c24 ($9.47 in chips)
Seat 5: 356c5079 ($5.83 in chips)
Seat 6: Hero ($16.38 in chips)
3b85f8e6: posts small blind $0.02
ae0cde3d: posts big blind $0.05
*** HOLE CARDS ***
Dealt to 94cb065d 
Dealt to 3b85f8e6 
Dealt to ae0cde3d 
Dealt to c096c24 
Dealt to 356c5079 
Dealt to Hero [8s 9s]
c096c24: folds
356c5079: folds
Hero: raises $0.05 to $0.1
94cb065d: folds
3b85f8e6: folds
ae0cde3d: calls $0.05
*** FLOP *** [Jd Ts 4c]
ae0cde3d: checks
Hero: bets $0.08
ae0cde3d: folds
Uncalled bet ($0.08) returned to Hero
*** SHOWDOWN ***
Hero collected $0.21 from pot
*** SUMMARY ***
Total pot $0.22 | Rake $0.01 | Jackpot $0 | Bingo $0 | Fortune $0 | Tax $0
Board [Jd Ts 4c]
Seat 1: 94cb065d (button) folded before Flop (didn't bet)
Seat 2: 3b85f8e6 (small blind) folded before Flop
Seat 3: ae0cde3d (big blind) folded on the Flop
Seat 4: c096c24 folded before Flop (didn't bet)
Seat 5: 356c5079 folded before Flop (didn't bet)
Seat 6: Hero won ($0.21)


Poker Hand #RC3334556312: Hold'em No Limit ($0.02/$0.05) - 2025/02/17 21:17:11
Table 'RushAndCash621572' 6-max Seat #1 is the button
Seat 1: Hero ($16.38 in chips)
Seat 2: 5e166e9a ($9.13 in chips)
Seat 3: 8e07c53 ($5.24 in chips)
Seat 4: e5e6041b ($5.62 in chips)
Seat 5: 1fee54bc ($5.35 in chips)
Seat 6: 8f77797e ($4.98 in chips)
5e166e9a: posts small blind $0.02
8e07c53: posts big blind $0.05
*** HOLE CARDS ***
Dealt to Hero [Ah Td]
Dealt to 5e166e9a 
Dealt to 8e07c53 
Dealt to e5e6041b 
Dealt to 1fee54bc 
Dealt to 8f77797e 
e5e6041b: folds
1fee54bc: raises $0.05 to $0.1
8f77797e: folds
Hero: folds
5e166e9a: folds
8e07c53: folds
Uncalled bet ($0.05) returned to 1fee54bc
*** SHOWDOWN ***
1fee54bc collected $0.12 from pot
*** SUMMARY ***
Total pot $0.12 | Rake $0 | Jackpot $0 | Bingo $0 | Fortune $0 | Tax $0
Seat 1: Hero (button) folded before Flop (didn't bet)
Seat 2: 5e166e9a (small blind) folded before Flop
Seat 3: 8e07c53 (big blind) folded before Flop
Seat 4: e5e6041b folded before Flop (didn't bet)
Seat 5: 1fee54bc collected ($0.12)
Seat 6: 8f77797e folded before Flop (didn't bet)


Poker Hand #RC3334555944: Hold'em No Limit ($0.02/$0.05) - 2025/02/17 21:16:25
Table 'RushAndCash621204' 6-max Seat #1 is the button
Seat 1: 1095926a ($5.49 in chips)
Seat 2: Hero ($14.75 in chips)
Seat 3: 8a5a4b28 ($1.89 in chips)
Seat 4: cc45300b ($5 in chips)
Seat 5: f0d238ad ($12.91 in chips)
Seat 6: bfef046a ($23.83 in chips)
Hero: posts small blind $0.02
8a5a4b28: posts big blind $0.05
*** HOLE CARDS ***
Dealt to 1095926a 
Dealt to Hero [Ah Jh]
Dealt to 8a5a4b28 
Dealt to cc45300b 
Dealt to f0d238ad 
Dealt to bfef046a 
cc45300b: folds
f0d238ad: folds
bfef046a: folds
1095926a: raises $0.08 to $0.13
Hero: raises $0.39 to $0.52
8a5a4b28: folds
1095926a: calls $0.39
*** FLOP *** [8d Ks 7h]
Hero: bets $0.36
1095926a: calls $0.36
*** TURN *** [8d Ks 7h] [As]
Hero: bets $0.92
1095926a: calls $0.92
*** RIVER *** [8d Ks 7h As] [9s]
Hero: checks
1095926a: checks
Hero: shows [Ah Jh] (Pair of Aces)
1095926a: shows [Kh Qc] (Pair of Kings)
*** SHOWDOWN ***
Hero collected $3.43 from pot
*** SUMMARY ***
Total pot $3.65 | Rake $0.15 | Jackpot $0.07 | Bingo $0 | Fortune $0 | Tax $0
Board [8d Ks 7h As 9s]
Seat 1: 1095926a (button) showed [Kh Qc] and lost with Pair of Kings
Seat 2: Hero (small blind) showed [Ah Jh] and won ($3.43) with Pair of Aces
Seat 3: 8a5a4b28 (big blind) folded before Flop
Seat 4: cc45300b folded before Flop (didn't bet)
Seat 5: f0d238ad folded before Flop (didn't bet)
Seat 6: bfef046a folded before Flop (didn't bet)


Poker Hand #RC3334555909: Hold'em No Limit ($0.02/$0.05) - 2025/02/17 21:16:21
Table 'RushAndCash621169' 6-max Seat #1 is the button
Seat 1: 1fa8537 ($7.17 in chips)
Seat 2: ccabd9d2 ($4.61 in chips)
Seat 3: e97b3270 ($17.73 in chips)
Seat 4: 99d91f75 ($5.07 in chips)
Seat 5: Hero ($14.75 in chips)
Seat 6: cedf4726 ($13.82 in chips)
ccabd9d2: posts small blind $0.02
e97b3270: posts big blind $0.05
*** HOLE CARDS ***
Dealt to 1fa8537 
Dealt to ccabd9d2 
Dealt to e97b3270 
Dealt to 99d91f75 
Dealt to Hero [Qs 5s]
Dealt to cedf4726 
99d91f75: folds
Hero: folds
cedf4726: folds
1fa8537: raises $0.06 to $0.11
ccabd9d2: folds
e97b3270: folds
Uncalled bet ($0.06) returned to 1fa8537
*** SHOWDOWN ***
1fa8537 collected $0.12 from pot
*** SUMMARY ***
Total pot $0.12 | Rake $0 | Jackpot $0 | Bingo $0 | Fortune $0 | Tax $0
Seat 1: 1fa8537 (button) collected ($0.12)
Seat 2: ccabd9d2 (small blind) folded before Flop
Seat 3: e97b3270 (big blind) folded before Flop
Seat 4: 99d91f75 folded before Flop (didn't bet)
Seat 5: Hero folded before Flop (didn't bet)
Seat 6: cedf4726 folded before Flop (didn't bet)


Poker Hand #RC3334555880: Hold'em No Limit ($0.02/$0.05) - 2025/02/17 21:16:17
Table 'RushAndCash621140' 6-max Seat #1 is the button
Seat 1: 5466aa49 ($5.58 in chips)
Seat 2: 50254767 ($5 in chips)
Seat 3: Hero ($14.8 in chips)
Seat 4: 8ab2eae7 ($5.33 in chips)
Seat 5: 9864109b ($5.91 in chips)
Seat 6: e58268de ($7.64 in chips)
50254767: posts small blind $0.02
Hero: posts big blind $0.05
*** HOLE CARDS ***
Dealt to 5466aa49 
Dealt to 50254767 
Dealt to Hero [Qs 5h]
Dealt to 8ab2eae7 
Dealt to 9864109b 
Dealt to e58268de 
8ab2eae7: folds
9864109b: folds
e58268de: folds
5466aa49: raises $0.06 to $0.11
50254767: folds
Hero: folds
Uncalled bet ($0.06) returned to 5466aa49
*** SHOWDOWN ***
5466aa49 collected $0.12 from pot
*** SUMMARY ***
Total pot $0.12 | Rake $0 | Jackpot $0 | Bingo $0 | Fortune $0 | Tax $0
Seat 1: 5466aa49 (button) collected ($0.12)
Seat 2: 50254767 (small blind) folded before Flop
Seat 3: Hero (big blind) folded before Flop
Seat 4: 8ab2eae7 folded before Flop (didn't bet)
Seat 5: 9864109b folded before Flop (didn't bet)
Seat 6: e58268de folded before Flop (didn't bet)


Poker Hand #RC3334555858: Hold'em No Limit ($0.02/$0.05) - 2025/02/17 21:16:14
Table 'RushAndCash621118' 6-max Seat #1 is the button
Seat 1: 8c3789e ($5 in chips)
Seat 2: a375b232 ($5 in chips)
Seat 3: 95e89c51 ($5.63 in chips)
Seat 4: 207d9345 ($22.09 in chips)
Seat 5: Hero ($14.8 in chips)
Seat 6: 860b5247 ($9.7 in chips)
a375b232: posts small blind $0.02
95e89c51: posts big blind $0.05
*** HOLE CARDS ***
Dealt to 8c3789e 
Dealt to a375b232 
Dealt to 95e89c51 
Dealt to 207d9345 
Dealt to Hero [5c Th]
Dealt to 860b5247 
207d9345: folds
Hero: folds
860b5247: folds
8c3789e: folds
a375b232: raises $0.08 to $0.13
95e89c51: calls $0.08
*** FLOP *** [2d 2c 6d]
a375b232: checks
95e89c51: bets $0.05
a375b232: calls $0.05
*** TURN *** [2d 2c 6d] [5h]
a375b232: checks
95e89c51: bets $0.05
a375b232: calls $0.05
*** RIVER *** [2d 2c 6d 5h] [5d]
a375b232: checks
95e89c51: bets $0.05
a375b232: raises $0.73 to $0.78
95e89c51: folds
Uncalled bet ($0.73) returned to a375b232
*** SHOWDOWN ***
a375b232 collected $0.54 from pot
*** SUMMARY ***
Total pot $0.56 | Rake $0.02 | Jackpot $0 | Bingo $0 | Fortune $0 | Tax $0
Board [2d 2c 6d 5h 5d]
Seat 1: 8c3789e (button) folded before Flop (didn't bet)
Seat 2: a375b232 (small blind) won ($0.54)
Seat 3: 95e89c51 (big blind) folded on the River
Seat 4: 207d9345 folded before Flop (didn't bet)
Seat 5: Hero folded before Flop (didn't bet)
Seat 6: 860b5247 folded before Flop (didn't bet)


Poker Hand #RC3334555516: Hold'em No Limit ($0.02/$0.05) - 2025/02/17 21:15:28
Table 'RushAndCash620776' 6-max Seat #1 is the button
Seat 1: 18767060 ($10.86 in chips)
Seat 2: Hero ($14.53 in chips)
Seat 3: 5381eb4c ($9.36 in chips)
Seat 4: 2ffae4a2 ($15.08 in chips)
Seat 5: b6d5854b ($5.73 in chips)
Seat 6: dbb7a28 ($10.59 in chips)
Hero: posts small blind $0.02
5381eb4c: posts big blind $0.05
*** HOLE CARDS ***
Dealt to 18767060 
Dealt to Hero [Td Jd]
Dealt to 5381eb4c 
Dealt to 2ffae4a2 
Dealt to b6d5854b 
Dealt to dbb7a28 
2ffae4a2: folds
b6d5854b: folds
dbb7a28: folds
18767060: folds
Hero: calls $0.03
5381eb4c: raises $0.15 to $0.2
Hero: calls $0.15
*** FLOP *** [As Jh Js]
Hero: checks
5381eb4c: bets $0.1
Hero: calls $0.1
*** TURN *** [As Jh Js] [7h]
Hero: checks
5381eb4c: checks
*** RIVER *** [As Jh Js 7h] [3c]
Hero: bets $0.3
5381eb4c: folds
Uncalled bet ($0.3) returned to Hero
*** SHOWDOWN ***
Hero collected $0.57 from pot
*** SUMMARY ***
Total pot $0.6 | Rake $0.03 | Jackpot $0 | Bingo $0 | Fortune $0 | Tax $0
Board [As Jh Js 7h 3c]
Seat 1: 18767060 (button) folded before Flop (didn't bet)
Seat 2: Hero (small blind) won ($0.57)
Seat 3: 5381eb4c (big blind) folded on the River
Seat 4: 2ffae4a2 folded before Flop (didn't bet)
Seat 5: b6d5854b folded before Flop (didn't bet)
Seat 6: dbb7a28 folded before Flop (didn't bet)


Poker Hand #RC3334555405: Hold'em No Limit ($0.02/$0.05) - 2025/02/17 21:15:14
Table 'RushAndCash620665' 6-max Seat #1 is the button
Seat 1: e606bcb0 ($5.67 in chips)
Seat 2: 820e1571 ($6.37 in chips)
Seat 3: 1a2d8f33 ($6.41 in chips)
Seat 4: Hero ($14.46 in chips)
Seat 5: 598d859f ($11.33 in chips)
Seat 6: e7c4d687 ($4.53 in chips)
820e1571: posts small blind $0.02
1a2d8f33: posts big blind $0.05
*** HOLE CARDS ***
Dealt to e606bcb0 
Dealt to 820e1571 
Dealt to 1a2d8f33 
Dealt to Hero [Jh Js]
Dealt to 598d859f 
Dealt to e7c4d687 
Hero: raises $0.05 to $0.1
598d859f: folds
e7c4d687: folds
e606bcb0: folds
820e1571: folds
1a2d8f33: folds
Uncalled bet ($0.05) returned to Hero
*** SHOWDOWN ***
Hero collected $0.12 from pot
*** SUMMARY ***
Total pot $0.12 | Rake $0 | Jackpot $0 | Bingo $0 | Fortune $0 | Tax $0
Seat 1: e606bcb0 (button) folded before Flop (didn't bet)
Seat 2: 820e1571 (small blind) folded before Flop
Seat 3: 1a2d8f33 (big blind) folded before Flop
Seat 4: Hero collected ($0.12)
Seat 5: 598d859f folded before Flop (didn't bet)
Seat 6: e7c4d687 folded before Flop (didn't bet)


Poker Hand #RC3334555370: Hold'em No Limit ($0.02/$0.05) - 2025/02/17 21:15:10
Table 'RushAndCash620630' 6-max Seat #1 is the button
Seat 1: b0d0d63c ($8.8 in chips)
Seat 2: f994138c ($8.26 in chips)
Seat 3: 1aca371e ($9.27 in chips)
Seat 4: Hero ($14.46 in chips)
Seat 5: baaf0b0d ($5 in chips)
Seat 6: dfc02c40 ($5.24 in chips)
f994138c: posts small blind $0.02
1aca371e: posts big blind $0.05
*** HOLE CARDS ***
Dealt to b0d0d63c 
Dealt to f994138c 
Dealt to 1aca371e 
Dealt to Hero [8s 6s]
Dealt to baaf0b0d 
Dealt to dfc02c40 
Hero: folds
baaf0b0d: folds
dfc02c40: folds
b0d0d63c: raises $0.07 to $0.12
f994138c: folds
1aca371e: folds
Uncalled bet ($0.07) returned to b0d0d63c
*** SHOWDOWN ***
b0d0d63c collected $0.12 from pot
*** SUMMARY ***
Total pot $0.12 | Rake $0 | Jackpot $0 | Bingo $0 | Fortune $0 | Tax $0
Seat 1: b0d0d63c (button) collected ($0.12)
Seat 2: f994138c (small blind) folded before Flop
Seat 3: 1aca371e (big blind) folded before Flop
Seat 4: Hero folded before Flop (didn't bet)
Seat 5: baaf0b0d folded before Flop (didn't bet)
Seat 6: dfc02c40 folded before Flop (didn't bet)


Poker Hand #RC3334555349: Hold'em No Limit ($0.02/$0.05) - 2025/02/17 21:15:07
Table 'RushAndCash620609' 6-max Seat #1 is the button
Seat 1: 65900825 ($4.81 in chips)
Seat 2: 5c14c443 ($5.59 in chips)
Seat 3: c096c24 ($9.67 in chips)
Seat 4: 7dd18ea7 ($8.06 in chips)
Seat 5: Hero ($14.46 in chips)
Seat 6: f994138c ($8.26 in chips)
5c14c443: posts small blind $0.02
c096c24: posts big blind $0.05
*** HOLE CARDS ***
Dealt to 65900825 
Dealt to 5c14c443 
Dealt to c096c24 
Dealt to 7dd18ea7 
Dealt to Hero [Tc 4s]
Dealt to f994138c 
7dd18ea7: folds
Hero: folds
f994138c: folds
65900825: raises $0.1 to $0.15
5c14c443: folds
c096c24: folds
Uncalled bet ($0.1) returned to 65900825
*** SHOWDOWN ***
65900825 collected $0.12 from pot
*** SUMMARY ***
Total pot $0.12 | Rake $0 | Jackpot $0 | Bingo $0 | Fortune $0 | Tax $0
Seat 1: 65900825 (button) collected ($0.12)
Seat 2: 5c14c443 (small blind) folded before Flop
Seat 3: c096c24 (big blind) folded before Flop
Seat 4: 7dd18ea7 folded before Flop (didn't bet)
Seat 5: Hero folded before Flop (didn't bet)
Seat 6: f994138c folded before Flop (didn't bet)


Poker Hand #RC3334555300: Hold'em No Limit ($0.02/$0.05) - 2025/02/17 21:15:00
Table 'RushAndCash620560' 6-max Seat #1 is the button
Seat 1: Hero ($14.46 in chips)
Seat 2: 167e28c4 ($5.7 in chips)
Seat 3: 9b7148f5 ($9.5 in chips)
Seat 4: 64542a04 ($7.27 in chips)
Seat 5: be86537 ($6.93 in chips)
Seat 6: d5b0e893 ($9.15 in chips)
167e28c4: posts small blind $0.02
9b7148f5: posts big blind $0.05
*** HOLE CARDS ***
Dealt to Hero [6c Th]
Dealt to 167e28c4 
Dealt to 9b7148f5 
Dealt to 64542a04 
Dealt to be86537 
Dealt to d5b0e893 
64542a04: folds
be86537: folds
d5b0e893: raises $0.08 to $0.13
Hero: folds
167e28c4: folds
9b7148f5: folds
Uncalled bet ($0.08) returned to d5b0e893
*** SHOWDOWN ***
d5b0e893 collected $0.12 from pot
*** SUMMARY ***
Total pot $0.12 | Rake $0 | Jackpot $0 | Bingo $0 | Fortune $0 | Tax $0
Seat 1: Hero (button) folded before Flop (didn't bet)
Seat 2: 167e28c4 (small blind) folded before Flop
Seat 3: 9b7148f5 (big blind) folded before Flop
Seat 4: 64542a04 folded before Flop (didn't bet)
Seat 5: be86537 folded before Flop (didn't bet)
Seat 6: d5b0e893 collected ($0.12)


Poker Hand #RC3334555280: Hold'em No Limit ($0.02/$0.05) - 2025/02/17 21:14:57
Table 'RushAndCash620540' 6-max Seat #1 is the button
Seat 1: Hero ($14.46 in chips)
Seat 2: 5e3616df ($5 in chips)
Seat 3: 93dfef8b ($11.07 in chips)
Seat 4: 42fca4f9 ($9.79 in chips)
Seat 5: 6f8bb9d1 ($4.56 in chips)
Seat 6: 3dd0afef ($7.68 in chips)
5e3616df: posts small blind $0.02
93dfef8b: posts big blind $0.05
*** HOLE CARDS ***
Dealt to Hero [3s 2d]
Dealt to 5e3616df 
Dealt to 93dfef8b 
Dealt to 42fca4f9 
Dealt to 6f8bb9d1 
Dealt to 3dd0afef 
42fca4f9: raises $0.05 to $0.1
6f8bb9d1: folds
3dd0afef: folds
Hero: folds
5e3616df: folds
93dfef8b: folds
Uncalled bet ($0.05) returned to 42fca4f9
*** SHOWDOWN ***
42fca4f9 collected $0.12 from pot
*** SUMMARY ***
Total pot $0.12 | Rake $0 | Jackpot $0 | Bingo $0 | Fortune $0 | Tax $0
Seat 1: Hero (button) folded before Flop (didn't bet)
Seat 2: 5e3616df (small blind) folded before Flop
Seat 3: 93dfef8b (big blind) folded before Flop
Seat 4: 42fca4f9 collected ($0.12)
Seat 5: 6f8bb9d1 folded before Flop (didn't bet)
Seat 6: 3dd0afef folded before Flop (didn't bet)


Poker Hand #RC3334554968: Hold'em No Limit ($0.02/$0.05) - 2025/02/17 21:14:16
Table 'RushAndCash620228' 6-max Seat #1 is the button
Seat 1: 3b2a8270 ($12.95 in chips)
Seat 2: b59fc0b9 ($5.49 in chips)
Seat 3: Hero ($14.35 in chips)
Seat 4: 9dd1ff39 ($6.27 in chips)
Seat 5: d201e5fe ($8.99 in chips)
Seat 6: 143ede8b ($11.22 in chips)
b59fc0b9: posts small blind $0.02
Hero: posts big blind $0.05
*** HOLE CARDS ***
Dealt to 3b2a8270 
Dealt to b59fc0b9 
Dealt to Hero [9d Qs]
Dealt to 9dd1ff39 
Dealt to d201e5fe 
Dealt to 143ede8b 
9dd1ff39: folds
d201e5fe: folds
143ede8b: folds
3b2a8270: raises $0.05 to $0.1
b59fc0b9: folds
Hero: calls $0.05
*** FLOP *** [3d Ts Ks]
Hero: checks
3b2a8270: checks
*** TURN *** [3d Ts Ks] [4s]
Hero: checks
3b2a8270: checks
*** RIVER *** [3d Ts Ks 4s] [Ac]
Hero: checks
3b2a8270: checks
Hero: shows [9d Qs] (Ace-High)
3b2a8270: shows [Qd 7h] (Ace-High)
*** SHOWDOWN ***
Hero collected $0.21 from pot
*** SUMMARY ***
Total pot $0.22 | Rake $0.01 | Jackpot $0 | Bingo $0 | Fortune $0 | Tax $0
Board [3d Ts Ks 4s Ac]
Seat 1: 3b2a8270 (button) showed [Qd 7h] and lost with Ace-High
Seat 2: b59fc0b9 (small blind) folded before Flop
Seat 3: Hero (big blind) showed [9d Qs] and won ($0.21) with Ace-High
Seat 4: 9dd1ff39 folded before Flop (didn't bet)
Seat 5: d201e5fe folded before Flop (didn't bet)
Seat 6: 143ede8b folded before Flop (didn't bet)


Poker Hand #RC3334554942: Hold'em No Limit ($0.02/$0.05) - 2025/02/17 21:14:12
Table 'RushAndCash620202' 6-max Seat #1 is the button
Seat 1: cd69b3e5 ($4.62 in chips)
Seat 2: 1640de52 ($14.75 in chips)
Seat 3: d5b0e893 ($8.98 in chips)
Seat 4: 679a8f7 ($7.59 in chips)
Seat 5: 1b6c31ec ($6.89 in chips)
Seat 6: Hero ($14.35 in chips)
1640de52: posts small blind $0.02
d5b0e893: posts big blind $0.05
*** HOLE CARDS ***
Dealt to cd69b3e5 
Dealt to 1640de52 
Dealt to d5b0e893 
Dealt to 679a8f7 
Dealt to 1b6c31ec 
Dealt to Hero [9c As]
679a8f7: folds
1b6c31ec: folds
Hero: folds
cd69b3e5: raises $0.06 to $0.11
1640de52: folds
d5b0e893: calls $0.06
*** FLOP *** [4s Kd Jd]
d5b0e893: checks
cd69b3e5: bets $0.08
d5b0e893: raises $0.4 to $0.48
cd69b3e5: folds
Uncalled bet ($0.4) returned to d5b0e893
*** SHOWDOWN ***
d5b0e893 collected $0.38 from pot
*** SUMMARY ***
Total pot $0.4 | Rake $0.02 | Jackpot $0 | Bingo $0 | Fortune $0 | Tax $0
Board [4s Kd Jd]
Seat 1: cd69b3e5 (button) folded on the Flop
Seat 2: 1640de52 (small blind) folded before Flop
Seat 3: d5b0e893 (big blind) won ($0.38)
Seat 4: 679a8f7 folded before Flop (didn't bet)
Seat 5: 1b6c31ec folded before Flop (didn't bet)
Seat 6: Hero folded before Flop (didn't bet)


Poker Hand #RC3334554916: Hold'em No Limit ($0.02/$0.05) - 2025/02/17 21:14:09
Table 'RushAndCash620176' 6-max Seat #1 is the button
Seat 1: be86537 ($7.07 in chips)
Seat 2: 69a18b01 ($5.02 in chips)
Seat 3: b2966865 ($9.37 in chips)
Seat 4: e0a9129e ($3.17 in chips)
Seat 5: 35016d48 ($5.62 in chips)
Seat 6: Hero ($14.35 in chips)
69a18b01: posts small blind $0.02
b2966865: posts big blind $0.05
*** HOLE CARDS ***
Dealt to be86537 
Dealt to 69a18b01 
Dealt to b2966865 
Dealt to e0a9129e 
Dealt to 35016d48 
Dealt to Hero [6d Qs]
e0a9129e: folds
35016d48: folds
Hero: folds
be86537: folds
69a18b01: folds
Uncalled bet ($0.03) returned to b2966865
*** SHOWDOWN ***
b2966865 collected $0.04 from pot
*** SUMMARY ***
Total pot $0.04 | Rake $0 | Jackpot $0 | Bingo $0 | Fortune $0 | Tax $0
Seat 1: be86537 (button) folded before Flop (didn't bet)
Seat 2: 69a18b01 (small blind) folded before Flop
Seat 3: b2966865 (big blind) collected ($0.04)
Seat 4: e0a9129e folded before Flop (didn't bet)
Seat 5: 35016d48 folded before Flop (didn't bet)
Seat 6: Hero folded before Flop (didn't bet)


Poker Hand #RC3334554892: Hold'em No Limit ($0.02/$0.05) - 2025/02/17 21:14:06
Table 'RushAndCash620152' 6-max Seat #1 is the button
Seat 1: aa08a1c ($5.54 in chips)
Seat 2: Hero ($14.37 in chips)
Seat 3: a0b33aca ($5.82 in chips)
Seat 4: 7a40fb8f ($5 in chips)
Seat 5: fa30bfa7 ($5.05 in chips)
Seat 6: 266a98da ($1.84 in chips)
Hero: posts small blind $0.02
a0b33aca: posts big blind $0.05
*** HOLE CARDS ***
Dealt to aa08a1c 
Dealt to Hero [7h Kd]
Dealt to a0b33aca 
Dealt to 7a40fb8f 
Dealt to fa30bfa7 
Dealt to 266a98da 
7a40fb8f: folds
fa30bfa7: folds
266a98da: folds
aa08a1c: folds
Hero: folds
Uncalled bet ($0.03) returned to a0b33aca
*** SHOWDOWN ***
a0b33aca collected $0.04 from pot
*** SUMMARY ***
Total pot $0.04 | Rake $0 | Jackpot $0 | Bingo $0 | Fortune $0 | Tax $0
Seat 1: aa08a1c (button) folded before Flop (didn't bet)
Seat 2: Hero (small blind) folded before Flop
Seat 3: a0b33aca (big blind) collected ($0.04)
Seat 4: 7a40fb8f folded before Flop (didn't bet)
Seat 5: fa30bfa7 folded before Flop (didn't bet)
Seat 6: 266a98da folded before Flop (didn't bet)


Poker Hand #RC3334554866: Hold'em No Limit ($0.02/$0.05) - 2025/02/17 21:14:03
Table 'RushAndCash620126' 6-max Seat #1 is the button
Seat 1: Hero ($14.37 in chips)
Seat 2: d55e014a ($4.95 in chips)
Seat 3: 73d087f7 ($5.46 in chips)
Seat 4: e3cc36cb ($5.38 in chips)
Seat 5: 54c506e4 ($5.05 in chips)
Seat 6: 5197516b ($5.72 in chips)
d55e014a: posts small blind $0.02
73d087f7: posts big blind $0.05
*** HOLE CARDS ***
Dealt to Hero [4d Jc]
Dealt to d55e014a 
Dealt to 73d087f7 
Dealt to e3cc36cb 
Dealt to 54c506e4 
Dealt to 5197516b 
e3cc36cb: raises $0.1 to $0.15
54c506e4: folds
5197516b: folds
Hero: folds
d55e014a: folds
73d087f7: folds
Uncalled bet ($0.1) returned to e3cc36cb
*** SHOWDOWN ***
e3cc36cb collected $0.12 from pot
*** SUMMARY ***
Total pot $0.12 | Rake $0 | Jackpot $0 | Bingo $0 | Fortune $0 | Tax $0
Seat 1: Hero (button) folded before Flop (didn't bet)
Seat 2: d55e014a (small blind) folded before Flop
Seat 3: 73d087f7 (big blind) folded before Flop
Seat 4: e3cc36cb collected ($0.12)
Seat 5: 54c506e4 folded before Flop (didn't bet)
Seat 6: 5197516b folded before Flop (didn't bet)


Poker Hand #RC3334554828: Hold'em No Limit ($0.02/$0.05) - 2025/02/17 21:13:58
Table 'RushAndCash620088' 6-max Seat #1 is the button
Seat 1: 40816bf9 ($5.22 in chips)
Seat 2: fb90f143 ($14.55 in chips)
Seat 3: 7aca7e93 ($5.14 in chips)
Seat 4: 4e5ae3cb ($5.75 in chips)
Seat 5: 8d378f31 ($6.34 in chips)
Seat 6: Hero ($14.3 in chips)
fb90f143: posts small blind $0.02
7aca7e93: posts big blind $0.05
*** HOLE CARDS ***
Dealt to 40816bf9 
Dealt to fb90f143 
Dealt to 7aca7e93 
Dealt to 4e5ae3cb 
Dealt to 8d378f31 
Dealt to Hero [7h 8d]
4e5ae3cb: folds
8d378f31: folds
Hero: folds
40816bf9: raises $0.08 to $0.13
fb90f143: folds
7aca7e93: calls $0.08
*** FLOP *** [Kc 3s 7s]
7aca7e93: checks
40816bf9: checks
*** TURN *** [Kc 3s 7s] [5h]
7aca7e93: checks
40816bf9: checks
*** RIVER *** [Kc 3s 7s 5h] [As]
7aca7e93: bets $0.1
40816bf9: calls $0.1
7aca7e93: shows [5d Ac] (Pair of Aces and Pair of Fives)
40816bf9: shows [Ah 6d] (Pair of Aces)
*** SHOWDOWN ***
7aca7e93 collected $0.46 from pot
*** SUMMARY ***
Total pot $0.48 | Rake $0.02 | Jackpot $0 | Bingo $0 | Fortune $0 | Tax $0
Board [Kc 3s 7s 5h As]
Seat 1: 40816bf9 (button) showed [Ah 6d] and lost with Pair of Aces
Seat 2: fb90f143 (small blind) folded before Flop
Seat 3: 7aca7e93 (big blind) showed [5d Ac] and won ($0.46) with Pair of Aces and Pair of Fives
Seat 4: 4e5ae3cb folded before Flop (didn't bet)
Seat 5: 8d378f31 folded before Flop (didn't bet)
Seat 6: Hero folded before Flop (didn't bet)


Poker Hand #RC3334554774: Hold'em No Limit ($0.02/$0.05) - 2025/02/17 21:13:51
Table 'RushAndCash620034' 6-max Seat #1 is the button
Seat 1: b258f9f9 ($5.93 in chips)
Seat 2: 358be854 ($5 in chips)
Seat 3: 9f9e1094 ($6.6 in chips)
Seat 4: 6ebc3323 ($8.61 in chips)
Seat 5: Hero ($14.3 in chips)
Seat 6: ab01942e ($4.63 in chips)
358be854: posts small blind $0.02
9f9e1094: posts big blind $0.05
*** HOLE CARDS ***
Dealt to b258f9f9 
Dealt to 358be854 
Dealt to 9f9e1094 
Dealt to 6ebc3323 
Dealt to Hero [9c Th]
Dealt to ab01942e 
6ebc3323: folds
Hero: folds
ab01942e: folds
b258f9f9: raises $0.07 to $0.12
358be854: folds
9f9e1094: folds
Uncalled bet ($0.07) returned to b258f9f9
*** SHOWDOWN ***
b258f9f9 collected $0.12 from pot
*** SUMMARY ***
Total pot $0.12 | Rake $0 | Jackpot $0 | Bingo $0 | Fortune $0 | Tax $0
Seat 1: b258f9f9 (button) collected ($0.12)
Seat 2: 358be854 (small blind) folded before Flop
Seat 3: 9f9e1094 (big blind) folded before Flop
Seat 4: 6ebc3323 folded before Flop (didn't bet)
Seat 5: Hero folded before Flop (didn't bet)
Seat 6: ab01942e folded before Flop (didn't bet)


Poker Hand #RC3334484735: Hold'em No Limit ($0.02/$0.05) - 2025/02/17 21:13:46
Table 'RushAndCash619995' 6-max Seat #1 is the button
Seat 1: b67f7812 ($7.46 in chips)
Seat 2: Hero ($14.32 in chips)
Seat 3: b59fc0b9 ($5.54 in chips)
Seat 4: 4e5ae3cb ($5.75 in chips)
Seat 5: 9dba8a1e ($5.78 in chips)
Seat 6: 6d5fa70b ($5.26 in chips)
Hero: posts small blind $0.02
b59fc0b9: posts big blind $0.05
*** HOLE CARDS ***
Dealt to b67f7812 
Dealt to Hero [Qh 7c]
Dealt to b59fc0b9 
Dealt to 4e5ae3cb 
Dealt to 9dba8a1e 
Dealt to 6d5fa70b 
4e5ae3cb: folds
9dba8a1e: raises $0.05 to $0.1
6d5fa70b: raises $0.22 to $0.32
b67f7812: folds
Hero: folds
b59fc0b9: folds
9dba8a1e: calls $0.22
*** FLOP *** [Qd 2d Td]
9dba8a1e: checks
6d5fa70b: checks
*** TURN *** [Qd 2d Td] [Kc]
9dba8a1e: bets $0.54
6d5fa70b: folds
Uncalled bet ($0.54) returned to 9dba8a1e
*** SHOWDOWN ***
9dba8a1e collected $0.68 from pot
*** SUMMARY ***
Total pot $0.71 | Rake $0.03 | Jackpot $0 | Bingo $0 | Fortune $0 | Tax $0
Board [Qd 2d Td Kc]
Seat 1: b67f7812 (button) folded before Flop (didn't bet)
Seat 2: Hero (small blind) folded before Flop
Seat 3: b59fc0b9 (big blind) folded before Flop
Seat 4: 4e5ae3cb folded before Flop (didn't bet)
Seat 5: 9dba8a1e won ($0.68)
Seat 6: 6d5fa70b folded on the Turn


Poker Hand #RC3334484711: Hold'em No Limit ($0.02/$0.05) - 2025/02/17 21:13:43
Table 'RushAndCash619971' 6-max Seat #1 is the button
Seat 1: b88dd991 ($5.06 in chips)
Seat 2: 81acf14c ($5 in chips)
Seat 3: Hero ($14.37 in chips)
Seat 4: c62b7a0b ($22.54 in chips)
Seat 5: 71e00d83 ($16.15 in chips)
Seat 6: f68df189 ($5.66 in chips)
81acf14c: posts small blind $0.02
Hero: posts big blind $0.05
*** HOLE CARDS ***
Dealt to b88dd991 
Dealt to 81acf14c 
Dealt to Hero [Td 9h]
Dealt to c62b7a0b 
Dealt to 71e00d83 
Dealt to f68df189 
c62b7a0b: folds
71e00d83: folds
f68df189: folds
b88dd991: folds
81acf14c: folds
Uncalled bet ($0.03) returned to Hero
*** SHOWDOWN ***
Hero collected $0.04 from pot
*** SUMMARY ***
Total pot $0.04 | Rake $0 | Jackpot $0 | Bingo $0 | Fortune $0 | Tax $0
Seat 1: b88dd991 (button) folded before Flop (didn't bet)
Seat 2: 81acf14c (small blind) folded before Flop
Seat 3: Hero (big blind) collected ($0.04)
Seat 4: c62b7a0b folded before Flop (didn't bet)
Seat 5: 71e00d83 folded before Flop (didn't bet)
Seat 6: f68df189 folded before Flop (didn't bet)


Poker Hand #RC3334484687: Hold'em No Limit ($0.02/$0.05) - 2025/02/17 21:13:40
Table 'RushAndCash619947' 6-max Seat #1 is the button
Seat 1: Hero ($14.37 in chips)
Seat 2: 9dba8a1e ($5.8 in chips)
Seat 3: aaa792dc ($5.48 in chips)
Seat 4: d691d846 ($3.42 in chips)
Seat 5: b8a41e4 ($5.41 in chips)
Seat 6: 23c23672 ($5.27 in chips)
9dba8a1e: posts small blind $0.02
aaa792dc: posts big blind $0.05
*** HOLE CARDS ***
Dealt to Hero [Th 2s]
Dealt to 9dba8a1e 
Dealt to aaa792dc 
Dealt to d691d846 
Dealt to b8a41e4 
Dealt to 23c23672 
d691d846: raises $0.05 to $0.1
b8a41e4: folds
23c23672: folds
Hero: folds
9dba8a1e: folds
aaa792dc: folds
Uncalled bet ($0.05) returned to d691d846
*** SHOWDOWN ***
d691d846 collected $0.12 from pot
*** SUMMARY ***
Total pot $0.12 | Rake $0 | Jackpot $0 | Bingo $0 | Fortune $0 | Tax $0
Seat 1: Hero (button) folded before Flop (didn't bet)
Seat 2: 9dba8a1e (small blind) folded before Flop
Seat 3: aaa792dc (big blind) folded before Flop
Seat 4: d691d846 collected ($0.12)
Seat 5: b8a41e4 folded before Flop (didn't bet)
Seat 6: 23c23672 folded before Flop (didn't bet)


Poker Hand #RC3334484663: Hold'em No Limit ($0.02/$0.05) - 2025/02/17 21:13:37
Table 'RushAndCash619923' 6-max Seat #1 is the button
Seat 1: Hero ($14.37 in chips)
Seat 2: 8974621f ($4.95 in chips)
Seat 3: f6efd55a ($8.97 in chips)
Seat 4: 23c23672 ($5.27 in chips)
Seat 5: 6d2abfa5 ($6.7 in chips)
Seat 6: 3ed1e77f ($5.1 in chips)
8974621f: posts small blind $0.02
f6efd55a: posts big blind $0.05
*** HOLE CARDS ***
Dealt to Hero [3c Ad]
Dealt to 8974621f 
Dealt to f6efd55a 
Dealt to 23c23672 
Dealt to 6d2abfa5 
Dealt to 3ed1e77f 
23c23672: folds
6d2abfa5: folds
3ed1e77f: folds
Hero: folds
8974621f: folds
Uncalled bet ($0.03) returned to f6efd55a
*** SHOWDOWN ***
f6efd55a collected $0.04 from pot
*** SUMMARY ***
Total pot $0.04 | Rake $0 | Jackpot $0 | Bingo $0 | Fortune $0 | Tax $0
Seat 1: Hero (button) folded before Flop (didn't bet)
Seat 2: 8974621f (small blind) folded before Flop
Seat 3: f6efd55a (big blind) collected ($0.04)
Seat 4: 23c23672 folded before Flop (didn't bet)
Seat 5: 6d2abfa5 folded before Flop (didn't bet)
Seat 6: 3ed1e77f folded before Flop (didn't bet)


Poker Hand #RC3334484642: Hold'em No Limit ($0.02/$0.05) - 2025/02/17 21:13:34
Table 'RushAndCash619902' 6-max Seat #1 is the button
Seat 1: 1941fa92 ($2.33 in chips)
Seat 2: aaa792dc ($5.5 in chips)
Seat 3: 56640090 ($4.06 in chips)
Seat 4: 92e1348d ($7.27 in chips)
Seat 5: 2b13f4d5 ($4.18 in chips)
Seat 6: Hero ($14.37 in chips)
aaa792dc: posts small blind $0.02
56640090: posts big blind $0.05
*** HOLE CARDS ***
Dealt to 1941fa92 
Dealt to aaa792dc 
Dealt to 56640090 
Dealt to 92e1348d 
Dealt to 2b13f4d5 
Dealt to Hero [5h Js]
92e1348d: folds
2b13f4d5: folds
Hero: folds
1941fa92: raises $0.05 to $0.1
aaa792dc: folds
56640090: calls $0.05
*** FLOP *** [8s Ks 8h]
56640090: checks
1941fa92: bets $0.11
56640090: raises $0.22 to $0.33
1941fa92: calls $0.22
*** TURN *** [8s Ks 8h] [9s]
56640090: bets $0.44
1941fa92: folds
Uncalled bet ($0.44) returned to 56640090
*** SHOWDOWN ***
56640090 collected $0.84 from pot
*** SUMMARY ***
Total pot $0.88 | Rake $0.04 | Jackpot $0 | Bingo $0 | Fortune $0 | Tax $0
Board [8s Ks 8h 9s]
Seat 1: 1941fa92 (button) folded on the Turn
Seat 2: aaa792dc (small blind) folded before Flop
Seat 3: 56640090 (big blind) won ($0.84)
Seat 4: 92e1348d folded before Flop (didn't bet)
Seat 5: 2b13f4d5 folded before Flop (didn't bet)
Seat 6: Hero folded before Flop (didn't bet)


Poker Hand #RC3334484615: Hold'em No Limit ($0.02/$0.05) - 2025/02/17 21:13:30
Table 'RushAndCash619875' 6-max Seat #1 is the button
Seat 1: 9ccadbb5 ($10.37 in chips)
Seat 2: f7c51ea2 ($5 in chips)
Seat 3: Hero ($14.42 in chips)
Seat 4: 24aff26b ($5.83 in chips)
Seat 5: cd69b3e5 ($4.55 in chips)
Seat 6: e32dc6f0 ($5.07 in chips)
f7c51ea2: posts small blind $0.02
Hero: posts big blind $0.05
*** HOLE CARDS ***
Dealt to 9ccadbb5 
Dealt to f7c51ea2 
Dealt to Hero [2h Jh]
Dealt to 24aff26b 
Dealt to cd69b3e5 
Dealt to e32dc6f0 
24aff26b: folds
cd69b3e5: raises $0.06 to $0.11
e32dc6f0: folds
9ccadbb5: folds
f7c51ea2: folds
Hero: folds
Uncalled bet ($0.06) returned to cd69b3e5
*** SHOWDOWN ***
cd69b3e5 collected $0.12 from pot
*** SUMMARY ***
Total pot $0.12 | Rake $0 | Jackpot $0 | Bingo $0 | Fortune $0 | Tax $0
Seat 1: 9ccadbb5 (button) folded before Flop (didn't bet)
Seat 2: f7c51ea2 (small blind) folded before Flop
Seat 3: Hero (big blind) folded before Flop
Seat 4: 24aff26b folded before Flop (didn't bet)
Seat 5: cd69b3e5 collected ($0.12)
Seat 6: e32dc6f0 folded before Flop (didn't bet)


Poker Hand #RC3334484529: Hold'em No Limit ($0.02/$0.05) - 2025/02/17 21:13:19
Table 'RushAndCash619789' 6-max Seat #1 is the button
Seat 1: f68df189 ($5.66 in chips)
Seat 2: 94cb065d ($6.54 in chips)
Seat 3: c24b20b9 ($19.09 in chips)
Seat 4: 3d537b07 ($5.16 in chips)
Seat 5: 3939bf98 ($5 in chips)
Seat 6: Hero ($14.35 in chips)
94cb065d: posts small blind $0.02
c24b20b9: posts big blind $0.05
*** HOLE CARDS ***
Dealt to f68df189 
Dealt to 94cb065d 
Dealt to c24b20b9 
Dealt to 3d537b07 
Dealt to 3939bf98 
Dealt to Hero [Ah Jh]
3d537b07: folds
3939bf98: folds
Hero: raises $0.05 to $0.1
f68df189: folds
94cb065d: folds
c24b20b9: folds
Uncalled bet ($0.05) returned to Hero
*** SHOWDOWN ***
Hero collected $0.12 from pot
*** SUMMARY ***
Total pot $0.12 | Rake $0 | Jackpot $0 | Bingo $0 | Fortune $0 | Tax $0
Seat 1: f68df189 (button) folded before Flop (didn't bet)
Seat 2: 94cb065d (small blind) folded before Flop
Seat 3: c24b20b9 (big blind) folded before Flop
Seat 4: 3d537b07 folded before Flop (didn't bet)
Seat 5: 3939bf98 folded before Flop (didn't bet)
Seat 6: Hero collected ($0.12)


Poker Hand #RC3334484504: Hold'em No Limit ($0.02/$0.05) - 2025/02/17 21:13:16
Table 'RushAndCash619764' 6-max Seat #1 is the button
Seat 1: 6d2abfa5 ($6.77 in chips)
Seat 2: Hero ($14.37 in chips)
Seat 3: 918d412c ($4.34 in chips)
Seat 4: a2a0f00 ($10.06 in chips)
Seat 5: 3d537b07 ($5.16 in chips)
Seat 6: 42fca4f9 ($10.27 in chips)
Hero: posts small blind $0.02
918d412c: posts big blind $0.05
*** HOLE CARDS ***
Dealt to 6d2abfa5 
Dealt to Hero [Jc 2s]
Dealt to 918d412c 
Dealt to a2a0f00 
Dealt to 3d537b07 
Dealt to 42fca4f9 
a2a0f00: raises $0.06 to $0.11
3d537b07: folds
42fca4f9: folds
6d2abfa5: folds
Hero: folds
918d412c: calls $0.06
*** FLOP *** [8d 6h 7s]
918d412c: checks
a2a0f00: bets $0.1
918d412c: calls $0.1
*** TURN *** [8d 6h 7s] [Jh]
918d412c: bets $0.22
a2a0f00: calls $0.22
*** RIVER *** [8d 6h 7s Jh] [Qh]
918d412c: checks
a2a0f00: bets $0.3
918d412c: folds
Uncalled bet ($0.3) returned to a2a0f00
*** SHOWDOWN ***
a2a0f00 collected $0.84 from pot
*** SUMMARY ***
Total pot $0.88 | Rake $0.04 | Jackpot $0 | Bingo $0 | Fortune $0 | Tax $0
Board [8d 6h 7s Jh Qh]
Seat 1: 6d2abfa5 (button) folded before Flop (didn't bet)
Seat 2: Hero (small blind) folded before Flop
Seat 3: 918d412c (big blind) folded on the River
Seat 4: a2a0f00 won ($0.84)
Seat 5: 3d537b07 folded before Flop (didn't bet)
Seat 6: 42fca4f9 folded before Flop (didn't bet)


Poker Hand #RC3334483959: Hold'em No Limit ($0.02/$0.05) - 2025/02/17 21:12:03
Table 'RushAndCash619219' 6-max Seat #1 is the button
Seat 1: 6de2662f ($6.33 in chips)
Seat 2: 229ec9a7 ($6.9 in chips)
Seat 3: 2ad19ee2 ($5 in chips)
Seat 4: Hero ($13.93 in chips)
Seat 5: b9ea571d ($5.95 in chips)
Seat 6: 74d92f2b ($10.56 in chips)
229ec9a7: posts small blind $0.02
2ad19ee2: posts big blind $0.05
*** HOLE CARDS ***
Dealt to 6de2662f 
Dealt to 229ec9a7 
Dealt to 2ad19ee2 
Dealt to Hero [Qd Qc]
Dealt to b9ea571d 
Dealt to 74d92f2b 
Hero: raises $0.05 to $0.1
b9ea571d: folds
74d92f2b: folds
6de2662f: folds
229ec9a7: folds
2ad19ee2: calls $0.05
*** FLOP *** [9c 3c 6c]
2ad19ee2: checks
Hero: bets $0.12
2ad19ee2: calls $0.12
*** TURN *** [9c 3c 6c] [6s]
2ad19ee2: checks
Hero: bets $0.24
2ad19ee2: calls $0.24
*** RIVER *** [9c 3c 6c 6s] [4s]
2ad19ee2: checks
Hero: checks
2ad19ee2: shows [Ad Jc] (Pair of Sixes)
Hero: shows [Qd Qc] (Pair of Queens and Pair of Sixes)
*** SHOWDOWN ***
Hero collected $0.9 from pot
*** SUMMARY ***
Total pot $0.94 | Rake $0.04 | Jackpot $0 | Bingo $0 | Fortune $0 | Tax $0
Board [9c 3c 6c 6s 4s]
Seat 1: 6de2662f (button) folded before Flop (didn't bet)
Seat 2: 229ec9a7 (small blind) folded before Flop
Seat 3: 2ad19ee2 (big blind) showed [Ad Jc] and lost with Pair of Sixes
Seat 4: Hero showed [Qd Qc] and won ($0.9) with Pair of Queens and Pair of Sixes
Seat 5: b9ea571d folded before Flop (didn't bet)
Seat 6: 74d92f2b folded before Flop (didn't bet)


Poker Hand #RC3334483919: Hold'em No Limit ($0.02/$0.05) - 2025/02/17 21:11:58
Table 'RushAndCash619179' 6-max Seat #1 is the button
Seat 1: 53a8c2fd ($5 in chips)
Seat 2: 4238ab48 ($6.35 in chips)
Seat 3: 12cda2e0 ($22.03 in chips)
Seat 4: 6d2abfa5 ($6.84 in chips)
Seat 5: cbfd6c92 ($9.14 in chips)
Seat 6: Hero ($13.93 in chips)
4238ab48: posts small blind $0.02
12cda2e0: posts big blind $0.05
*** HOLE CARDS ***
Dealt to 53a8c2fd 
Dealt to 4238ab48 
Dealt to 12cda2e0 
Dealt to 6d2abfa5 
Dealt to cbfd6c92 
Dealt to Hero [8s 2d]
6d2abfa5: folds
cbfd6c92: folds
Hero: folds
53a8c2fd: raises $0.06 to $0.11
4238ab48: folds
12cda2e0: folds
Uncalled bet ($0.06) returned to 53a8c2fd
*** SHOWDOWN ***
53a8c2fd collected $0.12 from pot
*** SUMMARY ***
Total pot $0.12 | Rake $0 | Jackpot $0 | Bingo $0 | Fortune $0 | Tax $0
Seat 1: 53a8c2fd (button) collected ($0.12)
Seat 2: 4238ab48 (small blind) folded before Flop
Seat 3: 12cda2e0 (big blind) folded before Flop
Seat 4: 6d2abfa5 folded before Flop (didn't bet)
Seat 5: cbfd6c92 folded before Flop (didn't bet)
Seat 6: Hero folded before Flop (didn't bet)


Poker Hand #RC3334483852: Hold'em No Limit ($0.02/$0.05) - 2025/02/17 21:11:50
Table 'RushAndCash619112' 6-max Seat #1 is the button
Seat 1: ae0cde3d ($6.37 in chips)
Seat 2: d201e5fe ($9.01 in chips)
Seat 3: c55fc96f ($4.82 in chips)
Seat 4: Hero ($13.93 in chips)
Seat 5: ec767863 ($4.95 in chips)
Seat 6: 626359de ($12.42 in chips)
d201e5fe: posts small blind $0.02
c55fc96f: posts big blind $0.05
*** HOLE CARDS ***
Dealt to ae0cde3d 
Dealt to d201e5fe 
Dealt to c55fc96f 
Dealt to Hero [4h Ad]
Dealt to ec767863 
Dealt to 626359de 
Hero: folds
ec767863: folds
626359de: folds
ae0cde3d: folds
d201e5fe: folds
Uncalled bet ($0.03) returned to c55fc96f
*** SHOWDOWN ***
c55fc96f collected $0.04 from pot
*** SUMMARY ***
Total pot $0.04 | Rake $0 | Jackpot $0 | Bingo $0 | Fortune $0 | Tax $0
Seat 1: ae0cde3d (button) folded before Flop (didn't bet)
Seat 2: d201e5fe (small blind) folded before Flop
Seat 3: c55fc96f (big blind) collected ($0.04)
Seat 4: Hero folded before Flop (didn't bet)
Seat 5: ec767863 folded before Flop (didn't bet)
Seat 6: 626359de folded before Flop (didn't bet)


Poker Hand #RC3334483692: Hold'em No Limit ($0.02/$0.05) - 2025/02/17 21:11:30
Table 'RushAndCash618952' 6-max Seat #1 is the button
Seat 1: 2ad19ee2 ($5 in chips)
Seat 2: dcd4e05 ($1.95 in chips)
Seat 3: Hero ($13.98 in chips)
Seat 4: 6008538 ($4.36 in chips)
Seat 5: 679a8f7 ($7.65 in chips)
Seat 6: c1784884 ($5.02 in chips)
dcd4e05: posts small blind $0.02
Hero: posts big blind $0.05
*** HOLE CARDS ***
Dealt to 2ad19ee2 
Dealt to dcd4e05 
Dealt to Hero [8s Ad]
Dealt to 6008538 
Dealt to 679a8f7 
Dealt to c1784884 
6008538: folds
679a8f7: raises $0.05 to $0.1
c1784884: folds
2ad19ee2: folds
dcd4e05: calls $0.08
Hero: folds
*** FLOP *** [7d As 9h]
dcd4e05: checks
679a8f7: bets $0.07
dcd4e05: calls $0.07
*** TURN *** [7d As 9h] [3s]
dcd4e05: checks
679a8f7: bets $0.21
dcd4e05: folds
Uncalled bet ($0.21) returned to 679a8f7
*** SHOWDOWN ***
679a8f7 collected $0.37 from pot
*** SUMMARY ***
Total pot $0.39 | Rake $0.02 | Jackpot $0 | Bingo $0 | Fortune $0 | Tax $0
Board [7d As 9h 3s]
Seat 1: 2ad19ee2 (button) folded before Flop (didn't bet)
Seat 2: dcd4e05 (small blind) folded on the Turn
Seat 3: Hero (big blind) folded before Flop
Seat 4: 6008538 folded before Flop (didn't bet)
Seat 5: 679a8f7 won ($0.37)
Seat 6: c1784884 folded before Flop (didn't bet)


Poker Hand #RC3334483664: Hold'em No Limit ($0.02/$0.05) - 2025/02/17 21:11:27
Table 'RushAndCash618924' 6-max Seat #1 is the button
Seat 1: 1754e33c ($9.95 in chips)
Seat 2: fb6c913 ($9.16 in chips)
Seat 3: 942af666 ($5.75 in chips)
Seat 4: c1784884 ($5.02 in chips)
Seat 5: a0b33aca ($5 in chips)
Seat 6: Hero ($13.98 in chips)
fb6c913: posts small blind $0.02
942af666: posts big blind $0.05
*** HOLE CARDS ***
Dealt to 1754e33c 
Dealt to fb6c913 
Dealt to 942af666 
Dealt to c1784884 
Dealt to a0b33aca 
Dealt to Hero [8h Jc]
c1784884: folds
a0b33aca: folds
Hero: folds
1754e33c: folds
fb6c913: raises $0.05 to $0.1
942af666: calls $0.05
*** FLOP *** [Th 7s Kh]
fb6c913: checks
942af666: checks
*** TURN *** [Th 7s Kh] [Kd]
fb6c913: checks
942af666: bets $0.07
fb6c913: calls $0.07
*** RIVER *** [Th 7s Kh Kd] [2c]
fb6c913: checks
942af666: bets $0.24
fb6c913: calls $0.24
942af666: shows [Jh 9h] (Pair of Kings)
fb6c913: shows [4s 4d] (Pair of Kings and Pair of Fours)
*** SHOWDOWN ***
fb6c913 collected $0.78 from pot
*** SUMMARY ***
Total pot $0.82 | Rake $0.04 | Jackpot $0 | Bingo $0 | Fortune $0 | Tax $0
Board [Th 7s Kh Kd 2c]
Seat 1: 1754e33c (button) folded before Flop (didn't bet)
Seat 2: fb6c913 (small blind) showed [4s 4d] and won ($0.78) with Pair of Kings and Pair of Fours
Seat 3: 942af666 (big blind) showed [Jh 9h] and lost with Pair of Kings
Seat 4: c1784884 folded before Flop (didn't bet)
Seat 5: a0b33aca folded before Flop (didn't bet)
Seat 6: Hero folded before Flop (didn't bet)


Poker Hand #RC3334483609: Hold'em No Limit ($0.02/$0.05) - 2025/02/17 21:11:21
Table 'RushAndCash618869' 6-max Seat #1 is the button
Seat 1: cda83b9b ($7.43 in chips)
Seat 2: Hero ($14 in chips)
Seat 3: a375b232 ($5 in chips)
Seat 4: 86e70506 ($5.16 in chips)
Seat 5: 64542a04 ($6.87 in chips)
Seat 6: 3ba7378 ($4.02 in chips)
Hero: posts small blind $0.02
a375b232: posts big blind $0.05
*** HOLE CARDS ***
Dealt to cda83b9b 
Dealt to Hero [Jh 7c]
Dealt to a375b232 
Dealt to 86e70506 
Dealt to 64542a04 
Dealt to 3ba7378 
86e70506: folds
64542a04: folds
3ba7378: folds
cda83b9b: folds
Hero: folds
Uncalled bet ($0.03) returned to a375b232
*** SHOWDOWN ***
a375b232 collected $0.04 from pot
*** SUMMARY ***
Total pot $0.04 | Rake $0 | Jackpot $0 | Bingo $0 | Fortune $0 | Tax $0
Seat 1: cda83b9b (button) folded before Flop (didn't bet)
Seat 2: Hero (small blind) folded before Flop
Seat 3: a375b232 (big blind) collected ($0.04)
Seat 4: 86e70506 folded before Flop (didn't bet)
Seat 5: 64542a04 folded before Flop (didn't bet)
Seat 6: 3ba7378 folded before Flop (didn't bet)


Poker Hand #RC3334483566: Hold'em No Limit ($0.02/$0.05) - 2025/02/17 21:11:15
Table 'RushAndCash618826' 6-max Seat #1 is the button
Seat 1: e89071f6 ($6.99 in chips)
Seat 2: fa36f7b1 ($5.29 in chips)
Seat 3: c1784884 ($5 in chips)
Seat 4: 23619adf ($5.61 in chips)
Seat 5: Hero ($14 in chips)
Seat 6: 395dd35d ($5.1 in chips)
fa36f7b1: posts small blind $0.02
c1784884: posts big blind $0.05
*** HOLE CARDS ***
Dealt to e89071f6 
Dealt to fa36f7b1 
Dealt to c1784884 
Dealt to 23619adf 
Dealt to Hero [Qd 2s]
Dealt to 395dd35d 
23619adf: folds
Hero: folds
395dd35d: folds
e89071f6: folds
fa36f7b1: folds
Uncalled bet ($0.03) returned to c1784884
*** SHOWDOWN ***
c1784884 collected $0.04 from pot
*** SUMMARY ***
Total pot $0.04 | Rake $0 | Jackpot $0 | Bingo $0 | Fortune $0 | Tax $0
Seat 1: e89071f6 (button) folded before Flop (didn't bet)
Seat 2: fa36f7b1 (small blind) folded before Flop
Seat 3: c1784884 (big blind) collected ($0.04)
Seat 4: 23619adf folded before Flop (didn't bet)
Seat 5: Hero folded before Flop (didn't bet)
Seat 6: 395dd35d folded before Flop (didn't bet)


Poker Hand #RC3334483363: Hold'em No Limit ($0.02/$0.05) - 2025/02/17 21:10:48
Table 'RushAndCash618623' 6-max Seat #1 is the button
Seat 1: 84667b37 ($5 in chips)
Seat 2: 22005c45 ($4.85 in chips)
Seat 3: fa36f7b1 ($5.39 in chips)
Seat 4: d58b99ca ($29.04 in chips)
Seat 5: Hero ($13.79 in chips)
Seat 6: b01e47a0 ($5 in chips)
22005c45: posts small blind $0.02
fa36f7b1: posts big blind $0.05
*** HOLE CARDS ***
Dealt to 84667b37 
Dealt to 22005c45 
Dealt to fa36f7b1 
Dealt to d58b99ca 
Dealt to Hero [Ah Kh]
Dealt to b01e47a0 
d58b99ca: folds
Hero: raises $0.05 to $0.1
b01e47a0: calls $0.1
84667b37: folds
22005c45: folds
fa36f7b1: calls $0.05
*** FLOP *** [5h Ac 2s]
fa36f7b1: checks
Hero: bets $0.16
b01e47a0: folds
fa36f7b1: folds
Uncalled bet ($0.16) returned to Hero
*** SHOWDOWN ***
Hero collected $0.31 from pot
*** SUMMARY ***
Total pot $0.32 | Rake $0.01 | Jackpot $0 | Bingo $0 | Fortune $0 | Tax $0
Board [5h Ac 2s]
Seat 1: 84667b37 (button) folded before Flop (didn't bet)
Seat 2: 22005c45 (small blind) folded before Flop
Seat 3: fa36f7b1 (big blind) folded on the Flop
Seat 4: d58b99ca folded before Flop (didn't bet)
Seat 5: Hero won ($0.31)
Seat 6: b01e47a0 folded on the Flop


Poker Hand #RC3334483340: Hold'em No Limit ($0.02/$0.05) - 2025/02/17 21:10:45
Table 'RushAndCash618600' 6-max Seat #1 is the button
Seat 1: d75cab93 ($6.26 in chips)
Seat 2: 35016d48 ($5.45 in chips)
Seat 3: 6614dc4b ($5.91 in chips)
Seat 4: 4b71998b ($6.19 in chips)
Seat 5: Hero ($13.79 in chips)
Seat 6: 3ad90733 ($5 in chips)
35016d48: posts small blind $0.02
6614dc4b: posts big blind $0.05
*** HOLE CARDS ***
Dealt to d75cab93 
Dealt to 35016d48 
Dealt to 6614dc4b 
Dealt to 4b71998b 
Dealt to Hero [3h 5c]
Dealt to 3ad90733 
4b71998b: folds
Hero: folds
3ad90733: raises $0.05 to $0.1
d75cab93: folds
35016d48: folds
6614dc4b: raises $0.25 to $0.35
3ad90733: calls $0.25
*** FLOP *** [3s Kc 8d]
6614dc4b: bets $0.36
3ad90733: folds
Uncalled bet ($0.36) returned to 6614dc4b
*** SHOWDOWN ***
6614dc4b collected $0.69 from pot
*** SUMMARY ***
Total pot $0.72 | Rake $0.03 | Jackpot $0 | Bingo $0 | Fortune $0 | Tax $0
Board [3s Kc 8d]
Seat 1: d75cab93 (button) folded before Flop (didn't bet)
Seat 2: 35016d48 (small blind) folded before Flop
Seat 3: 6614dc4b (big blind) won ($0.69)
Seat 4: 4b71998b folded before Flop (didn't bet)
Seat 5: Hero folded before Flop (didn't bet)
Seat 6: 3ad90733 folded on the Flop


Poker Hand #RC3334483315: Hold'em No Limit ($0.02/$0.05) - 2025/02/17 21:10:42
Table 'RushAndCash618575' 6-max Seat #1 is the button
Seat 1: 3ad90733 ($5 in chips)
Seat 2: Hero ($13.81 in chips)
Seat 3: 12cda2e0 ($22.24 in chips)
Seat 4: c4483bd8 ($5.64 in chips)
Seat 5: 2e388e95 ($6.82 in chips)
Seat 6: e5c03448 ($6.91 in chips)
Hero: posts small blind $0.02
12cda2e0: posts big blind $0.05
*** HOLE CARDS ***
Dealt to 3ad90733 
Dealt to Hero [Tc 7s]
Dealt to 12cda2e0 
Dealt to c4483bd8 
Dealt to 2e388e95 
Dealt to e5c03448 
c4483bd8: folds
2e388e95: folds
e5c03448: raises $0.05 to $0.1
3ad90733: folds
Hero: folds
12cda2e0: folds
Uncalled bet ($0.05) returned to e5c03448
*** SHOWDOWN ***
e5c03448 collected $0.12 from pot
*** SUMMARY ***
Total pot $0.12 | Rake $0 | Jackpot $0 | Bingo $0 | Fortune $0 | Tax $0
Seat 1: 3ad90733 (button) folded before Flop (didn't bet)
Seat 2: Hero (small blind) folded before Flop
Seat 3: 12cda2e0 (big blind) folded before Flop
Seat 4: c4483bd8 folded before Flop (didn't bet)
Seat 5: 2e388e95 folded before Flop (didn't bet)
Seat 6: e5c03448 collected ($0.12)


Poker Hand #RC3334483282: Hold'em No Limit ($0.02/$0.05) - 2025/02/17 21:10:38
Table 'RushAndCash618542' 6-max Seat #1 is the button
Seat 1: bb090dff ($4.69 in chips)
Seat 2: ead6cfaf ($5.92 in chips)
Seat 3: ccabd9d2 ($4.98 in chips)
Seat 4: Hero ($13.81 in chips)
Seat 5: edf64ec2 ($5.05 in chips)
Seat 6: fdbac393 ($5.34 in chips)
ead6cfaf: posts small blind $0.02
ccabd9d2: posts big blind $0.05
*** HOLE CARDS ***
Dealt to bb090dff 
Dealt to ead6cfaf 
Dealt to ccabd9d2 
Dealt to Hero [2h 6d]
Dealt to edf64ec2 
Dealt to fdbac393 
Hero: folds
edf64ec2: folds
fdbac393: folds
bb090dff: folds
ead6cfaf: folds
Uncalled bet ($0.03) returned to ccabd9d2
*** SHOWDOWN ***
ccabd9d2 collected $0.04 from pot
*** SUMMARY ***
Total pot $0.04 | Rake $0 | Jackpot $0 | Bingo $0 | Fortune $0 | Tax $0
Seat 1: bb090dff (button) folded before Flop (didn't bet)
Seat 2: ead6cfaf (small blind) folded before Flop
Seat 3: ccabd9d2 (big blind) collected ($0.04)
Seat 4: Hero folded before Flop (didn't bet)
Seat 5: edf64ec2 folded before Flop (didn't bet)
Seat 6: fdbac393 folded before Flop (didn't bet)


Poker Hand #RC3334482801: Hold'em No Limit ($0.02/$0.05) - 2025/02/17 21:09:41
Table 'RushAndCash618061' 6-max Seat #1 is the button
Seat 1: 191b60c1 ($8.21 in chips)
Seat 2: e3c5673f ($3.92 in chips)
Seat 3: Hero ($13.96 in chips)
Seat 4: 2e388e95 ($6.9 in chips)
Seat 5: 90c3e611 ($5.4 in chips)
Seat 6: ead6cfaf ($5.22 in chips)
e3c5673f: posts small blind $0.02
Hero: posts big blind $0.05
*** HOLE CARDS ***
Dealt to 191b60c1 
Dealt to e3c5673f 
Dealt to Hero [5s 5c]
Dealt to 2e388e95 
Dealt to 90c3e611 
Dealt to ead6cfaf 
2e388e95: folds
90c3e611: folds
ead6cfaf: raises $0.1 to $0.15
191b60c1: folds
e3c5673f: calls $0.13
Hero: calls $0.1
*** FLOP *** [As 7d Ac]
e3c5673f: checks
Hero: checks
ead6cfaf: checks
*** TURN *** [As 7d Ac] [9s]
e3c5673f: checks
Hero: checks
ead6cfaf: bets $0.23
e3c5673f: calls $0.23
Hero: folds
*** RIVER *** [As 7d Ac 9s] [Qc]
e3c5673f: checks
ead6cfaf: bets $0.31
e3c5673f: calls $0.31
ead6cfaf: shows [8h Ah] (Three Aces)
e3c5673f: shows [Kc Qh] (Pair of Aces and Pair of Queens)
*** SHOWDOWN ***
ead6cfaf collected $1.39 from pot
*** SUMMARY ***
Total pot $1.53 | Rake $0.07 | Jackpot $0.07 | Bingo $0 | Fortune $0 | Tax $0
Board [As 7d Ac 9s Qc]
Seat 1: 191b60c1 (button) folded before Flop (didn't bet)
Seat 2: e3c5673f (small blind) showed [Kc Qh] and lost with Pair of Aces and Pair of Queens
Seat 3: Hero (big blind) folded on the Turn
Seat 4: 2e388e95 folded before Flop (didn't bet)
Seat 5: 90c3e611 folded before Flop (didn't bet)
Seat 6: ead6cfaf showed [8h Ah] and won ($1.39) with Three Aces


Poker Hand #RC3334482672: Hold'em No Limit ($0.02/$0.05) - 2025/02/17 21:09:26
Table 'RushAndCash617932' 6-max Seat #1 is the button
Seat 1: d2b9404f ($6.04 in chips)
Seat 2: Hero ($13.81 in chips)
Seat 3: c1f4858e ($5.92 in chips)
Seat 4: baaf0b0d ($5 in chips)
Seat 5: 71e00d83 ($12.54 in chips)
Seat 6: 75d5d480 ($6.43 in chips)
Hero: posts small blind $0.02
c1f4858e: posts big blind $0.05
*** HOLE CARDS ***
Dealt to d2b9404f 
Dealt to Hero [Ac Kc]
Dealt to c1f4858e 
Dealt to baaf0b0d 
Dealt to 71e00d83 
Dealt to 75d5d480 
baaf0b0d: folds
71e00d83: folds
75d5d480: folds
d2b9404f: raises $0.06 to $0.11
Hero: raises $0.35 to $0.46
c1f4858e: folds
d2b9404f: folds
Uncalled bet ($0.35) returned to Hero
*** SHOWDOWN ***
Hero collected $0.26 from pot
*** SUMMARY ***
Total pot $0.27 | Rake $0.01 | Jackpot $0 | Bingo $0 | Fortune $0 | Tax $0
Seat 1: d2b9404f (button) folded before Flop
Seat 2: Hero (small blind) collected ($0.26)
Seat 3: c1f4858e (big blind) folded before Flop
Seat 4: baaf0b0d folded before Flop (didn't bet)
Seat 5: 71e00d83 folded before Flop (didn't bet)
Seat 6: 75d5d480 folded before Flop (didn't bet)


Poker Hand #RC3334482636: Hold'em No Limit ($0.02/$0.05) - 2025/02/17 21:09:23
Table 'RushAndCash617896' 6-max Seat #1 is the button
Seat 1: caa19347 ($6.13 in chips)
Seat 2: 677c4b25 ($6.01 in chips)
Seat 3: ead6cfaf ($5.27 in chips)
Seat 4: 1941fa92 ($2.69 in chips)
Seat 5: Hero ($13.81 in chips)
Seat 6: d676606b ($5.18 in chips)
677c4b25: posts small blind $0.02
ead6cfaf: posts big blind $0.05
*** HOLE CARDS ***
Dealt to caa19347 
Dealt to 677c4b25 
Dealt to ead6cfaf 
Dealt to 1941fa92 
Dealt to Hero [7h As]
Dealt to d676606b 
1941fa92: folds
Hero: folds
d676606b: folds
caa19347: raises $0.06 to $0.11
677c4b25: folds
ead6cfaf: folds
Uncalled bet ($0.06) returned to caa19347
*** SHOWDOWN ***
caa19347 collected $0.12 from pot
*** SUMMARY ***
Total pot $0.12 | Rake $0 | Jackpot $0 | Bingo $0 | Fortune $0 | Tax $0
Seat 1: caa19347 (button) collected ($0.12)
Seat 2: 677c4b25 (small blind) folded before Flop
Seat 3: ead6cfaf (big blind) folded before Flop
Seat 4: 1941fa92 folded before Flop (didn't bet)
Seat 5: Hero folded before Flop (didn't bet)
Seat 6: d676606b folded before Flop (didn't bet)


Poker Hand #RC3334482608: Hold'em No Limit ($0.02/$0.05) - 2025/02/17 21:09:19
Table 'RushAndCash617868' 6-max Seat #1 is the button
Seat 1: d676606b ($5.18 in chips)
Seat 2: dfc02c40 ($5.71 in chips)
Seat 3: 76135c78 ($11.89 in chips)
Seat 4: 1c0eec17 ($5 in chips)
Seat 5: Hero ($13.81 in chips)
Seat 6: 87205baf ($14.93 in chips)
dfc02c40: posts small blind $0.02
76135c78: posts big blind $0.05
*** HOLE CARDS ***
Dealt to d676606b 
Dealt to dfc02c40 
Dealt to 76135c78 
Dealt to 1c0eec17 
Dealt to Hero [Kc 4s]
Dealt to 87205baf 
1c0eec17: raises $0.05 to $0.1
Hero: folds
87205baf: folds
d676606b: folds
dfc02c40: folds
76135c78: calls $0.05
*** FLOP *** [6s 7s Kd]
76135c78: checks
1c0eec17: bets $0.09
76135c78: calls $0.09
*** TURN *** [6s 7s Kd] [4d]
76135c78: checks
1c0eec17: checks
*** RIVER *** [6s 7s Kd 4d] [Th]
76135c78: bets $0.31
1c0eec17: folds
Uncalled bet ($0.31) returned to 76135c78
*** SHOWDOWN ***
76135c78 collected $0.38 from pot
*** SUMMARY ***
Total pot $0.4 | Rake $0.02 | Jackpot $0 | Bingo $0 | Fortune $0 | Tax $0
Board [6s 7s Kd 4d Th]
Seat 1: d676606b (button) folded before Flop (didn't bet)
Seat 2: dfc02c40 (small blind) folded before Flop
Seat 3: 76135c78 (big blind) won ($0.38)
Seat 4: 1c0eec17 folded on the River
Seat 5: Hero folded before Flop (didn't bet)
Seat 6: 87205baf folded before Flop (didn't bet)


Poker Hand #RC3334482581: Hold'em No Limit ($0.02/$0.05) - 2025/02/17 21:09:16
Table 'RushAndCash617841' 6-max Seat #1 is the button
Seat 1: Hero ($13.81 in chips)
Seat 2: 9788125b ($5.28 in chips)
Seat 3: 73d087f7 ($5.07 in chips)
Seat 4: fe0566a4 ($14.93 in chips)
Seat 5: 18e1b476 ($7.48 in chips)
Seat 6: 70521b8f ($5.33 in chips)
9788125b: posts small blind $0.02
73d087f7: posts big blind $0.05
*** HOLE CARDS ***
Dealt to Hero [Kh 6d]
Dealt to 9788125b 
Dealt to 73d087f7 
Dealt to fe0566a4 
Dealt to 18e1b476 
Dealt to 70521b8f 
fe0566a4: folds
18e1b476: folds
70521b8f: folds
Hero: folds
9788125b: folds
Uncalled bet ($0.03) returned to 73d087f7
*** SHOWDOWN ***
73d087f7 collected $0.04 from pot
*** SUMMARY ***
Total pot $0.04 | Rake $0 | Jackpot $0 | Bingo $0 | Fortune $0 | Tax $0
Seat 1: Hero (button) folded before Flop (didn't bet)
Seat 2: 9788125b (small blind) folded before Flop
Seat 3: 73d087f7 (big blind) collected ($0.04)
Seat 4: fe0566a4 folded before Flop (didn't bet)
Seat 5: 18e1b476 folded before Flop (didn't bet)
Seat 6: 70521b8f folded before Flop (didn't bet)


Poker Hand #RC3334482364: Hold'em No Limit ($0.02/$0.05) - 2025/02/17 21:08:48
Table 'RushAndCash617624' 6-max Seat #1 is the button
Seat 1: a63aa4b7 ($17.02 in chips)
Seat 2: ab43c8b8 ($5.63 in chips)
Seat 3: Hero ($13.91 in chips)
Seat 4: fe0566a4 ($14.82 in chips)
Seat 5: 21c758a ($5.86 in chips)
Seat 6: d5150c28 ($6.31 in chips)
ab43c8b8: posts small blind $0.02
Hero: posts big blind $0.05
*** HOLE CARDS ***
Dealt to a63aa4b7 
Dealt to ab43c8b8 
Dealt to Hero [4h 2h]
Dealt to fe0566a4 
Dealt to 21c758a 
Dealt to d5150c28 
fe0566a4: raises $0.05 to $0.1
21c758a: folds
d5150c28: folds
a63aa4b7: folds
ab43c8b8: folds
Hero: calls $0.05
*** FLOP *** [Ks Qd 3d]
Hero: checks
fe0566a4: bets $0.2
Hero: folds
Uncalled bet ($0.2) returned to fe0566a4
*** SHOWDOWN ***
fe0566a4 collected $0.21 from pot
*** SUMMARY ***
Total pot $0.22 | Rake $0.01 | Jackpot $0 | Bingo $0 | Fortune $0 | Tax $0
Board [Ks Qd 3d]
Seat 1: a63aa4b7 (button) folded before Flop (didn't bet)
Seat 2: ab43c8b8 (small blind) folded before Flop
Seat 3: Hero (big blind) folded on the Flop
Seat 4: fe0566a4 won ($0.21)
Seat 5: 21c758a folded before Flop (didn't bet)
Seat 6: d5150c28 folded before Flop (didn't bet)


Poker Hand #RC3334482334: Hold'em No Limit ($0.02/$0.05) - 2025/02/17 21:08:44
Table 'RushAndCash617594' 6-max Seat #1 is the button
Seat 1: Hero ($13.91 in chips)
Seat 2: ef7e6107 ($5 in chips)
Seat 3: a678f821 ($11.07 in chips)
Seat 4: ac6c5037 ($5.81 in chips)
Seat 5: 19bb03b5 ($11.84 in chips)
Seat 6: 5c8c19b7 ($13.55 in chips)
ef7e6107: posts small blind $0.02
a678f821: posts big blind $0.05
*** HOLE CARDS ***
Dealt to Hero [9d Ts]
Dealt to ef7e6107 
Dealt to a678f821 
Dealt to ac6c5037 
Dealt to 19bb03b5 
Dealt to 5c8c19b7 
ac6c5037: folds
19bb03b5: folds
5c8c19b7: folds
Hero: folds
ef7e6107: folds
Uncalled bet ($0.03) returned to a678f821
*** SHOWDOWN ***
a678f821 collected $0.04 from pot
*** SUMMARY ***
Total pot $0.04 | Rake $0 | Jackpot $0 | Bingo $0 | Fortune $0 | Tax $0
Seat 1: Hero (button) folded before Flop (didn't bet)
Seat 2: ef7e6107 (small blind) folded before Flop
Seat 3: a678f821 (big blind) collected ($0.04)
Seat 4: ac6c5037 folded before Flop (didn't bet)
Seat 5: 19bb03b5 folded before Flop (didn't bet)
Seat 6: 5c8c19b7 folded before Flop (didn't bet)


Poker Hand #RC3334481971: Hold'em No Limit ($0.02/$0.05) - 2025/02/17 21:07:58
Table 'RushAndCash617231' 6-max Seat #1 is the button
Seat 1: 3ff27d73 ($5 in chips)
Seat 2: Hero ($12.6 in chips)
Seat 3: a223d3ca ($5.11 in chips)
Seat 4: 6c8cb957 ($10.28 in chips)
Seat 5: 5c8c19b7 ($15.02 in chips)
Seat 6: a9472a77 ($3.81 in chips)
Hero: posts small blind $0.02
a223d3ca: posts big blind $0.05
*** HOLE CARDS ***
Dealt to 3ff27d73 
Dealt to Hero [Ad Js]
Dealt to a223d3ca 
Dealt to 6c8cb957 
Dealt to 5c8c19b7 
Dealt to a9472a77 
6c8cb957: folds
5c8c19b7: raises $0.05 to $0.1
a9472a77: folds
3ff27d73: folds
Hero: raises $0.32 to $0.42
a223d3ca: folds
5c8c19b7: calls $0.32
*** FLOP *** [7d 3d Jh]
Hero: bets $0.3
5c8c19b7: calls $0.3
*** TURN *** [7d 3d Jh] [5h]
Hero: checks
5c8c19b7: bets $0.75
Hero: calls $0.75
*** RIVER *** [7d 3d Jh 5h] [Jd]
Hero: checks
5c8c19b7: checks
Hero: shows [Ad Js] (Three Jacks)
5c8c19b7: shows [Ks Ac] (Pair of Jacks)
*** SHOWDOWN ***
Hero collected $2.78 from pot
*** SUMMARY ***
Total pot $2.99 | Rake $0.14 | Jackpot $0.07 | Bingo $0 | Fortune $0 | Tax $0
Board [7d 3d Jh 5h Jd]
Seat 1: 3ff27d73 (button) folded before Flop (didn't bet)
Seat 2: Hero (small blind) showed [Ad Js] and won ($2.78) with Three Jacks
Seat 3: a223d3ca (big blind) folded before Flop
Seat 4: 6c8cb957 folded before Flop (didn't bet)
Seat 5: 5c8c19b7 showed [Ks Ac] and lost with Pair of Jacks
Seat 6: a9472a77 folded before Flop (didn't bet)


Poker Hand #RC3334481943: Hold'em No Limit ($0.02/$0.05) - 2025/02/17 21:07:54
Table 'RushAndCash617203' 6-max Seat #1 is the button
Seat 1: 717e9861 ($5 in chips)
Seat 2: 3ff27d73 ($5.02 in chips)
Seat 3: 9babc997 ($5.4 in chips)
Seat 4: bf84714d ($5.96 in chips)
Seat 5: Hero ($12.6 in chips)
Seat 6: 8dbd0a2d ($9.62 in chips)
3ff27d73: posts small blind $0.02
9babc997: posts big blind $0.05
*** HOLE CARDS ***
Dealt to 717e9861 
Dealt to 3ff27d73 
Dealt to 9babc997 
Dealt to bf84714d 
Dealt to Hero [7d 5c]
Dealt to 8dbd0a2d 
bf84714d: folds
Hero: folds
8dbd0a2d: folds
717e9861: raises $0.05 to $0.1
3ff27d73: folds
9babc997: calls $0.05
*** FLOP *** [Qh 9d Tc]
9babc997: checks
717e9861: checks
*** TURN *** [Qh 9d Tc] [2s]
9babc997: checks
717e9861: bets $0.17
9babc997: folds
Uncalled bet ($0.17) returned to 717e9861
*** SHOWDOWN ***
717e9861 collected $0.21 from pot
*** SUMMARY ***
Total pot $0.22 | Rake $0.01 | Jackpot $0 | Bingo $0 | Fortune $0 | Tax $0
Board [Qh 9d Tc 2s]
Seat 1: 717e9861 (button) won ($0.21)
Seat 2: 3ff27d73 (small blind) folded before Flop
Seat 3: 9babc997 (big blind) folded on the Turn
Seat 4: bf84714d folded before Flop (didn't bet)
Seat 5: Hero folded before Flop (didn't bet)
Seat 6: 8dbd0a2d folded before Flop (didn't bet)


Poker Hand #RC3334481916: Hold'em No Limit ($0.02/$0.05) - 2025/02/17 21:07:51
Table 'RushAndCash617176' 6-max Seat #1 is the button
Seat 1: 626359de ($12.23 in chips)
Seat 2: 1c0eec17 ($4.86 in chips)
Seat 3: c24b20b9 ($19.92 in chips)
Seat 4: a2123cbe ($13.02 in chips)
Seat 5: Hero ($12.6 in chips)
Seat 6: d3baa206 ($5.59 in chips)
1c0eec17: posts small blind $0.02
c24b20b9: posts big blind $0.05
*** HOLE CARDS ***
Dealt to 626359de 
Dealt to 1c0eec17 
Dealt to c24b20b9 
Dealt to a2123cbe 
Dealt to Hero [4c Kd]
Dealt to d3baa206 
a2123cbe: raises $0.05 to $0.1
Hero: folds
d3baa206: calls $0.1
626359de: folds
1c0eec17: folds
c24b20b9: calls $0.05
*** FLOP *** [Js 9s 7h]
c24b20b9: checks
a2123cbe: bets $0.11
d3baa206: calls $0.11
c24b20b9: folds
*** TURN *** [Js 9s 7h] [3c]
a2123cbe: bets $0.55
d3baa206: calls $0.55
*** RIVER *** [Js 9s 7h 3c] [5d]
a2123cbe: checks
d3baa206: checks
a2123cbe: shows [Th Kc] (King-High)
d3baa206: shows [Ac Jh] (Pair of Jacks)
*** SHOWDOWN ***
d3baa206 collected $1.5 from pot
*** SUMMARY ***
Total pot $1.64 | Rake $0.07 | Jackpot $0.07 | Bingo $0 | Fortune $0 | Tax $0
Board [Js 9s 7h 3c 5d]
Seat 1: 626359de (button) folded before Flop (didn't bet)
Seat 2: 1c0eec17 (small blind) folded before Flop
Seat 3: c24b20b9 (big blind) folded on the Flop
Seat 4: a2123cbe showed [Th Kc] and lost with King-High
Seat 5: Hero folded before Flop (didn't bet)
Seat 6: d3baa206 showed [Ac Jh] and won ($1.5) with Pair of Jacks


Poker Hand #RC3334481893: Hold'em No Limit ($0.02/$0.05) - 2025/02/17 21:07:48
Table 'RushAndCash617153' 6-max Seat #1 is the button
Seat 1: 3ffd6491 ($5.29 in chips)
Seat 2: 730098b8 ($6.94 in chips)
Seat 3: 1941fa92 ($3 in chips)
Seat 4: 679a8f7 ($8.26 in chips)
Seat 5: 868521d5 ($5.15 in chips)
Seat 6: Hero ($12.6 in chips)
730098b8: posts small blind $0.02
1941fa92: posts big blind $0.05
*** HOLE CARDS ***
Dealt to 3ffd6491 
Dealt to 730098b8 
Dealt to 1941fa92 
Dealt to 679a8f7 
Dealt to 868521d5 
Dealt to Hero [2h 9c]
679a8f7: folds
868521d5: folds
Hero: folds
3ffd6491: raises $0.07 to $0.12
730098b8: folds
1941fa92: calls $0.07
*** FLOP *** [7c 3c 2d]
1941fa92: checks
3ffd6491: bets $0.09
1941fa92: raises $0.15 to $0.24
3ffd6491: calls $0.15
*** TURN *** [7c 3c 2d] [Tc]
1941fa92: checks
3ffd6491: bets $0.56
1941fa92: folds
Uncalled bet ($0.56) returned to 3ffd6491
*** SHOWDOWN ***
3ffd6491 collected $0.71 from pot
*** SUMMARY ***
Total pot $0.74 | Rake $0.03 | Jackpot $0 | Bingo $0 | Fortune $0 | Tax $0
Board [7c 3c 2d Tc]
Seat 1: 3ffd6491 (button) won ($0.71)
Seat 2: 730098b8 (small blind) folded before Flop
Seat 3: 1941fa92 (big blind) folded on the Turn
Seat 4: 679a8f7 folded before Flop (didn't bet)
Seat 5: 868521d5 folded before Flop (didn't bet)
Seat 6: Hero folded before Flop (didn't bet)


Poker Hand #RC3334481864: Hold'em No Limit ($0.02/$0.05) - 2025/02/17 21:07:45
Table 'RushAndCash617124' 6-max Seat #1 is the button
Seat 1: 472d279e ($5.22 in chips)
Seat 2: b282789b ($5.25 in chips)
Seat 3: 23c23672 ($5.07 in chips)
Seat 4: Hero ($12.6 in chips)
Seat 5: f56d4922 ($5 in chips)
Seat 6: 3ed1e77f ($5.43 in chips)
b282789b: posts small blind $0.02
23c23672: posts big blind $0.05
*** HOLE CARDS ***
Dealt to 472d279e 
Dealt to b282789b 
Dealt to 23c23672 
Dealt to Hero [2h 5h]
Dealt to f56d4922 
Dealt to 3ed1e77f 
Hero: folds
f56d4922: folds
3ed1e77f: folds
472d279e: raises $0.1 to $0.15
b282789b: folds
23c23672: folds
Uncalled bet ($0.1) returned to 472d279e
*** SHOWDOWN ***
472d279e collected $0.12 from pot
*** SUMMARY ***
Total pot $0.12 | Rake $0 | Jackpot $0 | Bingo $0 | Fortune $0 | Tax $0
Seat 1: 472d279e (button) collected ($0.12)
Seat 2: b282789b (small blind) folded before Flop
Seat 3: 23c23672 (big blind) folded before Flop
Seat 4: Hero folded before Flop (didn't bet)
Seat 5: f56d4922 folded before Flop (didn't bet)
Seat 6: 3ed1e77f folded before Flop (didn't bet)


Poker Hand #RC3334481607: Hold'em No Limit ($0.02/$0.05) - 2025/02/17 21:07:12
Table 'RushAndCash616867' 6-max Seat #1 is the button
Seat 1: Hero ($12.7 in chips)
Seat 2: eabdba88 ($10.64 in chips)
Seat 3: b282789b ($5.14 in chips)
Seat 4: 188c8947 ($7.84 in chips)
Seat 5: e5c03448 ($5.44 in chips)
Seat 6: 23619adf ($5.81 in chips)
eabdba88: posts small blind $0.02
b282789b: posts big blind $0.05
*** HOLE CARDS ***
Dealt to Hero [Jc Td]
Dealt to eabdba88 
Dealt to b282789b 
Dealt to 188c8947 
Dealt to e5c03448 
Dealt to 23619adf 
188c8947: folds
e5c03448: folds
23619adf: folds
Hero: raises $0.05 to $0.1
eabdba88: folds
b282789b: calls $0.05
*** FLOP *** [3d 3h Kh]
b282789b: checks
Hero: checks
*** TURN *** [3d 3h Kh] [8c]
b282789b: checks
Hero: checks
*** RIVER *** [3d 3h Kh 8c] [4h]
b282789b: checks
Hero: checks
b282789b: shows [5h As] (Pair of Treys)
Hero: shows [Jc Td] (Pair of Treys)
*** SHOWDOWN ***
b282789b collected $0.21 from pot
*** SUMMARY ***
Total pot $0.22 | Rake $0.01 | Jackpot $0 | Bingo $0 | Fortune $0 | Tax $0
Board [3d 3h Kh 8c 4h]
Seat 1: Hero (button) showed [Jc Td] and lost with Pair of Treys
Seat 2: eabdba88 (small blind) folded before Flop
Seat 3: b282789b (big blind) showed [5h As] and won ($0.21) with Pair of Treys
Seat 4: 188c8947 folded before Flop (didn't bet)
Seat 5: e5c03448 folded before Flop (didn't bet)
Seat 6: 23619adf folded before Flop (didn't bet)


Poker Hand #RC3334481581: Hold'em No Limit ($0.02/$0.05) - 2025/02/17 21:07:09
Table 'RushAndCash616841' 6-max Seat #1 is the button
Seat 1: 5fe62400 ($5.93 in chips)
Seat 2: 868c7021 ($7.75 in chips)
Seat 3: Hero ($12.75 in chips)
Seat 4: dbf5f543 ($8.17 in chips)
Seat 5: febb8b03 ($7.76 in chips)
Seat 6: 3939bf98 ($5.19 in chips)
868c7021: posts small blind $0.02
Hero: posts big blind $0.05
*** HOLE CARDS ***
Dealt to 5fe62400 
Dealt to 868c7021 
Dealt to Hero [5h Qs]
Dealt to dbf5f543 
Dealt to febb8b03 
Dealt to 3939bf98 
dbf5f543: folds
febb8b03: calls $0.05
3939bf98: folds
5fe62400: folds
868c7021: folds
Hero: checks
*** FLOP *** [8c As 6d]
Hero: checks
febb8b03: bets $0.05
Hero: folds
Uncalled bet ($0.05) returned to febb8b03
*** SHOWDOWN ***
febb8b03 collected $0.12 from pot
*** SUMMARY ***
Total pot $0.12 | Rake $0 | Jackpot $0 | Bingo $0 | Fortune $0 | Tax $0
Board [8c As 6d]
Seat 1: 5fe62400 (button) folded before Flop (didn't bet)
Seat 2: 868c7021 (small blind) folded before Flop
Seat 3: Hero (big blind) folded on the Flop
Seat 4: dbf5f543 folded before Flop (didn't bet)
Seat 5: febb8b03 won ($0.12)
Seat 6: 3939bf98 folded before Flop (didn't bet)


Poker Hand #RC3334481537: Hold'em No Limit ($0.02/$0.05) - 2025/02/17 21:07:04
Table 'RushAndCash616797' 6-max Seat #1 is the button
Seat 1: 621c3c07 ($5.99 in chips)
Seat 2: 9e3e5e70 ($7.83 in chips)
Seat 3: Hero ($12.8 in chips)
Seat 4: 653af57c ($5.77 in chips)
Seat 5: 3565018d ($4.19 in chips)
Seat 6: 3b2a8270 ($13.74 in chips)
9e3e5e70: posts small blind $0.02
Hero: posts big blind $0.05
*** HOLE CARDS ***
Dealt to 621c3c07 
Dealt to 9e3e5e70 
Dealt to Hero [6d Kc]
Dealt to 653af57c 
Dealt to 3565018d 
Dealt to 3b2a8270 
653af57c: folds
3565018d: raises $0.1 to $0.15
3b2a8270: folds
621c3c07: raises $0.3 to $0.45
9e3e5e70: folds
Hero: folds
3565018d: folds
Uncalled bet ($0.3) returned to 621c3c07
*** SHOWDOWN ***
621c3c07 collected $0.36 from pot
*** SUMMARY ***
Total pot $0.37 | Rake $0.01 | Jackpot $0 | Bingo $0 | Fortune $0 | Tax $0
Seat 1: 621c3c07 (button) collected ($0.36)
Seat 2: 9e3e5e70 (small blind) folded before Flop
Seat 3: Hero (big blind) folded before Flop
Seat 4: 653af57c folded before Flop (didn't bet)
Seat 5: 3565018d folded before Flop
Seat 6: 3b2a8270 folded before Flop (didn't bet)


Poker Hand #RC3334481431: Hold'em No Limit ($0.02/$0.05) - 2025/02/17 21:06:51
Table 'RushAndCash616691' 6-max Seat #1 is the button
Seat 1: 656af102 ($6.28 in chips)
Seat 2: 8bfa05cc ($5.15 in chips)
Seat 3: a4e63c5 ($5.19 in chips)
Seat 4: Hero ($12.73 in chips)
Seat 5: 8c6d38f2 ($10.3 in chips)
Seat 6: b9ea571d ($5.3 in chips)
8bfa05cc: posts small blind $0.02
a4e63c5: posts big blind $0.05
*** HOLE CARDS ***
Dealt to 656af102 
Dealt to 8bfa05cc 
Dealt to a4e63c5 
Dealt to Hero [Jh Js]
Dealt to 8c6d38f2 
Dealt to b9ea571d 
Hero: raises $0.05 to $0.1
8c6d38f2: folds
b9ea571d: folds
656af102: folds
8bfa05cc: folds
a4e63c5: folds
Uncalled bet ($0.05) returned to Hero
*** SHOWDOWN ***
Hero collected $0.12 from pot
*** SUMMARY ***
Total pot $0.12 | Rake $0 | Jackpot $0 | Bingo $0 | Fortune $0 | Tax $0
Seat 1: 656af102 (button) folded before Flop (didn't bet)
Seat 2: 8bfa05cc (small blind) folded before Flop
Seat 3: a4e63c5 (big blind) folded before Flop
Seat 4: Hero collected ($0.12)
Seat 5: 8c6d38f2 folded before Flop (didn't bet)
Seat 6: b9ea571d folded before Flop (didn't bet)


Poker Hand #RC3334481366: Hold'em No Limit ($0.02/$0.05) - 2025/02/17 21:06:43
Table 'RushAndCash616626' 6-max Seat #1 is the button
Seat 1: Hero ($12.66 in chips)
Seat 2: 21bff972 ($5.7 in chips)
Seat 3: 3db4c32a ($5.52 in chips)
Seat 4: 688b40f9 ($6.01 in chips)
Seat 5: f43eaf15 ($7.97 in chips)
Seat 6: 71f2556b ($2.2 in chips)
21bff972: posts small blind $0.02
3db4c32a: posts big blind $0.05
*** HOLE CARDS ***
Dealt to Hero [Tc Kd]
Dealt to 21bff972 
Dealt to 3db4c32a 
Dealt to 688b40f9 
Dealt to f43eaf15 
Dealt to 71f2556b 
688b40f9: folds
f43eaf15: folds
71f2556b: folds
Hero: raises $0.05 to $0.1
21bff972: folds
3db4c32a: folds
Uncalled bet ($0.05) returned to Hero
*** SHOWDOWN ***
Hero collected $0.12 from pot
*** SUMMARY ***
Total pot $0.12 | Rake $0 | Jackpot $0 | Bingo $0 | Fortune $0 | Tax $0
Seat 1: Hero (button) collected ($0.12)
Seat 2: 21bff972 (small blind) folded before Flop
Seat 3: 3db4c32a (big blind) folded before Flop
Seat 4: 688b40f9 folded before Flop (didn't bet)
Seat 5: f43eaf15 folded before Flop (didn't bet)
Seat 6: 71f2556b folded before Flop (didn't bet)


Poker Hand #RC3334481335: Hold'em No Limit ($0.02/$0.05) - 2025/02/17 21:06:40
Table 'RushAndCash616595' 6-max Seat #1 is the button
Seat 1: 87256f31 ($5.66 in chips)
Seat 2: e632d40b ($7.24 in chips)
Seat 3: 78622913 ($6.14 in chips)
Seat 4: Hero ($12.66 in chips)
Seat 5: 3b1b6d04 ($6.22 in chips)
Seat 6: c27051e0 ($6.42 in chips)
e632d40b: posts small blind $0.02
78622913: posts big blind $0.05
*** HOLE CARDS ***
Dealt to 87256f31 
Dealt to e632d40b 
Dealt to 78622913 
Dealt to Hero [4d 9s]
Dealt to 3b1b6d04 
Dealt to c27051e0 
Hero: folds
3b1b6d04: folds
c27051e0: folds
87256f31: raises $0.08 to $0.13
e632d40b: folds
78622913: folds
Uncalled bet ($0.08) returned to 87256f31
*** SHOWDOWN ***
87256f31 collected $0.12 from pot
*** SUMMARY ***
Total pot $0.12 | Rake $0 | Jackpot $0 | Bingo $0 | Fortune $0 | Tax $0
Seat 1: 87256f31 (button) collected ($0.12)
Seat 2: e632d40b (small blind) folded before Flop
Seat 3: 78622913 (big blind) folded before Flop
Seat 4: Hero folded before Flop (didn't bet)
Seat 5: 3b1b6d04 folded before Flop (didn't bet)
Seat 6: c27051e0 folded before Flop (didn't bet)


Poker Hand #RC3334481305: Hold'em No Limit ($0.02/$0.05) - 2025/02/17 21:06:36
Table 'RushAndCash616565' 6-max Seat #1 is the button
Seat 1: 66981141 ($11.38 in chips)
Seat 2: Hero ($12.68 in chips)
Seat 3: b0ee20aa ($22.85 in chips)
Seat 4: 266a98da ($1.28 in chips)
Seat 5: 8e07c53 ($5.52 in chips)
Seat 6: 8d378f31 ($6.35 in chips)
Hero: posts small blind $0.02
b0ee20aa: posts big blind $0.05
*** HOLE CARDS ***
Dealt to 66981141 
Dealt to Hero [8c 3h]
Dealt to b0ee20aa 
Dealt to 266a98da 
Dealt to 8e07c53 
Dealt to 8d378f31 
266a98da: raises $0.05 to $0.1
8e07c53: folds
8d378f31: folds
66981141: folds
Hero: folds
b0ee20aa: folds
Uncalled bet ($0.05) returned to 266a98da
*** SHOWDOWN ***
266a98da collected $0.12 from pot
*** SUMMARY ***
Total pot $0.12 | Rake $0 | Jackpot $0 | Bingo $0 | Fortune $0 | Tax $0
Seat 1: 66981141 (button) folded before Flop (didn't bet)
Seat 2: Hero (small blind) folded before Flop
Seat 3: b0ee20aa (big blind) folded before Flop
Seat 4: 266a98da collected ($0.12)
Seat 5: 8e07c53 folded before Flop (didn't bet)
Seat 6: 8d378f31 folded before Flop (didn't bet)


Poker Hand #RC3334481277: Hold'em No Limit ($0.02/$0.05) - 2025/02/17 21:06:33
Table 'RushAndCash616537' 6-max Seat #1 is the button
Seat 1: 304e7bcd ($4.75 in chips)
Seat 2: 87205baf ($14.93 in chips)
Seat 3: 24aff26b ($5 in chips)
Seat 4: 6d5fa70b ($5.37 in chips)
Seat 5: Hero ($12.68 in chips)
Seat 6: afceb40a ($2.13 in chips)
87205baf: posts small blind $0.02
24aff26b: posts big blind $0.05
*** HOLE CARDS ***
Dealt to 304e7bcd 
Dealt to 87205baf 
Dealt to 24aff26b 
Dealt to 6d5fa70b 
Dealt to Hero [3s Td]
Dealt to afceb40a 
6d5fa70b: folds
Hero: folds
afceb40a: folds
304e7bcd: raises $0.05 to $0.1
87205baf: raises $0.4 to $0.5
24aff26b: folds
304e7bcd: folds
Uncalled bet ($0.4) returned to 87205baf
*** SHOWDOWN ***
87205baf collected $0.24 from pot
*** SUMMARY ***
Total pot $0.25 | Rake $0.01 | Jackpot $0 | Bingo $0 | Fortune $0 | Tax $0
Seat 1: 304e7bcd (button) folded before Flop
Seat 2: 87205baf (small blind) collected ($0.24)
Seat 3: 24aff26b (big blind) folded before Flop
Seat 4: 6d5fa70b folded before Flop (didn't bet)
Seat 5: Hero folded before Flop (didn't bet)
Seat 6: afceb40a folded before Flop (didn't bet)


Poker Hand #RC3334481251: Hold'em No Limit ($0.02/$0.05) - 2025/02/17 21:06:30
Table 'RushAndCash616511' 6-max Seat #1 is the button
Seat 1: 598d859f ($7.33 in chips)
Seat 2: 87d5083b ($23.17 in chips)
Seat 3: e7a0ba42 ($11.43 in chips)
Seat 4: Hero ($12.68 in chips)
Seat 5: 3dd0afef ($5.49 in chips)
Seat 6: 2d6a0da2 ($5.22 in chips)
87d5083b: posts small blind $0.02
e7a0ba42: posts big blind $0.05
*** HOLE CARDS ***
Dealt to 598d859f 
Dealt to 87d5083b 
Dealt to e7a0ba42 
Dealt to Hero [Qc 2d]
Dealt to 3dd0afef 
Dealt to 2d6a0da2 
Hero: folds
3dd0afef: folds
2d6a0da2: folds
598d859f: folds
87d5083b: folds
Uncalled bet ($0.03) returned to e7a0ba42
*** SHOWDOWN ***
e7a0ba42 collected $0.04 from pot
*** SUMMARY ***
Total pot $0.04 | Rake $0 | Jackpot $0 | Bingo $0 | Fortune $0 | Tax $0
Seat 1: 598d859f (button) folded before Flop (didn't bet)
Seat 2: 87d5083b (small blind) folded before Flop
Seat 3: e7a0ba42 (big blind) collected ($0.04)
Seat 4: Hero folded before Flop (didn't bet)
Seat 5: 3dd0afef folded before Flop (didn't bet)
Seat 6: 2d6a0da2 folded before Flop (didn't bet)


Poker Hand #RC3334481220: Hold'em No Limit ($0.02/$0.05) - 2025/02/17 21:06:26
Table 'RushAndCash616480' 6-max Seat #1 is the button
Seat 1: Hero ($12.68 in chips)
Seat 2: 22643080 ($9.08 in chips)
Seat 3: b8a41e4 ($5.56 in chips)
Seat 4: 1f187ba0 ($5.44 in chips)
Seat 5: a708a98a ($18.26 in chips)
Seat 6: e7a0ba42 ($11.43 in chips)
22643080: posts small blind $0.02
b8a41e4: posts big blind $0.05
*** HOLE CARDS ***
Dealt to Hero [Tc 9s]
Dealt to 22643080 
Dealt to b8a41e4 
Dealt to 1f187ba0 
Dealt to a708a98a 
Dealt to e7a0ba42 
1f187ba0: raises $0.05 to $0.1
a708a98a: folds
e7a0ba42: folds
Hero: folds
22643080: folds
b8a41e4: calls $0.05
*** FLOP *** [Ah 2c Ac]
b8a41e4: checks
1f187ba0: checks
*** TURN *** [Ah 2c Ac] [6h]
b8a41e4: checks
1f187ba0: bets $0.17
b8a41e4: calls $0.17
*** RIVER *** [Ah 2c Ac 6h] [As]
b8a41e4: checks
1f187ba0: bets $0.56
b8a41e4: calls $0.56
1f187ba0: shows [Jc Ad] (Four Aces)
b8a41e4: shows [7h 6s] (Aces Full over Sixes)
*** SHOWDOWN ***
1f187ba0 collected $1.53 from pot
*** SUMMARY ***
Total pot $1.68 | Rake $0.08 | Jackpot $0.07 | Bingo $0 | Fortune $0 | Tax $0
Board [Ah 2c Ac 6h As]
Seat 1: Hero (button) folded before Flop (didn't bet)
Seat 2: 22643080 (small blind) folded before Flop
Seat 3: b8a41e4 (big blind) showed [7h 6s] and lost with Aces Full over Sixes
Seat 4: 1f187ba0 showed [Jc Ad] and won ($1.53) with Four Aces
Seat 5: a708a98a folded before Flop (didn't bet)
Seat 6: e7a0ba42 folded before Flop (didn't bet)


Poker Hand #RC3334481109: Hold'em No Limit ($0.02/$0.05) - 2025/02/17 21:06:13
Table 'RushAndCash616369' 6-max Seat #1 is the button
Seat 1: edb41254 ($4.91 in chips)
Seat 2: b9ba5363 ($13.58 in chips)
Seat 3: ef96c0c8 ($5.31 in chips)
Seat 4: 9ccadbb5 ($10.55 in chips)
Seat 5: Hero ($12.61 in chips)
Seat 6: 8c3789e ($5 in chips)
b9ba5363: posts small blind $0.02
ef96c0c8: posts big blind $0.05
*** HOLE CARDS ***
Dealt to edb41254 
Dealt to b9ba5363 
Dealt to ef96c0c8 
Dealt to 9ccadbb5 
Dealt to Hero [Kc Jh]
Dealt to 8c3789e 
9ccadbb5: folds
Hero: raises $0.05 to $0.1
8c3789e: folds
edb41254: folds
b9ba5363: folds
ef96c0c8: folds
Uncalled bet ($0.05) returned to Hero
*** SHOWDOWN ***
Hero collected $0.12 from pot
*** SUMMARY ***
Total pot $0.12 | Rake $0 | Jackpot $0 | Bingo $0 | Fortune $0 | Tax $0
Seat 1: edb41254 (button) folded before Flop (didn't bet)
Seat 2: b9ba5363 (small blind) folded before Flop
Seat 3: ef96c0c8 (big blind) folded before Flop
Seat 4: 9ccadbb5 folded before Flop (didn't bet)
Seat 5: Hero collected ($0.12)
Seat 6: 8c3789e folded before Flop (didn't bet)


Poker Hand #RC3334481024: Hold'em No Limit ($0.02/$0.05) - 2025/02/17 21:06:03
Table 'RushAndCash616284' 6-max Seat #1 is the button
Seat 1: 69407b3a ($8.33 in chips)
Seat 2: 8ec32764 ($5.05 in chips)
Seat 3: Hero ($12.59 in chips)
Seat 4: ae4e82ab ($6.98 in chips)
Seat 5: a61c94e4 ($5 in chips)
Seat 6: e89071f6 ($7.68 in chips)
8ec32764: posts small blind $0.02
Hero: posts big blind $0.05
*** HOLE CARDS ***
Dealt to 69407b3a 
Dealt to 8ec32764 
Dealt to Hero [6d 9s]
Dealt to ae4e82ab 
Dealt to a61c94e4 
Dealt to e89071f6 
ae4e82ab: folds
a61c94e4: folds
e89071f6: folds
69407b3a: folds
8ec32764: folds
Uncalled bet ($0.03) returned to Hero
*** SHOWDOWN ***
Hero collected $0.04 from pot
*** SUMMARY ***
Total pot $0.04 | Rake $0 | Jackpot $0 | Bingo $0 | Fortune $0 | Tax $0
Seat 1: 69407b3a (button) folded before Flop (didn't bet)
Seat 2: 8ec32764 (small blind) folded before Flop
Seat 3: Hero (big blind) collected ($0.04)
Seat 4: ae4e82ab folded before Flop (didn't bet)
Seat 5: a61c94e4 folded before Flop (didn't bet)
Seat 6: e89071f6 folded before Flop (didn't bet)


Poker Hand #RC3334481000: Hold'em No Limit ($0.02/$0.05) - 2025/02/17 21:06:01
Table 'RushAndCash616260' 6-max Seat #1 is the button
Seat 1: c806dd25 ($5.48 in chips)
Seat 2: 4e3e8f0e ($5.47 in chips)
Seat 3: d86379c5 ($6.63 in chips)
Seat 4: 9f70f94d ($5.83 in chips)
Seat 5: Hero ($12.59 in chips)
Seat 6: c826a560 ($13.47 in chips)
4e3e8f0e: posts small blind $0.02
d86379c5: posts big blind $0.05
*** HOLE CARDS ***
Dealt to c806dd25 
Dealt to 4e3e8f0e 
Dealt to d86379c5 
Dealt to 9f70f94d 
Dealt to Hero [3c 8d]
Dealt to c826a560 
9f70f94d: raises $0.05 to $0.1
Hero: folds
c826a560: folds
c806dd25: raises $0.3 to $0.4
4e3e8f0e: folds
d86379c5: calls $0.35
9f70f94d: raises $5.43 to $5.83 and is all-in
c806dd25: calls $5.08 and is all-in
d86379c5: folds
Uncalled bet ($0.35) returned to 9f70f94d
9f70f94d: shows [Jd Jh]
c806dd25: shows [Kc Kd]
*** FLOP *** [8s 3s 3d]
*** TURN *** [8s 3s 3d] [Qc]
*** RIVER *** [8s 3s 3d Qc] [2c]
d86379c5: shows [Qh Qs] (Queens Full over Treys)
*** SHOWDOWN ***
c806dd25 collected $11.16 from pot
*** SUMMARY ***
Total pot $11.38 | Rake $0.15 | Jackpot $0.07 | Bingo $0 | Fortune $0 | Tax $0
Board [8s 3s 3d Qc 2c]
Seat 1: c806dd25 (button) showed [Kc Kd] and won ($11.16) with Pair of Kings and Pair of Treys
Seat 2: 4e3e8f0e (small blind) folded before Flop
Seat 3: d86379c5 (big blind) folded before Flop
Seat 4: 9f70f94d showed [Jd Jh] and lost with Pair of Jacks and Pair of Treys
Seat 5: Hero folded before Flop (didn't bet)
Seat 6: c826a560 folded before Flop (didn't bet)


Poker Hand #RC3334480737: Hold'em No Limit ($0.02/$0.05) - 2025/02/17 21:05:25
Table 'RushAndCash615997' 6-max Seat #1 is the button
Seat 1: 14620cce ($15.9 in chips)
Seat 2: 77d1364f ($5.6 in chips)
Seat 3: c7e9103c ($11.89 in chips)
Seat 4: 65ca9276 ($5.52 in chips)
Seat 5: 75d5d480 ($5.29 in chips)
Seat 6: Hero ($12.72 in chips)
77d1364f: posts small blind $0.02
c7e9103c: posts big blind $0.05
*** HOLE CARDS ***
Dealt to 14620cce 
Dealt to 77d1364f 
Dealt to c7e9103c 
Dealt to 65ca9276 
Dealt to 75d5d480 
Dealt to Hero [6c 6d]
65ca9276: raises $0.08 to $0.13
75d5d480: folds
Hero: calls $0.13
14620cce: folds
77d1364f: folds
c7e9103c: folds
*** FLOP *** [Kh 2h Kc]
65ca9276: checks
Hero: checks
*** TURN *** [Kh 2h Kc] [Jd]
65ca9276: checks
Hero: checks
*** RIVER *** [Kh 2h Kc Jd] [As]
65ca9276: bets $0.14
Hero: folds
Uncalled bet ($0.14) returned to 65ca9276
*** SHOWDOWN ***
65ca9276 collected $0.32 from pot
*** SUMMARY ***
Total pot $0.33 | Rake $0.01 | Jackpot $0 | Bingo $0 | Fortune $0 | Tax $0
Board [Kh 2h Kc Jd As]
Seat 1: 14620cce (button) folded before Flop (didn't bet)
Seat 2: 77d1364f (small blind) folded before Flop
Seat 3: c7e9103c (big blind) folded before Flop
Seat 4: 65ca9276 won ($0.32)
Seat 5: 75d5d480 folded before Flop (didn't bet)
Seat 6: Hero folded on the River


Poker Hand #RC3334480652: Hold'em No Limit ($0.02/$0.05) - 2025/02/17 21:05:14
Table 'RushAndCash615912' 6-max Seat #1 is the button
Seat 1: 6f565fd ($5.05 in chips)
Seat 2: Hero ($12.74 in chips)
Seat 3: 1fa8537 ($6.62 in chips)
Seat 4: c27051e0 ($5.05 in chips)
Seat 5: 2b9f39df ($5.81 in chips)
Seat 6: 528d10e7 ($5.53 in chips)
Hero: posts small blind $0.02
1fa8537: posts big blind $0.05
*** HOLE CARDS ***
Dealt to 6f565fd 
Dealt to Hero [7c Ks]
Dealt to 1fa8537 
Dealt to c27051e0 
Dealt to 2b9f39df 
Dealt to 528d10e7 
c27051e0: folds
2b9f39df: folds
528d10e7: raises $0.06 to $0.11
6f565fd: folds
Hero: folds
1fa8537: folds
Uncalled bet ($0.06) returned to 528d10e7
*** SHOWDOWN ***
528d10e7 collected $0.12 from pot
*** SUMMARY ***
Total pot $0.12 | Rake $0 | Jackpot $0 | Bingo $0 | Fortune $0 | Tax $0
Seat 1: 6f565fd (button) folded before Flop (didn't bet)
Seat 2: Hero (small blind) folded before Flop
Seat 3: 1fa8537 (big blind) folded before Flop
Seat 4: c27051e0 folded before Flop (didn't bet)
Seat 5: 2b9f39df folded before Flop (didn't bet)
Seat 6: 528d10e7 collected ($0.12)


Poker Hand #RC3334480617: Hold'em No Limit ($0.02/$0.05) - 2025/02/17 21:05:10
Table 'RushAndCash615877' 6-max Seat #1 is the button
Seat 1: 6008538 ($3.5 in chips)
Seat 2: b4b34357 ($5.23 in chips)
Seat 3: 4e3c3196 ($26.83 in chips)
Seat 4: c036efb9 ($2.47 in chips)
Seat 5: Hero ($12.74 in chips)
Seat 6: 4d8ae83 ($5.23 in chips)
b4b34357: posts small blind $0.02
4e3c3196: posts big blind $0.05
*** HOLE CARDS ***
Dealt to 6008538 
Dealt to b4b34357 
Dealt to 4e3c3196 
Dealt to c036efb9 
Dealt to Hero [7s Jd]
Dealt to 4d8ae83 
c036efb9: folds
Hero: folds
4d8ae83: folds
6008538: folds
b4b34357: raises $0.05 to $0.1
4e3c3196: folds
Uncalled bet ($0.05) returned to b4b34357
*** SHOWDOWN ***
b4b34357 collected $0.1 from pot
*** SUMMARY ***
Total pot $0.1 | Rake $0 | Jackpot $0 | Bingo $0 | Fortune $0 | Tax $0
Seat 1: 6008538 (button) folded before Flop (didn't bet)
Seat 2: b4b34357 (small blind) collected ($0.1)
Seat 3: 4e3c3196 (big blind) folded before Flop
Seat 4: c036efb9 folded before Flop (didn't bet)
Seat 5: Hero folded before Flop (didn't bet)
Seat 6: 4d8ae83 folded before Flop (didn't bet)


Poker Hand #RC3334480263: Hold'em No Limit ($0.02/$0.05) - 2025/02/17 21:04:24
Table 'RushAndCash615523' 6-max Seat #1 is the button
Seat 1: 719071b8 ($5 in chips)
Seat 2: 3ffd6491 ($5.14 in chips)
Seat 3: Hero ($12.62 in chips)
Seat 4: 5e3616df ($7.57 in chips)
Seat 5: e9396ee6 ($6.64 in chips)
Seat 6: c49da358 ($5.07 in chips)
3ffd6491: posts small blind $0.02
Hero: posts big blind $0.05
*** HOLE CARDS ***
Dealt to 719071b8 
Dealt to 3ffd6491 
Dealt to Hero [Ks 5s]
Dealt to 5e3616df 
Dealt to e9396ee6 
Dealt to c49da358 
5e3616df: raises $0.06 to $0.11
e9396ee6: folds
c49da358: folds
719071b8: folds
3ffd6491: folds
Hero: calls $0.06
*** FLOP *** [6h 6s 7s]
Hero: checks
5e3616df: checks
*** TURN *** [6h 6s 7s] [2s]
Hero: bets $0.12
5e3616df: folds
Uncalled bet ($0.12) returned to Hero
*** SHOWDOWN ***
Hero collected $0.23 from pot
*** SUMMARY ***
Total pot $0.24 | Rake $0.01 | Jackpot $0 | Bingo $0 | Fortune $0 | Tax $0
Board [6h 6s 7s 2s]
Seat 1: 719071b8 (button) folded before Flop (didn't bet)
Seat 2: 3ffd6491 (small blind) folded before Flop
Seat 3: Hero (big blind) won ($0.23)
Seat 4: 5e3616df folded on the Turn
Seat 5: e9396ee6 folded before Flop (didn't bet)
Seat 6: c49da358 folded before Flop (didn't bet)


Poker Hand #RC3334480215: Hold'em No Limit ($0.02/$0.05) - 2025/02/17 21:04:18
Table 'RushAndCash615475' 6-max Seat #1 is the button
Seat 1: ed41f291 ($5 in chips)
Seat 2: e74a324 ($5.42 in chips)
Seat 3: 757f29d9 ($5.39 in chips)
Seat 4: Hero ($12.62 in chips)
Seat 5: f1f26d78 ($6.59 in chips)
Seat 6: cf7f09c2 ($16.57 in chips)
e74a324: posts small blind $0.02
757f29d9: posts big blind $0.05
*** HOLE CARDS ***
Dealt to ed41f291 
Dealt to e74a324 
Dealt to 757f29d9 
Dealt to Hero [Jh 4h]
Dealt to f1f26d78 
Dealt to cf7f09c2 
Hero: folds
f1f26d78: folds
cf7f09c2: folds
ed41f291: raises $0.05 to $0.1
e74a324: folds
757f29d9: calls $0.05
*** FLOP *** [3h 7d Td]
757f29d9: checks
ed41f291: checks
*** TURN *** [3h 7d Td] [5h]
757f29d9: bets $0.11
ed41f291: calls $0.11
*** RIVER *** [3h 7d Td 5h] [9c]
757f29d9: bets $0.22
ed41f291: raises $0.8 to $1.02
757f29d9: folds
Uncalled bet ($0.8) returned to ed41f291
*** SHOWDOWN ***
ed41f291 collected $0.84 from pot
*** SUMMARY ***
Total pot $0.88 | Rake $0.04 | Jackpot $0 | Bingo $0 | Fortune $0 | Tax $0
Board [3h 7d Td 5h 9c]
Seat 1: ed41f291 (button) won ($0.84)
Seat 2: e74a324 (small blind) folded before Flop
Seat 3: 757f29d9 (big blind) folded on the River
Seat 4: Hero folded before Flop (didn't bet)
Seat 5: f1f26d78 folded before Flop (didn't bet)
Seat 6: cf7f09c2 folded before Flop (didn't bet)


Poker Hand #RC3334480185: Hold'em No Limit ($0.02/$0.05) - 2025/02/17 21:04:15
Table 'RushAndCash615445' 6-max Seat #1 is the button
Seat 1: 1095926a ($5.04 in chips)
Seat 2: 198a1e4 ($6.41 in chips)
Seat 3: 4b71998b ($5.45 in chips)
Seat 4: cf7f09c2 ($16.57 in chips)
Seat 5: Hero ($12.62 in chips)
Seat 6: 868c7021 ($7.74 in chips)
198a1e4: posts small blind $0.02
4b71998b: posts big blind $0.05
*** HOLE CARDS ***
Dealt to 1095926a 
Dealt to 198a1e4 
Dealt to 4b71998b 
Dealt to cf7f09c2 
Dealt to Hero [2d 9d]
Dealt to 868c7021 
cf7f09c2: folds
Hero: folds
868c7021: folds
1095926a: folds
198a1e4: folds
Uncalled bet ($0.03) returned to 4b71998b
*** SHOWDOWN ***
4b71998b collected $0.04 from pot
*** SUMMARY ***
Total pot $0.04 | Rake $0 | Jackpot $0 | Bingo $0 | Fortune $0 | Tax $0
Seat 1: 1095926a (button) folded before Flop (didn't bet)
Seat 2: 198a1e4 (small blind) folded before Flop
Seat 3: 4b71998b (big blind) collected ($0.04)
Seat 4: cf7f09c2 folded before Flop (didn't bet)
Seat 5: Hero folded before Flop (didn't bet)
Seat 6: 868c7021 folded before Flop (didn't bet)


Poker Hand #RC3334480152: Hold'em No Limit ($0.02/$0.05) - 2025/02/17 21:04:10
Table 'RushAndCash615412' 6-max Seat #1 is the button
Seat 1: 9b152430 ($5.55 in chips)
Seat 2: Hero ($12.64 in chips)
Seat 3: cdcc575e ($5 in chips)
Seat 4: 28e11496 ($5.02 in chips)
Seat 5: bda9ba33 ($2.1 in chips)
Seat 6: 2b9f39df ($5.95 in chips)
Hero: posts small blind $0.02
cdcc575e: posts big blind $0.05
*** HOLE CARDS ***
Dealt to 9b152430 
Dealt to Hero [Jc 7d]
Dealt to cdcc575e 
Dealt to 28e11496 
Dealt to bda9ba33 
Dealt to 2b9f39df 
28e11496: folds
bda9ba33: folds
2b9f39df: folds
9b152430: folds
Hero: folds
Uncalled bet ($0.03) returned to cdcc575e
*** SHOWDOWN ***
cdcc575e collected $0.04 from pot
*** SUMMARY ***
Total pot $0.04 | Rake $0 | Jackpot $0 | Bingo $0 | Fortune $0 | Tax $0
Seat 1: 9b152430 (button) folded before Flop (didn't bet)
Seat 2: Hero (small blind) folded before Flop
Seat 3: cdcc575e (big blind) collected ($0.04)
Seat 4: 28e11496 folded before Flop (didn't bet)
Seat 5: bda9ba33 folded before Flop (didn't bet)
Seat 6: 2b9f39df folded before Flop (didn't bet)


Poker Hand #RC3334480118: Hold'em No Limit ($0.02/$0.05) - 2025/02/17 21:04:06
Table 'RushAndCash615378' 6-max Seat #1 is the button
Seat 1: Hero ($12.64 in chips)
Seat 2: 8e93231a ($5.01 in chips)
Seat 3: 9f70f94d ($5.51 in chips)
Seat 4: 692e3a83 ($9.77 in chips)
Seat 5: 2d6a0da2 ($5.34 in chips)
Seat 6: 6c6b017a ($5 in chips)
8e93231a: posts small blind $0.02
9f70f94d: posts big blind $0.05
*** HOLE CARDS ***
Dealt to Hero [3h Kh]
Dealt to 8e93231a 
Dealt to 9f70f94d 
Dealt to 692e3a83 
Dealt to 2d6a0da2 
Dealt to 6c6b017a 
692e3a83: folds
2d6a0da2: raises $0.07 to $0.12
6c6b017a: folds
Hero: folds
8e93231a: folds
9f70f94d: folds
Uncalled bet ($0.07) returned to 2d6a0da2
*** SHOWDOWN ***
2d6a0da2 collected $0.12 from pot
*** SUMMARY ***
Total pot $0.12 | Rake $0 | Jackpot $0 | Bingo $0 | Fortune $0 | Tax $0
Seat 1: Hero (button) folded before Flop (didn't bet)
Seat 2: 8e93231a (small blind) folded before Flop
Seat 3: 9f70f94d (big blind) folded before Flop
Seat 4: 692e3a83 folded before Flop (didn't bet)
Seat 5: 2d6a0da2 collected ($0.12)
Seat 6: 6c6b017a folded before Flop (didn't bet)


Poker Hand #RC3334480085: Hold'em No Limit ($0.02/$0.05) - 2025/02/17 21:04:02
Table 'RushAndCash615345' 6-max Seat #1 is the button
Seat 1: 8dbd0a2d ($9.7 in chips)
Seat 2: fb90f143 ($14.06 in chips)
Seat 3: ed41f291 ($5.02 in chips)
Seat 4: Hero ($12.64 in chips)
Seat 5: 188c8947 ($9.33 in chips)
Seat 6: 35016d48 ($5.94 in chips)
fb90f143: posts small blind $0.02
ed41f291: posts big blind $0.05
*** HOLE CARDS ***
Dealt to 8dbd0a2d 
Dealt to fb90f143 
Dealt to ed41f291 
Dealt to Hero [Ts 5s]
Dealt to 188c8947 
Dealt to 35016d48 
Hero: folds
188c8947: folds
35016d48: folds
8dbd0a2d: raises $0.08 to $0.13
fb90f143: folds
ed41f291: folds
Uncalled bet ($0.08) returned to 8dbd0a2d
*** SHOWDOWN ***
8dbd0a2d collected $0.12 from pot
*** SUMMARY ***
Total pot $0.12 | Rake $0 | Jackpot $0 | Bingo $0 | Fortune $0 | Tax $0
Seat 1: 8dbd0a2d (button) collected ($0.12)
Seat 2: fb90f143 (small blind) folded before Flop
Seat 3: ed41f291 (big blind) folded before Flop
Seat 4: Hero folded before Flop (didn't bet)
Seat 5: 188c8947 folded before Flop (didn't bet)
Seat 6: 35016d48 folded before Flop (didn't bet)


Poker Hand #RC3334479961: Hold'em No Limit ($0.02/$0.05) - 2025/02/17 21:03:46
Table 'RushAndCash615221' 6-max Seat #1 is the button
Seat 1: 9f70f94d ($5.46 in chips)
Seat 2: Hero ($12.49 in chips)
Seat 3: d00f991c ($10.35 in chips)
Seat 4: 650e9dc7 ($7.37 in chips)
Seat 5: fcfd355a ($5.75 in chips)
Seat 6: aa81a28f ($4.85 in chips)
Hero: posts small blind $0.02
d00f991c: posts big blind $0.05
*** HOLE CARDS ***
Dealt to 9f70f94d 
Dealt to Hero [Kc Ac]
Dealt to d00f991c 
Dealt to 650e9dc7 
Dealt to fcfd355a 
Dealt to aa81a28f 
650e9dc7: folds
fcfd355a: folds
aa81a28f: raises $0.06 to $0.11
9f70f94d: folds
Hero: raises $0.35 to $0.46
d00f991c: folds
aa81a28f: folds
Uncalled bet ($0.35) returned to Hero
*** SHOWDOWN ***
Hero collected $0.26 from pot
*** SUMMARY ***
Total pot $0.27 | Rake $0.01 | Jackpot $0 | Bingo $0 | Fortune $0 | Tax $0
Seat 1: 9f70f94d (button) folded before Flop (didn't bet)
Seat 2: Hero (small blind) collected ($0.26)
Seat 3: d00f991c (big blind) folded before Flop
Seat 4: 650e9dc7 folded before Flop (didn't bet)
Seat 5: fcfd355a folded before Flop (didn't bet)
Seat 6: aa81a28f folded before Flop


Poker Hand #RC3334479930: Hold'em No Limit ($0.02/$0.05) - 2025/02/17 21:03:43
Table 'RushAndCash615190' 6-max Seat #1 is the button
Seat 1: c826a560 ($13.53 in chips)
Seat 2: 3b1b6d04 ($6.32 in chips)
Seat 3: 8e93231a ($5.08 in chips)
Seat 4: ef7e6107 ($5.25 in chips)
Seat 5: d00f991c ($10.35 in chips)
Seat 6: Hero ($12.49 in chips)
3b1b6d04: posts small blind $0.02
8e93231a: posts big blind $0.05
*** HOLE CARDS ***
Dealt to c826a560 
Dealt to 3b1b6d04 
Dealt to 8e93231a 
Dealt to ef7e6107 
Dealt to d00f991c 
Dealt to Hero [9c 4d]
ef7e6107: folds
d00f991c: folds
Hero: folds
c826a560: raises $0.07 to $0.12
3b1b6d04: calls $0.1
8e93231a: folds
*** FLOP *** [Ks 5c Qh]
3b1b6d04: checks
c826a560: bets $0.09
3b1b6d04: calls $0.09
*** TURN *** [Ks 5c Qh] [8h]
3b1b6d04: checks
c826a560: checks
*** RIVER *** [Ks 5c Qh 8h] [Qc]
3b1b6d04: bets $0.36
c826a560: folds
Uncalled bet ($0.36) returned to 3b1b6d04
*** SHOWDOWN ***
3b1b6d04 collected $0.45 from pot
*** SUMMARY ***
Total pot $0.47 | Rake $0.02 | Jackpot $0 | Bingo $0 | Fortune $0 | Tax $0
Board [Ks 5c Qh 8h Qc]
Seat 1: c826a560 (button) folded on the River
Seat 2: 3b1b6d04 (small blind) won ($0.45)
Seat 3: 8e93231a (big blind) folded before Flop
Seat 4: ef7e6107 folded before Flop (didn't bet)
Seat 5: d00f991c folded before Flop (didn't bet)
Seat 6: Hero folded before Flop (didn't bet)


Poker Hand #RC3334479903: Hold'em No Limit ($0.02/$0.05) - 2025/02/17 21:03:39
Table 'RushAndCash615163' 6-max Seat #1 is the button
Seat 1: 2d6a0da2 ($5.36 in chips)
Seat 2: fad7078a ($5.9 in chips)
Seat 3: Hero ($12.54 in chips)
Seat 4: 626359de ($12.58 in chips)
Seat 5: 28e11496 ($5.06 in chips)
Seat 6: 21c758a ($6 in chips)
fad7078a: posts small blind $0.02
Hero: posts big blind $0.05
*** HOLE CARDS ***
Dealt to 2d6a0da2 
Dealt to fad7078a 
Dealt to Hero [Qc 3s]
Dealt to 626359de 
Dealt to 28e11496 
Dealt to 21c758a 
626359de: raises $0.08 to $0.13
28e11496: folds
21c758a: folds
2d6a0da2: folds
fad7078a: calls $0.11
Hero: folds
*** FLOP *** [Ac 2d 5d]
fad7078a: checks
626359de: bets $0.15
fad7078a: calls $0.15
*** TURN *** [Ac 2d 5d] [4d]
fad7078a: checks
626359de: checks
*** RIVER *** [Ac 2d 5d 4d] [Kc]
fad7078a: bets $0.32
626359de: folds
Uncalled bet ($0.32) returned to fad7078a
*** SHOWDOWN ***
fad7078a collected $0.58 from pot
*** SUMMARY ***
Total pot $0.61 | Rake $0.03 | Jackpot $0 | Bingo $0 | Fortune $0 | Tax $0
Board [Ac 2d 5d 4d Kc]
Seat 1: 2d6a0da2 (button) folded before Flop (didn't bet)
Seat 2: fad7078a (small blind) won ($0.58)
Seat 3: Hero (big blind) folded before Flop
Seat 4: 626359de folded on the River
Seat 5: 28e11496 folded before Flop (didn't bet)
Seat 6: 21c758a folded before Flop (didn't bet)


Poker Hand #RC3334479875: Hold'em No Limit ($0.02/$0.05) - 2025/02/17 21:03:36
Table 'RushAndCash615135' 6-max Seat #1 is the button
Seat 1: 1fa8537 ($6.96 in chips)
Seat 2: 22643080 ($8.86 in chips)
Seat 3: 808dd9c ($5 in chips)
Seat 4: 806e9b7b ($3.26 in chips)
Seat 5: Hero ($12.54 in chips)
Seat 6: e390e48e ($10.04 in chips)
22643080: posts small blind $0.02
808dd9c: posts big blind $0.05
*** HOLE CARDS ***
Dealt to 1fa8537 
Dealt to 22643080 
Dealt to 808dd9c 
Dealt to 806e9b7b 
Dealt to Hero [4h Jd]
Dealt to e390e48e 
806e9b7b: folds
Hero: folds
e390e48e: folds
1fa8537: raises $0.06 to $0.11
22643080: folds
808dd9c: calls $0.06
*** FLOP *** [Ac 3d Qc]
808dd9c: checks
1fa8537: checks
*** TURN *** [Ac 3d Qc] [Qs]
808dd9c: checks
1fa8537: checks
*** RIVER *** [Ac 3d Qc Qs] [7c]
808dd9c: bets $0.12
1fa8537: calls $0.12
808dd9c: shows [9c Tc] (Ace High Flush)
1fa8537: shows [Js Ah] (Pair of Aces and Pair of Queens)
*** SHOWDOWN ***
808dd9c collected $0.46 from pot
*** SUMMARY ***
Total pot $0.48 | Rake $0.02 | Jackpot $0 | Bingo $0 | Fortune $0 | Tax $0
Board [Ac 3d Qc Qs 7c]
Seat 1: 1fa8537 (button) showed [Js Ah] and lost with Pair of Aces and Pair of Queens
Seat 2: 22643080 (small blind) folded before Flop
Seat 3: 808dd9c (big blind) showed [9c Tc] and won ($0.46) with Ace High Flush
Seat 4: 806e9b7b folded before Flop (didn't bet)
Seat 5: Hero folded before Flop (didn't bet)
Seat 6: e390e48e folded before Flop (didn't bet)


Poker Hand #RC3334479460: Hold'em No Limit ($0.02/$0.05) - 2025/02/17 21:02:43
Table 'RushAndCash614720' 6-max Seat #1 is the button
Seat 1: Hero ($8.18 in chips)
Seat 2: 598d859f ($6.97 in chips)
Seat 3: f9d64f1a ($5.16 in chips)
Seat 4: 5a37a767 ($6.59 in chips)
Seat 5: 65964033 ($5 in chips)
Seat 6: 757f29d9 ($4.5 in chips)
598d859f: posts small blind $0.02
f9d64f1a: posts big blind $0.05
*** HOLE CARDS ***
Dealt to Hero [As Ac]
Dealt to 598d859f 
Dealt to f9d64f1a 
Dealt to 5a37a767 
Dealt to 65964033 
Dealt to 757f29d9 
5a37a767: folds
65964033: folds
757f29d9: raises $0.08 to $0.13
Hero: raises $0.25 to $0.38
598d859f: folds
f9d64f1a: folds
757f29d9: raises $0.78 to $1.16
Hero: raises $7.02 to $8.18 and is all-in
757f29d9: calls $3.34 and is all-in
Uncalled bet ($3.68) returned to Hero
Hero: shows [As Ac]
757f29d9: shows [Kh Kd]
*** FIRST FLOP *** [7s 7h Js]
*** FIRST TURN *** [7s 7h Js] [2h]
*** FIRST RIVER *** [7s 7h Js 2h] [Tc]
*** SECOND FLOP *** [9s 9d 3c]
*** SECOND TURN *** [9s 9d 3c] [7d]
*** SECOND RIVER *** [9s 9d 3c 7d] [Qh]
*** FIRST SHOWDOWN ***
Hero collected $4.43 from pot
*** SECOND SHOWDOWN ***
Hero collected $4.43 from pot
*** SUMMARY ***
Total pot $9.07 | Rake $0.14 | Jackpot $0.07 | Bingo $0 | Fortune $0 | Tax $0
Hand was run two times
FIRST Board [7s 7h Js 2h Tc]
SECOND Board [9s 9d 3c 7d Qh]
Seat 1: Hero (button) showed [As Ac] and won ($4.43) with Pair of Aces and Pair of Sevens, and won ($4.43) with Pair of Aces and Pair of Nines
Seat 2: 598d859f (small blind) folded before Flop
Seat 3: f9d64f1a (big blind) folded before Flop
Seat 4: 5a37a767 folded before Flop (didn't bet)
Seat 5: 65964033 folded before Flop (didn't bet)
Seat 6: 757f29d9 showed [Kh Kd] and lost with Pair of Kings and Pair of Sevens, and lost with Pair of Kings and Pair of Nines


Poker Hand #RC3334479432: Hold'em No Limit ($0.02/$0.05) - 2025/02/17 21:02:40
Table 'RushAndCash614692' 6-max Seat #1 is the button
Seat 1: 679a8f7 ($9.01 in chips)
Seat 2: f68df189 ($5.11 in chips)
Seat 3: 3c76a91d ($5.56 in chips)
Seat 4: ef7e6107 ($5.39 in chips)
Seat 5: 688b40f9 ($6.31 in chips)
Seat 6: Hero ($8.18 in chips)
f68df189: posts small blind $0.02
3c76a91d: posts big blind $0.05
*** HOLE CARDS ***
Dealt to 679a8f7 
Dealt to f68df189 
Dealt to 3c76a91d 
Dealt to ef7e6107 
Dealt to 688b40f9 
Dealt to Hero [3c Jh]
ef7e6107: folds
688b40f9: folds
Hero: folds
679a8f7: folds
f68df189: folds
Uncalled bet ($0.03) returned to 3c76a91d
*** SHOWDOWN ***
3c76a91d collected $0.04 from pot
*** SUMMARY ***
Total pot $0.04 | Rake $0 | Jackpot $0 | Bingo $0 | Fortune $0 | Tax $0
Seat 1: 679a8f7 (button) folded before Flop (didn't bet)
Seat 2: f68df189 (small blind) folded before Flop
Seat 3: 3c76a91d (big blind) collected ($0.04)
Seat 4: ef7e6107 folded before Flop (didn't bet)
Seat 5: 688b40f9 folded before Flop (didn't bet)
Seat 6: Hero folded before Flop (didn't bet)


Poker Hand #RC3334479408: Hold'em No Limit ($0.02/$0.05) - 2025/02/17 21:02:37
Table 'RushAndCash614668' 6-max Seat #1 is the button
Seat 1: e89071f6 ($7.89 in chips)
Seat 2: 4abcea5e ($6.42 in chips)
Seat 3: Hero ($8.23 in chips)
Seat 4: 81e1b438 ($6.48 in chips)
Seat 5: 9dd1ff39 ($7.33 in chips)
Seat 6: 65964033 ($5 in chips)
4abcea5e: posts small blind $0.02
Hero: posts big blind $0.05
*** HOLE CARDS ***
Dealt to e89071f6 
Dealt to 4abcea5e 
Dealt to Hero [Td 4d]
Dealt to 81e1b438 
Dealt to 9dd1ff39 
Dealt to 65964033 
81e1b438: raises $0.05 to $0.1
9dd1ff39: folds
65964033: folds
e89071f6: calls $0.1
4abcea5e: folds
Hero: folds
*** FLOP *** [Ks 2s Qc]
81e1b438: checks
e89071f6: bets $0.09
81e1b438: raises $0.23 to $0.32
e89071f6: folds
Uncalled bet ($0.23) returned to 81e1b438
*** SHOWDOWN ***
81e1b438 collected $0.43 from pot
*** SUMMARY ***
Total pot $0.45 | Rake $0.02 | Jackpot $0 | Bingo $0 | Fortune $0 | Tax $0
Board [Ks 2s Qc]
Seat 1: e89071f6 (button) folded on the Flop
Seat 2: 4abcea5e (small blind) folded before Flop
Seat 3: Hero (big blind) folded before Flop
Seat 4: 81e1b438 won ($0.43)
Seat 5: 9dd1ff39 folded before Flop (didn't bet)
Seat 6: 65964033 folded before Flop (didn't bet)


Poker Hand #RC3334479379: Hold'em No Limit ($0.02/$0.05) - 2025/02/17 21:02:34
Table 'RushAndCash614639' 6-max Seat #1 is the button
Seat 1: Hero ($8.23 in chips)
Seat 2: 9b152430 ($5.84 in chips)
Seat 3: 9dba8a1e ($6.36 in chips)
Seat 4: 94b22b92 ($10.66 in chips)
Seat 5: d86379c5 ($7.16 in chips)
Seat 6: 802a8ffb ($5.14 in chips)
9b152430: posts small blind $0.02
9dba8a1e: posts big blind $0.05
*** HOLE CARDS ***
Dealt to Hero [Ad 5h]
Dealt to 9b152430 
Dealt to 9dba8a1e 
Dealt to 94b22b92 
Dealt to d86379c5 
Dealt to 802a8ffb 
94b22b92: raises $0.05 to $0.1
d86379c5: folds
802a8ffb: folds
Hero: folds
9b152430: folds
9dba8a1e: calls $0.05
*** FLOP *** [4c 4h 5s]
9dba8a1e: checks
94b22b92: checks
*** TURN *** [4c 4h 5s] [7c]
9dba8a1e: bets $0.17
94b22b92: folds
Uncalled bet ($0.17) returned to 9dba8a1e
*** SHOWDOWN ***
9dba8a1e collected $0.21 from pot
*** SUMMARY ***
Total pot $0.22 | Rake $0.01 | Jackpot $0 | Bingo $0 | Fortune $0 | Tax $0
Board [4c 4h 5s 7c]
Seat 1: Hero (button) folded before Flop (didn't bet)
Seat 2: 9b152430 (small blind) folded before Flop
Seat 3: 9dba8a1e (big blind) won ($0.21)
Seat 4: 94b22b92 folded on the Turn
Seat 5: d86379c5 folded before Flop (didn't bet)
Seat 6: 802a8ffb folded before Flop (didn't bet)


Poker Hand #RC3334479356: Hold'em No Limit ($0.02/$0.05) - 2025/02/17 21:02:31
Table 'RushAndCash614616' 6-max Seat #1 is the button
Seat 1: 5725be4f ($11.87 in chips)
Seat 2: Hero ($8.25 in chips)
Seat 3: 95096c6a ($6.96 in chips)
Seat 4: 157631a0 ($6.58 in chips)
Seat 5: 650e9dc7 ($7.32 in chips)
Seat 6: 1157f85d ($9.37 in chips)
Hero: posts small blind $0.02
95096c6a: posts big blind $0.05
*** HOLE CARDS ***
Dealt to 5725be4f 
Dealt to Hero [9h 8c]
Dealt to 95096c6a 
Dealt to 157631a0 
Dealt to 650e9dc7 
Dealt to 1157f85d 
157631a0: folds
650e9dc7: folds
1157f85d: folds
5725be4f: raises $0.08 to $0.13
Hero: folds
95096c6a: folds
Uncalled bet ($0.08) returned to 5725be4f
*** SHOWDOWN ***
5725be4f collected $0.12 from pot
*** SUMMARY ***
Total pot $0.12 | Rake $0 | Jackpot $0 | Bingo $0 | Fortune $0 | Tax $0
Seat 1: 5725be4f (button) collected ($0.12)
Seat 2: Hero (small blind) folded before Flop
Seat 3: 95096c6a (big blind) folded before Flop
Seat 4: 157631a0 folded before Flop (didn't bet)
Seat 5: 650e9dc7 folded before Flop (didn't bet)
Seat 6: 1157f85d folded before Flop (didn't bet)


Poker Hand #RC3334479333: Hold'em No Limit ($0.02/$0.05) - 2025/02/17 21:02:27
Table 'RushAndCash614593' 6-max Seat #1 is the button
Seat 1: 35016d48 ($6.84 in chips)
Seat 2: af9df96 ($6.54 in chips)
Seat 3: 18e1b476 ($7.67 in chips)
Seat 4: 9b152430 ($5.84 in chips)
Seat 5: 4e3c3196 ($26.22 in chips)
Seat 6: Hero ($8.25 in chips)
af9df96: posts small blind $0.02
18e1b476: posts big blind $0.05
*** HOLE CARDS ***
Dealt to 35016d48 
Dealt to af9df96 
Dealt to 18e1b476 
Dealt to 9b152430 
Dealt to 4e3c3196 
Dealt to Hero [Qs 6c]
9b152430: folds
4e3c3196: folds
Hero: folds
35016d48: folds
af9df96: raises $0.1 to $0.15
18e1b476: folds
Uncalled bet ($0.1) returned to af9df96
*** SHOWDOWN ***
af9df96 collected $0.1 from pot
*** SUMMARY ***
Total pot $0.1 | Rake $0 | Jackpot $0 | Bingo $0 | Fortune $0 | Tax $0
Seat 1: 35016d48 (button) folded before Flop (didn't bet)
Seat 2: af9df96 (small blind) collected ($0.1)
Seat 3: 18e1b476 (big blind) folded before Flop
Seat 4: 9b152430 folded before Flop (didn't bet)
Seat 5: 4e3c3196 folded before Flop (didn't bet)
Seat 6: Hero folded before Flop (didn't bet)


Poker Hand #RC3334479312: Hold'em No Limit ($0.02/$0.05) - 2025/02/17 21:02:24
Table 'RushAndCash614572' 6-max Seat #1 is the button
Seat 1: 98b7c00d ($5 in chips)
Seat 2: 868c7021 ($7.69 in chips)
Seat 3: b67f7812 ($9.25 in chips)
Seat 4: 4d7b761 ($5.15 in chips)
Seat 5: b4b34357 ($5 in chips)
Seat 6: Hero ($8.25 in chips)
868c7021: posts small blind $0.02
b67f7812: posts big blind $0.05
*** HOLE CARDS ***
Dealt to 98b7c00d 
Dealt to 868c7021 
Dealt to b67f7812 
Dealt to 4d7b761 
Dealt to b4b34357 
Dealt to Hero [5d 7s]
4d7b761: folds
b4b34357: folds
Hero: folds
98b7c00d: raises $0.08 to $0.13
868c7021: folds
b67f7812: folds
Uncalled bet ($0.08) returned to 98b7c00d
*** SHOWDOWN ***
98b7c00d collected $0.12 from pot
*** SUMMARY ***
Total pot $0.12 | Rake $0 | Jackpot $0 | Bingo $0 | Fortune $0 | Tax $0
Seat 1: 98b7c00d (button) collected ($0.12)
Seat 2: 868c7021 (small blind) folded before Flop
Seat 3: b67f7812 (big blind) folded before Flop
Seat 4: 4d7b761 folded before Flop (didn't bet)
Seat 5: b4b34357 folded before Flop (didn't bet)
Seat 6: Hero folded before Flop (didn't bet)


Poker Hand #RC3334479284: Hold'em No Limit ($0.02/$0.05) - 2025/02/17 21:02:21
Table 'RushAndCash614544' 6-max Seat #1 is the button
Seat 1: 9165e0e3 ($8.06 in chips)
Seat 2: 14620cce ($16.39 in chips)
Seat 3: e8b95847 ($5.06 in chips)
Seat 4: Hero ($8.25 in chips)
Seat 5: 191b60c1 ($8.52 in chips)
Seat 6: 742ccfee ($2.64 in chips)
14620cce: posts small blind $0.02
e8b95847: posts big blind $0.05
*** HOLE CARDS ***
Dealt to 9165e0e3 
Dealt to 14620cce 
Dealt to e8b95847 
Dealt to Hero [7d Qh]
Dealt to 191b60c1 
Dealt to 742ccfee 
Hero: folds
191b60c1: folds
742ccfee: folds
9165e0e3: folds
14620cce: folds
Uncalled bet ($0.03) returned to e8b95847
*** SHOWDOWN ***
e8b95847 collected $0.04 from pot
*** SUMMARY ***
Total pot $0.04 | Rake $0 | Jackpot $0 | Bingo $0 | Fortune $0 | Tax $0
Seat 1: 9165e0e3 (button) folded before Flop (didn't bet)
Seat 2: 14620cce (small blind) folded before Flop
Seat 3: e8b95847 (big blind) collected ($0.04)
Seat 4: Hero folded before Flop (didn't bet)
Seat 5: 191b60c1 folded before Flop (didn't bet)
Seat 6: 742ccfee folded before Flop (didn't bet)


Poker Hand #RC3334479256: Hold'em No Limit ($0.02/$0.05) - 2025/02/17 21:02:17
Table 'RushAndCash614516' 6-max Seat #1 is the button
Seat 1: 1b6c31ec ($8.22 in chips)
Seat 2: 194ee370 ($5.21 in chips)
Seat 3: baaf0b0d ($5 in chips)
Seat 4: Hero ($8.25 in chips)
Seat 5: dda0a24a ($6 in chips)
Seat 6: c73f4765 ($2.05 in chips)
194ee370: posts small blind $0.02
baaf0b0d: posts big blind $0.05
*** HOLE CARDS ***
Dealt to 1b6c31ec 
Dealt to 194ee370 
Dealt to baaf0b0d 
Dealt to Hero [5s 5c]
Dealt to dda0a24a 
Dealt to c73f4765 
Hero: folds
dda0a24a: folds
c73f4765: folds
1b6c31ec: folds
194ee370: folds
Uncalled bet ($0.03) returned to baaf0b0d
*** SHOWDOWN ***
baaf0b0d collected $0.04 from pot
*** SUMMARY ***
Total pot $0.04 | Rake $0 | Jackpot $0 | Bingo $0 | Fortune $0 | Tax $0
Seat 1: 1b6c31ec (button) folded before Flop (didn't bet)
Seat 2: 194ee370 (small blind) folded before Flop
Seat 3: baaf0b0d (big blind) collected ($0.04)
Seat 4: Hero folded before Flop (didn't bet)
Seat 5: dda0a24a folded before Flop (didn't bet)
Seat 6: c73f4765 folded before Flop (didn't bet)


Poker Hand #RC3334479226: Hold'em No Limit ($0.02/$0.05) - 2025/02/17 21:02:14
Table 'RushAndCash614486' 6-max Seat #1 is the button
Seat 1: eb1bbc7a ($5.23 in chips)
Seat 2: 5c8c19b7 ($16.16 in chips)
Seat 3: 8c3789e ($5.06 in chips)
Seat 4: a3b43a4c ($5.58 in chips)
Seat 5: Hero ($8.25 in chips)
Seat 6: 5197516b ($9.03 in chips)
5c8c19b7: posts small blind $0.02
8c3789e: posts big blind $0.05
*** HOLE CARDS ***
Dealt to eb1bbc7a 
Dealt to 5c8c19b7 
Dealt to 8c3789e 
Dealt to a3b43a4c 
Dealt to Hero [3c Ad]
Dealt to 5197516b 
a3b43a4c: folds
Hero: folds
5197516b: folds
eb1bbc7a: folds
5c8c19b7: raises $0.1 to $0.15
8c3789e: folds
Uncalled bet ($0.1) returned to 5c8c19b7
*** SHOWDOWN ***
5c8c19b7 collected $0.1 from pot
*** SUMMARY ***
Total pot $0.1 | Rake $0 | Jackpot $0 | Bingo $0 | Fortune $0 | Tax $0
Seat 1: eb1bbc7a (button) folded before Flop (didn't bet)
Seat 2: 5c8c19b7 (small blind) collected ($0.1)
Seat 3: 8c3789e (big blind) folded before Flop
Seat 4: a3b43a4c folded before Flop (didn't bet)
Seat 5: Hero folded before Flop (didn't bet)
Seat 6: 5197516b folded before Flop (didn't bet)


Poker Hand #RC3334479202: Hold'em No Limit ($0.02/$0.05) - 2025/02/17 21:02:11
Table 'RushAndCash614462' 6-max Seat #1 is the button
Seat 1: Hero ($8.25 in chips)
Seat 2: 742ccfee ($2.71 in chips)
Seat 3: 157631a0 ($6.63 in chips)
Seat 4: bc00a523 ($5.93 in chips)
Seat 5: 258a2071 ($5.49 in chips)
Seat 6: baaf0b0d ($5 in chips)
742ccfee: posts small blind $0.02
157631a0: posts big blind $0.05
*** HOLE CARDS ***
Dealt to Hero [3s 9c]
Dealt to 742ccfee 
Dealt to 157631a0 
Dealt to bc00a523 
Dealt to 258a2071 
Dealt to baaf0b0d 
bc00a523: raises $0.08 to $0.13
258a2071: folds
baaf0b0d: folds
Hero: folds
742ccfee: folds
157631a0: folds
Uncalled bet ($0.08) returned to bc00a523
*** SHOWDOWN ***
bc00a523 collected $0.12 from pot
*** SUMMARY ***
Total pot $0.12 | Rake $0 | Jackpot $0 | Bingo $0 | Fortune $0 | Tax $0
Seat 1: Hero (button) folded before Flop (didn't bet)
Seat 2: 742ccfee (small blind) folded before Flop
Seat 3: 157631a0 (big blind) folded before Flop
Seat 4: bc00a523 collected ($0.12)
Seat 5: 258a2071 folded before Flop (didn't bet)
Seat 6: baaf0b0d folded before Flop (didn't bet)


Poker Hand #RC3334479178: Hold'em No Limit ($0.02/$0.05) - 2025/02/17 21:02:07
Table 'RushAndCash614438' 6-max Seat #1 is the button
Seat 1: 76135c78 ($13.04 in chips)
Seat 2: Hero ($8.27 in chips)
Seat 3: 5fe62400 ($5.74 in chips)
Seat 4: 151b0c91 ($4.97 in chips)
Seat 5: 1b6c31ec ($8.15 in chips)
Seat 6: 8eb51349 ($5 in chips)
Hero: posts small blind $0.02
5fe62400: posts big blind $0.05
*** HOLE CARDS ***
Dealt to 76135c78 
Dealt to Hero [7d 3c]
Dealt to 5fe62400 
Dealt to 151b0c91 
Dealt to 1b6c31ec 
Dealt to 8eb51349 
151b0c91: folds
1b6c31ec: raises $0.05 to $0.1
8eb51349: folds
76135c78: folds
Hero: folds
5fe62400: folds
Uncalled bet ($0.05) returned to 1b6c31ec
*** SHOWDOWN ***
1b6c31ec collected $0.12 from pot
*** SUMMARY ***
Total pot $0.12 | Rake $0 | Jackpot $0 | Bingo $0 | Fortune $0 | Tax $0
Seat 1: 76135c78 (button) folded before Flop (didn't bet)
Seat 2: Hero (small blind) folded before Flop
Seat 3: 5fe62400 (big blind) folded before Flop
Seat 4: 151b0c91 folded before Flop (didn't bet)
Seat 5: 1b6c31ec collected ($0.12)
Seat 6: 8eb51349 folded before Flop (didn't bet)


Poker Hand #RC3334478944: Hold'em No Limit ($0.02/$0.05) - 2025/02/17 21:01:38
Table 'RushAndCash614204' 6-max Seat #1 is the button
Seat 1: f68df189 ($5.78 in chips)
Seat 2: 151b0c91 ($4.7 in chips)
Seat 3: Hero ($8.57 in chips)
Seat 4: 9df8d688 ($5.09 in chips)
Seat 5: 22005c45 ($4.98 in chips)
Seat 6: 9c1c8cec ($4.75 in chips)
151b0c91: posts small blind $0.02
Hero: posts big blind $0.05
*** HOLE CARDS ***
Dealt to f68df189 
Dealt to 151b0c91 
Dealt to Hero [Ah Js]
Dealt to 9df8d688 
Dealt to 22005c45 
Dealt to 9c1c8cec 
9df8d688: folds
22005c45: folds
9c1c8cec: folds
f68df189: folds
151b0c91: calls $0.03
Hero: raises $0.13 to $0.18
151b0c91: calls $0.13
*** FLOP *** [Tc 9h 3d]
151b0c91: bets $0.12
Hero: calls $0.12
*** TURN *** [Tc 9h 3d] [5s]
151b0c91: bets $0.3
Hero: folds
Uncalled bet ($0.3) returned to 151b0c91
*** SHOWDOWN ***
151b0c91 collected $0.57 from pot
*** SUMMARY ***
Total pot $0.6 | Rake $0.03 | Jackpot $0 | Bingo $0 | Fortune $0 | Tax $0
Board [Tc 9h 3d 5s]
Seat 1: f68df189 (button) folded before Flop (didn't bet)
Seat 2: 151b0c91 (small blind) won ($0.57)
Seat 3: Hero (big blind) folded on the Turn
Seat 4: 9df8d688 folded before Flop (didn't bet)
Seat 5: 22005c45 folded before Flop (didn't bet)
Seat 6: 9c1c8cec folded before Flop (didn't bet)


Poker Hand #RC3334478919: Hold'em No Limit ($0.02/$0.05) - 2025/02/17 21:01:35
Table 'RushAndCash614179' 6-max Seat #1 is the button
Seat 1: 93cbff75 ($7.66 in chips)
Seat 2: 2c1a5c09 ($5.66 in chips)
Seat 3: b05c1b36 ($4.93 in chips)
Seat 4: 18af90c ($10.72 in chips)
Seat 5: Hero ($8.57 in chips)
Seat 6: e349aa35 ($5.56 in chips)
2c1a5c09: posts small blind $0.02
b05c1b36: posts big blind $0.05
*** HOLE CARDS ***
Dealt to 93cbff75 
Dealt to 2c1a5c09 
Dealt to b05c1b36 
Dealt to 18af90c 
Dealt to Hero [Jh 4s]
Dealt to e349aa35 
18af90c: folds
Hero: folds
e349aa35: folds
93cbff75: folds
2c1a5c09: folds
Uncalled bet ($0.03) returned to b05c1b36
*** SHOWDOWN ***
b05c1b36 collected $0.04 from pot
*** SUMMARY ***
Total pot $0.04 | Rake $0 | Jackpot $0 | Bingo $0 | Fortune $0 | Tax $0
Seat 1: 93cbff75 (button) folded before Flop (didn't bet)
Seat 2: 2c1a5c09 (small blind) folded before Flop
Seat 3: b05c1b36 (big blind) collected ($0.04)
Seat 4: 18af90c folded before Flop (didn't bet)
Seat 5: Hero folded before Flop (didn't bet)
Seat 6: e349aa35 folded before Flop (didn't bet)


Poker Hand #RC3334475648: Hold'em No Limit ($0.02/$0.05) - 2025/02/17 20:54:11
Table 'RushAndCash610908' 6-max Seat #1 is the button
Seat 1: 94b22b92 ($10.28 in chips)
Seat 2: Hero ($8.59 in chips)
Seat 3: 21e0e4ee ($5.07 in chips)
Seat 4: 3b2a8270 ($5 in chips)
Seat 5: 742ccfee ($3.67 in chips)
Seat 6: ac4a6064 ($5.05 in chips)
Hero: posts small blind $0.02
21e0e4ee: posts big blind $0.05
*** HOLE CARDS ***
Dealt to 94b22b92 
Dealt to Hero [5d Ks]
Dealt to 21e0e4ee 
Dealt to 3b2a8270 
Dealt to 742ccfee 
Dealt to ac4a6064 
3b2a8270: folds
742ccfee: folds
ac4a6064: raises $0.05 to $0.1
94b22b92: folds
Hero: folds
21e0e4ee: folds
Uncalled bet ($0.05) returned to ac4a6064
*** SHOWDOWN ***
ac4a6064 collected $0.12 from pot
*** SUMMARY ***
Total pot $0.12 | Rake $0 | Jackpot $0 | Bingo $0 | Fortune $0 | Tax $0
Seat 1: 94b22b92 (button) folded before Flop (didn't bet)
Seat 2: Hero (small blind) folded before Flop
Seat 3: 21e0e4ee (big blind) folded before Flop
Seat 4: 3b2a8270 folded before Flop (didn't bet)
Seat 5: 742ccfee folded before Flop (didn't bet)
Seat 6: ac4a6064 collected ($0.12)


Poker Hand #RC3334475615: Hold'em No Limit ($0.02/$0.05) - 2025/02/17 20:54:06
Table 'RushAndCash610875' 6-max Seat #1 is the button
Seat 1: 77368e62 ($4 in chips)
Seat 2: 63499226 ($3.57 in chips)
Seat 3: Hero ($8.64 in chips)
Seat 4: 84667b37 ($5.79 in chips)
Seat 5: 4bf24d63 ($5.1 in chips)
Seat 6: 84a1bb5f ($6.41 in chips)
63499226: posts small blind $0.02
Hero: posts big blind $0.05
*** HOLE CARDS ***
Dealt to 77368e62 
Dealt to 63499226 
Dealt to Hero [Tc 3c]
Dealt to 84667b37 
Dealt to 4bf24d63 
Dealt to 84a1bb5f 
84667b37: raises $0.05 to $0.1
4bf24d63: raises $0.21 to $0.31
84a1bb5f: folds
77368e62: folds
63499226: folds
Hero: folds
84667b37: calls $0.21
*** FLOP *** [7s Qd 5c]
84667b37: checks
4bf24d63: bets $0.35
84667b37: folds
Uncalled bet ($0.35) returned to 4bf24d63
*** SHOWDOWN ***
4bf24d63 collected $0.66 from pot
*** SUMMARY ***
Total pot $0.69 | Rake $0.03 | Jackpot $0 | Bingo $0 | Fortune $0 | Tax $0
Board [7s Qd 5c]
Seat 1: 77368e62 (button) folded before Flop (didn't bet)
Seat 2: 63499226 (small blind) folded before Flop
Seat 3: Hero (big blind) folded before Flop
Seat 4: 84667b37 folded on the Flop
Seat 5: 4bf24d63 won ($0.66)
Seat 6: 84a1bb5f folded before Flop (didn't bet)


Poker Hand #RC3334475579: Hold'em No Limit ($0.02/$0.05) - 2025/02/17 20:54:02
Table 'RushAndCash610839' 6-max Seat #1 is the button
Seat 1: 92099542 ($19.07 in chips)
Seat 2: 1b8b89c1 ($6.25 in chips)
Seat 3: a6ca20e7 ($38.86 in chips)
Seat 4: Hero ($8.64 in chips)
Seat 5: bce71d0e ($5.63 in chips)
Seat 6: 4c9f897a ($6.67 in chips)
1b8b89c1: posts small blind $0.02
a6ca20e7: posts big blind $0.05
*** HOLE CARDS ***
Dealt to 92099542 
Dealt to 1b8b89c1 
Dealt to a6ca20e7 
Dealt to Hero [Qs Jh]
Dealt to bce71d0e 
Dealt to 4c9f897a 
Hero: folds
bce71d0e: raises $0.1 to $0.15
4c9f897a: folds
92099542: folds
1b8b89c1: raises $0.47 to $0.62
a6ca20e7: folds
bce71d0e: calls $0.47
*** FLOP *** [Ad 6c 6s]
1b8b89c1: bets $0.43
bce71d0e: calls $0.43
*** TURN *** [Ad 6c 6s] [3c]
1b8b89c1: bets $1.22
bce71d0e: raises $3.36 to $4.58 and is all-in
1b8b89c1: calls $3.36
bce71d0e: shows [Js As] (Pair of Aces and Pair of Sixes)
1b8b89c1: shows [Ah Kc] (Pair of Aces and Pair of Sixes)
*** RIVER *** [Ad 6c 6s 3c] [2h]
*** SHOWDOWN ***
1b8b89c1 collected $11.09 from pot
*** SUMMARY ***
Total pot $11.31 | Rake $0.15 | Jackpot $0.07 | Bingo $0 | Fortune $0 | Tax $0
Board [Ad 6c 6s 3c 2h]
Seat 1: 92099542 (button) folded before Flop (didn't bet)
Seat 2: 1b8b89c1 (small blind) showed [Ah Kc] and won ($11.09) with Pair of Aces and Pair of Sixes
Seat 3: a6ca20e7 (big blind) folded before Flop
Seat 4: Hero folded before Flop (didn't bet)
Seat 5: bce71d0e showed [Js As] and lost with Pair of Aces and Pair of Sixes
Seat 6: 4c9f897a folded before Flop (didn't bet)


Poker Hand #RC3334475553: Hold'em No Limit ($0.02/$0.05) - 2025/02/17 20:53:59
Table 'RushAndCash610813' 6-max Seat #1 is the button
Seat 1: ada87216 ($6.37 in chips)
Seat 2: 7a40fb8f ($5.17 in chips)
Seat 3: 6f565fd ($5 in chips)
Seat 4: Hero ($8.64 in chips)
Seat 5: baaf0b0d ($5.03 in chips)
Seat 6: e20e5cfc ($5.53 in chips)
7a40fb8f: posts small blind $0.02
6f565fd: posts big blind $0.05
*** HOLE CARDS ***
Dealt to ada87216 
Dealt to 7a40fb8f 
Dealt to 6f565fd 
Dealt to Hero [5d Jc]
Dealt to baaf0b0d 
Dealt to e20e5cfc 
Hero: folds
baaf0b0d: raises $0.06 to $0.11
e20e5cfc: calls $0.11
ada87216: folds
7a40fb8f: folds
6f565fd: folds
*** FLOP *** [Ac 5c Kd]
baaf0b0d: checks
e20e5cfc: checks
*** TURN *** [Ac 5c Kd] [2d]
baaf0b0d: checks
e20e5cfc: checks
*** RIVER *** [Ac 5c Kd 2d] [Qs]
baaf0b0d: checks
e20e5cfc: checks
baaf0b0d: shows [8c Tc] (Ace-High)
e20e5cfc: shows [6c 6h] (Pair of Sixes)
*** SHOWDOWN ***
e20e5cfc collected $0.28 from pot
*** SUMMARY ***
Total pot $0.29 | Rake $0.01 | Jackpot $0 | Bingo $0 | Fortune $0 | Tax $0
Board [Ac 5c Kd 2d Qs]
Seat 1: ada87216 (button) folded before Flop (didn't bet)
Seat 2: 7a40fb8f (small blind) folded before Flop
Seat 3: 6f565fd (big blind) folded before Flop
Seat 4: Hero folded before Flop (didn't bet)
Seat 5: baaf0b0d showed [8c Tc] and lost with Ace-High
Seat 6: e20e5cfc showed [6c 6h] and won ($0.28) with Pair of Sixes


Poker Hand #RC3334475526: Hold'em No Limit ($0.02/$0.05) - 2025/02/17 20:53:56
Table 'RushAndCash610786' 6-max Seat #1 is the button
Seat 1: 72fa4c0f ($3.37 in chips)
Seat 2: 26e655d0 ($6.86 in chips)
Seat 3: b144f063 ($12.73 in chips)
Seat 4: fad7078a ($5.2 in chips)
Seat 5: Hero ($8.64 in chips)
Seat 6: d33976ee ($6.03 in chips)
26e655d0: posts small blind $0.02
b144f063: posts big blind $0.05
*** HOLE CARDS ***
Dealt to 72fa4c0f 
Dealt to 26e655d0 
Dealt to b144f063 
Dealt to fad7078a 
Dealt to Hero [As 5d]
Dealt to d33976ee 
fad7078a: folds
Hero: folds
d33976ee: folds
72fa4c0f: folds
26e655d0: folds
Uncalled bet ($0.03) returned to b144f063
*** SHOWDOWN ***
b144f063 collected $0.04 from pot
*** SUMMARY ***
Total pot $0.04 | Rake $0 | Jackpot $0 | Bingo $0 | Fortune $0 | Tax $0
Seat 1: 72fa4c0f (button) folded before Flop (didn't bet)
Seat 2: 26e655d0 (small blind) folded before Flop
Seat 3: b144f063 (big blind) collected ($0.04)
Seat 4: fad7078a folded before Flop (didn't bet)
Seat 5: Hero folded before Flop (didn't bet)
Seat 6: d33976ee folded before Flop (didn't bet)


Poker Hand #RC3334475490: Hold'em No Limit ($0.02/$0.05) - 2025/02/17 20:53:52
Table 'RushAndCash610750' 6-max Seat #1 is the button
Seat 1: 61f5d558 ($12.56 in chips)
Seat 2: 8c3789e ($6.57 in chips)
Seat 3: 8e07c53 ($5 in chips)
Seat 4: 9b1a3dd2 ($6.75 in chips)
Seat 5: 7d2d3f96 ($5.19 in chips)
Seat 6: Hero ($8.64 in chips)
8c3789e: posts small blind $0.02
8e07c53: posts big blind $0.05
*** HOLE CARDS ***
Dealt to 61f5d558 
Dealt to 8c3789e 
Dealt to 8e07c53 
Dealt to 9b1a3dd2 
Dealt to 7d2d3f96 
Dealt to Hero [6s Qd]
9b1a3dd2: folds
7d2d3f96: folds
Hero: folds
61f5d558: calls $0.05
8c3789e: folds
8e07c53: checks
*** FLOP *** [Tc 7h Qc]
8e07c53: checks
61f5d558: bets $0.07
8e07c53: folds
Uncalled bet ($0.07) returned to 61f5d558
*** SHOWDOWN ***
61f5d558 collected $0.12 from pot
*** SUMMARY ***
Total pot $0.12 | Rake $0 | Jackpot $0 | Bingo $0 | Fortune $0 | Tax $0
Board [Tc 7h Qc]
Seat 1: 61f5d558 (button) won ($0.12)
Seat 2: 8c3789e (small blind) folded before Flop
Seat 3: 8e07c53 (big blind) folded on the Flop
Seat 4: 9b1a3dd2 folded before Flop (didn't bet)
Seat 5: 7d2d3f96 folded before Flop (didn't bet)
Seat 6: Hero folded before Flop (didn't bet)


Poker Hand #RC3334475228: Hold'em No Limit ($0.02/$0.05) - 2025/02/17 20:53:18
Table 'RushAndCash610488' 6-max Seat #1 is the button
Seat 1: 1696890b ($5.75 in chips)
Seat 2: 95fac4b9 ($10.26 in chips)
Seat 3: Hero ($8.75 in chips)
Seat 4: 8c3789e ($6.45 in chips)
Seat 5: 9dba8a1e ($5.17 in chips)
Seat 6: 56006c55 ($4.93 in chips)
95fac4b9: posts small blind $0.02
Hero: posts big blind $0.05
*** HOLE CARDS ***
Dealt to 1696890b 
Dealt to 95fac4b9 
Dealt to Hero [9h 8h]
Dealt to 8c3789e 
Dealt to 9dba8a1e 
Dealt to 56006c55 
8c3789e: raises $0.06 to $0.11
9dba8a1e: folds
56006c55: folds
1696890b: folds
95fac4b9: folds
Hero: calls $0.06
*** FLOP *** [5h 4d 7c]
Hero: checks
8c3789e: checks
*** TURN *** [5h 4d 7c] [Ac]
Hero: checks
8c3789e: checks
*** RIVER *** [5h 4d 7c Ac] [Td]
Hero: checks
8c3789e: checks
Hero: shows [9h 8h] (Ace-High)
8c3789e: shows [Jh Kh] (Ace-High)
*** SHOWDOWN ***
8c3789e collected $0.23 from pot
*** SUMMARY ***
Total pot $0.24 | Rake $0.01 | Jackpot $0 | Bingo $0 | Fortune $0 | Tax $0
Board [5h 4d 7c Ac Td]
Seat 1: 1696890b (button) folded before Flop (didn't bet)
Seat 2: 95fac4b9 (small blind) folded before Flop
Seat 3: Hero (big blind) showed [9h 8h] and lost with Ace-High
Seat 4: 8c3789e showed [Jh Kh] and won ($0.23) with Ace-High
Seat 5: 9dba8a1e folded before Flop (didn't bet)
Seat 6: 56006c55 folded before Flop (didn't bet)


Poker Hand #RC3334475192: Hold'em No Limit ($0.02/$0.05) - 2025/02/17 20:53:14
Table 'RushAndCash610452' 6-max Seat #1 is the button
Seat 1: Hero ($8.75 in chips)
Seat 2: 16081ce9 ($14.59 in chips)
Seat 3: c7d7e6aa ($18.25 in chips)
Seat 4: 1e2c3e8b ($5.14 in chips)
Seat 5: e662d075 ($5.51 in chips)
Seat 6: db83c16e ($6.31 in chips)
16081ce9: posts small blind $0.02
c7d7e6aa: posts big blind $0.05
*** HOLE CARDS ***
Dealt to Hero [Kd 3d]
Dealt to 16081ce9 
Dealt to c7d7e6aa 
Dealt to 1e2c3e8b 
Dealt to e662d075 
Dealt to db83c16e 
1e2c3e8b: folds
e662d075: folds
db83c16e: folds
Hero: folds
16081ce9: folds
Uncalled bet ($0.03) returned to c7d7e6aa
*** SHOWDOWN ***
c7d7e6aa collected $0.04 from pot
*** SUMMARY ***
Total pot $0.04 | Rake $0 | Jackpot $0 | Bingo $0 | Fortune $0 | Tax $0
Seat 1: Hero (button) folded before Flop (didn't bet)
Seat 2: 16081ce9 (small blind) folded before Flop
Seat 3: c7d7e6aa (big blind) collected ($0.04)
Seat 4: 1e2c3e8b folded before Flop (didn't bet)
Seat 5: e662d075 folded before Flop (didn't bet)
Seat 6: db83c16e folded before Flop (didn't bet)


Poker Hand #RC3334475155: Hold'em No Limit ($0.02/$0.05) - 2025/02/17 20:53:10
Table 'RushAndCash610415' 6-max Seat #1 is the button
Seat 1: c806dd25 ($5.09 in chips)
Seat 2: f45ac3d0 ($7.56 in chips)
Seat 3: cbfd6c92 ($10.02 in chips)
Seat 4: 87d5083b ($23.76 in chips)
Seat 5: Hero ($8.75 in chips)
Seat 6: 5bf5cd50 ($5.97 in chips)
f45ac3d0: posts small blind $0.02
cbfd6c92: posts big blind $0.05
*** HOLE CARDS ***
Dealt to c806dd25 
Dealt to f45ac3d0 
Dealt to cbfd6c92 
Dealt to 87d5083b 
Dealt to Hero [3h 8d]
Dealt to 5bf5cd50 
87d5083b: raises $0.05 to $0.1
Hero: folds
5bf5cd50: folds
c806dd25: folds
f45ac3d0: folds
cbfd6c92: folds
Uncalled bet ($0.05) returned to 87d5083b
*** SHOWDOWN ***
87d5083b collected $0.12 from pot
*** SUMMARY ***
Total pot $0.12 | Rake $0 | Jackpot $0 | Bingo $0 | Fortune $0 | Tax $0
Seat 1: c806dd25 (button) folded before Flop (didn't bet)
Seat 2: f45ac3d0 (small blind) folded before Flop
Seat 3: cbfd6c92 (big blind) folded before Flop
Seat 4: 87d5083b collected ($0.12)
Seat 5: Hero folded before Flop (didn't bet)
Seat 6: 5bf5cd50 folded before Flop (didn't bet)


Poker Hand #RC3334475129: Hold'em No Limit ($0.02/$0.05) - 2025/02/17 20:53:07
Table 'RushAndCash610389' 6-max Seat #1 is the button
Seat 1: f45ac3d0 ($7.56 in chips)
Seat 2: Hero ($8.77 in chips)
Seat 3: 9f9e1094 ($5.57 in chips)
Seat 4: 87d5083b ($23.76 in chips)
Seat 5: 19bb03b5 ($13.21 in chips)
Seat 6: e30bf6a3 ($1.61 in chips)
Hero: posts small blind $0.02
9f9e1094: posts big blind $0.05
*** HOLE CARDS ***
Dealt to f45ac3d0 
Dealt to Hero [8c 5c]
Dealt to 9f9e1094 
Dealt to 87d5083b 
Dealt to 19bb03b5 
Dealt to e30bf6a3 
87d5083b: folds
19bb03b5: folds
e30bf6a3: folds
f45ac3d0: folds
Hero: folds
Uncalled bet ($0.03) returned to 9f9e1094
*** SHOWDOWN ***
9f9e1094 collected $0.04 from pot
*** SUMMARY ***
Total pot $0.04 | Rake $0 | Jackpot $0 | Bingo $0 | Fortune $0 | Tax $0
Seat 1: f45ac3d0 (button) folded before Flop (didn't bet)
Seat 2: Hero (small blind) folded before Flop
Seat 3: 9f9e1094 (big blind) collected ($0.04)
Seat 4: 87d5083b folded before Flop (didn't bet)
Seat 5: 19bb03b5 folded before Flop (didn't bet)
Seat 6: e30bf6a3 folded before Flop (didn't bet)


Poker Hand #RC3334475104: Hold'em No Limit ($0.02/$0.05) - 2025/02/17 20:53:04
Table 'RushAndCash610364' 6-max Seat #1 is the button
Seat 1: 532b1615 ($3.88 in chips)
Seat 2: 84a1bb5f ($6.36 in chips)
Seat 3: 23a65ab7 ($5 in chips)
Seat 4: 21075cc3 ($4.8 in chips)
Seat 5: Hero ($8.77 in chips)
Seat 6: 2f9e8867 ($5.58 in chips)
84a1bb5f: posts small blind $0.02
23a65ab7: posts big blind $0.05
*** HOLE CARDS ***
Dealt to 532b1615 
Dealt to 84a1bb5f 
Dealt to 23a65ab7 
Dealt to 21075cc3 
Dealt to Hero [6s 4d]
Dealt to 2f9e8867 
21075cc3: folds
Hero: folds
2f9e8867: folds
532b1615: folds
84a1bb5f: raises $0.07 to $0.12
23a65ab7: folds
Uncalled bet ($0.07) returned to 84a1bb5f
*** SHOWDOWN ***
84a1bb5f collected $0.1 from pot
*** SUMMARY ***
Total pot $0.1 | Rake $0 | Jackpot $0 | Bingo $0 | Fortune $0 | Tax $0
Seat 1: 532b1615 (button) folded before Flop (didn't bet)
Seat 2: 84a1bb5f (small blind) collected ($0.1)
Seat 3: 23a65ab7 (big blind) folded before Flop
Seat 4: 21075cc3 folded before Flop (didn't bet)
Seat 5: Hero folded before Flop (didn't bet)
Seat 6: 2f9e8867 folded before Flop (didn't bet)


Poker Hand #RC3334475066: Hold'em No Limit ($0.02/$0.05) - 2025/02/17 20:52:59
Table 'RushAndCash610326' 6-max Seat #1 is the button
Seat 1: Hero ($8.77 in chips)
Seat 2: f3a68bc9 ($5.14 in chips)
Seat 3: c585480d ($5 in chips)
Seat 4: c864f9f6 ($5 in chips)
Seat 5: 32d40ce0 ($6.05 in chips)
Seat 6: 74f9576e ($5 in chips)
f3a68bc9: posts small blind $0.02
c585480d: posts big blind $0.05
*** HOLE CARDS ***
Dealt to Hero [5h 2d]
Dealt to f3a68bc9 
Dealt to c585480d 
Dealt to c864f9f6 
Dealt to 32d40ce0 
Dealt to 74f9576e 
c864f9f6: folds
32d40ce0: folds
74f9576e: folds
Hero: folds
f3a68bc9: raises $0.07 to $0.12
c585480d: folds
Uncalled bet ($0.07) returned to f3a68bc9
*** SHOWDOWN ***
f3a68bc9 collected $0.1 from pot
*** SUMMARY ***
Total pot $0.1 | Rake $0 | Jackpot $0 | Bingo $0 | Fortune $0 | Tax $0
Seat 1: Hero (button) folded before Flop (didn't bet)
Seat 2: f3a68bc9 (small blind) collected ($0.1)
Seat 3: c585480d (big blind) folded before Flop
Seat 4: c864f9f6 folded before Flop (didn't bet)
Seat 5: 32d40ce0 folded before Flop (didn't bet)
Seat 6: 74f9576e folded before Flop (didn't bet)


Poker Hand #RC3334475038: Hold'em No Limit ($0.02/$0.05) - 2025/02/17 20:52:55
Table 'RushAndCash610298' 6-max Seat #1 is the button
Seat 1: f2a32196 ($6.22 in chips)
Seat 2: f739af93 ($12.86 in chips)
Seat 3: 94706c35 ($16.15 in chips)
Seat 4: c607d475 ($8.18 in chips)
Seat 5: 8e07c53 ($5 in chips)
Seat 6: Hero ($8.77 in chips)
f739af93: posts small blind $0.02
94706c35: posts big blind $0.05
*** HOLE CARDS ***
Dealt to f2a32196 
Dealt to f739af93 
Dealt to 94706c35 
Dealt to c607d475 
Dealt to 8e07c53 
Dealt to Hero [4h Jd]
c607d475: folds
8e07c53: folds
Hero: folds
f2a32196: folds
f739af93: raises $0.1 to $0.15
94706c35: calls $0.1
*** FLOP *** [6h 3d 9h]
f739af93: bets $0.15
94706c35: folds
Uncalled bet ($0.15) returned to f739af93
*** SHOWDOWN ***
f739af93 collected $0.29 from pot
*** SUMMARY ***
Total pot $0.3 | Rake $0.01 | Jackpot $0 | Bingo $0 | Fortune $0 | Tax $0
Board [6h 3d 9h]
Seat 1: f2a32196 (button) folded before Flop (didn't bet)
Seat 2: f739af93 (small blind) won ($0.29)
Seat 3: 94706c35 (big blind) folded on the Flop
Seat 4: c607d475 folded before Flop (didn't bet)
Seat 5: 8e07c53 folded before Flop (didn't bet)
Seat 6: Hero folded before Flop (didn't bet)


Poker Hand #RC3334475010: Hold'em No Limit ($0.02/$0.05) - 2025/02/17 20:52:52
Table 'RushAndCash610270' 6-max Seat #1 is the button
Seat 1: 64e5de41 ($6 in chips)
Seat 2: Hero ($8.79 in chips)
Seat 3: bf84714d ($5 in chips)
Seat 4: 77d1364f ($5.8 in chips)
Seat 5: 73c2df1f ($15.41 in chips)
Seat 6: 54a16a21 ($5.05 in chips)
Hero: posts small blind $0.02
bf84714d: posts big blind $0.05
*** HOLE CARDS ***
Dealt to 64e5de41 
Dealt to Hero [3c 7d]
Dealt to bf84714d 
Dealt to 77d1364f 
Dealt to 73c2df1f 
Dealt to 54a16a21 
77d1364f: folds
73c2df1f: folds
54a16a21: folds
64e5de41: folds
Hero: folds
Uncalled bet ($0.03) returned to bf84714d
*** SHOWDOWN ***
bf84714d collected $0.04 from pot
*** SUMMARY ***
Total pot $0.04 | Rake $0 | Jackpot $0 | Bingo $0 | Fortune $0 | Tax $0
Seat 1: 64e5de41 (button) folded before Flop (didn't bet)
Seat 2: Hero (small blind) folded before Flop
Seat 3: bf84714d (big blind) collected ($0.04)
Seat 4: 77d1364f folded before Flop (didn't bet)
Seat 5: 73c2df1f folded before Flop (didn't bet)
Seat 6: 54a16a21 folded before Flop (didn't bet)


Poker Hand #RC3334474954: Hold'em No Limit ($0.02/$0.05) - 2025/02/17 20:52:45
Table 'RushAndCash610214' 6-max Seat #1 is the button
Seat 1: 19bb03b5 ($13.14 in chips)
Seat 2: 4bf24d63 ($5.05 in chips)
Seat 3: Hero ($8.84 in chips)
Seat 4: 6aa0c391 ($5.53 in chips)
Seat 5: ca2247af ($7 in chips)
Seat 6: 18af90c ($10.51 in chips)
4bf24d63: posts small blind $0.02
Hero: posts big blind $0.05
*** HOLE CARDS ***
Dealt to 19bb03b5 
Dealt to 4bf24d63 
Dealt to Hero [8h 4h]
Dealt to 6aa0c391 
Dealt to ca2247af 
Dealt to 18af90c 
6aa0c391: folds
ca2247af: folds
18af90c: folds
19bb03b5: raises $0.06 to $0.11
4bf24d63: folds
Hero: folds
Uncalled bet ($0.06) returned to 19bb03b5
*** SHOWDOWN ***
19bb03b5 collected $0.12 from pot
*** SUMMARY ***
Total pot $0.12 | Rake $0 | Jackpot $0 | Bingo $0 | Fortune $0 | Tax $0
Seat 1: 19bb03b5 (button) collected ($0.12)
Seat 2: 4bf24d63 (small blind) folded before Flop
Seat 3: Hero (big blind) folded before Flop
Seat 4: 6aa0c391 folded before Flop (didn't bet)
Seat 5: ca2247af folded before Flop (didn't bet)
Seat 6: 18af90c folded before Flop (didn't bet)


Poker Hand #RC3334474878: Hold'em No Limit ($0.02/$0.05) - 2025/02/17 20:52:34
Table 'RushAndCash610138' 6-max Seat #1 is the button
Seat 1: Hero ($8.77 in chips)
Seat 2: bf2195f6 ($4.81 in chips)
Seat 3: b00c4f8 ($11.86 in chips)
Seat 4: 1a54a2fc ($10.23 in chips)
Seat 5: 742ccfee ($3.63 in chips)
Seat 6: 4b3dba4 ($6.11 in chips)
bf2195f6: posts small blind $0.02
b00c4f8: posts big blind $0.05
*** HOLE CARDS ***
Dealt to Hero [6h 6s]
Dealt to bf2195f6 
Dealt to b00c4f8 
Dealt to 1a54a2fc 
Dealt to 742ccfee 
Dealt to 4b3dba4 
1a54a2fc: folds
742ccfee: folds
4b3dba4: folds
Hero: raises $0.05 to $0.1
bf2195f6: folds
b00c4f8: folds
Uncalled bet ($0.05) returned to Hero
*** SHOWDOWN ***
Hero collected $0.12 from pot
*** SUMMARY ***
Total pot $0.12 | Rake $0 | Jackpot $0 | Bingo $0 | Fortune $0 | Tax $0
Seat 1: Hero (button) collected ($0.12)
Seat 2: bf2195f6 (small blind) folded before Flop
Seat 3: b00c4f8 (big blind) folded before Flop
Seat 4: 1a54a2fc folded before Flop (didn't bet)
Seat 5: 742ccfee folded before Flop (didn't bet)
Seat 6: 4b3dba4 folded before Flop (didn't bet)


Poker Hand #RC3334474858: Hold'em No Limit ($0.02/$0.05) - 2025/02/17 20:52:31
Table 'RushAndCash610118' 6-max Seat #1 is the button
Seat 1: 8dbd0a2d ($9.08 in chips)
Seat 2: 186b316a ($5 in chips)
Seat 3: 87256f31 ($4.56 in chips)
Seat 4: 29ffb7d5 ($6.67 in chips)
Seat 5: Hero ($8.77 in chips)
Seat 6: 1063406 ($9.68 in chips)
186b316a: posts small blind $0.02
87256f31: posts big blind $0.05
*** HOLE CARDS ***
Dealt to 8dbd0a2d 
Dealt to 186b316a 
Dealt to 87256f31 
Dealt to 29ffb7d5 
Dealt to Hero [9s 6h]
Dealt to 1063406 
29ffb7d5: folds
Hero: folds
1063406: folds
8dbd0a2d: folds
186b316a: raises $0.08 to $0.13
87256f31: folds
Uncalled bet ($0.08) returned to 186b316a
*** SHOWDOWN ***
186b316a collected $0.1 from pot
*** SUMMARY ***
Total pot $0.1 | Rake $0 | Jackpot $0 | Bingo $0 | Fortune $0 | Tax $0
Seat 1: 8dbd0a2d (button) folded before Flop (didn't bet)
Seat 2: 186b316a (small blind) collected ($0.1)
Seat 3: 87256f31 (big blind) folded before Flop
Seat 4: 29ffb7d5 folded before Flop (didn't bet)
Seat 5: Hero folded before Flop (didn't bet)
Seat 6: 1063406 folded before Flop (didn't bet)


Poker Hand #RC3334444738: Hold'em No Limit ($0.02/$0.05) - 2025/02/17 20:52:16
Table 'RushAndCash609998' 6-max Seat #1 is the button
Seat 1: 29ffb7d5 ($6.67 in chips)
Seat 2: 78b1f985 ($5.14 in chips)
Seat 3: 9165e0e3 ($5 in chips)
Seat 4: 4a302754 ($5.15 in chips)
Seat 5: Hero ($8.7 in chips)
Seat 6: d670287d ($6.78 in chips)
78b1f985: posts small blind $0.02
9165e0e3: posts big blind $0.05
*** HOLE CARDS ***
Dealt to 29ffb7d5 
Dealt to 78b1f985 
Dealt to 9165e0e3 
Dealt to 4a302754 
Dealt to Hero [6s 6c]
Dealt to d670287d 
4a302754: folds
Hero: raises $0.05 to $0.1
d670287d: folds
29ffb7d5: folds
78b1f985: folds
9165e0e3: folds
Uncalled bet ($0.05) returned to Hero
*** SHOWDOWN ***
Hero collected $0.12 from pot
*** SUMMARY ***
Total pot $0.12 | Rake $0 | Jackpot $0 | Bingo $0 | Fortune $0 | Tax $0
Seat 1: 29ffb7d5 (button) folded before Flop (didn't bet)
Seat 2: 78b1f985 (small blind) folded before Flop
Seat 3: 9165e0e3 (big blind) folded before Flop
Seat 4: 4a302754 folded before Flop (didn't bet)
Seat 5: Hero collected ($0.12)
Seat 6: d670287d folded before Flop (didn't bet)


Poker Hand #RC3334444680: Hold'em No Limit ($0.02/$0.05) - 2025/02/17 20:52:08
Table 'RushAndCash609940' 6-max Seat #1 is the button
Seat 1: 1696890b ($4.88 in chips)
Seat 2: c2143d25 ($4.66 in chips)
Seat 3: 9b152430 ($5 in chips)
Seat 4: 39109629 ($5.01 in chips)
Seat 5: Hero ($8.7 in chips)
Seat 6: 81060c15 ($5.02 in chips)
c2143d25: posts small blind $0.02
9b152430: posts big blind $0.05
*** HOLE CARDS ***
Dealt to 1696890b 
Dealt to c2143d25 
Dealt to 9b152430 
Dealt to 39109629 
Dealt to Hero [7d Kc]
Dealt to 81060c15 
39109629: folds
Hero: folds
81060c15: raises $0.05 to $0.1
1696890b: folds
c2143d25: raises $0.22 to $0.32
9b152430: folds
81060c15: calls $0.22
*** FLOP *** [6h 9h 6c]
c2143d25: bets $0.32
81060c15: calls $0.32
*** TURN *** [6h 9h 6c] [7h]
c2143d25: checks
81060c15: checks
*** RIVER *** [6h 9h 6c 7h] [8d]
c2143d25: bets $0.43
81060c15: calls $0.43
c2143d25: shows [Qh As] (Pair of Sixes)
81060c15: shows [2c 2d] (Pair of Sixes and Pair of Twos)
*** SHOWDOWN ***
81060c15 collected $2 from pot
*** SUMMARY ***
Total pot $2.19 | Rake $0.12 | Jackpot $0.07 | Bingo $0 | Fortune $0 | Tax $0
Board [6h 9h 6c 7h 8d]
Seat 1: 1696890b (button) folded before Flop (didn't bet)
Seat 2: c2143d25 (small blind) showed [Qh As] and lost with Pair of Sixes
Seat 3: 9b152430 (big blind) folded before Flop
Seat 4: 39109629 folded before Flop (didn't bet)
Seat 5: Hero folded before Flop (didn't bet)
Seat 6: 81060c15 showed [2c 2d] and won ($2) with Pair of Sixes and Pair of Twos


Poker Hand #RC3334444408: Hold'em No Limit ($0.02/$0.05) - 2025/02/17 20:51:33
Table 'RushAndCash609668' 6-max Seat #1 is the button
Seat 1: 26e655d0 ($6.47 in chips)
Seat 2: 2b8b2921 ($8.5 in chips)
Seat 3: e2777133 ($9.35 in chips)
Seat 4: 94706c35 ($16 in chips)
Seat 5: a28ca95c ($21.9 in chips)
Seat 6: Hero ($8.63 in chips)
2b8b2921: posts small blind $0.02
e2777133: posts big blind $0.05
*** HOLE CARDS ***
Dealt to 26e655d0 
Dealt to 2b8b2921 
Dealt to e2777133 
Dealt to 94706c35 
Dealt to a28ca95c 
Dealt to Hero [Qc Ts]
94706c35: folds
a28ca95c: folds
Hero: raises $0.05 to $0.1
26e655d0: folds
2b8b2921: folds
e2777133: folds
Uncalled bet ($0.05) returned to Hero
*** SHOWDOWN ***
Hero collected $0.12 from pot
*** SUMMARY ***
Total pot $0.12 | Rake $0 | Jackpot $0 | Bingo $0 | Fortune $0 | Tax $0
Seat 1: 26e655d0 (button) folded before Flop (didn't bet)
Seat 2: 2b8b2921 (small blind) folded before Flop
Seat 3: e2777133 (big blind) folded before Flop
Seat 4: 94706c35 folded before Flop (didn't bet)
Seat 5: a28ca95c folded before Flop (didn't bet)
Seat 6: Hero collected ($0.12)


Poker Hand #RC3334444233: Hold'em No Limit ($0.02/$0.05) - 2025/02/17 20:51:08
Table 'RushAndCash609493' 6-max Seat #1 is the button
Seat 1: cc8de981 ($5.38 in chips)
Seat 2: Hero ($8.49 in chips)
Seat 3: c1784884 ($8.07 in chips)
Seat 4: 38a4c833 ($8.85 in chips)
Seat 5: 902b47de ($5.72 in chips)
Seat 6: 18767060 ($12.21 in chips)
Hero: posts small blind $0.02
c1784884: posts big blind $0.05
*** HOLE CARDS ***
Dealt to cc8de981 
Dealt to Hero [Qc As]
Dealt to c1784884 
Dealt to 38a4c833 
Dealt to 902b47de 
Dealt to 18767060 
38a4c833: folds
902b47de: folds
18767060: raises $0.05 to $0.1
cc8de981: folds
Hero: raises $0.32 to $0.42
c1784884: folds
18767060: folds
Uncalled bet ($0.32) returned to Hero
*** SHOWDOWN ***
Hero collected $0.24 from pot
*** SUMMARY ***
Total pot $0.25 | Rake $0.01 | Jackpot $0 | Bingo $0 | Fortune $0 | Tax $0
Seat 1: cc8de981 (button) folded before Flop (didn't bet)
Seat 2: Hero (small blind) collected ($0.24)
Seat 3: c1784884 (big blind) folded before Flop
Seat 4: 38a4c833 folded before Flop (didn't bet)
Seat 5: 902b47de folded before Flop (didn't bet)
Seat 6: 18767060 folded before Flop


Poker Hand #RC3334444202: Hold'em No Limit ($0.02/$0.05) - 2025/02/17 20:51:05
Table 'RushAndCash609462' 6-max Seat #1 is the button
Seat 1: 11778018 ($5.05 in chips)
Seat 2: 4ad79f79 ($5.02 in chips)
Seat 3: Hero ($8.54 in chips)
Seat 4: 84667b37 ($3.83 in chips)
Seat 5: 868521d5 ($5.53 in chips)
Seat 6: f8db84a ($5.78 in chips)
4ad79f79: posts small blind $0.02
Hero: posts big blind $0.05
*** HOLE CARDS ***
Dealt to 11778018 
Dealt to 4ad79f79 
Dealt to Hero [7c Kh]
Dealt to 84667b37 
Dealt to 868521d5 
Dealt to f8db84a 
84667b37: folds
868521d5: raises $0.06 to $0.11
f8db84a: folds
11778018: folds
4ad79f79: calls $0.09
Hero: folds
*** FLOP *** [2c Qc 5s]
4ad79f79: checks
868521d5: checks
*** TURN *** [2c Qc 5s] [9h]
4ad79f79: checks
868521d5: bets $0.15
4ad79f79: calls $0.15
*** RIVER *** [2c Qc 5s 9h] [8c]
4ad79f79: checks
868521d5: checks
4ad79f79: shows [Js Ks] (King-High)
868521d5: shows [Ac Qs] (Pair of Queens)
*** SHOWDOWN ***
868521d5 collected $0.55 from pot
*** SUMMARY ***
Total pot $0.57 | Rake $0.02 | Jackpot $0 | Bingo $0 | Fortune $0 | Tax $0
Board [2c Qc 5s 9h 8c]
Seat 1: 11778018 (button) folded before Flop (didn't bet)
Seat 2: 4ad79f79 (small blind) showed [Js Ks] and lost with King-High
Seat 3: Hero (big blind) folded before Flop
Seat 4: 84667b37 folded before Flop (didn't bet)
Seat 5: 868521d5 showed [Ac Qs] and won ($0.55) with Pair of Queens
Seat 6: f8db84a folded before Flop (didn't bet)


Poker Hand #RC3334444176: Hold'em No Limit ($0.02/$0.05) - 2025/02/17 20:51:00
Table 'RushAndCash609436' 6-max Seat #1 is the button
Seat 1: Hero ($8.54 in chips)
Seat 2: 70521b8f ($6.34 in chips)
Seat 3: 123dc5ea ($10.43 in chips)
Seat 4: 11778018 ($5.05 in chips)
Seat 5: 571b193 ($5.05 in chips)
Seat 6: c7e9103c ($17.44 in chips)
70521b8f: posts small blind $0.02
123dc5ea: posts big blind $0.05
*** HOLE CARDS ***
Dealt to Hero [5d 9d]
Dealt to 70521b8f 
Dealt to 123dc5ea 
Dealt to 11778018 
Dealt to 571b193 
Dealt to c7e9103c 
11778018: folds
571b193: folds
c7e9103c: folds
Hero: folds
70521b8f: raises $0.1 to $0.15
123dc5ea: folds
Uncalled bet ($0.1) returned to 70521b8f
*** SHOWDOWN ***
70521b8f collected $0.1 from pot
*** SUMMARY ***
Total pot $0.1 | Rake $0 | Jackpot $0 | Bingo $0 | Fortune $0 | Tax $0
Seat 1: Hero (button) folded before Flop (didn't bet)
Seat 2: 70521b8f (small blind) collected ($0.1)
Seat 3: 123dc5ea (big blind) folded before Flop
Seat 4: 11778018 folded before Flop (didn't bet)
Seat 5: 571b193 folded before Flop (didn't bet)
Seat 6: c7e9103c folded before Flop (didn't bet)


Poker Hand #RC3334444145: Hold'em No Limit ($0.02/$0.05) - 2025/02/17 20:50:56
Table 'RushAndCash609405' 6-max Seat #1 is the button
Seat 1: 571b193 ($5.05 in chips)
Seat 2: 1f187ba0 ($4.85 in chips)
Seat 3: 8a5a4b28 ($2.54 in chips)
Seat 4: Hero ($8.54 in chips)
Seat 5: b9ae439d ($7.11 in chips)
Seat 6: 61f5d558 ($11.65 in chips)
1f187ba0: posts small blind $0.02
8a5a4b28: posts big blind $0.05
*** HOLE CARDS ***
Dealt to 571b193 
Dealt to 1f187ba0 
Dealt to 8a5a4b28 
Dealt to Hero [7d 4d]
Dealt to b9ae439d 
Dealt to 61f5d558 
Hero: folds
b9ae439d: folds
61f5d558: folds
571b193: folds
1f187ba0: folds
Uncalled bet ($0.03) returned to 8a5a4b28
*** SHOWDOWN ***
8a5a4b28 collected $0.04 from pot
*** SUMMARY ***
Total pot $0.04 | Rake $0 | Jackpot $0 | Bingo $0 | Fortune $0 | Tax $0
Seat 1: 571b193 (button) folded before Flop (didn't bet)
Seat 2: 1f187ba0 (small blind) folded before Flop
Seat 3: 8a5a4b28 (big blind) collected ($0.04)
Seat 4: Hero folded before Flop (didn't bet)
Seat 5: b9ae439d folded before Flop (didn't bet)
Seat 6: 61f5d558 folded before Flop (didn't bet)


Poker Hand #RC3334444117: Hold'em No Limit ($0.02/$0.05) - 2025/02/17 20:50:52
Table 'RushAndCash609377' 6-max Seat #1 is the button
Seat 1: 3b85f8e6 ($13.87 in chips)
Seat 2: Hero ($8.56 in chips)
Seat 3: ab5e89b2 ($5.66 in chips)
Seat 4: 3b2a8270 ($5.06 in chips)
Seat 5: 1e474bac ($7.15 in chips)
Seat 6: 742ccfee ($3.58 in chips)
Hero: posts small blind $0.02
ab5e89b2: posts big blind $0.05
*** HOLE CARDS ***
Dealt to 3b85f8e6 
Dealt to Hero [Jh 7h]
Dealt to ab5e89b2 
Dealt to 3b2a8270 
Dealt to 1e474bac 
Dealt to 742ccfee 
3b2a8270: folds
1e474bac: folds
742ccfee: folds
3b85f8e6: raises $0.07 to $0.12
Hero: folds
ab5e89b2: folds
Uncalled bet ($0.07) returned to 3b85f8e6
*** SHOWDOWN ***
3b85f8e6 collected $0.12 from pot
*** SUMMARY ***
Total pot $0.12 | Rake $0 | Jackpot $0 | Bingo $0 | Fortune $0 | Tax $0
Seat 1: 3b85f8e6 (button) collected ($0.12)
Seat 2: Hero (small blind) folded before Flop
Seat 3: ab5e89b2 (big blind) folded before Flop
Seat 4: 3b2a8270 folded before Flop (didn't bet)
Seat 5: 1e474bac folded before Flop (didn't bet)
Seat 6: 742ccfee folded before Flop (didn't bet)


Poker Hand #RC3334444035: Hold'em No Limit ($0.02/$0.05) - 2025/02/17 20:50:41
Table 'RushAndCash609295' 6-max Seat #1 is the button
Seat 1: 62156df3 ($6.35 in chips)
Seat 2: a51b9462 ($5.32 in chips)
Seat 3: Hero ($8.61 in chips)
Seat 4: af9df96 ($5.16 in chips)
Seat 5: 78b1f985 ($5.07 in chips)
Seat 6: f3f5406e ($15.13 in chips)
a51b9462: posts small blind $0.02
Hero: posts big blind $0.05
*** HOLE CARDS ***
Dealt to 62156df3 
Dealt to a51b9462 
Dealt to Hero [5s 2h]
Dealt to af9df96 
Dealt to 78b1f985 
Dealt to f3f5406e 
af9df96: folds
78b1f985: folds
f3f5406e: folds
62156df3: raises $0.06 to $0.11
a51b9462: raises $0.44 to $0.55
Hero: folds
62156df3: raises $0.58 to $1.13
a51b9462: raises $4.19 to $5.32 and is all-in
62156df3: folds
Uncalled bet ($4.19) returned to a51b9462
*** SHOWDOWN ***
a51b9462 collected $2.13 from pot
*** SUMMARY ***
Total pot $2.31 | Rake $0.11 | Jackpot $0.07 | Bingo $0 | Fortune $0 | Tax $0
Seat 1: 62156df3 (button) folded before Flop
Seat 2: a51b9462 (small blind) collected ($2.13)
Seat 3: Hero (big blind) folded before Flop
Seat 4: af9df96 folded before Flop (didn't bet)
Seat 5: 78b1f985 folded before Flop (didn't bet)
Seat 6: f3f5406e folded before Flop (didn't bet)


Poker Hand #RC3334444013: Hold'em No Limit ($0.02/$0.05) - 2025/02/17 20:50:38
Table 'RushAndCash609273' 6-max Seat #1 is the button
Seat 1: 520ec40f ($4.55 in chips)
Seat 2: 18767060 ($12.23 in chips)
Seat 3: 1ac52efc ($5.02 in chips)
Seat 4: 38f4cc4d ($6.23 in chips)
Seat 5: Hero ($8.61 in chips)
Seat 6: 626359de ($13.12 in chips)
18767060: posts small blind $0.02
1ac52efc: posts big blind $0.05
*** HOLE CARDS ***
Dealt to 520ec40f 
Dealt to 18767060 
Dealt to 1ac52efc 
Dealt to 38f4cc4d 
Dealt to Hero [2h 9h]
Dealt to 626359de 
38f4cc4d: folds
Hero: folds
626359de: folds
520ec40f: folds
18767060: calls $0.03
1ac52efc: checks
*** FLOP *** [3d 4c Ad]
18767060: bets $0.05
1ac52efc: folds
Uncalled bet ($0.05) returned to 18767060
*** SHOWDOWN ***
18767060 collected $0.1 from pot
*** SUMMARY ***
Total pot $0.1 | Rake $0 | Jackpot $0 | Bingo $0 | Fortune $0 | Tax $0
Board [3d 4c Ad]
Seat 1: 520ec40f (button) folded before Flop (didn't bet)
Seat 2: 18767060 (small blind) won ($0.1)
Seat 3: 1ac52efc (big blind) folded on the Flop
Seat 4: 38f4cc4d folded before Flop (didn't bet)
Seat 5: Hero folded before Flop (didn't bet)
Seat 6: 626359de folded before Flop (didn't bet)


Poker Hand #RC3334443986: Hold'em No Limit ($0.02/$0.05) - 2025/02/17 20:50:34
Table 'RushAndCash609246' 6-max Seat #1 is the button
Seat 1: 68e67dc8 ($7.69 in chips)
Seat 2: 520ec40f ($4.57 in chips)
Seat 3: c7e9103c ($17.56 in chips)
Seat 4: f9d64f1a ($5.16 in chips)
Seat 5: 1157f85d ($3.8 in chips)
Seat 6: Hero ($8.61 in chips)
520ec40f: posts small blind $0.02
c7e9103c: posts big blind $0.05
*** HOLE CARDS ***
Dealt to 68e67dc8 
Dealt to 520ec40f 
Dealt to c7e9103c 
Dealt to f9d64f1a 
Dealt to 1157f85d 
Dealt to Hero [4s 8s]
f9d64f1a: folds
1157f85d: raises $0.07 to $0.12
Hero: folds
68e67dc8: folds
520ec40f: folds
c7e9103c: folds
Uncalled bet ($0.07) returned to 1157f85d
*** SHOWDOWN ***
1157f85d collected $0.12 from pot
*** SUMMARY ***
Total pot $0.12 | Rake $0 | Jackpot $0 | Bingo $0 | Fortune $0 | Tax $0
Seat 1: 68e67dc8 (button) folded before Flop (didn't bet)
Seat 2: 520ec40f (small blind) folded before Flop
Seat 3: c7e9103c (big blind) folded before Flop
Seat 4: f9d64f1a folded before Flop (didn't bet)
Seat 5: 1157f85d collected ($0.12)
Seat 6: Hero folded before Flop (didn't bet)


Poker Hand #RC3334443960: Hold'em No Limit ($0.02/$0.05) - 2025/02/17 20:50:30
Table 'RushAndCash609220' 6-max Seat #1 is the button
Seat 1: 4bf24d63 ($5.19 in chips)
Seat 2: 9b152430 ($5.1 in chips)
Seat 3: 4f7979c7 ($5.97 in chips)
Seat 4: 9604af2 ($6.56 in chips)
Seat 5: 3b85f8e6 ($13.96 in chips)
Seat 6: Hero ($8.61 in chips)
9b152430: posts small blind $0.02
4f7979c7: posts big blind $0.05
*** HOLE CARDS ***
Dealt to 4bf24d63 
Dealt to 9b152430 
Dealt to 4f7979c7 
Dealt to 9604af2 
Dealt to 3b85f8e6 
Dealt to Hero [8d 3h]
9604af2: folds
3b85f8e6: folds
Hero: folds
4bf24d63: folds
9b152430: raises $0.1 to $0.15
4f7979c7: folds
Uncalled bet ($0.1) returned to 9b152430
*** SHOWDOWN ***
9b152430 collected $0.1 from pot
*** SUMMARY ***
Total pot $0.1 | Rake $0 | Jackpot $0 | Bingo $0 | Fortune $0 | Tax $0
Seat 1: 4bf24d63 (button) folded before Flop (didn't bet)
Seat 2: 9b152430 (small blind) collected ($0.1)
Seat 3: 4f7979c7 (big blind) folded before Flop
Seat 4: 9604af2 folded before Flop (didn't bet)
Seat 5: 3b85f8e6 folded before Flop (didn't bet)
Seat 6: Hero folded before Flop (didn't bet)


Poker Hand #RC3334443398: Hold'em No Limit ($0.02/$0.05) - 2025/02/17 20:49:16
Table 'RushAndCash608658' 6-max Seat #1 is the button
Seat 1: Hero ($8.79 in chips)
Seat 2: 886c894a ($8.27 in chips)
Seat 3: 4bf24d63 ($5 in chips)
Seat 4: ec1214a6 ($5 in chips)
Seat 5: ee3fdfd8 ($5.97 in chips)
Seat 6: 8d17f774 ($5.26 in chips)
886c894a: posts small blind $0.02
4bf24d63: posts big blind $0.05
*** HOLE CARDS ***
Dealt to Hero [Kc 9c]
Dealt to 886c894a 
Dealt to 4bf24d63 
Dealt to ec1214a6 
Dealt to ee3fdfd8 
Dealt to 8d17f774 
ec1214a6: folds
ee3fdfd8: folds
8d17f774: folds
Hero: raises $0.05 to $0.1
886c894a: folds
4bf24d63: calls $0.05
*** FLOP *** [Qc 6d 3c]
4bf24d63: checks
Hero: bets $0.08
4bf24d63: calls $0.08
*** TURN *** [Qc 6d 3c] [5d]
4bf24d63: checks
Hero: checks
*** RIVER *** [Qc 6d 3c 5d] [Th]
4bf24d63: checks
Hero: checks
4bf24d63: shows [8d Ac] (Ace-High)
Hero: shows [Kc 9c] (King-High)
*** SHOWDOWN ***
4bf24d63 collected $0.37 from pot
*** SUMMARY ***
Total pot $0.38 | Rake $0.01 | Jackpot $0 | Bingo $0 | Fortune $0 | Tax $0
Board [Qc 6d 3c 5d Th]
Seat 1: Hero (button) showed [Kc 9c] and lost with King-High
Seat 2: 886c894a (small blind) folded before Flop
Seat 3: 4bf24d63 (big blind) showed [8d Ac] and won ($0.37) with Ace-High
Seat 4: ec1214a6 folded before Flop (didn't bet)
Seat 5: ee3fdfd8 folded before Flop (didn't bet)
Seat 6: 8d17f774 folded before Flop (didn't bet)


Poker Hand #RC3334443372: Hold'em No Limit ($0.02/$0.05) - 2025/02/17 20:49:13
Table 'RushAndCash608632' 6-max Seat #1 is the button
Seat 1: 187f2194 ($11.47 in chips)
Seat 2: ee368e2c ($6.36 in chips)
Seat 3: bce71d0e ($5.07 in chips)
Seat 4: 6a5a3ab6 ($3.58 in chips)
Seat 5: Hero ($8.79 in chips)
Seat 6: 151b0c91 ($5.49 in chips)
ee368e2c: posts small blind $0.02
bce71d0e: posts big blind $0.05
*** HOLE CARDS ***
Dealt to 187f2194 
Dealt to ee368e2c 
Dealt to bce71d0e 
Dealt to 6a5a3ab6 
Dealt to Hero [4s 7h]
Dealt to 151b0c91 
6a5a3ab6: folds
Hero: folds
151b0c91: folds
187f2194: folds
ee368e2c: raises $0.09 to $0.14
bce71d0e: raises $0.28 to $0.42
ee368e2c: folds
Uncalled bet ($0.28) returned to bce71d0e
*** SHOWDOWN ***
bce71d0e collected $0.27 from pot
*** SUMMARY ***
Total pot $0.28 | Rake $0.01 | Jackpot $0 | Bingo $0 | Fortune $0 | Tax $0
Seat 1: 187f2194 (button) folded before Flop (didn't bet)
Seat 2: ee368e2c (small blind) folded before Flop
Seat 3: bce71d0e (big blind) collected ($0.27)
Seat 4: 6a5a3ab6 folded before Flop (didn't bet)
Seat 5: Hero folded before Flop (didn't bet)
Seat 6: 151b0c91 folded before Flop (didn't bet)


Poker Hand #RC3334443349: Hold'em No Limit ($0.02/$0.05) - 2025/02/17 20:49:09
Table 'RushAndCash608609' 6-max Seat #1 is the button
Seat 1: 84f270f8 ($5.76 in chips)
Seat 2: Hero ($8.81 in chips)
Seat 3: e26361cd ($6.98 in chips)
Seat 4: 820e1571 ($5.14 in chips)
Seat 5: 3b85f8e6 ($14.2 in chips)
Seat 6: 2509f499 ($4.79 in chips)
Hero: posts small blind $0.02
e26361cd: posts big blind $0.05
*** HOLE CARDS ***
Dealt to 84f270f8 
Dealt to Hero [9c 3d]
Dealt to e26361cd 
Dealt to 820e1571 
Dealt to 3b85f8e6 
Dealt to 2509f499 
820e1571: folds
3b85f8e6: folds
2509f499: folds
84f270f8: folds
Hero: folds
Uncalled bet ($0.03) returned to e26361cd
*** SHOWDOWN ***
e26361cd collected $0.04 from pot
*** SUMMARY ***
Total pot $0.04 | Rake $0 | Jackpot $0 | Bingo $0 | Fortune $0 | Tax $0
Seat 1: 84f270f8 (button) folded before Flop (didn't bet)
Seat 2: Hero (small blind) folded before Flop
Seat 3: e26361cd (big blind) collected ($0.04)
Seat 4: 820e1571 folded before Flop (didn't bet)
Seat 5: 3b85f8e6 folded before Flop (didn't bet)
Seat 6: 2509f499 folded before Flop (didn't bet)


Poker Hand #RC3334443168: Hold'em No Limit ($0.02/$0.05) - 2025/02/17 20:48:44
Table 'RushAndCash608428' 6-max Seat #1 is the button
Seat 1: 1f187ba0 ($4.25 in chips)
Seat 2: 52f43d28 ($8.41 in chips)
Seat 3: Hero ($8.69 in chips)
Seat 4: 6e885b98 ($4.95 in chips)
Seat 5: 4f7979c7 ($6.44 in chips)
Seat 6: 18af90c ($11.4 in chips)
52f43d28: posts small blind $0.02
Hero: posts big blind $0.05
*** HOLE CARDS ***
Dealt to 1f187ba0 
Dealt to 52f43d28 
Dealt to Hero [3d 7d]
Dealt to 6e885b98 
Dealt to 4f7979c7 
Dealt to 18af90c 
6e885b98: folds
4f7979c7: folds
18af90c: folds
1f187ba0: folds
52f43d28: raises $0.08 to $0.13
Hero: calls $0.08
*** FLOP *** [4h 8s 6c]
52f43d28: checks
Hero: checks
*** TURN *** [4h 8s 6c] [4c]
52f43d28: checks
Hero: bets $0.14
52f43d28: folds
Uncalled bet ($0.14) returned to Hero
*** SHOWDOWN ***
Hero collected $0.25 from pot
*** SUMMARY ***
Total pot $0.26 | Rake $0.01 | Jackpot $0 | Bingo $0 | Fortune $0 | Tax $0
Board [4h 8s 6c 4c]
Seat 1: 1f187ba0 (button) folded before Flop (didn't bet)
Seat 2: 52f43d28 (small blind) folded on the Turn
Seat 3: Hero (big blind) won ($0.25)
Seat 4: 6e885b98 folded before Flop (didn't bet)
Seat 5: 4f7979c7 folded before Flop (didn't bet)
Seat 6: 18af90c folded before Flop (didn't bet)


Poker Hand #RC3334442821: Hold'em No Limit ($0.02/$0.05) - 2025/02/17 20:47:55
Table 'RushAndCash608081' 6-max Seat #1 is the button
Seat 1: 4c5ef89 ($3.84 in chips)
Seat 2: 87d5083b ($22.5 in chips)
Seat 3: 18af90c ($11.98 in chips)
Seat 4: Hero ($8.14 in chips)
Seat 5: f6efd55a ($5.54 in chips)
Seat 6: 6c8cb957 ($5 in chips)
87d5083b: posts small blind $0.02
18af90c: posts big blind $0.05
*** HOLE CARDS ***
Dealt to 4c5ef89 
Dealt to 87d5083b 
Dealt to 18af90c 
Dealt to Hero [Ah Kh]
Dealt to f6efd55a 
Dealt to 6c8cb957 
Hero: raises $0.05 to $0.1
f6efd55a: folds
6c8cb957: folds
4c5ef89: folds
87d5083b: folds
18af90c: calls $0.05
*** FLOP *** [6d 2h Ks]
18af90c: checks
Hero: bets $0.12
18af90c: calls $0.12
*** TURN *** [6d 2h Ks] [8s]
18af90c: checks
Hero: bets $0.36
18af90c: calls $0.36
*** RIVER *** [6d 2h Ks 8s] [7c]
18af90c: checks
Hero: checks
18af90c: shows [Js Kd] (Pair of Kings)
Hero: shows [Ah Kh] (Pair of Kings)
*** SHOWDOWN ***
Hero collected $1.13 from pot
*** SUMMARY ***
Total pot $1.18 | Rake $0.05 | Jackpot $0 | Bingo $0 | Fortune $0 | Tax $0
Board [6d 2h Ks 8s 7c]
Seat 1: 4c5ef89 (button) folded before Flop (didn't bet)
Seat 2: 87d5083b (small blind) folded before Flop
Seat 3: 18af90c (big blind) showed [Js Kd] and lost with Pair of Kings
Seat 4: Hero showed [Ah Kh] and won ($1.13) with Pair of Kings
Seat 5: f6efd55a folded before Flop (didn't bet)
Seat 6: 6c8cb957 folded before Flop (didn't bet)


Poker Hand #RC3334442800: Hold'em No Limit ($0.02/$0.05) - 2025/02/17 20:47:51
Table 'RushAndCash608060' 6-max Seat #1 is the button
Seat 1: Hero ($8.14 in chips)
Seat 2: b7d97ee0 ($5.25 in chips)
Seat 3: 41720de0 ($19.54 in chips)
Seat 4: 677c4b25 ($5.71 in chips)
Seat 5: c95c6ae6 ($17.65 in chips)
Seat 6: c096c24 ($6.78 in chips)
b7d97ee0: posts small blind $0.02
41720de0: posts big blind $0.05
*** HOLE CARDS ***
Dealt to Hero [9s 3d]
Dealt to b7d97ee0 
Dealt to 41720de0 
Dealt to 677c4b25 
Dealt to c95c6ae6 
Dealt to c096c24 
677c4b25: folds
c95c6ae6: raises $0.05 to $0.1
c096c24: folds
Hero: folds
b7d97ee0: folds
41720de0: folds
Uncalled bet ($0.05) returned to c95c6ae6
*** SHOWDOWN ***
c95c6ae6 collected $0.12 from pot
*** SUMMARY ***
Total pot $0.12 | Rake $0 | Jackpot $0 | Bingo $0 | Fortune $0 | Tax $0
Seat 1: Hero (button) folded before Flop (didn't bet)
Seat 2: b7d97ee0 (small blind) folded before Flop
Seat 3: 41720de0 (big blind) folded before Flop
Seat 4: 677c4b25 folded before Flop (didn't bet)
Seat 5: c95c6ae6 collected ($0.12)
Seat 6: c096c24 folded before Flop (didn't bet)


Poker Hand #RC3334442676: Hold'em No Limit ($0.02/$0.05) - 2025/02/17 20:47:32
Table 'RushAndCash607936' 6-max Seat #1 is the button
Seat 1: 99af2b58 ($13.69 in chips)
Seat 2: Hero ($8.09 in chips)
Seat 3: 8c6d38f2 ($5.53 in chips)
Seat 4: 8023de0f ($5.79 in chips)
Seat 5: 418289b0 ($4.11 in chips)
Seat 6: 85a41100 ($5 in chips)
Hero: posts small blind $0.02
8c6d38f2: posts big blind $0.05
*** HOLE CARDS ***
Dealt to 99af2b58 
Dealt to Hero [Jh Qh]
Dealt to 8c6d38f2 
Dealt to 8023de0f 
Dealt to 418289b0 
Dealt to 85a41100 
8023de0f: folds
418289b0: calls $0.05
85a41100: folds
99af2b58: raises $0.1 to $0.15
Hero: folds
8c6d38f2: folds
418289b0: calls $0.1
*** FLOP *** [2d 9c 9d]
418289b0: checks
99af2b58: bets $0.19
418289b0: folds
Uncalled bet ($0.19) returned to 99af2b58
*** SHOWDOWN ***
99af2b58 collected $0.36 from pot
*** SUMMARY ***
Total pot $0.37 | Rake $0.01 | Jackpot $0 | Bingo $0 | Fortune $0 | Tax $0
Board [2d 9c 9d]
Seat 1: 99af2b58 (button) won ($0.36)
Seat 2: Hero (small blind) folded before Flop
Seat 3: 8c6d38f2 (big blind) folded before Flop
Seat 4: 8023de0f folded before Flop (didn't bet)
Seat 5: 418289b0 folded on the Flop
Seat 6: 85a41100 folded before Flop (didn't bet)


Poker Hand #RC3334442655: Hold'em No Limit ($0.02/$0.05) - 2025/02/17 20:47:29
Table 'RushAndCash607915' 6-max Seat #1 is the button
Seat 1: 4abcea5e ($5.7 in chips)
Seat 2: 69c3afd2 ($6.96 in chips)
Seat 3: Hero ($8.14 in chips)
Seat 4: 7e8993bd ($4.39 in chips)
Seat 5: f0d238ad ($10.54 in chips)
Seat 6: 886c894a ($9.8 in chips)
69c3afd2: posts small blind $0.02
Hero: posts big blind $0.05
*** HOLE CARDS ***
Dealt to 4abcea5e 
Dealt to 69c3afd2 
Dealt to Hero [3c As]
Dealt to 7e8993bd 
Dealt to f0d238ad 
Dealt to 886c894a 
7e8993bd: folds
f0d238ad: folds
886c894a: folds
4abcea5e: folds
69c3afd2: folds
Uncalled bet ($0.03) returned to Hero
*** SHOWDOWN ***
Hero collected $0.04 from pot
*** SUMMARY ***
Total pot $0.04 | Rake $0 | Jackpot $0 | Bingo $0 | Fortune $0 | Tax $0
Seat 1: 4abcea5e (button) folded before Flop (didn't bet)
Seat 2: 69c3afd2 (small blind) folded before Flop
Seat 3: Hero (big blind) collected ($0.04)
Seat 4: 7e8993bd folded before Flop (didn't bet)
Seat 5: f0d238ad folded before Flop (didn't bet)
Seat 6: 886c894a folded before Flop (didn't bet)


Poker Hand #RC3334442253: Hold'em No Limit ($0.02/$0.05) - 2025/02/17 20:46:29
Table 'RushAndCash607513' 6-max Seat #1 is the button
Seat 1: 69c3afd2 ($6.53 in chips)
Seat 2: 188c8947 ($5.92 in chips)
Seat 3: 74f9576e ($5 in chips)
Seat 4: b59fc0b9 ($5.02 in chips)
Seat 5: Hero ($8.38 in chips)
Seat 6: 45d33c76 ($8.52 in chips)
188c8947: posts small blind $0.02
74f9576e: posts big blind $0.05
*** HOLE CARDS ***
Dealt to 69c3afd2 
Dealt to 188c8947 
Dealt to 74f9576e 
Dealt to b59fc0b9 
Dealt to Hero [6h 7h]
Dealt to 45d33c76 
b59fc0b9: raises $0.05 to $0.1
Hero: calls $0.1
45d33c76: folds
69c3afd2: calls $0.1
188c8947: folds
74f9576e: calls $0.05
*** FLOP *** [Th Kh 3s]
74f9576e: checks
b59fc0b9: checks
Hero: checks
69c3afd2: bets $0.14
74f9576e: folds
b59fc0b9: folds
Hero: calls $0.14
*** TURN *** [Th Kh 3s] [9c]
Hero: checks
69c3afd2: bets $0.35
Hero: folds
Uncalled bet ($0.35) returned to 69c3afd2
*** SHOWDOWN ***
69c3afd2 collected $0.67 from pot
*** SUMMARY ***
Total pot $0.7 | Rake $0.03 | Jackpot $0 | Bingo $0 | Fortune $0 | Tax $0
Board [Th Kh 3s 9c]
Seat 1: 69c3afd2 (button) won ($0.67)
Seat 2: 188c8947 (small blind) folded before Flop
Seat 3: 74f9576e (big blind) folded on the Flop
Seat 4: b59fc0b9 folded on the Flop
Seat 5: Hero folded on the Turn
Seat 6: 45d33c76 folded before Flop (didn't bet)


Poker Hand #RC3334442237: Hold'em No Limit ($0.02/$0.05) - 2025/02/17 20:46:26
Table 'RushAndCash607497' 6-max Seat #1 is the button
Seat 1: e8992002 ($6.45 in chips)
Seat 2: 65964033 ($5.55 in chips)
Seat 3: 3c12c5d8 ($5 in chips)
Seat 4: Hero ($8.38 in chips)
Seat 5: 3ffd6491 ($5.8 in chips)
Seat 6: 8a220c5 ($3.53 in chips)
65964033: posts small blind $0.02
3c12c5d8: posts big blind $0.05
*** HOLE CARDS ***
Dealt to e8992002 
Dealt to 65964033 
Dealt to 3c12c5d8 
Dealt to Hero [4h Js]
Dealt to 3ffd6491 
Dealt to 8a220c5 
Hero: folds
3ffd6491: folds
8a220c5: folds
e8992002: folds
65964033: folds
Uncalled bet ($0.03) returned to 3c12c5d8
*** SHOWDOWN ***
3c12c5d8 collected $0.04 from pot
*** SUMMARY ***
Total pot $0.04 | Rake $0 | Jackpot $0 | Bingo $0 | Fortune $0 | Tax $0
Seat 1: e8992002 (button) folded before Flop (didn't bet)
Seat 2: 65964033 (small blind) folded before Flop
Seat 3: 3c12c5d8 (big blind) collected ($0.04)
Seat 4: Hero folded before Flop (didn't bet)
Seat 5: 3ffd6491 folded before Flop (didn't bet)
Seat 6: 8a220c5 folded before Flop (didn't bet)


Poker Hand #RC3334442217: Hold'em No Limit ($0.02/$0.05) - 2025/02/17 20:46:22
Table 'RushAndCash607477' 6-max Seat #1 is the button
Seat 1: 742ccfee ($3.51 in chips)
Seat 2: 1696890b ($4.95 in chips)
Seat 3: 191b60c1 ($13.1 in chips)
Seat 4: Hero ($8.38 in chips)
Seat 5: aac5b60f ($4.6 in chips)
Seat 6: 6e885b98 ($5.12 in chips)
1696890b: posts small blind $0.02
191b60c1: posts big blind $0.05
*** HOLE CARDS ***
Dealt to 742ccfee 
Dealt to 1696890b 
Dealt to 191b60c1 
Dealt to Hero [8d Jd]
Dealt to aac5b60f 
Dealt to 6e885b98 
Hero: folds
aac5b60f: folds
6e885b98: folds
742ccfee: folds
1696890b: raises $0.1 to $0.15
191b60c1: folds
Uncalled bet ($0.1) returned to 1696890b
*** SHOWDOWN ***
1696890b collected $0.1 from pot
*** SUMMARY ***
Total pot $0.1 | Rake $0 | Jackpot $0 | Bingo $0 | Fortune $0 | Tax $0
Seat 1: 742ccfee (button) folded before Flop (didn't bet)
Seat 2: 1696890b (small blind) collected ($0.1)
Seat 3: 191b60c1 (big blind) folded before Flop
Seat 4: Hero folded before Flop (didn't bet)
Seat 5: aac5b60f folded before Flop (didn't bet)
Seat 6: 6e885b98 folded before Flop (didn't bet)


Poker Hand #RC3334442194: Hold'em No Limit ($0.02/$0.05) - 2025/02/17 20:46:19
Table 'RushAndCash607454' 6-max Seat #1 is the button
Seat 1: Hero ($8.38 in chips)
Seat 2: 32d40ce0 ($5.85 in chips)
Seat 3: 6650c8cb ($13.11 in chips)
Seat 4: 17d82e36 ($4.97 in chips)
Seat 5: f0600331 ($5 in chips)
Seat 6: 651cc52f ($2.84 in chips)
32d40ce0: posts small blind $0.02
6650c8cb: posts big blind $0.05
*** HOLE CARDS ***
Dealt to Hero [5h 2s]
Dealt to 32d40ce0 
Dealt to 6650c8cb 
Dealt to 17d82e36 
Dealt to f0600331 
Dealt to 651cc52f 
17d82e36: folds
f0600331: raises $0.08 to $0.13
651cc52f: folds
Hero: folds
32d40ce0: folds
6650c8cb: folds
Uncalled bet ($0.08) returned to f0600331
*** SHOWDOWN ***
f0600331 collected $0.12 from pot
*** SUMMARY ***
Total pot $0.12 | Rake $0 | Jackpot $0 | Bingo $0 | Fortune $0 | Tax $0
Seat 1: Hero (button) folded before Flop (didn't bet)
Seat 2: 32d40ce0 (small blind) folded before Flop
Seat 3: 6650c8cb (big blind) folded before Flop
Seat 4: 17d82e36 folded before Flop (didn't bet)
Seat 5: f0600331 collected ($0.12)
Seat 6: 651cc52f folded before Flop (didn't bet)


Poker Hand #RC3334442173: Hold'em No Limit ($0.02/$0.05) - 2025/02/17 20:46:16
Table 'RushAndCash607433' 6-max Seat #1 is the button
Seat 1: 4f7979c7 ($6.35 in chips)
Seat 2: 80b2520f ($5.47 in chips)
Seat 3: fe374609 ($4.97 in chips)
Seat 4: 4e3c3196 ($29.09 in chips)
Seat 5: c826a560 ($5.84 in chips)
Seat 6: Hero ($8.38 in chips)
80b2520f: posts small blind $0.02
fe374609: posts big blind $0.05
*** HOLE CARDS ***
Dealt to 4f7979c7 
Dealt to 80b2520f 
Dealt to fe374609 
Dealt to 4e3c3196 
Dealt to c826a560 
Dealt to Hero [8c Qs]
4e3c3196: folds
c826a560: folds
Hero: folds
4f7979c7: folds
80b2520f: raises $0.1 to $0.15
fe374609: calls $0.1
*** FLOP *** [6c 9c Ad]
80b2520f: checks
fe374609: checks
*** TURN *** [6c 9c Ad] [4d]
80b2520f: checks
fe374609: checks
*** RIVER *** [6c 9c Ad 4d] [3c]
80b2520f: checks
fe374609: checks
80b2520f: shows [6d 3d] (Pair of Sixes and Pair of Treys)
fe374609: shows [8d Qc] (Ace-High)
*** SHOWDOWN ***
80b2520f collected $0.29 from pot
*** SUMMARY ***
Total pot $0.3 | Rake $0.01 | Jackpot $0 | Bingo $0 | Fortune $0 | Tax $0
Board [6c 9c Ad 4d 3c]
Seat 1: 4f7979c7 (button) folded before Flop (didn't bet)
Seat 2: 80b2520f (small blind) showed [6d 3d] and won ($0.29) with Pair of Sixes and Pair of Treys
Seat 3: fe374609 (big blind) showed [8d Qc] and lost with Ace-High
Seat 4: 4e3c3196 folded before Flop (didn't bet)
Seat 5: c826a560 folded before Flop (didn't bet)
Seat 6: Hero folded before Flop (didn't bet)


Poker Hand #RC3334442109: Hold'em No Limit ($0.02/$0.05) - 2025/02/17 20:46:06
Table 'RushAndCash607369' 6-max Seat #1 is the button
Seat 1: 38d2fc1e ($5.82 in chips)
Seat 2: f83d0c9c ($6.09 in chips)
Seat 3: Hero ($8.43 in chips)
Seat 4: dfe61c13 ($4.29 in chips)
Seat 5: 5a53cba2 ($5.13 in chips)
Seat 6: 87d5083b ($21.61 in chips)
f83d0c9c: posts small blind $0.02
Hero: posts big blind $0.05
*** HOLE CARDS ***
Dealt to 38d2fc1e 
Dealt to f83d0c9c 
Dealt to Hero [7d Td]
Dealt to dfe61c13 
Dealt to 5a53cba2 
Dealt to 87d5083b 
dfe61c13: folds
5a53cba2: folds
87d5083b: folds
38d2fc1e: raises $0.05 to $0.1
f83d0c9c: raises $0.25 to $0.35
Hero: folds
38d2fc1e: calls $0.25
*** FLOP *** [Tc 3s Qh]
f83d0c9c: checks
38d2fc1e: checks
*** TURN *** [Tc 3s Qh] [9s]
f83d0c9c: bets $0.6
38d2fc1e: folds
Uncalled bet ($0.6) returned to f83d0c9c
*** SHOWDOWN ***
f83d0c9c collected $0.72 from pot
*** SUMMARY ***
Total pot $0.75 | Rake $0.03 | Jackpot $0 | Bingo $0 | Fortune $0 | Tax $0
Board [Tc 3s Qh 9s]
Seat 1: 38d2fc1e (button) folded on the Turn
Seat 2: f83d0c9c (small blind) won ($0.72)
Seat 3: Hero (big blind) folded before Flop
Seat 4: dfe61c13 folded before Flop (didn't bet)
Seat 5: 5a53cba2 folded before Flop (didn't bet)
Seat 6: 87d5083b folded before Flop (didn't bet)


Poker Hand #RC3334442085: Hold'em No Limit ($0.02/$0.05) - 2025/02/17 20:46:02
Table 'RushAndCash607345' 6-max Seat #1 is the button
Seat 1: 9864109b ($5.37 in chips)
Seat 2: 4e3c3196 ($29.16 in chips)
Seat 3: 5abd227b ($6.02 in chips)
Seat 4: d51a15ca ($7 in chips)
Seat 5: 151b0c91 ($6.36 in chips)
Seat 6: Hero ($8.43 in chips)
4e3c3196: posts small blind $0.02
5abd227b: posts big blind $0.05
*** HOLE CARDS ***
Dealt to 9864109b 
Dealt to 4e3c3196 
Dealt to 5abd227b 
Dealt to d51a15ca 
Dealt to 151b0c91 
Dealt to Hero [7d 2s]
d51a15ca: folds
151b0c91: folds
Hero: folds
9864109b: folds
4e3c3196: folds
Uncalled bet ($0.03) returned to 5abd227b
*** SHOWDOWN ***
5abd227b collected $0.04 from pot
*** SUMMARY ***
Total pot $0.04 | Rake $0 | Jackpot $0 | Bingo $0 | Fortune $0 | Tax $0
Seat 1: 9864109b (button) folded before Flop (didn't bet)
Seat 2: 4e3c3196 (small blind) folded before Flop
Seat 3: 5abd227b (big blind) collected ($0.04)
Seat 4: d51a15ca folded before Flop (didn't bet)
Seat 5: 151b0c91 folded before Flop (didn't bet)
Seat 6: Hero folded before Flop (didn't bet)


Poker Hand #RC3334442067: Hold'em No Limit ($0.02/$0.05) - 2025/02/17 20:45:59
Table 'RushAndCash607327' 6-max Seat #1 is the button
Seat 1: 18af90c ($11.64 in chips)
Seat 2: bda9ba33 ($4.27 in chips)
Seat 3: 143ede8b ($7.01 in chips)
Seat 4: 42fca4f9 ($7.68 in chips)
Seat 5: 79df293 ($5.26 in chips)
Seat 6: Hero ($8.43 in chips)
bda9ba33: posts small blind $0.02
143ede8b: posts big blind $0.05
*** HOLE CARDS ***
Dealt to 18af90c 
Dealt to bda9ba33 
Dealt to 143ede8b 
Dealt to 42fca4f9 
Dealt to 79df293 
Dealt to Hero [5h Ah]
42fca4f9: folds
79df293: folds
Hero: folds
18af90c: raises $0.08 to $0.13
bda9ba33: folds
143ede8b: folds
Uncalled bet ($0.08) returned to 18af90c
*** SHOWDOWN ***
18af90c collected $0.12 from pot
*** SUMMARY ***
Total pot $0.12 | Rake $0 | Jackpot $0 | Bingo $0 | Fortune $0 | Tax $0
Seat 1: 18af90c (button) collected ($0.12)
Seat 2: bda9ba33 (small blind) folded before Flop
Seat 3: 143ede8b (big blind) folded before Flop
Seat 4: 42fca4f9 folded before Flop (didn't bet)
Seat 5: 79df293 folded before Flop (didn't bet)
Seat 6: Hero folded before Flop (didn't bet)


Poker Hand #RC3334441955: Hold'em No Limit ($0.02/$0.05) - 2025/02/17 20:45:43
Table 'RushAndCash607215' 6-max Seat #1 is the button
Seat 1: 20e2d62 ($5 in chips)
Seat 2: Hero ($8.38 in chips)
Seat 3: e632d40b ($6.1 in chips)
Seat 4: c806dd25 ($6.04 in chips)
Seat 5: 9ad74e07 ($5.12 in chips)
Seat 6: 90fb5891 ($8.54 in chips)
Hero: posts small blind $0.02
e632d40b: posts big blind $0.05
*** HOLE CARDS ***
Dealt to 20e2d62 
Dealt to Hero [4d 4c]
Dealt to e632d40b 
Dealt to c806dd25 
Dealt to 9ad74e07 
Dealt to 90fb5891 
c806dd25: folds
9ad74e07: folds
90fb5891: folds
20e2d62: folds
Hero: calls $0.03
e632d40b: checks
*** FLOP *** [3c Ac Jc]
Hero: bets $0.05
e632d40b: folds
Uncalled bet ($0.05) returned to Hero
*** SHOWDOWN ***
Hero collected $0.1 from pot
*** SUMMARY ***
Total pot $0.1 | Rake $0 | Jackpot $0 | Bingo $0 | Fortune $0 | Tax $0
Board [3c Ac Jc]
Seat 1: 20e2d62 (button) folded before Flop (didn't bet)
Seat 2: Hero (small blind) won ($0.1)
Seat 3: e632d40b (big blind) folded on the Flop
Seat 4: c806dd25 folded before Flop (didn't bet)
Seat 5: 9ad74e07 folded before Flop (didn't bet)
Seat 6: 90fb5891 folded before Flop (didn't bet)


Poker Hand #RC3334441926: Hold'em No Limit ($0.02/$0.05) - 2025/02/17 20:45:38
Table 'RushAndCash607186' 6-max Seat #1 is the button
Seat 1: Hero ($8.38 in chips)
Seat 2: af8ce89c ($3.39 in chips)
Seat 3: 886c894a ($10.32 in chips)
Seat 4: 90a78ad4 ($1.77 in chips)
Seat 5: b940aa44 ($10.23 in chips)
Seat 6: 83cc7f46 ($2.64 in chips)
af8ce89c: posts small blind $0.02
886c894a: posts big blind $0.05
*** HOLE CARDS ***
Dealt to Hero [4s Qh]
Dealt to af8ce89c 
Dealt to 886c894a 
Dealt to 90a78ad4 
Dealt to b940aa44 
Dealt to 83cc7f46 
90a78ad4: folds
b940aa44: folds
83cc7f46: folds
Hero: folds
af8ce89c: folds
Uncalled bet ($0.03) returned to 886c894a
*** SHOWDOWN ***
886c894a collected $0.04 from pot
*** SUMMARY ***
Total pot $0.04 | Rake $0 | Jackpot $0 | Bingo $0 | Fortune $0 | Tax $0
Seat 1: Hero (button) folded before Flop (didn't bet)
Seat 2: af8ce89c (small blind) folded before Flop
Seat 3: 886c894a (big blind) collected ($0.04)
Seat 4: 90a78ad4 folded before Flop (didn't bet)
Seat 5: b940aa44 folded before Flop (didn't bet)
Seat 6: 83cc7f46 folded before Flop (didn't bet)


Poker Hand #RC3334441900: Hold'em No Limit ($0.02/$0.05) - 2025/02/17 20:45:34
Table 'RushAndCash607160' 6-max Seat #1 is the button
Seat 1: 22a3f0e8 ($5.06 in chips)
Seat 2: fa7bb2c5 ($5 in chips)
Seat 3: f3f5406e ($16.45 in chips)
Seat 4: 80b2520f ($5.52 in chips)
Seat 5: c1784884 ($9.47 in chips)
Seat 6: Hero ($8.38 in chips)
fa7bb2c5: posts small blind $0.02
f3f5406e: posts big blind $0.05
*** HOLE CARDS ***
Dealt to 22a3f0e8 
Dealt to fa7bb2c5 
Dealt to f3f5406e 
Dealt to 80b2520f 
Dealt to c1784884 
Dealt to Hero [Td Qh]
80b2520f: folds
c1784884: raises $0.05 to $0.1
Hero: folds
22a3f0e8: folds
fa7bb2c5: folds
f3f5406e: folds
Uncalled bet ($0.05) returned to c1784884
*** SHOWDOWN ***
c1784884 collected $0.12 from pot
*** SUMMARY ***
Total pot $0.12 | Rake $0 | Jackpot $0 | Bingo $0 | Fortune $0 | Tax $0
Seat 1: 22a3f0e8 (button) folded before Flop (didn't bet)
Seat 2: fa7bb2c5 (small blind) folded before Flop
Seat 3: f3f5406e (big blind) folded before Flop
Seat 4: 80b2520f folded before Flop (didn't bet)
Seat 5: c1784884 collected ($0.12)
Seat 6: Hero folded before Flop (didn't bet)


Poker Hand #RC3334441879: Hold'em No Limit ($0.02/$0.05) - 2025/02/17 20:45:31
Table 'RushAndCash607139' 6-max Seat #1 is the button
Seat 1: Hero ($8.38 in chips)
Seat 2: 1e4e1a58 ($6.88 in chips)
Seat 3: 5c8c19b7 ($10.68 in chips)
Seat 4: 2dba12ed ($5.09 in chips)
Seat 5: 51f33dae ($26.6 in chips)
Seat 6: d1cd1071 ($14.45 in chips)
1e4e1a58: posts small blind $0.02
5c8c19b7: posts big blind $0.05
*** HOLE CARDS ***
Dealt to Hero [Qh 4s]
Dealt to 1e4e1a58 
Dealt to 5c8c19b7 
Dealt to 2dba12ed 
Dealt to 51f33dae 
Dealt to d1cd1071 
2dba12ed: raises $0.05 to $0.1
51f33dae: folds
d1cd1071: raises $0.25 to $0.35
Hero: folds
1e4e1a58: folds
5c8c19b7: calls $0.3
2dba12ed: folds
*** FLOP *** [5s 6d Kh]
5c8c19b7: checks
d1cd1071: bets $0.29
5c8c19b7: calls $0.29
*** TURN *** [5s 6d Kh] [4d]
5c8c19b7: checks
d1cd1071: checks
*** RIVER *** [5s 6d Kh 4d] [9s]
5c8c19b7: checks
d1cd1071: checks
5c8c19b7: shows [Jd Js] (Pair of Jacks)
d1cd1071: shows [Qs As] (Ace-High)
*** SHOWDOWN ***
5c8c19b7 collected $1.33 from pot
*** SUMMARY ***
Total pot $1.4 | Rake $0.07 | Jackpot $0 | Bingo $0 | Fortune $0 | Tax $0
Board [5s 6d Kh 4d 9s]
Seat 1: Hero (button) folded before Flop (didn't bet)
Seat 2: 1e4e1a58 (small blind) folded before Flop
Seat 3: 5c8c19b7 (big blind) showed [Jd Js] and won ($1.33) with Pair of Jacks
Seat 4: 2dba12ed folded before Flop
Seat 5: 51f33dae folded before Flop (didn't bet)
Seat 6: d1cd1071 showed [Qs As] and lost with Ace-High


Poker Hand #RC3334441859: Hold'em No Limit ($0.02/$0.05) - 2025/02/17 20:45:27
Table 'RushAndCash607119' 6-max Seat #1 is the button
Seat 1: e92b360e ($14.93 in chips)
Seat 2: 99df5763 ($6.2 in chips)
Seat 3: 9dba8a1e ($5 in chips)
Seat 4: dcee0577 ($7.54 in chips)
Seat 5: Hero ($8.38 in chips)
Seat 6: 20e2d62 ($5.05 in chips)
99df5763: posts small blind $0.02
9dba8a1e: posts big blind $0.05
*** HOLE CARDS ***
Dealt to e92b360e 
Dealt to 99df5763 
Dealt to 9dba8a1e 
Dealt to dcee0577 
Dealt to Hero [9c 5h]
Dealt to 20e2d62 
dcee0577: folds
Hero: folds
20e2d62: folds
e92b360e: folds
99df5763: raises $0.12 to $0.17
9dba8a1e: folds
Uncalled bet ($0.12) returned to 99df5763
*** SHOWDOWN ***
99df5763 collected $0.1 from pot
*** SUMMARY ***
Total pot $0.1 | Rake $0 | Jackpot $0 | Bingo $0 | Fortune $0 | Tax $0
Seat 1: e92b360e (button) folded before Flop (didn't bet)
Seat 2: 99df5763 (small blind) collected ($0.1)
Seat 3: 9dba8a1e (big blind) folded before Flop
Seat 4: dcee0577 folded before Flop (didn't bet)
Seat 5: Hero folded before Flop (didn't bet)
Seat 6: 20e2d62 folded before Flop (didn't bet)


Poker Hand #RC3334441841: Hold'em No Limit ($0.02/$0.05) - 2025/02/17 20:45:24
Table 'RushAndCash607101' 6-max Seat #1 is the button
Seat 1: 6be17d4e ($5.57 in chips)
Seat 2: e92b360e ($14.95 in chips)
Seat 3: c3b473c1 ($5.12 in chips)
Seat 4: a223d3ca ($5.72 in chips)
Seat 5: 8a2a3713 ($3.96 in chips)
Seat 6: Hero ($8.38 in chips)
e92b360e: posts small blind $0.02
c3b473c1: posts big blind $0.05
*** HOLE CARDS ***
Dealt to 6be17d4e 
Dealt to e92b360e 
Dealt to c3b473c1 
Dealt to a223d3ca 
Dealt to 8a2a3713 
Dealt to Hero [Ac 8h]
a223d3ca: folds
8a2a3713: raises $0.06 to $0.11
Hero: folds
6be17d4e: folds
e92b360e: folds
c3b473c1: folds
Uncalled bet ($0.06) returned to 8a2a3713
*** SHOWDOWN ***
8a2a3713 collected $0.12 from pot
*** SUMMARY ***
Total pot $0.12 | Rake $0 | Jackpot $0 | Bingo $0 | Fortune $0 | Tax $0
Seat 1: 6be17d4e (button) folded before Flop (didn't bet)
Seat 2: e92b360e (small blind) folded before Flop
Seat 3: c3b473c1 (big blind) folded before Flop
Seat 4: a223d3ca folded before Flop (didn't bet)
Seat 5: 8a2a3713 collected ($0.12)
Seat 6: Hero folded before Flop (didn't bet)


Poker Hand #RC3334441713: Hold'em No Limit ($0.02/$0.05) - 2025/02/17 20:45:06
Table 'RushAndCash606973' 6-max Seat #1 is the button
Seat 1: e9c5dfd7 ($8.72 in chips)
Seat 2: Hero ($8.53 in chips)
Seat 3: 9b99e93a ($11.47 in chips)
Seat 4: d51a15ca ($6.79 in chips)
Seat 5: 130fc8d7 ($16.59 in chips)
Seat 6: fdbac393 ($5.77 in chips)
Hero: posts small blind $0.02
9b99e93a: posts big blind $0.05
*** HOLE CARDS ***
Dealt to e9c5dfd7 
Dealt to Hero [6s 5s]
Dealt to 9b99e93a 
Dealt to d51a15ca 
Dealt to 130fc8d7 
Dealt to fdbac393 
d51a15ca: raises $0.1 to $0.15
130fc8d7: folds
fdbac393: folds
e9c5dfd7: folds
Hero: calls $0.13
9b99e93a: calls $0.1
*** FLOP *** [8h Tc Ad]
Hero: checks
9b99e93a: checks
d51a15ca: bets $0.23
Hero: folds
9b99e93a: folds
Uncalled bet ($0.23) returned to d51a15ca
*** SHOWDOWN ***
d51a15ca collected $0.43 from pot
*** SUMMARY ***
Total pot $0.45 | Rake $0.02 | Jackpot $0 | Bingo $0 | Fortune $0 | Tax $0
Board [8h Tc Ad]
Seat 1: e9c5dfd7 (button) folded before Flop (didn't bet)
Seat 2: Hero (small blind) folded on the Flop
Seat 3: 9b99e93a (big blind) folded on the Flop
Seat 4: d51a15ca won ($0.43)
Seat 5: 130fc8d7 folded before Flop (didn't bet)
Seat 6: fdbac393 folded before Flop (didn't bet)


Poker Hand #RC3334441689: Hold'em No Limit ($0.02/$0.05) - 2025/02/17 20:45:02
Table 'RushAndCash606949' 6-max Seat #1 is the button
Seat 1: 2e8ab509 ($5 in chips)
Seat 2: da25c79c ($7.26 in chips)
Seat 3: Hero ($8.58 in chips)
Seat 4: 677c4b25 ($5.07 in chips)
Seat 5: 6c6b017a ($8.31 in chips)
Seat 6: cbfd6c92 ($5.42 in chips)
da25c79c: posts small blind $0.02
Hero: posts big blind $0.05
*** HOLE CARDS ***
Dealt to 2e8ab509 
Dealt to da25c79c 
Dealt to Hero [4d 8s]
Dealt to 677c4b25 
Dealt to 6c6b017a 
Dealt to cbfd6c92 
677c4b25: folds
6c6b017a: folds
cbfd6c92: raises $0.05 to $0.1
2e8ab509: folds
da25c79c: folds
Hero: folds
Uncalled bet ($0.05) returned to cbfd6c92
*** SHOWDOWN ***
cbfd6c92 collected $0.12 from pot
*** SUMMARY ***
Total pot $0.12 | Rake $0 | Jackpot $0 | Bingo $0 | Fortune $0 | Tax $0
Seat 1: 2e8ab509 (button) folded before Flop (didn't bet)
Seat 2: da25c79c (small blind) folded before Flop
Seat 3: Hero (big blind) folded before Flop
Seat 4: 677c4b25 folded before Flop (didn't bet)
Seat 5: 6c6b017a folded before Flop (didn't bet)
Seat 6: cbfd6c92 collected ($0.12)


Poker Hand #RC3334441552: Hold'em No Limit ($0.02/$0.05) - 2025/02/17 20:44:43
Table 'RushAndCash606812' 6-max Seat #1 is the button
Seat 1: Hero ($8.68 in chips)
Seat 2: 1ac52efc ($5 in chips)
Seat 3: e2e9e4d1 ($7.99 in chips)
Seat 4: ae49e9c ($5 in chips)
Seat 5: b6df9c9 ($5.07 in chips)
Seat 6: bac47e2a ($4 in chips)
1ac52efc: posts small blind $0.02
e2e9e4d1: posts big blind $0.05
*** HOLE CARDS ***
Dealt to Hero [Tc Ah]
Dealt to 1ac52efc 
Dealt to e2e9e4d1 
Dealt to ae49e9c 
Dealt to b6df9c9 
Dealt to bac47e2a 
ae49e9c: folds
b6df9c9: folds
bac47e2a: folds
Hero: raises $0.05 to $0.1
1ac52efc: raises $0.25 to $0.35
e2e9e4d1: raises $0.63 to $0.98
Hero: folds
1ac52efc: folds
Uncalled bet ($0.63) returned to e2e9e4d1
*** SHOWDOWN ***
e2e9e4d1 collected $0.76 from pot
*** SUMMARY ***
Total pot $0.8 | Rake $0.04 | Jackpot $0 | Bingo $0 | Fortune $0 | Tax $0
Seat 1: Hero (button) folded before Flop
Seat 2: 1ac52efc (small blind) folded before Flop
Seat 3: e2e9e4d1 (big blind) collected ($0.76)
Seat 4: ae49e9c folded before Flop (didn't bet)
Seat 5: b6df9c9 folded before Flop (didn't bet)
Seat 6: bac47e2a folded before Flop (didn't bet)


Poker Hand #RC3334441331: Hold'em No Limit ($0.02/$0.05) - 2025/02/17 20:44:13
Table 'RushAndCash606591' 6-max Seat #1 is the button
Seat 1: 54884390 ($10.06 in chips)
Seat 2: eaafe260 ($11.54 in chips)
Seat 3: Hero ($8.54 in chips)
Seat 4: 6c8cb957 ($5 in chips)
Seat 5: 803e9f05 ($6.92 in chips)
Seat 6: 54ca1f06 ($6.26 in chips)
eaafe260: posts small blind $0.02
Hero: posts big blind $0.05
*** HOLE CARDS ***
Dealt to 54884390 
Dealt to eaafe260 
Dealt to Hero [2d 2c]
Dealt to 6c8cb957 
Dealt to 803e9f05 
Dealt to 54ca1f06 
6c8cb957: folds
803e9f05: folds
54ca1f06: folds
54884390: raises $0.08 to $0.13
eaafe260: folds
Hero: calls $0.08
*** FLOP *** [2h 5h 6d]
Hero: checks
54884390: checks
*** TURN *** [2h 5h 6d] [7h]
Hero: bets $0.14
54884390: folds
Uncalled bet ($0.14) returned to Hero
*** SHOWDOWN ***
Hero collected $0.27 from pot
*** SUMMARY ***
Total pot $0.28 | Rake $0.01 | Jackpot $0 | Bingo $0 | Fortune $0 | Tax $0
Board [2h 5h 6d 7h]
Seat 1: 54884390 (button) folded on the Turn
Seat 2: eaafe260 (small blind) folded before Flop
Seat 3: Hero (big blind) won ($0.27)
Seat 4: 6c8cb957 folded before Flop (didn't bet)
Seat 5: 803e9f05 folded before Flop (didn't bet)
Seat 6: 54ca1f06 folded before Flop (didn't bet)


Poker Hand #RC3334441246: Hold'em No Limit ($0.02/$0.05) - 2025/02/17 20:44:01
Table 'RushAndCash606506' 6-max Seat #1 is the button
Seat 1: 94cb065d ($7.51 in chips)
Seat 2: 9013f95e ($12.35 in chips)
Seat 3: dc257e7 ($4.33 in chips)
Seat 4: Hero ($8.54 in chips)
Seat 5: d1cd1071 ($14.36 in chips)
Seat 6: f6e684ae ($13.1 in chips)
9013f95e: posts small blind $0.02
dc257e7: posts big blind $0.05
*** HOLE CARDS ***
Dealt to 94cb065d 
Dealt to 9013f95e 
Dealt to dc257e7 
Dealt to Hero [4d 2c]
Dealt to d1cd1071 
Dealt to f6e684ae 
Hero: folds
d1cd1071: folds
f6e684ae: folds
94cb065d: folds
9013f95e: calls $0.03
dc257e7: checks
*** FLOP *** [Qh Qc 3c]
9013f95e: checks
dc257e7: checks
*** TURN *** [Qh Qc 3c] [6s]
9013f95e: checks
dc257e7: bets $0.05
9013f95e: folds
Uncalled bet ($0.05) returned to dc257e7
*** SHOWDOWN ***
dc257e7 collected $0.1 from pot
*** SUMMARY ***
Total pot $0.1 | Rake $0 | Jackpot $0 | Bingo $0 | Fortune $0 | Tax $0
Board [Qh Qc 3c 6s]
Seat 1: 94cb065d (button) folded before Flop (didn't bet)
Seat 2: 9013f95e (small blind) folded on the Turn
Seat 3: dc257e7 (big blind) won ($0.1)
Seat 4: Hero folded before Flop (didn't bet)
Seat 5: d1cd1071 folded before Flop (didn't bet)
Seat 6: f6e684ae folded before Flop (didn't bet)


Poker Hand #RC3334440985: Hold'em No Limit ($0.02/$0.05) - 2025/02/17 20:43:27
Table 'RushAndCash606245' 6-max Seat #1 is the button
Seat 1: 1fa8537 ($5.13 in chips)
Seat 2: Hero ($8.64 in chips)
Seat 3: f6e684ae ($13.01 in chips)
Seat 4: 7fc44808 ($11.42 in chips)
Seat 5: 773fdf96 ($6.54 in chips)
Seat 6: b6df9c9 ($5.21 in chips)
Hero: posts small blind $0.02
f6e684ae: posts big blind $0.05
*** HOLE CARDS ***
Dealt to 1fa8537 
Dealt to Hero [Ah 8h]
Dealt to f6e684ae 
Dealt to 7fc44808 
Dealt to 773fdf96 
Dealt to b6df9c9 
7fc44808: folds
773fdf96: folds
b6df9c9: folds
1fa8537: folds
Hero: calls $0.03
f6e684ae: checks
*** FLOP *** [7d Kh Kd]
Hero: checks
f6e684ae: bets $0.05
Hero: calls $0.05
*** TURN *** [7d Kh Kd] [6d]
Hero: checks
f6e684ae: bets $0.1
Hero: folds
Uncalled bet ($0.1) returned to f6e684ae
*** SHOWDOWN ***
f6e684ae collected $0.19 from pot
*** SUMMARY ***
Total pot $0.2 | Rake $0.01 | Jackpot $0 | Bingo $0 | Fortune $0 | Tax $0
Board [7d Kh Kd 6d]
Seat 1: 1fa8537 (button) folded before Flop (didn't bet)
Seat 2: Hero (small blind) folded on the Turn
Seat 3: f6e684ae (big blind) won ($0.19)
Seat 4: 7fc44808 folded before Flop (didn't bet)
Seat 5: 773fdf96 folded before Flop (didn't bet)
Seat 6: b6df9c9 folded before Flop (didn't bet)


Poker Hand #RC3334440836: Hold'em No Limit ($0.02/$0.05) - 2025/02/17 20:43:07
Table 'RushAndCash606096' 6-max Seat #1 is the button
Seat 1: b6df9c9 ($5.05 in chips)
Seat 2: 8c1b0cdf ($2.53 in chips)
Seat 3: e56ac911 ($3.25 in chips)
Seat 4: c607d475 ($8.49 in chips)
Seat 5: 2b9f39df ($5.12 in chips)
Seat 6: Hero ($8.74 in chips)
8c1b0cdf: posts small blind $0.02
e56ac911: posts big blind $0.05
*** HOLE CARDS ***
Dealt to b6df9c9 
Dealt to 8c1b0cdf 
Dealt to e56ac911 
Dealt to c607d475 
Dealt to 2b9f39df 
Dealt to Hero [4d 5d]
c607d475: folds
2b9f39df: folds
Hero: raises $0.05 to $0.1
b6df9c9: calls $0.1
8c1b0cdf: folds
e56ac911: folds
*** FLOP *** [9c Qh 9d]
Hero: checks
b6df9c9: bets $0.05
Hero: folds
Uncalled bet ($0.05) returned to b6df9c9
*** SHOWDOWN ***
b6df9c9 collected $0.26 from pot
*** SUMMARY ***
Total pot $0.27 | Rake $0.01 | Jackpot $0 | Bingo $0 | Fortune $0 | Tax $0
Board [9c Qh 9d]
Seat 1: b6df9c9 (button) won ($0.26)
Seat 2: 8c1b0cdf (small blind) folded before Flop
Seat 3: e56ac911 (big blind) folded before Flop
Seat 4: c607d475 folded before Flop (didn't bet)
Seat 5: 2b9f39df folded before Flop (didn't bet)
Seat 6: Hero folded on the Flop


Poker Hand #RC3334440781: Hold'em No Limit ($0.02/$0.05) - 2025/02/17 20:43:00
Table 'RushAndCash606041' 6-max Seat #1 is the button
Seat 1: 50053f22 ($5.6 in chips)
Seat 2: 7df4712d ($7.93 in chips)
Seat 3: 803e9f05 ($6.8 in chips)
Seat 4: Hero ($8.74 in chips)
Seat 5: 75091df4 ($8.03 in chips)
Seat 6: 11b91184 ($5.14 in chips)
7df4712d: posts small blind $0.02
803e9f05: posts big blind $0.05
*** HOLE CARDS ***
Dealt to 50053f22 
Dealt to 7df4712d 
Dealt to 803e9f05 
Dealt to Hero [4h Th]
Dealt to 75091df4 
Dealt to 11b91184 
Hero: folds
75091df4: raises $0.05 to $0.1
11b91184: folds
50053f22: folds
7df4712d: folds
803e9f05: folds
Uncalled bet ($0.05) returned to 75091df4
*** SHOWDOWN ***
75091df4 collected $0.12 from pot
*** SUMMARY ***
Total pot $0.12 | Rake $0 | Jackpot $0 | Bingo $0 | Fortune $0 | Tax $0
Seat 1: 50053f22 (button) folded before Flop (didn't bet)
Seat 2: 7df4712d (small blind) folded before Flop
Seat 3: 803e9f05 (big blind) folded before Flop
Seat 4: Hero folded before Flop (didn't bet)
Seat 5: 75091df4 collected ($0.12)
Seat 6: 11b91184 folded before Flop (didn't bet)


Poker Hand #RC3334440756: Hold'em No Limit ($0.02/$0.05) - 2025/02/17 20:42:57
Table 'RushAndCash606016' 6-max Seat #1 is the button
Seat 1: Hero ($8.74 in chips)
Seat 2: 18cb11a ($5.92 in chips)
Seat 3: 6662e866 ($16.26 in chips)
Seat 4: 85a41100 ($5.1 in chips)
Seat 5: 673e17b3 ($5 in chips)
Seat 6: e56ac911 ($3.25 in chips)
18cb11a: posts small blind $0.02
6662e866: posts big blind $0.05
*** HOLE CARDS ***
Dealt to Hero [9d Tc]
Dealt to 18cb11a 
Dealt to 6662e866 
Dealt to 85a41100 
Dealt to 673e17b3 
Dealt to e56ac911 
85a41100: folds
673e17b3: raises $0.06 to $0.11
e56ac911: folds
Hero: folds
18cb11a: folds
6662e866: folds
Uncalled bet ($0.06) returned to 673e17b3
*** SHOWDOWN ***
673e17b3 collected $0.12 from pot
*** SUMMARY ***
Total pot $0.12 | Rake $0 | Jackpot $0 | Bingo $0 | Fortune $0 | Tax $0
Seat 1: Hero (button) folded before Flop (didn't bet)
Seat 2: 18cb11a (small blind) folded before Flop
Seat 3: 6662e866 (big blind) folded before Flop
Seat 4: 85a41100 folded before Flop (didn't bet)
Seat 5: 673e17b3 collected ($0.12)
Seat 6: e56ac911 folded before Flop (didn't bet)


Poker Hand #RC3334440730: Hold'em No Limit ($0.02/$0.05) - 2025/02/17 20:42:54
Table 'RushAndCash605990' 6-max Seat #1 is the button
Seat 1: 3dbbdac8 ($5.25 in chips)
Seat 2: c3b473c1 ($5.13 in chips)
Seat 3: a28ca95c ($18.72 in chips)
Seat 4: 6aa0c391 ($5 in chips)
Seat 5: Hero ($8.74 in chips)
Seat 6: 8dbd0a2d ($5.06 in chips)
c3b473c1: posts small blind $0.02
a28ca95c: posts big blind $0.05
*** HOLE CARDS ***
Dealt to 3dbbdac8 
Dealt to c3b473c1 
Dealt to a28ca95c 
Dealt to 6aa0c391 
Dealt to Hero [6h Jd]
Dealt to 8dbd0a2d 
6aa0c391: raises $0.08 to $0.13
Hero: folds
8dbd0a2d: folds
3dbbdac8: folds
c3b473c1: folds
a28ca95c: folds
Uncalled bet ($0.08) returned to 6aa0c391
*** SHOWDOWN ***
6aa0c391 collected $0.12 from pot
*** SUMMARY ***
Total pot $0.12 | Rake $0 | Jackpot $0 | Bingo $0 | Fortune $0 | Tax $0
Seat 1: 3dbbdac8 (button) folded before Flop (didn't bet)
Seat 2: c3b473c1 (small blind) folded before Flop
Seat 3: a28ca95c (big blind) folded before Flop
Seat 4: 6aa0c391 collected ($0.12)
Seat 5: Hero folded before Flop (didn't bet)
Seat 6: 8dbd0a2d folded before Flop (didn't bet)


Poker Hand #RC3334440706: Hold'em No Limit ($0.02/$0.05) - 2025/02/17 20:42:51
Table 'RushAndCash605966' 6-max Seat #1 is the button
Seat 1: dbb7a28 ($11.79 in chips)
Seat 2: 4238ab48 ($3.75 in chips)
Seat 3: Hero ($8.79 in chips)
Seat 4: 88f21ca8 ($6.05 in chips)
Seat 5: 4190d158 ($11.36 in chips)
Seat 6: 16b0b958 ($5.47 in chips)
4238ab48: posts small blind $0.02
Hero: posts big blind $0.05
*** HOLE CARDS ***
Dealt to dbb7a28 
Dealt to 4238ab48 
Dealt to Hero [2s 9h]
Dealt to 88f21ca8 
Dealt to 4190d158 
Dealt to 16b0b958 
88f21ca8: raises $0.05 to $0.1
4190d158: folds
16b0b958: folds
dbb7a28: folds
4238ab48: folds
Hero: folds
Uncalled bet ($0.05) returned to 88f21ca8
*** SHOWDOWN ***
88f21ca8 collected $0.12 from pot
*** SUMMARY ***
Total pot $0.12 | Rake $0 | Jackpot $0 | Bingo $0 | Fortune $0 | Tax $0
Seat 1: dbb7a28 (button) folded before Flop (didn't bet)
Seat 2: 4238ab48 (small blind) folded before Flop
Seat 3: Hero (big blind) folded before Flop
Seat 4: 88f21ca8 collected ($0.12)
Seat 5: 4190d158 folded before Flop (didn't bet)
Seat 6: 16b0b958 folded before Flop (didn't bet)


Poker Hand #RC3334440619: Hold'em No Limit ($0.02/$0.05) - 2025/02/17 20:42:40
Table 'RushAndCash605879' 6-max Seat #1 is the button
Seat 1: ead6cfaf ($5 in chips)
Seat 2: 88f21ca8 ($6.07 in chips)
Seat 3: 1aca371e ($8.67 in chips)
Seat 4: Hero ($8.72 in chips)
Seat 5: 50053f22 ($5.6 in chips)
Seat 6: 1d0217bc ($14.37 in chips)
88f21ca8: posts small blind $0.02
1aca371e: posts big blind $0.05
*** HOLE CARDS ***
Dealt to ead6cfaf 
Dealt to 88f21ca8 
Dealt to 1aca371e 
Dealt to Hero [5d 6d]
Dealt to 50053f22 
Dealt to 1d0217bc 
Hero: raises $0.05 to $0.1
50053f22: folds
1d0217bc: folds
ead6cfaf: folds
88f21ca8: folds
1aca371e: folds
Uncalled bet ($0.05) returned to Hero
*** SHOWDOWN ***
Hero collected $0.12 from pot
*** SUMMARY ***
Total pot $0.12 | Rake $0 | Jackpot $0 | Bingo $0 | Fortune $0 | Tax $0
Seat 1: ead6cfaf (button) folded before Flop (didn't bet)
Seat 2: 88f21ca8 (small blind) folded before Flop
Seat 3: 1aca371e (big blind) folded before Flop
Seat 4: Hero collected ($0.12)
Seat 5: 50053f22 folded before Flop (didn't bet)
Seat 6: 1d0217bc folded before Flop (didn't bet)


Poker Hand #RC3334440390: Hold'em No Limit ($0.02/$0.05) - 2025/02/17 20:42:07
Table 'RushAndCash605650' 6-max Seat #1 is the button
Seat 1: b282789b ($5 in chips)
Seat 2: Hero ($8.77 in chips)
Seat 3: fe374609 ($5.38 in chips)
Seat 4: 656af102 ($7.11 in chips)
Seat 5: 97fe2676 ($10.64 in chips)
Seat 6: f71f9fc0 ($3.96 in chips)
Hero: posts small blind $0.02
fe374609: posts big blind $0.05
*** HOLE CARDS ***
Dealt to b282789b 
Dealt to Hero [7d 6d]
Dealt to fe374609 
Dealt to 656af102 
Dealt to 97fe2676 
Dealt to f71f9fc0 
656af102: folds
97fe2676: folds
f71f9fc0: folds
b282789b: folds
Hero: calls $0.03
fe374609: checks
*** FLOP *** [Jc 8s 6c]
Hero: checks
fe374609: checks
*** TURN *** [Jc 8s 6c] [Qh]
Hero: checks
fe374609: checks
*** RIVER *** [Jc 8s 6c Qh] [4c]
Hero: checks
fe374609: checks
Hero: shows [7d 6d] (Pair of Sixes)
fe374609: shows [Jd 5c] (Pair of Jacks)
*** SHOWDOWN ***
fe374609 collected $0.1 from pot
*** SUMMARY ***
Total pot $0.1 | Rake $0 | Jackpot $0 | Bingo $0 | Fortune $0 | Tax $0
Board [Jc 8s 6c Qh 4c]
Seat 1: b282789b (button) folded before Flop (didn't bet)
Seat 2: Hero (small blind) showed [7d 6d] and lost with Pair of Sixes
Seat 3: fe374609 (big blind) showed [Jd 5c] and won ($0.1) with Pair of Jacks
Seat 4: 656af102 folded before Flop (didn't bet)
Seat 5: 97fe2676 folded before Flop (didn't bet)
Seat 6: f71f9fc0 folded before Flop (didn't bet)


Poker Hand #RC3334440310: Hold'em No Limit ($0.02/$0.05) - 2025/02/17 20:41:56
Table 'RushAndCash605570' 6-max Seat #1 is the button
Seat 1: 1696890b ($4.27 in chips)
Seat 2: 32d40ce0 ($6.6 in chips)
Seat 3: 5bf5cd50 ($5.54 in chips)
Seat 4: 3dbbdac8 ($5.39 in chips)
Seat 5: 7b6a3077 ($6.89 in chips)
Seat 6: Hero ($8.7 in chips)
32d40ce0: posts small blind $0.02
5bf5cd50: posts big blind $0.05
*** HOLE CARDS ***
Dealt to 1696890b 
Dealt to 32d40ce0 
Dealt to 5bf5cd50 
Dealt to 3dbbdac8 
Dealt to 7b6a3077 
Dealt to Hero [Qs 9d]
3dbbdac8: folds
7b6a3077: folds
Hero: raises $0.05 to $0.1
1696890b: folds
32d40ce0: folds
5bf5cd50: folds
Uncalled bet ($0.05) returned to Hero
*** SHOWDOWN ***
Hero collected $0.12 from pot
*** SUMMARY ***
Total pot $0.12 | Rake $0 | Jackpot $0 | Bingo $0 | Fortune $0 | Tax $0
Seat 1: 1696890b (button) folded before Flop (didn't bet)
Seat 2: 32d40ce0 (small blind) folded before Flop
Seat 3: 5bf5cd50 (big blind) folded before Flop
Seat 4: 3dbbdac8 folded before Flop (didn't bet)
Seat 5: 7b6a3077 folded before Flop (didn't bet)
Seat 6: Hero collected ($0.12)


Poker Hand #RC3334440276: Hold'em No Limit ($0.02/$0.05) - 2025/02/17 20:41:51
Table 'RushAndCash605536' 6-max Seat #1 is the button
Seat 1: 94706c35 ($15.04 in chips)
Seat 2: 16081ce9 ($15.04 in chips)
Seat 3: 1ea0f381 ($4.93 in chips)
Seat 4: 5c64b878 ($5.32 in chips)
Seat 5: 719071b8 ($5.44 in chips)
Seat 6: Hero ($8.7 in chips)
16081ce9: posts small blind $0.02
1ea0f381: posts big blind $0.05
*** HOLE CARDS ***
Dealt to 94706c35 
Dealt to 16081ce9 
Dealt to 1ea0f381 
Dealt to 5c64b878 
Dealt to 719071b8 
Dealt to Hero [5s Kh]
5c64b878: folds
719071b8: folds
Hero: folds
94706c35: folds
16081ce9: raises $0.05 to $0.1
1ea0f381: calls $0.05
*** FLOP *** [Tc 2h Qh]
16081ce9: bets $0.1
1ea0f381: calls $0.1
*** TURN *** [Tc 2h Qh] [5d]
16081ce9: checks
1ea0f381: bets $0.2
16081ce9: folds
Uncalled bet ($0.2) returned to 1ea0f381
*** SHOWDOWN ***
1ea0f381 collected $0.38 from pot
*** SUMMARY ***
Total pot $0.4 | Rake $0.02 | Jackpot $0 | Bingo $0 | Fortune $0 | Tax $0
Board [Tc 2h Qh 5d]
Seat 1: 94706c35 (button) folded before Flop (didn't bet)
Seat 2: 16081ce9 (small blind) folded on the Turn
Seat 3: 1ea0f381 (big blind) won ($0.38)
Seat 4: 5c64b878 folded before Flop (didn't bet)
Seat 5: 719071b8 folded before Flop (didn't bet)
Seat 6: Hero folded before Flop (didn't bet)


Poker Hand #RC3334440231: Hold'em No Limit ($0.02/$0.05) - 2025/02/17 20:41:45
Table 'RushAndCash605491' 6-max Seat #1 is the button
Seat 1: 5fe62400 ($5.22 in chips)
Seat 2: 54fe77bd ($5.16 in chips)
Seat 3: Hero ($8.75 in chips)
Seat 4: 692e3a83 ($11.9 in chips)
Seat 5: d25efca ($5.3 in chips)
Seat 6: ddc28699 ($4.64 in chips)
54fe77bd: posts small blind $0.02
Hero: posts big blind $0.05
*** HOLE CARDS ***
Dealt to 5fe62400 
Dealt to 54fe77bd 
Dealt to Hero [5h 2c]
Dealt to 692e3a83 
Dealt to d25efca 
Dealt to ddc28699 
692e3a83: raises $0.07 to $0.12
d25efca: folds
ddc28699: folds
5fe62400: folds
54fe77bd: calls $0.1
Hero: folds
*** FLOP *** [6h Jd 6d]
54fe77bd: checks
692e3a83: bets $0.1
54fe77bd: calls $0.1
*** TURN *** [6h Jd 6d] [2d]
54fe77bd: checks
692e3a83: bets $0.34
54fe77bd: calls $0.34
*** RIVER *** [6h Jd 6d 2d] [7h]
54fe77bd: checks
692e3a83: bets $0.75
54fe77bd: raises $0.75 to $1.5
692e3a83: calls $0.75
54fe77bd: shows [Kd Qd] (King High Flush)
692e3a83: shows [8d 7d] (Jack High Flush)
*** SHOWDOWN ***
54fe77bd collected $3.95 from pot
*** SUMMARY ***
Total pot $4.17 | Rake $0.15 | Jackpot $0.07 | Bingo $0 | Fortune $0 | Tax $0
Board [6h Jd 6d 2d 7h]
Seat 1: 5fe62400 (button) folded before Flop (didn't bet)
Seat 2: 54fe77bd (small blind) showed [Kd Qd] and won ($3.95) with King High Flush
Seat 3: Hero (big blind) folded before Flop
Seat 4: 692e3a83 showed [8d 7d] and lost with Jack High Flush
Seat 5: d25efca folded before Flop (didn't bet)
Seat 6: ddc28699 folded before Flop (didn't bet)


Poker Hand #RC3334440199: Hold'em No Limit ($0.02/$0.05) - 2025/02/17 20:41:41
Table 'RushAndCash605459' 6-max Seat #1 is the button
Seat 1: Hero ($8.75 in chips)
Seat 2: c95c6ae6 ($17.53 in chips)
Seat 3: 5fd404ad ($5.12 in chips)
Seat 4: c24b20b9 ($18.97 in chips)
Seat 5: 6662e866 ($16.17 in chips)
Seat 6: 6008538 ($3.28 in chips)
c95c6ae6: posts small blind $0.02
5fd404ad: posts big blind $0.05
*** HOLE CARDS ***
Dealt to Hero [6s Js]
Dealt to c95c6ae6 
Dealt to 5fd404ad 
Dealt to c24b20b9 
Dealt to 6662e866 
Dealt to 6008538 
c24b20b9: folds
6662e866: folds
6008538: folds
Hero: folds
c95c6ae6: calls $0.03
5fd404ad: checks
*** FLOP *** [Qh 5d 9h]
c95c6ae6: bets $0.05
5fd404ad: folds
Uncalled bet ($0.05) returned to c95c6ae6
*** SHOWDOWN ***
c95c6ae6 collected $0.1 from pot
*** SUMMARY ***
Total pot $0.1 | Rake $0 | Jackpot $0 | Bingo $0 | Fortune $0 | Tax $0
Board [Qh 5d 9h]
Seat 1: Hero (button) folded before Flop (didn't bet)
Seat 2: c95c6ae6 (small blind) won ($0.1)
Seat 3: 5fd404ad (big blind) folded on the Flop
Seat 4: c24b20b9 folded before Flop (didn't bet)
Seat 5: 6662e866 folded before Flop (didn't bet)
Seat 6: 6008538 folded before Flop (didn't bet)


Poker Hand #RC3334440175: Hold'em No Limit ($0.02/$0.05) - 2025/02/17 20:41:38
Table 'RushAndCash605435' 6-max Seat #1 is the button
Seat 1: 8023de0f ($5.12 in chips)
Seat 2: 3c1ddc3a ($6.32 in chips)
Seat 3: da25c79c ($5.61 in chips)
Seat 4: 29ffb7d5 ($5.73 in chips)
Seat 5: 835df346 ($14.53 in chips)
Seat 6: Hero ($8.75 in chips)
3c1ddc3a: posts small blind $0.02
da25c79c: posts big blind $0.05
*** HOLE CARDS ***
Dealt to 8023de0f 
Dealt to 3c1ddc3a 
Dealt to da25c79c 
Dealt to 29ffb7d5 
Dealt to 835df346 
Dealt to Hero [5c 2d]
29ffb7d5: folds
835df346: raises $0.08 to $0.13
Hero: folds
8023de0f: folds
3c1ddc3a: folds
da25c79c: folds
Uncalled bet ($0.08) returned to 835df346
*** SHOWDOWN ***
835df346 collected $0.12 from pot
*** SUMMARY ***
Total pot $0.12 | Rake $0 | Jackpot $0 | Bingo $0 | Fortune $0 | Tax $0
Seat 1: 8023de0f (button) folded before Flop (didn't bet)
Seat 2: 3c1ddc3a (small blind) folded before Flop
Seat 3: da25c79c (big blind) folded before Flop
Seat 4: 29ffb7d5 folded before Flop (didn't bet)
Seat 5: 835df346 collected ($0.12)
Seat 6: Hero folded before Flop (didn't bet)


Poker Hand #RC3334439936: Hold'em No Limit ($0.02/$0.05) - 2025/02/17 20:41:02
Table 'RushAndCash605196' 6-max Seat #1 is the button
Seat 1: a1fd9df7 ($5.31 in chips)
Seat 2: Hero ($8.87 in chips)
Seat 3: 90fb5891 ($14.46 in chips)
Seat 4: 287f8174 ($6.54 in chips)
Seat 5: 62156df3 ($5.02 in chips)
Seat 6: f3f5406e ($16.58 in chips)
Hero: posts small blind $0.02
90fb5891: posts big blind $0.05
*** HOLE CARDS ***
Dealt to a1fd9df7 
Dealt to Hero [Qs Kc]
Dealt to 90fb5891 
Dealt to 287f8174 
Dealt to 62156df3 
Dealt to f3f5406e 
287f8174: folds
62156df3: folds
f3f5406e: folds
a1fd9df7: raises $0.07 to $0.12
Hero: calls $0.1
90fb5891: folds
*** FLOP *** [4h 8d As]
Hero: checks
a1fd9df7: bets $0.1
Hero: folds
Uncalled bet ($0.1) returned to a1fd9df7
*** SHOWDOWN ***
a1fd9df7 collected $0.28 from pot
*** SUMMARY ***
Total pot $0.29 | Rake $0.01 | Jackpot $0 | Bingo $0 | Fortune $0 | Tax $0
Board [4h 8d As]
Seat 1: a1fd9df7 (button) won ($0.28)
Seat 2: Hero (small blind) folded on the Flop
Seat 3: 90fb5891 (big blind) folded before Flop
Seat 4: 287f8174 folded before Flop (didn't bet)
Seat 5: 62156df3 folded before Flop (didn't bet)
Seat 6: f3f5406e folded before Flop (didn't bet)


Poker Hand #RC3334439701: Hold'em No Limit ($0.02/$0.05) - 2025/02/17 20:40:30
Table 'RushAndCash604961' 6-max Seat #1 is the button
Seat 1: 4e55fa29 ($4.13 in chips)
Seat 2: Hero ($8.67 in chips)
Seat 3: 573eb753 ($6.16 in chips)
Seat 4: e8992002 ($5 in chips)
Seat 5: f71501ed ($5.28 in chips)
Seat 6: 90fb5891 ($14.62 in chips)
Hero: posts small blind $0.02
573eb753: posts big blind $0.05
*** HOLE CARDS ***
Dealt to 4e55fa29 
Dealt to Hero [Ah Th]
Dealt to 573eb753 
Dealt to e8992002 
Dealt to f71501ed 
Dealt to 90fb5891 
e8992002: folds
f71501ed: folds
90fb5891: raises $0.05 to $0.1
4e55fa29: folds
Hero: calls $0.08
573eb753: folds
*** FLOP *** [8d 7h 5s]
Hero: checks
90fb5891: bets $0.06
Hero: calls $0.06
*** TURN *** [8d 7h 5s] [7d]
Hero: checks
90fb5891: checks
*** RIVER *** [8d 7h 5s 7d] [Ac]
Hero: checks
90fb5891: checks
Hero: shows [Ah Th] (Pair of Aces and Pair of Sevens)
90fb5891: shows [Qd Ts] (Pair of Sevens)
*** SHOWDOWN ***
Hero collected $0.36 from pot
*** SUMMARY ***
Total pot $0.37 | Rake $0.01 | Jackpot $0 | Bingo $0 | Fortune $0 | Tax $0
Board [8d 7h 5s 7d Ac]
Seat 1: 4e55fa29 (button) folded before Flop (didn't bet)
Seat 2: Hero (small blind) showed [Ah Th] and won ($0.36) with Pair of Aces and Pair of Sevens
Seat 3: 573eb753 (big blind) folded before Flop
Seat 4: e8992002 folded before Flop (didn't bet)
Seat 5: f71501ed folded before Flop (didn't bet)
Seat 6: 90fb5891 showed [Qd Ts] and lost with Pair of Sevens


Poker Hand #RC3334439598: Hold'em No Limit ($0.02/$0.05) - 2025/02/17 20:40:17
Table 'RushAndCash604858' 6-max Seat #1 is the button
Seat 1: 16f2e5ce ($6.47 in chips)
Seat 2: 180f5daf ($4.6 in chips)
Seat 3: Hero ($8.72 in chips)
Seat 4: 14620cce ($16.21 in chips)
Seat 5: 8012317b ($12.94 in chips)
Seat 6: 1a54a2fc ($5 in chips)
180f5daf: posts small blind $0.02
Hero: posts big blind $0.05
*** HOLE CARDS ***
Dealt to 16f2e5ce 
Dealt to 180f5daf 
Dealt to Hero [Qs Th]
Dealt to 14620cce 
Dealt to 8012317b 
Dealt to 1a54a2fc 
14620cce: folds
8012317b: folds
1a54a2fc: raises $0.08 to $0.13
16f2e5ce: folds
180f5daf: raises $0.31 to $0.44
Hero: folds
1a54a2fc: calls $0.31
*** FLOP *** [Ts Kd Jh]
180f5daf: checks
1a54a2fc: checks
*** TURN *** [Ts Kd Jh] [3h]
180f5daf: checks
1a54a2fc: checks
*** RIVER *** [Ts Kd Jh 3h] [6d]
180f5daf: bets $0.5
1a54a2fc: folds
Uncalled bet ($0.5) returned to 180f5daf
*** SHOWDOWN ***
180f5daf collected $0.89 from pot
*** SUMMARY ***
Total pot $0.93 | Rake $0.04 | Jackpot $0 | Bingo $0 | Fortune $0 | Tax $0
Board [Ts Kd Jh 3h 6d]
Seat 1: 16f2e5ce (button) folded before Flop (didn't bet)
Seat 2: 180f5daf (small blind) won ($0.89)
Seat 3: Hero (big blind) folded before Flop
Seat 4: 14620cce folded before Flop (didn't bet)
Seat 5: 8012317b folded before Flop (didn't bet)
Seat 6: 1a54a2fc folded on the River


Poker Hand #RC3334439570: Hold'em No Limit ($0.02/$0.05) - 2025/02/17 20:40:13
Table 'RushAndCash604830' 6-max Seat #1 is the button
Seat 1: 4abcea5e ($5.33 in chips)
Seat 2: e3cc36cb ($5.01 in chips)
Seat 3: 18e8e582 ($9.74 in chips)
Seat 4: 1157f85d ($5 in chips)
Seat 5: Hero ($8.72 in chips)
Seat 6: 11fb4d12 ($10.12 in chips)
e3cc36cb: posts small blind $0.02
18e8e582: posts big blind $0.05
*** HOLE CARDS ***
Dealt to 4abcea5e 
Dealt to e3cc36cb 
Dealt to 18e8e582 
Dealt to 1157f85d 
Dealt to Hero [Qh 4c]
Dealt to 11fb4d12 
1157f85d: folds
Hero: folds
11fb4d12: folds
4abcea5e: raises $0.1 to $0.15
e3cc36cb: folds
18e8e582: folds
Uncalled bet ($0.1) returned to 4abcea5e
*** SHOWDOWN ***
4abcea5e collected $0.12 from pot
*** SUMMARY ***
Total pot $0.12 | Rake $0 | Jackpot $0 | Bingo $0 | Fortune $0 | Tax $0
Seat 1: 4abcea5e (button) collected ($0.12)
Seat 2: e3cc36cb (small blind) folded before Flop
Seat 3: 18e8e582 (big blind) folded before Flop
Seat 4: 1157f85d folded before Flop (didn't bet)
Seat 5: Hero folded before Flop (didn't bet)
Seat 6: 11fb4d12 folded before Flop (didn't bet)


Poker Hand #RC3334439317: Hold'em No Limit ($0.02/$0.05) - 2025/02/17 20:39:36
Table 'RushAndCash604577' 6-max Seat #1 is the button
Seat 1: 858b70a7 ($1.65 in chips)
Seat 2: 22a3f0e8 ($5.18 in chips)
Seat 3: bda9ba33 ($4.61 in chips)
Seat 4: bbdadd69 ($6.41 in chips)
Seat 5: Hero ($8.82 in chips)
Seat 6: 3b2a8270 ($10.38 in chips)
22a3f0e8: posts small blind $0.02
bda9ba33: posts big blind $0.05
*** HOLE CARDS ***
Dealt to 858b70a7 
Dealt to 22a3f0e8 
Dealt to bda9ba33 
Dealt to bbdadd69 
Dealt to Hero [9c 8c]
Dealt to 3b2a8270 
bbdadd69: raises $0.05 to $0.1
Hero: calls $0.1
3b2a8270: calls $0.1
858b70a7: folds
22a3f0e8: folds
bda9ba33: raises $0.42 to $0.52
bbdadd69: folds
Hero: folds
3b2a8270: calls $0.42
*** FLOP *** [Kd Qh 5d]
bda9ba33: bets $0.95
3b2a8270: folds
Uncalled bet ($0.95) returned to bda9ba33
*** SHOWDOWN ***
bda9ba33 collected $1.2 from pot
*** SUMMARY ***
Total pot $1.26 | Rake $0.06 | Jackpot $0 | Bingo $0 | Fortune $0 | Tax $0
Board [Kd Qh 5d]
Seat 1: 858b70a7 (button) folded before Flop (didn't bet)
Seat 2: 22a3f0e8 (small blind) folded before Flop
Seat 3: bda9ba33 (big blind) won ($1.2)
Seat 4: bbdadd69 folded before Flop
Seat 5: Hero folded before Flop
Seat 6: 3b2a8270 folded on the Flop


Poker Hand #RC3334439174: Hold'em No Limit ($0.02/$0.05) - 2025/02/17 20:39:17
Table 'RushAndCash604434' 6-max Seat #1 is the button
Seat 1: 1063406 ($7.73 in chips)
Seat 2: 6c6b017a ($8.68 in chips)
Seat 3: 5b91a195 ($12.07 in chips)
Seat 4: 50d9f656 ($6.98 in chips)
Seat 5: e390e48e ($7.05 in chips)
Seat 6: Hero ($8.75 in chips)
6c6b017a: posts small blind $0.02
5b91a195: posts big blind $0.05
*** HOLE CARDS ***
Dealt to 1063406 
Dealt to 6c6b017a 
Dealt to 5b91a195 
Dealt to 50d9f656 
Dealt to e390e48e 
Dealt to Hero [Jd Qs]
50d9f656: folds
e390e48e: folds
Hero: raises $0.05 to $0.1
1063406: folds
6c6b017a: folds
5b91a195: folds
Uncalled bet ($0.05) returned to Hero
*** SHOWDOWN ***
Hero collected $0.12 from pot
*** SUMMARY ***
Total pot $0.12 | Rake $0 | Jackpot $0 | Bingo $0 | Fortune $0 | Tax $0
Seat 1: 1063406 (button) folded before Flop (didn't bet)
Seat 2: 6c6b017a (small blind) folded before Flop
Seat 3: 5b91a195 (big blind) folded before Flop
Seat 4: 50d9f656 folded before Flop (didn't bet)
Seat 5: e390e48e folded before Flop (didn't bet)
Seat 6: Hero collected ($0.12)


Poker Hand #RC3334439144: Hold'em No Limit ($0.02/$0.05) - 2025/02/17 20:39:13
Table 'RushAndCash604404' 6-max Seat #1 is the button
Seat 1: 2ad7d6f4 ($2.53 in chips)
Seat 2: 868c7021 ($3.51 in chips)
Seat 3: d51a15ca ($5.42 in chips)
Seat 4: Hero ($8.75 in chips)
Seat 5: ead6cfaf ($5.14 in chips)
Seat 6: 842d7655 ($5.91 in chips)
868c7021: posts small blind $0.02
d51a15ca: posts big blind $0.05
*** HOLE CARDS ***
Dealt to 2ad7d6f4 
Dealt to 868c7021 
Dealt to d51a15ca 
Dealt to Hero [4s Jh]
Dealt to ead6cfaf 
Dealt to 842d7655 
Hero: folds
ead6cfaf: folds
842d7655: folds
2ad7d6f4: folds
868c7021: calls $0.03
d51a15ca: raises $0.1 to $0.15
868c7021: calls $0.1
*** FLOP *** [3h 2d Ad]
868c7021: checks
d51a15ca: bets $0.15
868c7021: folds
Uncalled bet ($0.15) returned to d51a15ca
*** SHOWDOWN ***
d51a15ca collected $0.29 from pot
*** SUMMARY ***
Total pot $0.3 | Rake $0.01 | Jackpot $0 | Bingo $0 | Fortune $0 | Tax $0
Board [3h 2d Ad]
Seat 1: 2ad7d6f4 (button) folded before Flop (didn't bet)
Seat 2: 868c7021 (small blind) folded on the Flop
Seat 3: d51a15ca (big blind) won ($0.29)
Seat 4: Hero folded before Flop (didn't bet)
Seat 5: ead6cfaf folded before Flop (didn't bet)
Seat 6: 842d7655 folded before Flop (didn't bet)


Poker Hand #RC3334439118: Hold'em No Limit ($0.02/$0.05) - 2025/02/17 20:39:10
Table 'RushAndCash604378' 6-max Seat #1 is the button
Seat 1: Hero ($8.75 in chips)
Seat 2: 1095926a ($5 in chips)
Seat 3: 6c6b017a ($8.73 in chips)
Seat 4: 16f2e5ce ($6.5 in chips)
Seat 5: 3c79b0ff ($6.55 in chips)
Seat 6: 7b1c045a ($5.15 in chips)
1095926a: posts small blind $0.02
6c6b017a: posts big blind $0.05
*** HOLE CARDS ***
Dealt to Hero [Ks 9d]
Dealt to 1095926a 
Dealt to 6c6b017a 
Dealt to 16f2e5ce 
Dealt to 3c79b0ff 
Dealt to 7b1c045a 
16f2e5ce: raises $0.05 to $0.1
3c79b0ff: folds
7b1c045a: folds
Hero: folds
1095926a: folds
6c6b017a: folds
Uncalled bet ($0.05) returned to 16f2e5ce
*** SHOWDOWN ***
16f2e5ce collected $0.12 from pot
*** SUMMARY ***
Total pot $0.12 | Rake $0 | Jackpot $0 | Bingo $0 | Fortune $0 | Tax $0
Seat 1: Hero (button) folded before Flop (didn't bet)
Seat 2: 1095926a (small blind) folded before Flop
Seat 3: 6c6b017a (big blind) folded before Flop
Seat 4: 16f2e5ce collected ($0.12)
Seat 5: 3c79b0ff folded before Flop (didn't bet)
Seat 6: 7b1c045a folded before Flop (didn't bet)


Poker Hand #RC3334439030: Hold'em No Limit ($0.02/$0.05) - 2025/02/17 20:38:59
Table 'RushAndCash604290' 6-max Seat #1 is the button
Seat 1: 65ca9276 ($7.61 in chips)
Seat 2: ddc28699 ($2.57 in chips)
Seat 3: 6ab8e60e ($15.94 in chips)
Seat 4: 816260d0 ($11.4 in chips)
Seat 5: e8e95c39 ($7.01 in chips)
Seat 6: Hero ($8.75 in chips)
ddc28699: posts small blind $0.02
6ab8e60e: posts big blind $0.05
*** HOLE CARDS ***
Dealt to 65ca9276 
Dealt to ddc28699 
Dealt to 6ab8e60e 
Dealt to 816260d0 
Dealt to e8e95c39 
Dealt to Hero [4s As]
816260d0: folds
e8e95c39: raises $0.05 to $0.1
Hero: folds
65ca9276: folds
ddc28699: folds
6ab8e60e: folds
Uncalled bet ($0.05) returned to e8e95c39
*** SHOWDOWN ***
e8e95c39 collected $0.12 from pot
*** SUMMARY ***
Total pot $0.12 | Rake $0 | Jackpot $0 | Bingo $0 | Fortune $0 | Tax $0
Seat 1: 65ca9276 (button) folded before Flop (didn't bet)
Seat 2: ddc28699 (small blind) folded before Flop
Seat 3: 6ab8e60e (big blind) folded before Flop
Seat 4: 816260d0 folded before Flop (didn't bet)
Seat 5: e8e95c39 collected ($0.12)
Seat 6: Hero folded before Flop (didn't bet)


Poker Hand #RC3334438993: Hold'em No Limit ($0.02/$0.05) - 2025/02/17 20:38:55
Table 'RushAndCash604253' 6-max Seat #1 is the button
Seat 1: Hero ($8.75 in chips)
Seat 2: 8c6d38f2 ($5.54 in chips)
Seat 3: e3c5673f ($5.36 in chips)
Seat 4: bddf8e1e ($11.22 in chips)
Seat 5: 1f06f573 ($5.13 in chips)
Seat 6: 6191b99d ($2.72 in chips)
8c6d38f2: posts small blind $0.02
e3c5673f: posts big blind $0.05
*** HOLE CARDS ***
Dealt to Hero [5h 6s]
Dealt to 8c6d38f2 
Dealt to e3c5673f 
Dealt to bddf8e1e 
Dealt to 1f06f573 
Dealt to 6191b99d 
bddf8e1e: folds
1f06f573: folds
6191b99d: folds
Hero: folds
8c6d38f2: folds
Uncalled bet ($0.03) returned to e3c5673f
*** SHOWDOWN ***
e3c5673f collected $0.04 from pot
*** SUMMARY ***
Total pot $0.04 | Rake $0 | Jackpot $0 | Bingo $0 | Fortune $0 | Tax $0
Seat 1: Hero (button) folded before Flop (didn't bet)
Seat 2: 8c6d38f2 (small blind) folded before Flop
Seat 3: e3c5673f (big blind) collected ($0.04)
Seat 4: bddf8e1e folded before Flop (didn't bet)
Seat 5: 1f06f573 folded before Flop (didn't bet)
Seat 6: 6191b99d folded before Flop (didn't bet)


Poker Hand #RC3334438794: Hold'em No Limit ($0.02/$0.05) - 2025/02/17 20:38:29
Table 'RushAndCash604054' 6-max Seat #1 is the button
Seat 1: 3952cabf ($5 in chips)
Seat 2: Hero ($8.8 in chips)
Seat 3: e6ee1d7f ($6.68 in chips)
Seat 4: 7b1c045a ($5.1 in chips)
Seat 5: 53c3b7da ($4.37 in chips)
Seat 6: e4464aff ($5.29 in chips)
Hero: posts small blind $0.02
e6ee1d7f: posts big blind $0.05
*** HOLE CARDS ***
Dealt to 3952cabf 
Dealt to Hero [Jc Ts]
Dealt to e6ee1d7f 
Dealt to 7b1c045a 
Dealt to 53c3b7da 
Dealt to e4464aff 
7b1c045a: folds
53c3b7da: folds
e4464aff: folds
3952cabf: folds
Hero: calls $0.03
e6ee1d7f: checks
*** FLOP *** [5c 6c Kd]
Hero: checks
e6ee1d7f: bets $0.05
Hero: folds
Uncalled bet ($0.05) returned to e6ee1d7f
*** SHOWDOWN ***
e6ee1d7f collected $0.1 from pot
*** SUMMARY ***
Total pot $0.1 | Rake $0 | Jackpot $0 | Bingo $0 | Fortune $0 | Tax $0
Board [5c 6c Kd]
Seat 1: 3952cabf (button) folded before Flop (didn't bet)
Seat 2: Hero (small blind) folded on the Flop
Seat 3: e6ee1d7f (big blind) won ($0.1)
Seat 4: 7b1c045a folded before Flop (didn't bet)
Seat 5: 53c3b7da folded before Flop (didn't bet)
Seat 6: e4464aff folded before Flop (didn't bet)


Poker Hand #RC3334438768: Hold'em No Limit ($0.02/$0.05) - 2025/02/17 20:38:26
Table 'RushAndCash604028' 6-max Seat #1 is the button
Seat 1: 598d859f ($5.96 in chips)
Seat 2: Hero ($8.82 in chips)
Seat 3: 5acd5e40 ($5.67 in chips)
Seat 4: 94cb065d ($5 in chips)
Seat 5: f3fc119a ($6.15 in chips)
Seat 6: 77368e62 ($5.36 in chips)
Hero: posts small blind $0.02
5acd5e40: posts big blind $0.05
*** HOLE CARDS ***
Dealt to 598d859f 
Dealt to Hero [2h 6c]
Dealt to 5acd5e40 
Dealt to 94cb065d 
Dealt to f3fc119a 
Dealt to 77368e62 
94cb065d: folds
f3fc119a: folds
77368e62: folds
598d859f: raises $0.08 to $0.13
Hero: folds
5acd5e40: folds
Uncalled bet ($0.08) returned to 598d859f
*** SHOWDOWN ***
598d859f collected $0.12 from pot
*** SUMMARY ***
Total pot $0.12 | Rake $0 | Jackpot $0 | Bingo $0 | Fortune $0 | Tax $0
Seat 1: 598d859f (button) collected ($0.12)
Seat 2: Hero (small blind) folded before Flop
Seat 3: 5acd5e40 (big blind) folded before Flop
Seat 4: 94cb065d folded before Flop (didn't bet)
Seat 5: f3fc119a folded before Flop (didn't bet)
Seat 6: 77368e62 folded before Flop (didn't bet)


Poker Hand #RC3334438741: Hold'em No Limit ($0.02/$0.05) - 2025/02/17 20:38:22
Table 'RushAndCash604001' 6-max Seat #1 is the button
Seat 1: 860fa4c9 ($5.21 in chips)
Seat 2: 9d7d4a76 ($5 in chips)
Seat 3: Hero ($8.87 in chips)
Seat 4: 3b2a8270 ($10.19 in chips)
Seat 5: f72dbf6d ($5.7 in chips)
Seat 6: dea8bb2e ($5.25 in chips)
9d7d4a76: posts small blind $0.02
Hero: posts big blind $0.05
*** HOLE CARDS ***
Dealt to 860fa4c9 
Dealt to 9d7d4a76 
Dealt to Hero [Jc 6d]
Dealt to 3b2a8270 
Dealt to f72dbf6d 
Dealt to dea8bb2e 
3b2a8270: folds
f72dbf6d: folds
dea8bb2e: folds
860fa4c9: folds
9d7d4a76: calls $0.03
Hero: checks
*** FLOP *** [Qd As 9h]
9d7d4a76: checks
Hero: checks
*** TURN *** [Qd As 9h] [2c]
9d7d4a76: bets $0.05
Hero: folds
Uncalled bet ($0.05) returned to 9d7d4a76
*** SHOWDOWN ***
9d7d4a76 collected $0.1 from pot
*** SUMMARY ***
Total pot $0.1 | Rake $0 | Jackpot $0 | Bingo $0 | Fortune $0 | Tax $0
Board [Qd As 9h 2c]
Seat 1: 860fa4c9 (button) folded before Flop (didn't bet)
Seat 2: 9d7d4a76 (small blind) won ($0.1)
Seat 3: Hero (big blind) folded on the Turn
Seat 4: 3b2a8270 folded before Flop (didn't bet)
Seat 5: f72dbf6d folded before Flop (didn't bet)
Seat 6: dea8bb2e folded before Flop (didn't bet)


Poker Hand #RC3334438717: Hold'em No Limit ($0.02/$0.05) - 2025/02/17 20:38:19
Table 'RushAndCash603977' 6-max Seat #1 is the button
Seat 1: d25efca ($5.06 in chips)
Seat 2: 98fa8579 ($5.47 in chips)
Seat 3: d1cd1071 ($14.74 in chips)
Seat 4: Hero ($8.87 in chips)
Seat 5: ec1d0d44 ($11.19 in chips)
Seat 6: c95c6ae6 ($14.19 in chips)
98fa8579: posts small blind $0.02
d1cd1071: posts big blind $0.05
*** HOLE CARDS ***
Dealt to d25efca 
Dealt to 98fa8579 
Dealt to d1cd1071 
Dealt to Hero [Kd 5c]
Dealt to ec1d0d44 
Dealt to c95c6ae6 
Hero: folds
ec1d0d44: folds
c95c6ae6: raises $0.05 to $0.1
d25efca: folds
98fa8579: folds
d1cd1071: folds
Uncalled bet ($0.05) returned to c95c6ae6
*** SHOWDOWN ***
c95c6ae6 collected $0.12 from pot
*** SUMMARY ***
Total pot $0.12 | Rake $0 | Jackpot $0 | Bingo $0 | Fortune $0 | Tax $0
Seat 1: d25efca (button) folded before Flop (didn't bet)
Seat 2: 98fa8579 (small blind) folded before Flop
Seat 3: d1cd1071 (big blind) folded before Flop
Seat 4: Hero folded before Flop (didn't bet)
Seat 5: ec1d0d44 folded before Flop (didn't bet)
Seat 6: c95c6ae6 collected ($0.12)


Poker Hand #RC3334438696: Hold'em No Limit ($0.02/$0.05) - 2025/02/17 20:38:16
Table 'RushAndCash603956' 6-max Seat #1 is the button
Seat 1: 4c5ef89 ($6.17 in chips)
Seat 2: 38ef00 ($1.78 in chips)
Seat 3: 74f9576e ($5 in chips)
Seat 4: 8d7c8253 ($5.47 in chips)
Seat 5: e3c5673f ($5.02 in chips)
Seat 6: Hero ($8.87 in chips)
38ef00: posts small blind $0.02
74f9576e: posts big blind $0.05
*** HOLE CARDS ***
Dealt to 4c5ef89 
Dealt to 38ef00 
Dealt to 74f9576e 
Dealt to 8d7c8253 
Dealt to e3c5673f 
Dealt to Hero [Qd 4d]
8d7c8253: folds
e3c5673f: raises $0.05 to $0.1
Hero: folds
4c5ef89: calls $0.1
38ef00: folds
74f9576e: folds
*** FLOP *** [4h Jd Qs]
e3c5673f: bets $0.14
4c5ef89: calls $0.14
*** TURN *** [4h Jd Qs] [Kc]
e3c5673f: bets $0.42
4c5ef89: folds
Uncalled bet ($0.42) returned to e3c5673f
*** SHOWDOWN ***
e3c5673f collected $0.53 from pot
*** SUMMARY ***
Total pot $0.55 | Rake $0.02 | Jackpot $0 | Bingo $0 | Fortune $0 | Tax $0
Board [4h Jd Qs Kc]
Seat 1: 4c5ef89 (button) folded on the Turn
Seat 2: 38ef00 (small blind) folded before Flop
Seat 3: 74f9576e (big blind) folded before Flop
Seat 4: 8d7c8253 folded before Flop (didn't bet)
Seat 5: e3c5673f won ($0.53)
Seat 6: Hero folded before Flop (didn't bet)


Poker Hand #RC3334438671: Hold'em No Limit ($0.02/$0.05) - 2025/02/17 20:38:12
Table 'RushAndCash603931' 6-max Seat #1 is the button
Seat 1: 3b2a8270 ($10.19 in chips)
Seat 2: e877c9db ($5.16 in chips)
Seat 3: 8b76c8c6 ($4.99 in chips)
Seat 4: 98fa8579 ($5.52 in chips)
Seat 5: Hero ($8.87 in chips)
Seat 6: 81e1b438 ($5.05 in chips)
e877c9db: posts small blind $0.02
8b76c8c6: posts big blind $0.05
*** HOLE CARDS ***
Dealt to 3b2a8270 
Dealt to e877c9db 
Dealt to 8b76c8c6 
Dealt to 98fa8579 
Dealt to Hero [Th 4c]
Dealt to 81e1b438 
98fa8579: folds
Hero: folds
81e1b438: folds
3b2a8270: folds
e877c9db: raises $0.1 to $0.15
8b76c8c6: folds
Uncalled bet ($0.1) returned to e877c9db
*** SHOWDOWN ***
e877c9db collected $0.1 from pot
*** SUMMARY ***
Total pot $0.1 | Rake $0 | Jackpot $0 | Bingo $0 | Fortune $0 | Tax $0
Seat 1: 3b2a8270 (button) folded before Flop (didn't bet)
Seat 2: e877c9db (small blind) collected ($0.1)
Seat 3: 8b76c8c6 (big blind) folded before Flop
Seat 4: 98fa8579 folded before Flop (didn't bet)
Seat 5: Hero folded before Flop (didn't bet)
Seat 6: 81e1b438 folded before Flop (didn't bet)


Poker Hand #RC3334438651: Hold'em No Limit ($0.02/$0.05) - 2025/02/17 20:38:10
Table 'RushAndCash603911' 6-max Seat #1 is the button
Seat 1: Hero ($8.8 in chips)
Seat 2: 76135c78 ($5 in chips)
Seat 3: b86c29aa ($5.07 in chips)
Seat 4: 9b7e5117 ($2.37 in chips)
Seat 5: c0de4e76 ($4.94 in chips)
Seat 6: 14d966a6 ($5.07 in chips)
76135c78: posts small blind $0.02
b86c29aa: posts big blind $0.05
*** HOLE CARDS ***
Dealt to Hero [Ac 2h]
Dealt to 76135c78 
Dealt to b86c29aa 
Dealt to 9b7e5117 
Dealt to c0de4e76 
Dealt to 14d966a6 
9b7e5117: folds
c0de4e76: raises $0.08 to $0.13
14d966a6: folds
Hero: folds
76135c78: folds
b86c29aa: folds
Uncalled bet ($0.08) returned to c0de4e76
*** SHOWDOWN ***
c0de4e76 collected $0.12 from pot
*** SUMMARY ***
Total pot $0.12 | Rake $0 | Jackpot $0 | Bingo $0 | Fortune $0 | Tax $0
Seat 1: Hero (button) folded before Flop (didn't bet)
Seat 2: 76135c78 (small blind) folded before Flop
Seat 3: b86c29aa (big blind) folded before Flop
Seat 4: 9b7e5117 folded before Flop (didn't bet)
Seat 5: c0de4e76 collected ($0.12)
Seat 6: 14d966a6 folded before Flop (didn't bet)


Poker Hand #RC3334438626: Hold'em No Limit ($0.02/$0.05) - 2025/02/17 20:38:06
Table 'RushAndCash603886' 6-max Seat #1 is the button
Seat 1: 4264790d ($5.33 in chips)
Seat 2: 98ea32b ($5.02 in chips)
Seat 3: Hero ($8.85 in chips)
Seat 4: 773fdf96 ($5.16 in chips)
Seat 5: a9af8bb8 ($5 in chips)
Seat 6: 1e474bac ($5.19 in chips)
98ea32b: posts small blind $0.02
Hero: posts big blind $0.05
*** HOLE CARDS ***
Dealt to 4264790d 
Dealt to 98ea32b 
Dealt to Hero [5s Tc]
Dealt to 773fdf96 
Dealt to a9af8bb8 
Dealt to 1e474bac 
773fdf96: folds
a9af8bb8: folds
1e474bac: folds
4264790d: folds
98ea32b: folds
Uncalled bet ($0.03) returned to Hero
*** SHOWDOWN ***
Hero collected $0.04 from pot
*** SUMMARY ***
Total pot $0.04 | Rake $0 | Jackpot $0 | Bingo $0 | Fortune $0 | Tax $0
Seat 1: 4264790d (button) folded before Flop (didn't bet)
Seat 2: 98ea32b (small blind) folded before Flop
Seat 3: Hero (big blind) collected ($0.04)
Seat 4: 773fdf96 folded before Flop (didn't bet)
Seat 5: a9af8bb8 folded before Flop (didn't bet)
Seat 6: 1e474bac folded before Flop (didn't bet)


Poker Hand #RC3334438572: Hold'em No Limit ($0.02/$0.05) - 2025/02/17 20:37:59
Table 'RushAndCash603832' 6-max Seat #1 is the button
Seat 1: eaafe260 ($11.55 in chips)
Seat 2: 91e92de9 ($8.98 in chips)
Seat 3: 3c79b0ff ($6.44 in chips)
Seat 4: Hero ($8.95 in chips)
Seat 5: 7df4712d ($7.11 in chips)
Seat 6: 2b15bcc3 ($2.18 in chips)
91e92de9: posts small blind $0.02
3c79b0ff: posts big blind $0.05
*** HOLE CARDS ***
Dealt to eaafe260 
Dealt to 91e92de9 
Dealt to 3c79b0ff 
Dealt to Hero [Js Ah]
Dealt to 7df4712d 
Dealt to 2b15bcc3 
Hero: raises $0.05 to $0.1
7df4712d: raises $0.21 to $0.31
2b15bcc3: folds
eaafe260: folds
91e92de9: folds
3c79b0ff: folds
Hero: folds
Uncalled bet ($0.21) returned to 7df4712d
*** SHOWDOWN ***
7df4712d collected $0.26 from pot
*** SUMMARY ***
Total pot $0.27 | Rake $0.01 | Jackpot $0 | Bingo $0 | Fortune $0 | Tax $0
Seat 1: eaafe260 (button) folded before Flop (didn't bet)
Seat 2: 91e92de9 (small blind) folded before Flop
Seat 3: 3c79b0ff (big blind) folded before Flop
Seat 4: Hero folded before Flop
Seat 5: 7df4712d collected ($0.26)
Seat 6: 2b15bcc3 folded before Flop (didn't bet)


Poker Hand #RC3334438547: Hold'em No Limit ($0.02/$0.05) - 2025/02/17 20:37:56
Table 'RushAndCash603807' 6-max Seat #1 is the button
Seat 1: 651cc52f ($3.9 in chips)
Seat 2: 1f7fd8bc ($5 in chips)
Seat 3: cd1f87c8 ($4.22 in chips)
Seat 4: Hero ($8.95 in chips)
Seat 5: b86c29aa ($5 in chips)
Seat 6: 93cbff75 ($6.87 in chips)
1f7fd8bc: posts small blind $0.02
cd1f87c8: posts big blind $0.05
*** HOLE CARDS ***
Dealt to 651cc52f 
Dealt to 1f7fd8bc 
Dealt to cd1f87c8 
Dealt to Hero [3d Ah]
Dealt to b86c29aa 
Dealt to 93cbff75 
Hero: folds
b86c29aa: folds
93cbff75: folds
651cc52f: folds
1f7fd8bc: folds
Uncalled bet ($0.03) returned to cd1f87c8
*** SHOWDOWN ***
cd1f87c8 collected $0.04 from pot
*** SUMMARY ***
Total pot $0.04 | Rake $0 | Jackpot $0 | Bingo $0 | Fortune $0 | Tax $0
Seat 1: 651cc52f (button) folded before Flop (didn't bet)
Seat 2: 1f7fd8bc (small blind) folded before Flop
Seat 3: cd1f87c8 (big blind) collected ($0.04)
Seat 4: Hero folded before Flop (didn't bet)
Seat 5: b86c29aa folded before Flop (didn't bet)
Seat 6: 93cbff75 folded before Flop (didn't bet)


Poker Hand #RC3334438526: Hold'em No Limit ($0.02/$0.05) - 2025/02/17 20:37:53
Table 'RushAndCash603786' 6-max Seat #1 is the button
Seat 1: e3a10bfa ($5.11 in chips)
Seat 2: ef82d036 ($21.97 in chips)
Seat 3: e8f41d33 ($3.83 in chips)
Seat 4: e4fd27d ($4.73 in chips)
Seat 5: Hero ($8.95 in chips)
Seat 6: bb702030 ($6.28 in chips)
ef82d036: posts small blind $0.02
e8f41d33: posts big blind $0.05
*** HOLE CARDS ***
Dealt to e3a10bfa 
Dealt to ef82d036 
Dealt to e8f41d33 
Dealt to e4fd27d 
Dealt to Hero [6h Tc]
Dealt to bb702030 
e4fd27d: raises $0.07 to $0.12
Hero: folds
bb702030: folds
e3a10bfa: folds
ef82d036: folds
e8f41d33: folds
Uncalled bet ($0.07) returned to e4fd27d
*** SHOWDOWN ***
e4fd27d collected $0.12 from pot
*** SUMMARY ***
Total pot $0.12 | Rake $0 | Jackpot $0 | Bingo $0 | Fortune $0 | Tax $0
Seat 1: e3a10bfa (button) folded before Flop (didn't bet)
Seat 2: ef82d036 (small blind) folded before Flop
Seat 3: e8f41d33 (big blind) folded before Flop
Seat 4: e4fd27d collected ($0.12)
Seat 5: Hero folded before Flop (didn't bet)
Seat 6: bb702030 folded before Flop (didn't bet)


Poker Hand #RC3334438506: Hold'em No Limit ($0.02/$0.05) - 2025/02/17 20:37:50
Table 'RushAndCash603766' 6-max Seat #1 is the button
Seat 1: 38a4c833 ($11.76 in chips)
Seat 2: c096c24 ($5.07 in chips)
Seat 3: f72dbf6d ($5.7 in chips)
Seat 4: bda9ba33 ($4.28 in chips)
Seat 5: Hero ($8.95 in chips)
Seat 6: ce23f617 ($5.07 in chips)
c096c24: posts small blind $0.02
f72dbf6d: posts big blind $0.05
*** HOLE CARDS ***
Dealt to 38a4c833 
Dealt to c096c24 
Dealt to f72dbf6d 
Dealt to bda9ba33 
Dealt to Hero [6s Td]
Dealt to ce23f617 
bda9ba33: folds
Hero: folds
ce23f617: folds
38a4c833: folds
c096c24: raises $0.05 to $0.1
f72dbf6d: folds
Uncalled bet ($0.05) returned to c096c24
*** SHOWDOWN ***
c096c24 collected $0.1 from pot
*** SUMMARY ***
Total pot $0.1 | Rake $0 | Jackpot $0 | Bingo $0 | Fortune $0 | Tax $0
Seat 1: 38a4c833 (button) folded before Flop (didn't bet)
Seat 2: c096c24 (small blind) collected ($0.1)
Seat 3: f72dbf6d (big blind) folded before Flop
Seat 4: bda9ba33 folded before Flop (didn't bet)
Seat 5: Hero folded before Flop (didn't bet)
Seat 6: ce23f617 folded before Flop (didn't bet)


Poker Hand #RC3334438485: Hold'em No Limit ($0.02/$0.05) - 2025/02/17 20:37:46
Table 'RushAndCash603745' 6-max Seat #1 is the button
Seat 1: 3b2a8270 ($10.21 in chips)
Seat 2: 93dfef8b ($11.75 in chips)
Seat 3: 7af747dc ($13.78 in chips)
Seat 4: Hero ($8.95 in chips)
Seat 5: f72dbf6d ($5.7 in chips)
Seat 6: b44ff266 ($6.22 in chips)
93dfef8b: posts small blind $0.02
7af747dc: posts big blind $0.05
*** HOLE CARDS ***
Dealt to 3b2a8270 
Dealt to 93dfef8b 
Dealt to 7af747dc 
Dealt to Hero [3s 8c]
Dealt to f72dbf6d 
Dealt to b44ff266 
Hero: folds
f72dbf6d: folds
b44ff266: raises $0.08 to $0.13
3b2a8270: folds
93dfef8b: folds
7af747dc: calls $0.08
*** FLOP *** [8s Qc Th]
7af747dc: checks
b44ff266: bets $0.08
7af747dc: calls $0.08
*** TURN *** [8s Qc Th] [7c]
7af747dc: checks
b44ff266: bets $0.3
7af747dc: calls $0.3
*** RIVER *** [8s Qc Th 7c] [Jc]
7af747dc: bets $0.35
b44ff266: folds
Uncalled bet ($0.35) returned to 7af747dc
*** SHOWDOWN ***
7af747dc collected $0.98 from pot
*** SUMMARY ***
Total pot $1.04 | Rake $0.06 | Jackpot $0 | Bingo $0 | Fortune $0 | Tax $0
Board [8s Qc Th 7c Jc]
Seat 1: 3b2a8270 (button) folded before Flop (didn't bet)
Seat 2: 93dfef8b (small blind) folded before Flop
Seat 3: 7af747dc (big blind) won ($0.98)
Seat 4: Hero folded before Flop (didn't bet)
Seat 5: f72dbf6d folded before Flop (didn't bet)
Seat 6: b44ff266 folded on the River


Poker Hand #RC3334438461: Hold'em No Limit ($0.02/$0.05) - 2025/02/17 20:37:43
Table 'RushAndCash603721' 6-max Seat #1 is the button
Seat 1: ac6a1821 ($5 in chips)
Seat 2: fad7078a ($5.02 in chips)
Seat 3: Hero ($9 in chips)
Seat 4: f26bf81c ($4.02 in chips)
Seat 5: 45d33c76 ($9.05 in chips)
Seat 6: 866bc80c ($3.94 in chips)
fad7078a: posts small blind $0.02
Hero: posts big blind $0.05
*** HOLE CARDS ***
Dealt to ac6a1821 
Dealt to fad7078a 
Dealt to Hero [5c Th]
Dealt to f26bf81c 
Dealt to 45d33c76 
Dealt to 866bc80c 
f26bf81c: folds
45d33c76: folds
866bc80c: folds
ac6a1821: folds
fad7078a: raises $0.08 to $0.13
Hero: folds
Uncalled bet ($0.08) returned to fad7078a
*** SHOWDOWN ***
fad7078a collected $0.1 from pot
*** SUMMARY ***
Total pot $0.1 | Rake $0 | Jackpot $0 | Bingo $0 | Fortune $0 | Tax $0
Seat 1: ac6a1821 (button) folded before Flop (didn't bet)
Seat 2: fad7078a (small blind) collected ($0.1)
Seat 3: Hero (big blind) folded before Flop
Seat 4: f26bf81c folded before Flop (didn't bet)
Seat 5: 45d33c76 folded before Flop (didn't bet)
Seat 6: 866bc80c folded before Flop (didn't bet)


Poker Hand #RC3334438437: Hold'em No Limit ($0.02/$0.05) - 2025/02/17 20:37:39
Table 'RushAndCash603697' 6-max Seat #1 is the button
Seat 1: Hero ($9 in chips)
Seat 2: 35fb946f ($4.67 in chips)
Seat 3: 9885e0a0 ($5 in chips)
Seat 4: 8ec32764 ($5.05 in chips)
Seat 5: b282789b ($5.43 in chips)
Seat 6: d0316f8a ($5 in chips)
35fb946f: posts small blind $0.02
9885e0a0: posts big blind $0.05
*** HOLE CARDS ***
Dealt to Hero [5h Th]
Dealt to 35fb946f 
Dealt to 9885e0a0 
Dealt to 8ec32764 
Dealt to b282789b 
Dealt to d0316f8a 
8ec32764: folds
b282789b: folds
d0316f8a: folds
Hero: folds
35fb946f: folds
Uncalled bet ($0.03) returned to 9885e0a0
*** SHOWDOWN ***
9885e0a0 collected $0.04 from pot
*** SUMMARY ***
Total pot $0.04 | Rake $0 | Jackpot $0 | Bingo $0 | Fortune $0 | Tax $0
Seat 1: Hero (button) folded before Flop (didn't bet)
Seat 2: 35fb946f (small blind) folded before Flop
Seat 3: 9885e0a0 (big blind) collected ($0.04)
Seat 4: 8ec32764 folded before Flop (didn't bet)
Seat 5: b282789b folded before Flop (didn't bet)
Seat 6: d0316f8a folded before Flop (didn't bet)


Poker Hand #RC3334438413: Hold'em No Limit ($0.02/$0.05) - 2025/02/17 20:37:35
Table 'RushAndCash603673' 6-max Seat #1 is the button
Seat 1: 6ac4af54 ($15.01 in chips)
Seat 2: 945593bf ($10.77 in chips)
Seat 3: 8e07c53 ($5.82 in chips)
Seat 4: Hero ($9 in chips)
Seat 5: 6008538 ($3.29 in chips)
Seat 6: db6d28b7 ($5.19 in chips)
945593bf: posts small blind $0.02
8e07c53: posts big blind $0.05
*** HOLE CARDS ***
Dealt to 6ac4af54 
Dealt to 945593bf 
Dealt to 8e07c53 
Dealt to Hero [6d Qc]
Dealt to 6008538 
Dealt to db6d28b7 
Hero: folds
6008538: folds
db6d28b7: raises $0.05 to $0.1
6ac4af54: folds
945593bf: raises $0.4 to $0.5
8e07c53: folds
db6d28b7: calls $0.4
*** FLOP *** [Ac 6s 9d]
945593bf: bets $0.35
db6d28b7: calls $0.35
*** TURN *** [Ac 6s 9d] [Td]
945593bf: checks
db6d28b7: checks
*** RIVER *** [Ac 6s 9d Td] [7d]
945593bf: checks
db6d28b7: checks
945593bf: shows [Kc Ks] (Pair of Kings)
db6d28b7: shows [Qh Qs] (Pair of Queens)
*** SHOWDOWN ***
945593bf collected $1.6 from pot
*** SUMMARY ***
Total pot $1.75 | Rake $0.08 | Jackpot $0.07 | Bingo $0 | Fortune $0 | Tax $0
Board [Ac 6s 9d Td 7d]
Seat 1: 6ac4af54 (button) folded before Flop (didn't bet)
Seat 2: 945593bf (small blind) showed [Kc Ks] and won ($1.6) with Pair of Kings
Seat 3: 8e07c53 (big blind) folded before Flop
Seat 4: Hero folded before Flop (didn't bet)
Seat 5: 6008538 folded before Flop (didn't bet)
Seat 6: db6d28b7 showed [Qh Qs] and lost with Pair of Queens


Poker Hand #RC3334438386: Hold'em No Limit ($0.02/$0.05) - 2025/02/17 20:37:31
Table 'RushAndCash603646' 6-max Seat #1 is the button
Seat 1: 2c7878da ($4.97 in chips)
Seat 2: 573eb753 ($5.65 in chips)
Seat 3: e813a51e ($2.93 in chips)
Seat 4: 3d2a56c8 ($5.85 in chips)
Seat 5: 9b4fbe63 ($8.9 in chips)
Seat 6: Hero ($8.93 in chips)
573eb753: posts small blind $0.02
e813a51e: posts big blind $0.05
*** HOLE CARDS ***
Dealt to 2c7878da 
Dealt to 573eb753 
Dealt to e813a51e 
Dealt to 3d2a56c8 
Dealt to 9b4fbe63 
Dealt to Hero [4s Jd]
3d2a56c8: folds
9b4fbe63: folds
Hero: folds
2c7878da: folds
573eb753: raises $0.08 to $0.13
e813a51e: calls $0.08
*** FLOP *** [Kh 3c 9s]
573eb753: checks
e813a51e: checks
*** TURN *** [Kh 3c 9s] [8h]
573eb753: bets $0.18
e813a51e: calls $0.18
*** RIVER *** [Kh 3c 9s 8h] [4h]
573eb753: bets $0.2
e813a51e: calls $0.2
573eb753: shows [Th 9h] (King High Flush)
e813a51e: shows [7s 8s] (Pair of Eights)
*** SHOWDOWN ***
573eb753 collected $0.97 from pot
*** SUMMARY ***
Total pot $1.02 | Rake $0.05 | Jackpot $0 | Bingo $0 | Fortune $0 | Tax $0
Board [Kh 3c 9s 8h 4h]
Seat 1: 2c7878da (button) folded before Flop (didn't bet)
Seat 2: 573eb753 (small blind) showed [Th 9h] and won ($0.97) with King High Flush
Seat 3: e813a51e (big blind) showed [7s 8s] and lost with Pair of Eights
Seat 4: 3d2a56c8 folded before Flop (didn't bet)
Seat 5: 9b4fbe63 folded before Flop (didn't bet)
Seat 6: Hero folded before Flop (didn't bet)


Poker Hand #RC3334438361: Hold'em No Limit ($0.02/$0.05) - 2025/02/17 20:37:28
Table 'RushAndCash603621' 6-max Seat #1 is the button
Seat 1: 31bef4 ($2.48 in chips)
Seat 2: 2c7878da ($4.99 in chips)
Seat 3: Hero ($8.98 in chips)
Seat 4: 6878e82a ($5.29 in chips)
Seat 5: 8f3a3c0a ($6.22 in chips)
Seat 6: 3d2a56c8 ($5.85 in chips)
2c7878da: posts small blind $0.02
Hero: posts big blind $0.05
*** HOLE CARDS ***
Dealt to 31bef4 
Dealt to 2c7878da 
Dealt to Hero [6d 5h]
Dealt to 6878e82a 
Dealt to 8f3a3c0a 
Dealt to 3d2a56c8 
6878e82a: folds
8f3a3c0a: folds
3d2a56c8: folds
31bef4: folds
2c7878da: folds
Uncalled bet ($0.03) returned to Hero
*** SHOWDOWN ***
Hero collected $0.04 from pot
*** SUMMARY ***
Total pot $0.04 | Rake $0 | Jackpot $0 | Bingo $0 | Fortune $0 | Tax $0
Seat 1: 31bef4 (button) folded before Flop (didn't bet)
Seat 2: 2c7878da (small blind) folded before Flop
Seat 3: Hero (big blind) collected ($0.04)
Seat 4: 6878e82a folded before Flop (didn't bet)
Seat 5: 8f3a3c0a folded before Flop (didn't bet)
Seat 6: 3d2a56c8 folded before Flop (didn't bet)


Poker Hand #RC3334438115: Hold'em No Limit ($0.02/$0.05) - 2025/02/17 20:36:56
Table 'RushAndCash603375' 6-max Seat #1 is the button
Seat 1: b86c29aa ($5 in chips)
Seat 2: Hero ($9.25 in chips)
Seat 3: 320e8d82 ($5.2 in chips)
Seat 4: 8f3a3c0a ($5.93 in chips)
Seat 5: 9eb2937a ($4.49 in chips)
Seat 6: 773fdf96 ($5.48 in chips)
Hero: posts small blind $0.02
320e8d82: posts big blind $0.05
*** HOLE CARDS ***
Dealt to b86c29aa 
Dealt to Hero [8c 7c]
Dealt to 320e8d82 
Dealt to 8f3a3c0a 
Dealt to 9eb2937a 
Dealt to 773fdf96 
8f3a3c0a: raises $0.1 to $0.15
9eb2937a: folds
773fdf96: folds
b86c29aa: folds
Hero: calls $0.13
320e8d82: folds
*** FLOP *** [Qd 9d 5c]
Hero: checks
8f3a3c0a: bets $0.12
Hero: calls $0.12
*** TURN *** [Qd 9d 5c] [5d]
Hero: checks
8f3a3c0a: bets $0.2
Hero: folds
Uncalled bet ($0.2) returned to 8f3a3c0a
*** SHOWDOWN ***
8f3a3c0a collected $0.56 from pot
*** SUMMARY ***
Total pot $0.59 | Rake $0.03 | Jackpot $0 | Bingo $0 | Fortune $0 | Tax $0
Board [Qd 9d 5c 5d]
Seat 1: b86c29aa (button) folded before Flop (didn't bet)
Seat 2: Hero (small blind) folded on the Turn
Seat 3: 320e8d82 (big blind) folded before Flop
Seat 4: 8f3a3c0a won ($0.56)
Seat 5: 9eb2937a folded before Flop (didn't bet)
Seat 6: 773fdf96 folded before Flop (didn't bet)


Poker Hand #RC3334437835: Hold'em No Limit ($0.02/$0.05) - 2025/02/17 20:36:18
Table 'RushAndCash603095' 6-max Seat #1 is the button
Seat 1: Hero ($8.63 in chips)
Seat 2: 9eb2937a ($5.07 in chips)
Seat 3: 1b8b89c1 ($5.5 in chips)
Seat 4: b66d20fa ($19.97 in chips)
Seat 5: f3fc119a ($6.27 in chips)
Seat 6: e6ee1d7f ($6.31 in chips)
9eb2937a: posts small blind $0.02
1b8b89c1: posts big blind $0.05
*** HOLE CARDS ***
Dealt to Hero [Kd Tc]
Dealt to 9eb2937a 
Dealt to 1b8b89c1 
Dealt to b66d20fa 
Dealt to f3fc119a 
Dealt to e6ee1d7f 
b66d20fa: folds
f3fc119a: folds
e6ee1d7f: folds
Hero: raises $0.05 to $0.1
9eb2937a: calls $0.08
1b8b89c1: calls $0.05
*** FLOP *** [4d 2h Td]
9eb2937a: checks
1b8b89c1: checks
Hero: bets $0.16
9eb2937a: calls $0.16
1b8b89c1: folds
*** TURN *** [4d 2h Td] [6h]
9eb2937a: checks
Hero: bets $0.32
9eb2937a: calls $0.32
*** RIVER *** [4d 2h Td 6h] [9h]
9eb2937a: checks
Hero: checks
9eb2937a: shows [Th Qd] (Pair of Tens)
Hero: shows [Kd Tc] (Pair of Tens)
*** SHOWDOWN ***
Hero collected $1.2 from pot
*** SUMMARY ***
Total pot $1.26 | Rake $0.06 | Jackpot $0 | Bingo $0 | Fortune $0 | Tax $0
Board [4d 2h Td 6h 9h]
Seat 1: Hero (button) showed [Kd Tc] and won ($1.2) with Pair of Tens
Seat 2: 9eb2937a (small blind) showed [Th Qd] and lost with Pair of Tens
Seat 3: 1b8b89c1 (big blind) folded on the Flop
Seat 4: b66d20fa folded before Flop (didn't bet)
Seat 5: f3fc119a folded before Flop (didn't bet)
Seat 6: e6ee1d7f folded before Flop (didn't bet)


Poker Hand #RC3334437675: Hold'em No Limit ($0.02/$0.05) - 2025/02/17 20:35:55
Table 'RushAndCash602935' 6-max Seat #1 is the button
Seat 1: 1b8b89c1 ($5.6 in chips)
Seat 2: 38a4c833 ($11.74 in chips)
Seat 3: 16b0b958 ($5.72 in chips)
Seat 4: Hero ($8.47 in chips)
Seat 5: ee3fdfd8 ($6.1 in chips)
Seat 6: 2c7878da ($4.93 in chips)
38a4c833: posts small blind $0.02
16b0b958: posts big blind $0.05
*** HOLE CARDS ***
Dealt to 1b8b89c1 
Dealt to 38a4c833 
Dealt to 16b0b958 
Dealt to Hero [8c 8h]
Dealt to ee3fdfd8 
Dealt to 2c7878da 
Hero: raises $0.05 to $0.1
ee3fdfd8: folds
2c7878da: folds
1b8b89c1: calls $0.1
38a4c833: folds
16b0b958: folds
*** FLOP *** [5s 4s 2h]
Hero: checks
1b8b89c1: checks
*** TURN *** [5s 4s 2h] [9s]
Hero: bets $0.1
1b8b89c1: folds
Uncalled bet ($0.1) returned to Hero
*** SHOWDOWN ***
Hero collected $0.26 from pot
*** SUMMARY ***
Total pot $0.27 | Rake $0.01 | Jackpot $0 | Bingo $0 | Fortune $0 | Tax $0
Board [5s 4s 2h 9s]
Seat 1: 1b8b89c1 (button) folded on the Turn
Seat 2: 38a4c833 (small blind) folded before Flop
Seat 3: 16b0b958 (big blind) folded before Flop
Seat 4: Hero won ($0.26)
Seat 5: ee3fdfd8 folded before Flop (didn't bet)
Seat 6: 2c7878da folded before Flop (didn't bet)


Poker Hand #RC3334437647: Hold'em No Limit ($0.02/$0.05) - 2025/02/17 20:35:51
Table 'RushAndCash602907' 6-max Seat #1 is the button
Seat 1: dea8bb2e ($5.09 in chips)
Seat 2: 868c7021 ($4.02 in chips)
Seat 3: fcc3c3cc ($4.6 in chips)
Seat 4: d9a113f2 ($7.1 in chips)
Seat 5: ead6cfaf ($5 in chips)
Seat 6: Hero ($8.47 in chips)
868c7021: posts small blind $0.02
fcc3c3cc: posts big blind $0.05
*** HOLE CARDS ***
Dealt to dea8bb2e 
Dealt to 868c7021 
Dealt to fcc3c3cc 
Dealt to d9a113f2 
Dealt to ead6cfaf 
Dealt to Hero [5c As]
d9a113f2: folds
ead6cfaf: folds
Hero: folds
dea8bb2e: raises $0.15 to $0.2
868c7021: folds
fcc3c3cc: folds
Uncalled bet ($0.15) returned to dea8bb2e
*** SHOWDOWN ***
dea8bb2e collected $0.12 from pot
*** SUMMARY ***
Total pot $0.12 | Rake $0 | Jackpot $0 | Bingo $0 | Fortune $0 | Tax $0
Seat 1: dea8bb2e (button) collected ($0.12)
Seat 2: 868c7021 (small blind) folded before Flop
Seat 3: fcc3c3cc (big blind) folded before Flop
Seat 4: d9a113f2 folded before Flop (didn't bet)
Seat 5: ead6cfaf folded before Flop (didn't bet)
Seat 6: Hero folded before Flop (didn't bet)


Poker Hand #RC3334437622: Hold'em No Limit ($0.02/$0.05) - 2025/02/17 20:35:48
Table 'RushAndCash602882' 6-max Seat #1 is the button
Seat 1: 4cbff13f ($5.1 in chips)
Seat 2: Hero ($8.49 in chips)
Seat 3: dc00ecae ($5 in chips)
Seat 4: af9df96 ($5.3 in chips)
Seat 5: ee3fdfd8 ($6.1 in chips)
Seat 6: dcee0577 ($5.87 in chips)
Hero: posts small blind $0.02
dc00ecae: posts big blind $0.05
*** HOLE CARDS ***
Dealt to 4cbff13f 
Dealt to Hero [4s 2s]
Dealt to dc00ecae 
Dealt to af9df96 
Dealt to ee3fdfd8 
Dealt to dcee0577 
af9df96: folds
ee3fdfd8: folds
dcee0577: raises $0.07 to $0.12
4cbff13f: folds
Hero: folds
dc00ecae: calls $0.07
*** FLOP *** [5d Jd 5h]
dc00ecae: checks
dcee0577: bets $0.13
dc00ecae: calls $0.13
*** TURN *** [5d Jd 5h] [6c]
dc00ecae: checks
dcee0577: bets $0.18
dc00ecae: raises $0.42 to $0.6
dcee0577: calls $0.42
*** RIVER *** [5d Jd 5h 6c] [Ah]
dc00ecae: bets $1.1
dcee0577: calls $1.1
dc00ecae: shows [9c Ts] (Pair of Fives)
dcee0577: shows [Js Ac] (Pair of Aces and Pair of Jacks)
*** SHOWDOWN ***
dcee0577 collected $3.7 from pot
*** SUMMARY ***
Total pot $3.92 | Rake $0.15 | Jackpot $0.07 | Bingo $0 | Fortune $0 | Tax $0
Board [5d Jd 5h 6c Ah]
Seat 1: 4cbff13f (button) folded before Flop (didn't bet)
Seat 2: Hero (small blind) folded before Flop
Seat 3: dc00ecae (big blind) showed [9c Ts] and lost with Pair of Fives
Seat 4: af9df96 folded before Flop (didn't bet)
Seat 5: ee3fdfd8 folded before Flop (didn't bet)
Seat 6: dcee0577 showed [Js Ac] and won ($3.7) with Pair of Aces and Pair of Jacks


Poker Hand #RC3334437358: Hold'em No Limit ($0.02/$0.05) - 2025/02/17 20:35:12
Table 'RushAndCash602618' 6-max Seat #1 is the button
Seat 1: 9f974160 ($5 in chips)
Seat 2: bfef046a ($5.35 in chips)
Seat 3: 6f086d39 ($5.12 in chips)
Seat 4: Hero ($8.92 in chips)
Seat 5: 9684e9f0 ($5.43 in chips)
Seat 6: 6bc74d1d ($6.91 in chips)
bfef046a: posts small blind $0.02
6f086d39: posts big blind $0.05
*** HOLE CARDS ***
Dealt to 9f974160 
Dealt to bfef046a 
Dealt to 6f086d39 
Dealt to Hero [Ac Qc]
Dealt to 9684e9f0 
Dealt to 6bc74d1d 
Hero: raises $0.05 to $0.1
9684e9f0: folds
6bc74d1d: folds
9f974160: folds
bfef046a: folds
6f086d39: raises $0.33 to $0.43
Hero: calls $0.33
*** FLOP *** [Js 7h 5d]
6f086d39: checks
Hero: checks
*** TURN *** [Js 7h 5d] [Ts]
6f086d39: bets $0.74
Hero: folds
Uncalled bet ($0.74) returned to 6f086d39
*** SHOWDOWN ***
6f086d39 collected $0.84 from pot
*** SUMMARY ***
Total pot $0.88 | Rake $0.04 | Jackpot $0 | Bingo $0 | Fortune $0 | Tax $0
Board [Js 7h 5d Ts]
Seat 1: 9f974160 (button) folded before Flop (didn't bet)
Seat 2: bfef046a (small blind) folded before Flop
Seat 3: 6f086d39 (big blind) won ($0.84)
Seat 4: Hero folded on the Turn
Seat 5: 9684e9f0 folded before Flop (didn't bet)
Seat 6: 6bc74d1d folded before Flop (didn't bet)


Poker Hand #RC3334437330: Hold'em No Limit ($0.02/$0.05) - 2025/02/17 20:35:08
Table 'RushAndCash602590' 6-max Seat #1 is the button
Seat 1: effdb5ef ($4.93 in chips)
Seat 2: a1fd9df7 ($5.36 in chips)
Seat 3: f553bfb4 ($8.72 in chips)
Seat 4: Hero ($8.92 in chips)
Seat 5: 1aae5bdb ($5.73 in chips)
Seat 6: 9b99e93a ($11.29 in chips)
a1fd9df7: posts small blind $0.02
f553bfb4: posts big blind $0.05
*** HOLE CARDS ***
Dealt to effdb5ef 
Dealt to a1fd9df7 
Dealt to f553bfb4 
Dealt to Hero [Qd 2c]
Dealt to 1aae5bdb 
Dealt to 9b99e93a 
Hero: folds
1aae5bdb: folds
9b99e93a: folds
effdb5ef: raises $0.06 to $0.11
a1fd9df7: folds
f553bfb4: folds
Uncalled bet ($0.06) returned to effdb5ef
*** SHOWDOWN ***
effdb5ef collected $0.12 from pot
*** SUMMARY ***
Total pot $0.12 | Rake $0 | Jackpot $0 | Bingo $0 | Fortune $0 | Tax $0
Seat 1: effdb5ef (button) collected ($0.12)
Seat 2: a1fd9df7 (small blind) folded before Flop
Seat 3: f553bfb4 (big blind) folded before Flop
Seat 4: Hero folded before Flop (didn't bet)
Seat 5: 1aae5bdb folded before Flop (didn't bet)
Seat 6: 9b99e93a folded before Flop (didn't bet)


Poker Hand #RC3334437093: Hold'em No Limit ($0.02/$0.05) - 2025/02/17 20:34:33
Table 'RushAndCash602353' 6-max Seat #1 is the button
Seat 1: 9b99e93a ($11.18 in chips)
Seat 2: 730098b8 ($7.45 in chips)
Seat 3: Hero ($9.02 in chips)
Seat 4: 1b8b89c1 ($5.48 in chips)
Seat 5: 36753d76 ($5.57 in chips)
Seat 6: 5381eb4c ($5.64 in chips)
730098b8: posts small blind $0.02
Hero: posts big blind $0.05
*** HOLE CARDS ***
Dealt to 9b99e93a 
Dealt to 730098b8 
Dealt to Hero [3s 3d]
Dealt to 1b8b89c1 
Dealt to 36753d76 
Dealt to 5381eb4c 
1b8b89c1: folds
36753d76: folds
5381eb4c: folds
9b99e93a: raises $0.05 to $0.1
730098b8: folds
Hero: calls $0.05
*** FLOP *** [6c 4d 8h]
Hero: checks
9b99e93a: checks
*** TURN *** [6c 4d 8h] [8c]
Hero: checks
9b99e93a: bets $0.05
Hero: folds
Uncalled bet ($0.05) returned to 9b99e93a
*** SHOWDOWN ***
9b99e93a collected $0.21 from pot
*** SUMMARY ***
Total pot $0.22 | Rake $0.01 | Jackpot $0 | Bingo $0 | Fortune $0 | Tax $0
Board [6c 4d 8h 8c]
Seat 1: 9b99e93a (button) won ($0.21)
Seat 2: 730098b8 (small blind) folded before Flop
Seat 3: Hero (big blind) folded on the Turn
Seat 4: 1b8b89c1 folded before Flop (didn't bet)
Seat 5: 36753d76 folded before Flop (didn't bet)
Seat 6: 5381eb4c folded before Flop (didn't bet)


Poker Hand #RC3334437058: Hold'em No Limit ($0.02/$0.05) - 2025/02/17 20:34:27
Table 'RushAndCash602318' 6-max Seat #1 is the button
Seat 1: Hero ($9.02 in chips)
Seat 2: 3c1ddc3a ($7.19 in chips)
Seat 3: 1696890b ($4.37 in chips)
Seat 4: 94706c35 ($15.24 in chips)
Seat 5: 8023de0f ($6.08 in chips)
Seat 6: 6d5fa70b ($5.94 in chips)
3c1ddc3a: posts small blind $0.02
1696890b: posts big blind $0.05
*** HOLE CARDS ***
Dealt to Hero [4c 9c]
Dealt to 3c1ddc3a 
Dealt to 1696890b 
Dealt to 94706c35 
Dealt to 8023de0f 
Dealt to 6d5fa70b 
94706c35: raises $0.05 to $0.1
8023de0f: folds
6d5fa70b: folds
Hero: folds
3c1ddc3a: calls $0.08
1696890b: raises $0.5 to $0.6
94706c35: folds
3c1ddc3a: folds
Uncalled bet ($0.5) returned to 1696890b
*** SHOWDOWN ***
1696890b collected $0.29 from pot
*** SUMMARY ***
Total pot $0.3 | Rake $0.01 | Jackpot $0 | Bingo $0 | Fortune $0 | Tax $0
Seat 1: Hero (button) folded before Flop (didn't bet)
Seat 2: 3c1ddc3a (small blind) folded before Flop
Seat 3: 1696890b (big blind) collected ($0.29)
Seat 4: 94706c35 folded before Flop
Seat 5: 8023de0f folded before Flop (didn't bet)
Seat 6: 6d5fa70b folded before Flop (didn't bet)


Poker Hand #RC3334437021: Hold'em No Limit ($0.02/$0.05) - 2025/02/17 20:34:22
Table 'RushAndCash602281' 6-max Seat #1 is the button
Seat 1: 18cb11a ($5.44 in chips)
Seat 2: Hero ($9.04 in chips)
Seat 3: 5a37a767 ($5 in chips)
Seat 4: 1b8b89c1 ($5.48 in chips)
Seat 5: 767730bd ($5.86 in chips)
Seat 6: bda9ba33 ($5.27 in chips)
Hero: posts small blind $0.02
5a37a767: posts big blind $0.05
*** HOLE CARDS ***
Dealt to 18cb11a 
Dealt to Hero [Js 8h]
Dealt to 5a37a767 
Dealt to 1b8b89c1 
Dealt to 767730bd 
Dealt to bda9ba33 
1b8b89c1: folds
767730bd: folds
bda9ba33: folds
18cb11a: raises $0.08 to $0.13
Hero: folds
5a37a767: raises $0.38 to $0.51
18cb11a: folds
Uncalled bet ($0.38) returned to 5a37a767
*** SHOWDOWN ***
5a37a767 collected $0.27 from pot
*** SUMMARY ***
Total pot $0.28 | Rake $0.01 | Jackpot $0 | Bingo $0 | Fortune $0 | Tax $0
Seat 1: 18cb11a (button) folded before Flop
Seat 2: Hero (small blind) folded before Flop
Seat 3: 5a37a767 (big blind) collected ($0.27)
Seat 4: 1b8b89c1 folded before Flop (didn't bet)
Seat 5: 767730bd folded before Flop (didn't bet)
Seat 6: bda9ba33 folded before Flop (didn't bet)


Poker Hand #RC3334436951: Hold'em No Limit ($0.02/$0.05) - 2025/02/17 20:34:13
Table 'RushAndCash602211' 6-max Seat #1 is the button
Seat 1: ce479ad2 ($5.34 in chips)
Seat 2: 581575fb ($7.09 in chips)
Seat 3: 23cd2f90 ($2.73 in chips)
Seat 4: Hero ($9.04 in chips)
Seat 5: 5db4cca ($6.01 in chips)
Seat 6: 7b6a3077 ($6.02 in chips)
581575fb: posts small blind $0.02
23cd2f90: posts big blind $0.05
*** HOLE CARDS ***
Dealt to ce479ad2 
Dealt to 581575fb 
Dealt to 23cd2f90 
Dealt to Hero [8s As]
Dealt to 5db4cca 
Dealt to 7b6a3077 
Hero: folds
5db4cca: raises $0.05 to $0.1
7b6a3077: folds
ce479ad2: folds
581575fb: folds
23cd2f90: calls $0.05
*** FLOP *** [5h 8d 6h]
23cd2f90: checks
5db4cca: checks
*** TURN *** [5h 8d 6h] [3s]
23cd2f90: bets $0.11
5db4cca: folds
Uncalled bet ($0.11) returned to 23cd2f90
*** SHOWDOWN ***
23cd2f90 collected $0.21 from pot
*** SUMMARY ***
Total pot $0.22 | Rake $0.01 | Jackpot $0 | Bingo $0 | Fortune $0 | Tax $0
Board [5h 8d 6h 3s]
Seat 1: ce479ad2 (button) folded before Flop (didn't bet)
Seat 2: 581575fb (small blind) folded before Flop
Seat 3: 23cd2f90 (big blind) won ($0.21)
Seat 4: Hero folded before Flop (didn't bet)
Seat 5: 5db4cca folded on the Turn
Seat 6: 7b6a3077 folded before Flop (didn't bet)


Poker Hand #RC3334436929: Hold'em No Limit ($0.02/$0.05) - 2025/02/17 20:34:09
Table 'RushAndCash602189' 6-max Seat #1 is the button
Seat 1: 6f8bb9d1 ($7.03 in chips)
Seat 2: 23cd2f90 ($2.75 in chips)
Seat 3: 9938ef4e ($5.12 in chips)
Seat 4: Hero ($9.04 in chips)
Seat 5: 7b6a3077 ($6.02 in chips)
Seat 6: ef7e6107 ($5.54 in chips)
23cd2f90: posts small blind $0.02
9938ef4e: posts big blind $0.05
*** HOLE CARDS ***
Dealt to 6f8bb9d1 
Dealt to 23cd2f90 
Dealt to 9938ef4e 
Dealt to Hero [4d 8c]
Dealt to 7b6a3077 
Dealt to ef7e6107 
Hero: folds
7b6a3077: folds
ef7e6107: folds
6f8bb9d1: raises $0.07 to $0.12
23cd2f90: folds
9938ef4e: raises $0.43 to $0.55
6f8bb9d1: folds
Uncalled bet ($0.43) returned to 9938ef4e
*** SHOWDOWN ***
9938ef4e collected $0.25 from pot
*** SUMMARY ***
Total pot $0.26 | Rake $0.01 | Jackpot $0 | Bingo $0 | Fortune $0 | Tax $0
Seat 1: 6f8bb9d1 (button) folded before Flop
Seat 2: 23cd2f90 (small blind) folded before Flop
Seat 3: 9938ef4e (big blind) collected ($0.25)
Seat 4: Hero folded before Flop (didn't bet)
Seat 5: 7b6a3077 folded before Flop (didn't bet)
Seat 6: ef7e6107 folded before Flop (didn't bet)


Poker Hand #RC3334436898: Hold'em No Limit ($0.02/$0.05) - 2025/02/17 20:34:05
Table 'RushAndCash602158' 6-max Seat #1 is the button
Seat 1: ef7e6107 ($5.54 in chips)
Seat 2: Hero ($9.06 in chips)
Seat 3: ce479ad2 ($5.32 in chips)
Seat 4: 5fe62400 ($5 in chips)
Seat 5: 742ccfee ($4.09 in chips)
Seat 6: 9babc997 ($5.53 in chips)
Hero: posts small blind $0.02
ce479ad2: posts big blind $0.05
*** HOLE CARDS ***
Dealt to ef7e6107 
Dealt to Hero [9c 6c]
Dealt to ce479ad2 
Dealt to 5fe62400 
Dealt to 742ccfee 
Dealt to 9babc997 
5fe62400: folds
742ccfee: folds
9babc997: folds
ef7e6107: folds
Hero: folds
Uncalled bet ($0.03) returned to ce479ad2
*** SHOWDOWN ***
ce479ad2 collected $0.04 from pot
*** SUMMARY ***
Total pot $0.04 | Rake $0 | Jackpot $0 | Bingo $0 | Fortune $0 | Tax $0
Seat 1: ef7e6107 (button) folded before Flop (didn't bet)
Seat 2: Hero (small blind) folded before Flop
Seat 3: ce479ad2 (big blind) collected ($0.04)
Seat 4: 5fe62400 folded before Flop (didn't bet)
Seat 5: 742ccfee folded before Flop (didn't bet)
Seat 6: 9babc997 folded before Flop (didn't bet)


Poker Hand #RC3334436874: Hold'em No Limit ($0.02/$0.05) - 2025/02/17 20:34:02
Table 'RushAndCash602134' 6-max Seat #1 is the button
Seat 1: Hero ($9.06 in chips)
Seat 2: 85ef1c62 ($5.85 in chips)
Seat 3: 63d707c4 ($5.52 in chips)
Seat 4: 886c894a ($9.5 in chips)
Seat 5: 1937cebf ($5.2 in chips)
Seat 6: 1754e33c ($5.89 in chips)
85ef1c62: posts small blind $0.02
63d707c4: posts big blind $0.05
*** HOLE CARDS ***
Dealt to Hero [4h 6c]
Dealt to 85ef1c62 
Dealt to 63d707c4 
Dealt to 886c894a 
Dealt to 1937cebf 
Dealt to 1754e33c 
886c894a: folds
1937cebf: folds
1754e33c: folds
Hero: folds
85ef1c62: folds
Uncalled bet ($0.03) returned to 63d707c4
*** SHOWDOWN ***
63d707c4 collected $0.04 from pot
*** SUMMARY ***
Total pot $0.04 | Rake $0 | Jackpot $0 | Bingo $0 | Fortune $0 | Tax $0
Seat 1: Hero (button) folded before Flop (didn't bet)
Seat 2: 85ef1c62 (small blind) folded before Flop
Seat 3: 63d707c4 (big blind) collected ($0.04)
Seat 4: 886c894a folded before Flop (didn't bet)
Seat 5: 1937cebf folded before Flop (didn't bet)
Seat 6: 1754e33c folded before Flop (didn't bet)


Poker Hand #RC3334436712: Hold'em No Limit ($0.02/$0.05) - 2025/02/17 20:33:37
Table 'RushAndCash601972' 6-max Seat #1 is the button
Seat 1: 63d707c4 ($5.41 in chips)
Seat 2: 598d859f ($5 in chips)
Seat 3: Hero ($9.16 in chips)
Seat 4: 6e885b98 ($4.95 in chips)
Seat 5: 6f8bb9d1 ($7.15 in chips)
Seat 6: 287f8174 ($7.07 in chips)
598d859f: posts small blind $0.02
Hero: posts big blind $0.05
*** HOLE CARDS ***
Dealt to 63d707c4 
Dealt to 598d859f 
Dealt to Hero [5c 5d]
Dealt to 6e885b98 
Dealt to 6f8bb9d1 
Dealt to 287f8174 
6e885b98: folds
6f8bb9d1: folds
287f8174: folds
63d707c4: raises $0.05 to $0.1
598d859f: folds
Hero: calls $0.05
*** FLOP *** [7d Tc Jh]
Hero: checks
63d707c4: checks
*** TURN *** [7d Tc Jh] [4h]
Hero: checks
63d707c4: bets $0.11
Hero: folds
Uncalled bet ($0.11) returned to 63d707c4
*** SHOWDOWN ***
63d707c4 collected $0.21 from pot
*** SUMMARY ***
Total pot $0.22 | Rake $0.01 | Jackpot $0 | Bingo $0 | Fortune $0 | Tax $0
Board [7d Tc Jh 4h]
Seat 1: 63d707c4 (button) won ($0.21)
Seat 2: 598d859f (small blind) folded before Flop
Seat 3: Hero (big blind) folded on the Turn
Seat 4: 6e885b98 folded before Flop (didn't bet)
Seat 5: 6f8bb9d1 folded before Flop (didn't bet)
Seat 6: 287f8174 folded before Flop (didn't bet)


Poker Hand #RC3334436653: Hold'em No Limit ($0.02/$0.05) - 2025/02/17 20:33:28
Table 'RushAndCash601913' 6-max Seat #1 is the button
Seat 1: 1b6c31ec ($5.54 in chips)
Seat 2: 200ba768 ($4.42 in chips)
Seat 3: 69407b3a ($5.75 in chips)
Seat 4: 32d40ce0 ($7.08 in chips)
Seat 5: 9885e0a0 ($5 in chips)
Seat 6: Hero ($9.16 in chips)
200ba768: posts small blind $0.02
69407b3a: posts big blind $0.05
*** HOLE CARDS ***
Dealt to 1b6c31ec 
Dealt to 200ba768 
Dealt to 69407b3a 
Dealt to 32d40ce0 
Dealt to 9885e0a0 
Dealt to Hero [2d Jc]
32d40ce0: folds
9885e0a0: folds
Hero: folds
1b6c31ec: raises $0.05 to $0.1
200ba768: folds
69407b3a: folds
Uncalled bet ($0.05) returned to 1b6c31ec
*** SHOWDOWN ***
1b6c31ec collected $0.12 from pot
*** SUMMARY ***
Total pot $0.12 | Rake $0 | Jackpot $0 | Bingo $0 | Fortune $0 | Tax $0
Seat 1: 1b6c31ec (button) collected ($0.12)
Seat 2: 200ba768 (small blind) folded before Flop
Seat 3: 69407b3a (big blind) folded before Flop
Seat 4: 32d40ce0 folded before Flop (didn't bet)
Seat 5: 9885e0a0 folded before Flop (didn't bet)
Seat 6: Hero folded before Flop (didn't bet)


Poker Hand #RC3334436292: Hold'em No Limit ($0.02/$0.05) - 2025/02/17 20:32:38
Table 'RushAndCash601552' 6-max Seat #1 is the button
Seat 1: 9a4345c8 ($17.81 in chips)
Seat 2: a21d255c ($5.09 in chips)
Seat 3: 16b0b958 ($5 in chips)
Seat 4: 6d5fa70b ($6.83 in chips)
Seat 5: Hero ($8.91 in chips)
Seat 6: 6be17d4e ($5.22 in chips)
a21d255c: posts small blind $0.02
16b0b958: posts big blind $0.05
*** HOLE CARDS ***
Dealt to 9a4345c8 
Dealt to a21d255c 
Dealt to 16b0b958 
Dealt to 6d5fa70b 
Dealt to Hero [Th Kh]
Dealt to 6be17d4e 
6d5fa70b: folds
Hero: raises $0.05 to $0.1
6be17d4e: folds
9a4345c8: calls $0.1
a21d255c: folds
16b0b958: folds
*** FLOP *** [Kc 9h 3c]
Hero: bets $0.1
9a4345c8: calls $0.1
*** TURN *** [Kc 9h 3c] [Tc]
Hero: bets $0.24
9a4345c8: folds
Uncalled bet ($0.24) returned to Hero
*** SHOWDOWN ***
Hero collected $0.45 from pot
*** SUMMARY ***
Total pot $0.47 | Rake $0.02 | Jackpot $0 | Bingo $0 | Fortune $0 | Tax $0
Board [Kc 9h 3c Tc]
Seat 1: 9a4345c8 (button) folded on the Turn
Seat 2: a21d255c (small blind) folded before Flop
Seat 3: 16b0b958 (big blind) folded before Flop
Seat 4: 6d5fa70b folded before Flop (didn't bet)
Seat 5: Hero won ($0.45)
Seat 6: 6be17d4e folded before Flop (didn't bet)


Poker Hand #RC3334436268: Hold'em No Limit ($0.02/$0.05) - 2025/02/17 20:32:35
Table 'RushAndCash601528' 6-max Seat #1 is the button
Seat 1: 86768906 ($8.78 in chips)
Seat 2: 7b0e5cb2 ($5 in chips)
Seat 3: 8c6b70e4 ($5 in chips)
Seat 4: 84f270f8 ($5.83 in chips)
Seat 5: f7c356b4 ($5 in chips)
Seat 6: Hero ($8.91 in chips)
7b0e5cb2: posts small blind $0.02
8c6b70e4: posts big blind $0.05
*** HOLE CARDS ***
Dealt to 86768906 
Dealt to 7b0e5cb2 
Dealt to 8c6b70e4 
Dealt to 84f270f8 
Dealt to f7c356b4 
Dealt to Hero [4d Qc]
84f270f8: folds
f7c356b4: folds
Hero: folds
86768906: folds
7b0e5cb2: folds
Uncalled bet ($0.03) returned to 8c6b70e4
*** SHOWDOWN ***
8c6b70e4 collected $0.04 from pot
*** SUMMARY ***
Total pot $0.04 | Rake $0 | Jackpot $0 | Bingo $0 | Fortune $0 | Tax $0
Seat 1: 86768906 (button) folded before Flop (didn't bet)
Seat 2: 7b0e5cb2 (small blind) folded before Flop
Seat 3: 8c6b70e4 (big blind) collected ($0.04)
Seat 4: 84f270f8 folded before Flop (didn't bet)
Seat 5: f7c356b4 folded before Flop (didn't bet)
Seat 6: Hero folded before Flop (didn't bet)


Poker Hand #RC3334436244: Hold'em No Limit ($0.02/$0.05) - 2025/02/17 20:32:32
Table 'RushAndCash601504' 6-max Seat #1 is the button
Seat 1: f7c356b4 ($5 in chips)
Seat 2: Hero ($8.93 in chips)
Seat 3: 886c894a ($9.27 in chips)
Seat 4: eaafe260 ($6.43 in chips)
Seat 5: 287f8174 ($6.38 in chips)
Seat 6: fb6c4072 ($6.27 in chips)
Hero: posts small blind $0.02
886c894a: posts big blind $0.05
*** HOLE CARDS ***
Dealt to f7c356b4 
Dealt to Hero [2h Ah]
Dealt to 886c894a 
Dealt to eaafe260 
Dealt to 287f8174 
Dealt to fb6c4072 
eaafe260: folds
287f8174: folds
fb6c4072: folds
f7c356b4: folds
Hero: folds
Uncalled bet ($0.03) returned to 886c894a
*** SHOWDOWN ***
886c894a collected $0.04 from pot
*** SUMMARY ***
Total pot $0.04 | Rake $0 | Jackpot $0 | Bingo $0 | Fortune $0 | Tax $0
Seat 1: f7c356b4 (button) folded before Flop (didn't bet)
Seat 2: Hero (small blind) folded before Flop
Seat 3: 886c894a (big blind) collected ($0.04)
Seat 4: eaafe260 folded before Flop (didn't bet)
Seat 5: 287f8174 folded before Flop (didn't bet)
Seat 6: fb6c4072 folded before Flop (didn't bet)


Poker Hand #RC3334436222: Hold'em No Limit ($0.02/$0.05) - 2025/02/17 20:32:29
Table 'RushAndCash601482' 6-max Seat #1 is the button
Seat 1: 8e5db286 ($7.28 in chips)
Seat 2: e183d966 ($6.26 in chips)
Seat 3: 7570303b ($5.2 in chips)
Seat 4: Hero ($8.93 in chips)
Seat 5: b66d20fa ($17.74 in chips)
Seat 6: 7b6a3077 ($6.41 in chips)
e183d966: posts small blind $0.02
7570303b: posts big blind $0.05
*** HOLE CARDS ***
Dealt to 8e5db286 
Dealt to e183d966 
Dealt to 7570303b 
Dealt to Hero [Jh 4d]
Dealt to b66d20fa 
Dealt to 7b6a3077 
Hero: folds
b66d20fa: folds
7b6a3077: raises $0.05 to $0.1
8e5db286: folds
e183d966: folds
7570303b: calls $0.05
*** FLOP *** [7s 9d 8c]
7570303b: checks
7b6a3077: bets $0.11
7570303b: calls $0.11
*** TURN *** [7s 9d 8c] [Qc]
7570303b: checks
7b6a3077: checks
*** RIVER *** [7s 9d 8c Qc] [Qh]
7570303b: checks
7b6a3077: checks
7570303b: shows [Ts Qs] (Three Queens)
7b6a3077: shows [Td 8d] (Pair of Queens and Pair of Eights)
*** SHOWDOWN ***
7570303b collected $0.42 from pot
*** SUMMARY ***
Total pot $0.44 | Rake $0.02 | Jackpot $0 | Bingo $0 | Fortune $0 | Tax $0
Board [7s 9d 8c Qc Qh]
Seat 1: 8e5db286 (button) folded before Flop (didn't bet)
Seat 2: e183d966 (small blind) folded before Flop
Seat 3: 7570303b (big blind) showed [Ts Qs] and won ($0.42) with Three Queens
Seat 4: Hero folded before Flop (didn't bet)
Seat 5: b66d20fa folded before Flop (didn't bet)
Seat 6: 7b6a3077 showed [Td 8d] and lost with Pair of Queens and Pair of Eights


Poker Hand #RC3334435788: Hold'em No Limit ($0.02/$0.05) - 2025/02/17 20:31:23
Table 'RushAndCash601048' 6-max Seat #1 is the button
Seat 1: 9864109b ($5.39 in chips)
Seat 2: b66d20fa ($18.62 in chips)
Seat 3: Hero ($8.2 in chips)
Seat 4: 9babc997 ($5.56 in chips)
Seat 5: 57d6169c ($5.73 in chips)
Seat 6: 27baaa05 ($7.61 in chips)
b66d20fa: posts small blind $0.02
Hero: posts big blind $0.05
*** HOLE CARDS ***
Dealt to 9864109b 
Dealt to b66d20fa 
Dealt to Hero [Jh Kc]
Dealt to 9babc997 
Dealt to 57d6169c 
Dealt to 27baaa05 
9babc997: folds
57d6169c: folds
27baaa05: folds
9864109b: folds
b66d20fa: raises $0.07 to $0.12
Hero: calls $0.07
*** FLOP *** [9h Ad Kd]
b66d20fa: bets $0.1
Hero: calls $0.1
*** TURN *** [9h Ad Kd] [Kh]
b66d20fa: checks
Hero: bets $0.22
b66d20fa: calls $0.22
*** RIVER *** [9h Ad Kd Kh] [9c]
b66d20fa: checks
Hero: bets $0.44
b66d20fa: calls $0.44
Hero: shows [Jh Kc] (Kings Full over Nines)
b66d20fa: shows [8c Ah] (Pair of Aces and Pair of Kings)
*** SHOWDOWN ***
Hero collected $1.61 from pot
*** SUMMARY ***
Total pot $1.76 | Rake $0.08 | Jackpot $0.07 | Bingo $0 | Fortune $0 | Tax $0
Board [9h Ad Kd Kh 9c]
Seat 1: 9864109b (button) folded before Flop (didn't bet)
Seat 2: b66d20fa (small blind) showed [8c Ah] and lost with Pair of Aces and Pair of Kings
Seat 3: Hero (big blind) showed [Jh Kc] and won ($1.61) with Kings Full over Nines
Seat 4: 9babc997 folded before Flop (didn't bet)
Seat 5: 57d6169c folded before Flop (didn't bet)
Seat 6: 27baaa05 folded before Flop (didn't bet)


Poker Hand #RC3334435753: Hold'em No Limit ($0.02/$0.05) - 2025/02/17 20:31:17
Table 'RushAndCash601013' 6-max Seat #1 is the button
Seat 1: Hero ($8.2 in chips)
Seat 2: cd1f87c8 ($4.4 in chips)
Seat 3: 711af4a4 ($5.22 in chips)
Seat 4: 9babc997 ($5.56 in chips)
Seat 5: a223d3ca ($5.16 in chips)
Seat 6: 9ed6ffbf ($4.28 in chips)
cd1f87c8: posts small blind $0.02
711af4a4: posts big blind $0.05
*** HOLE CARDS ***
Dealt to Hero [6h Td]
Dealt to cd1f87c8 
Dealt to 711af4a4 
Dealt to 9babc997 
Dealt to a223d3ca 
Dealt to 9ed6ffbf 
9babc997: folds
a223d3ca: raises $0.05 to $0.1
9ed6ffbf: folds
Hero: folds
cd1f87c8: folds
711af4a4: calls $0.05
*** FLOP *** [3h 5d Tc]
711af4a4: checks
a223d3ca: checks
*** TURN *** [3h 5d Tc] [Ks]
711af4a4: bets $0.08
a223d3ca: folds
Uncalled bet ($0.08) returned to 711af4a4
*** SHOWDOWN ***
711af4a4 collected $0.21 from pot
*** SUMMARY ***
Total pot $0.22 | Rake $0.01 | Jackpot $0 | Bingo $0 | Fortune $0 | Tax $0
Board [3h 5d Tc Ks]
Seat 1: Hero (button) folded before Flop (didn't bet)
Seat 2: cd1f87c8 (small blind) folded before Flop
Seat 3: 711af4a4 (big blind) won ($0.21)
Seat 4: 9babc997 folded before Flop (didn't bet)
Seat 5: a223d3ca folded on the Turn
Seat 6: 9ed6ffbf folded before Flop (didn't bet)


Poker Hand #RC3334435614: Hold'em No Limit ($0.02/$0.05) - 2025/02/17 20:30:56
Table 'RushAndCash600874' 6-max Seat #1 is the button
Seat 1: a223d3ca ($5 in chips)
Seat 2: e183d966 ($6.33 in chips)
Seat 3: b00c4f8 ($9.8 in chips)
Seat 4: Hero ($8.3 in chips)
Seat 5: cedf4726 ($13.03 in chips)
Seat 6: 4ea8e2e ($13.23 in chips)
e183d966: posts small blind $0.02
b00c4f8: posts big blind $0.05
*** HOLE CARDS ***
Dealt to a223d3ca 
Dealt to e183d966 
Dealt to b00c4f8 
Dealt to Hero [8h 7h]
Dealt to cedf4726 
Dealt to 4ea8e2e 
Hero: raises $0.05 to $0.1
cedf4726: folds
4ea8e2e: folds
a223d3ca: raises $0.2 to $0.3
e183d966: folds
b00c4f8: folds
Hero: folds
Uncalled bet ($0.2) returned to a223d3ca
*** SHOWDOWN ***
a223d3ca collected $0.26 from pot
*** SUMMARY ***
Total pot $0.27 | Rake $0.01 | Jackpot $0 | Bingo $0 | Fortune $0 | Tax $0
Seat 1: a223d3ca (button) collected ($0.26)
Seat 2: e183d966 (small blind) folded before Flop
Seat 3: b00c4f8 (big blind) folded before Flop
Seat 4: Hero folded before Flop
Seat 5: cedf4726 folded before Flop (didn't bet)
Seat 6: 4ea8e2e folded before Flop (didn't bet)


Poker Hand #RC3334435592: Hold'em No Limit ($0.02/$0.05) - 2025/02/17 20:30:53
Table 'RushAndCash600852' 6-max Seat #1 is the button
Seat 1: f108945f ($5 in chips)
Seat 2: 63a77bff ($4.31 in chips)
Seat 3: 7da1f29c ($5.21 in chips)
Seat 4: Hero ($8.3 in chips)
Seat 5: e69e22e ($12.18 in chips)
Seat 6: 6eae6bcb ($8.01 in chips)
63a77bff: posts small blind $0.02
7da1f29c: posts big blind $0.05
*** HOLE CARDS ***
Dealt to f108945f 
Dealt to 63a77bff 
Dealt to 7da1f29c 
Dealt to Hero [Ad 8h]
Dealt to e69e22e 
Dealt to 6eae6bcb 
Hero: folds
e69e22e: folds
6eae6bcb: folds
f108945f: folds
63a77bff: folds
Uncalled bet ($0.03) returned to 7da1f29c
*** SHOWDOWN ***
7da1f29c collected $0.04 from pot
*** SUMMARY ***
Total pot $0.04 | Rake $0 | Jackpot $0 | Bingo $0 | Fortune $0 | Tax $0
Seat 1: f108945f (button) folded before Flop (didn't bet)
Seat 2: 63a77bff (small blind) folded before Flop
Seat 3: 7da1f29c (big blind) collected ($0.04)
Seat 4: Hero folded before Flop (didn't bet)
Seat 5: e69e22e folded before Flop (didn't bet)
Seat 6: 6eae6bcb folded before Flop (didn't bet)


Poker Hand #RC3334435558: Hold'em No Limit ($0.02/$0.05) - 2025/02/17 20:30:48
Table 'RushAndCash600818' 6-max Seat #1 is the button
Seat 1: 6ac4af54 ($11.02 in chips)
Seat 2: ec1d0d44 ($11.24 in chips)
Seat 3: bfef046a ($5 in chips)
Seat 4: 1cc07d8b ($5.82 in chips)
Seat 5: Hero ($8.3 in chips)
Seat 6: 1d0217bc ($5.53 in chips)
ec1d0d44: posts small blind $0.02
bfef046a: posts big blind $0.05
*** HOLE CARDS ***
Dealt to 6ac4af54 
Dealt to ec1d0d44 
Dealt to bfef046a 
Dealt to 1cc07d8b 
Dealt to Hero [Ad 6s]
Dealt to 1d0217bc 
1cc07d8b: folds
Hero: folds
1d0217bc: folds
6ac4af54: raises $0.05 to $0.1
ec1d0d44: folds
bfef046a: calls $0.05
*** FLOP *** [Jd Jc 9d]
bfef046a: checks
6ac4af54: checks
*** TURN *** [Jd Jc 9d] [Qs]
bfef046a: bets $0.1
6ac4af54: calls $0.1
*** RIVER *** [Jd Jc 9d Qs] [2d]
bfef046a: bets $0.34
6ac4af54: folds
Uncalled bet ($0.34) returned to bfef046a
*** SHOWDOWN ***
bfef046a collected $0.4 from pot
*** SUMMARY ***
Total pot $0.42 | Rake $0.02 | Jackpot $0 | Bingo $0 | Fortune $0 | Tax $0
Board [Jd Jc 9d Qs 2d]
Seat 1: 6ac4af54 (button) folded on the River
Seat 2: ec1d0d44 (small blind) folded before Flop
Seat 3: bfef046a (big blind) won ($0.4)
Seat 4: 1cc07d8b folded before Flop (didn't bet)
Seat 5: Hero folded before Flop (didn't bet)
Seat 6: 1d0217bc folded before Flop (didn't bet)


Poker Hand #RC3334435536: Hold'em No Limit ($0.02/$0.05) - 2025/02/17 20:30:44
Table 'RushAndCash600796' 6-max Seat #1 is the button
Seat 1: 84d78f72 ($5 in chips)
Seat 2: Hero ($8.32 in chips)
Seat 3: a28ca95c ($18.78 in chips)
Seat 4: ed38df5e ($5.72 in chips)
Seat 5: 12cda2e0 ($17.08 in chips)
Seat 6: d913286e ($6.03 in chips)
Hero: posts small blind $0.02
a28ca95c: posts big blind $0.05
*** HOLE CARDS ***
Dealt to 84d78f72 
Dealt to Hero [6h Qs]
Dealt to a28ca95c 
Dealt to ed38df5e 
Dealt to 12cda2e0 
Dealt to d913286e 
ed38df5e: folds
12cda2e0: raises $0.08 to $0.13
d913286e: folds
84d78f72: folds
Hero: folds
a28ca95c: folds
Uncalled bet ($0.08) returned to 12cda2e0
*** SHOWDOWN ***
12cda2e0 collected $0.12 from pot
*** SUMMARY ***
Total pot $0.12 | Rake $0 | Jackpot $0 | Bingo $0 | Fortune $0 | Tax $0
Seat 1: 84d78f72 (button) folded before Flop (didn't bet)
Seat 2: Hero (small blind) folded before Flop
Seat 3: a28ca95c (big blind) folded before Flop
Seat 4: ed38df5e folded before Flop (didn't bet)
Seat 5: 12cda2e0 collected ($0.12)
Seat 6: d913286e folded before Flop (didn't bet)


Poker Hand #RC3334435278: Hold'em No Limit ($0.02/$0.05) - 2025/02/17 20:30:04
Table 'RushAndCash600538' 6-max Seat #1 is the button
Seat 1: fb6c4072 ($6.63 in chips)
Seat 2: f8db84a ($5.23 in chips)
Seat 3: Hero ($8.55 in chips)
Seat 4: d913286e ($5.8 in chips)
Seat 5: 568ca15f ($6.08 in chips)
Seat 6: 4c5ef89 ($14.39 in chips)
f8db84a: posts small blind $0.02
Hero: posts big blind $0.05
*** HOLE CARDS ***
Dealt to fb6c4072 
Dealt to f8db84a 
Dealt to Hero [7d 7h]
Dealt to d913286e 
Dealt to 568ca15f 
Dealt to 4c5ef89 
d913286e: raises $0.08 to $0.13
568ca15f: folds
4c5ef89: folds
fb6c4072: folds
f8db84a: folds
Hero: calls $0.08
*** FLOP *** [Jh Kd Jd]
Hero: checks
d913286e: bets $0.1
Hero: calls $0.1
*** TURN *** [Jh Kd Jd] [8h]
Hero: checks
d913286e: checks
*** RIVER *** [Jh Kd Jd 8h] [4c]
Hero: checks
d913286e: checks
Hero: shows [7d 7h] (Pair of Jacks and Pair of Sevens)
d913286e: shows [7c 8c] (Pair of Jacks and Pair of Eights)
*** SHOWDOWN ***
d913286e collected $0.46 from pot
*** SUMMARY ***
Total pot $0.48 | Rake $0.02 | Jackpot $0 | Bingo $0 | Fortune $0 | Tax $0
Board [Jh Kd Jd 8h 4c]
Seat 1: fb6c4072 (button) folded before Flop (didn't bet)
Seat 2: f8db84a (small blind) folded before Flop
Seat 3: Hero (big blind) showed [7d 7h] and lost with Pair of Jacks and Pair of Sevens
Seat 4: d913286e showed [7c 8c] and won ($0.46) with Pair of Jacks and Pair of Eights
Seat 5: 568ca15f folded before Flop (didn't bet)
Seat 6: 4c5ef89 folded before Flop (didn't bet)


Poker Hand #RC3334435261: Hold'em No Limit ($0.02/$0.05) - 2025/02/17 20:30:01
Table 'RushAndCash600521' 6-max Seat #1 is the button
Seat 1: Hero ($8.55 in chips)
Seat 2: fbb9d8f2 ($2.68 in chips)
Seat 3: 626359de ($5.75 in chips)
Seat 4: 4238ab48 ($4.61 in chips)
Seat 5: 4c5ef89 ($14.39 in chips)
Seat 6: 87d9de00 ($3.42 in chips)
fbb9d8f2: posts small blind $0.02
626359de: posts big blind $0.05
*** HOLE CARDS ***
Dealt to Hero [6c Qh]
Dealt to fbb9d8f2 
Dealt to 626359de 
Dealt to 4238ab48 
Dealt to 4c5ef89 
Dealt to 87d9de00 
4238ab48: folds
4c5ef89: folds
87d9de00: folds
Hero: folds
fbb9d8f2: folds
Uncalled bet ($0.03) returned to 626359de
*** SHOWDOWN ***
626359de collected $0.04 from pot
*** SUMMARY ***
Total pot $0.04 | Rake $0 | Jackpot $0 | Bingo $0 | Fortune $0 | Tax $0
Seat 1: Hero (button) folded before Flop (didn't bet)
Seat 2: fbb9d8f2 (small blind) folded before Flop
Seat 3: 626359de (big blind) collected ($0.04)
Seat 4: 4238ab48 folded before Flop (didn't bet)
Seat 5: 4c5ef89 folded before Flop (didn't bet)
Seat 6: 87d9de00 folded before Flop (didn't bet)


Poker Hand #RC3334435240: Hold'em No Limit ($0.02/$0.05) - 2025/02/17 20:29:58
Table 'RushAndCash600500' 6-max Seat #1 is the button
Seat 1: 2bfb551a ($5.26 in chips)
Seat 2: f1ef2c72 ($9.06 in chips)
Seat 3: 1f7fd8bc ($5.91 in chips)
Seat 4: 37558bf9 ($5.81 in chips)
Seat 5: Hero ($8.55 in chips)
Seat 6: 77936ad9 ($5.88 in chips)
f1ef2c72: posts small blind $0.02
1f7fd8bc: posts big blind $0.05
*** HOLE CARDS ***
Dealt to 2bfb551a 
Dealt to f1ef2c72 
Dealt to 1f7fd8bc 
Dealt to 37558bf9 
Dealt to Hero [9s 7h]
Dealt to 77936ad9 
37558bf9: raises $0.05 to $0.1
Hero: folds
77936ad9: folds
2bfb551a: folds
f1ef2c72: calls $0.08
1f7fd8bc: folds
*** FLOP *** [As 3c 9c]
f1ef2c72: checks
37558bf9: bets $0.09
f1ef2c72: raises $0.15 to $0.24
37558bf9: calls $0.15
*** TURN *** [As 3c 9c] [7c]
f1ef2c72: checks
37558bf9: checks
*** RIVER *** [As 3c 9c 7c] [Ah]
f1ef2c72: bets $0.37
37558bf9: folds
Uncalled bet ($0.37) returned to f1ef2c72
*** SHOWDOWN ***
f1ef2c72 collected $0.7 from pot
*** SUMMARY ***
Total pot $0.73 | Rake $0.03 | Jackpot $0 | Bingo $0 | Fortune $0 | Tax $0
Board [As 3c 9c 7c Ah]
Seat 1: 2bfb551a (button) folded before Flop (didn't bet)
Seat 2: f1ef2c72 (small blind) won ($0.7)
Seat 3: 1f7fd8bc (big blind) folded before Flop
Seat 4: 37558bf9 folded on the River
Seat 5: Hero folded before Flop (didn't bet)
Seat 6: 77936ad9 folded before Flop (didn't bet)


Poker Hand #RC3334435160: Hold'em No Limit ($0.02/$0.05) - 2025/02/17 20:29:47
Table 'RushAndCash600420' 6-max Seat #1 is the button
Seat 1: 5c64b878 ($5.48 in chips)
Seat 2: db83c16e ($4.95 in chips)
Seat 3: ae7aea10 ($8.32 in chips)
Seat 4: Hero ($8.55 in chips)
Seat 5: 6c122cb5 ($6.86 in chips)
Seat 6: c95c6ae6 ($13.77 in chips)
db83c16e: posts small blind $0.02
ae7aea10: posts big blind $0.05
*** HOLE CARDS ***
Dealt to 5c64b878 
Dealt to db83c16e 
Dealt to ae7aea10 
Dealt to Hero [Jd 8s]
Dealt to 6c122cb5 
Dealt to c95c6ae6 
Hero: folds
6c122cb5: folds
c95c6ae6: folds
5c64b878: raises $0.05 to $0.1
db83c16e: folds
ae7aea10: calls $0.05
*** FLOP *** [4c Jh Ac]
ae7aea10: checks
5c64b878: checks
*** TURN *** [4c Jh Ac] [7d]
ae7aea10: checks
5c64b878: checks
*** RIVER *** [4c Jh Ac 7d] [9d]
ae7aea10: checks
5c64b878: checks
ae7aea10: shows [Qc Ks] (Ace-High)
5c64b878: shows [Qh 6h] (Ace-High)
*** SHOWDOWN ***
ae7aea10 collected $0.21 from pot
*** SUMMARY ***
Total pot $0.22 | Rake $0.01 | Jackpot $0 | Bingo $0 | Fortune $0 | Tax $0
Board [4c Jh Ac 7d 9d]
Seat 1: 5c64b878 (button) showed [Qh 6h] and lost with Ace-High
Seat 2: db83c16e (small blind) folded before Flop
Seat 3: ae7aea10 (big blind) showed [Qc Ks] and won ($0.21) with Ace-High
Seat 4: Hero folded before Flop (didn't bet)
Seat 5: 6c122cb5 folded before Flop (didn't bet)
Seat 6: c95c6ae6 folded before Flop (didn't bet)


Poker Hand #RC3334435141: Hold'em No Limit ($0.02/$0.05) - 2025/02/17 20:29:44
Table 'RushAndCash600401' 6-max Seat #1 is the button
Seat 1: 86d9f390 ($5.21 in chips)
Seat 2: 5ebadbd5 ($5.76 in chips)
Seat 3: 188c8947 ($4.04 in chips)
Seat 4: 1b8b89c1 ($5.22 in chips)
Seat 5: Hero ($8.55 in chips)
Seat 6: 598d859f ($9.37 in chips)
5ebadbd5: posts small blind $0.02
188c8947: posts big blind $0.05
*** HOLE CARDS ***
Dealt to 86d9f390 
Dealt to 5ebadbd5 
Dealt to 188c8947 
Dealt to 1b8b89c1 
Dealt to Hero [7s Qd]
Dealt to 598d859f 
1b8b89c1: folds
Hero: folds
598d859f: raises $0.08 to $0.13
86d9f390: folds
5ebadbd5: raises $0.18 to $0.31
188c8947: folds
598d859f: raises $0.49 to $0.8
5ebadbd5: raises $0.8 to $1.6
598d859f: calls $0.8
*** FLOP *** [9c 3s 4c]
5ebadbd5: checks
598d859f: checks
*** TURN *** [9c 3s 4c] [3c]
5ebadbd5: bets $1.79
598d859f: calls $1.79
*** RIVER *** [9c 3s 4c 3c] [9h]
5ebadbd5: bets $2.37 and is all-in
598d859f: calls $2.37
5ebadbd5: shows [Ad Ac] (Pair of Aces and Pair of Nines)
598d859f: shows [Jh Js] (Pair of Jacks and Pair of Nines)
*** SHOWDOWN ***
5ebadbd5 collected $11.35 from pot
*** SUMMARY ***
Total pot $11.57 | Rake $0.15 | Jackpot $0.07 | Bingo $0 | Fortune $0 | Tax $0
Board [9c 3s 4c 3c 9h]
Seat 1: 86d9f390 (button) folded before Flop (didn't bet)
Seat 2: 5ebadbd5 (small blind) showed [Ad Ac] and won ($11.35) with Pair of Aces and Pair of Nines
Seat 3: 188c8947 (big blind) folded before Flop
Seat 4: 1b8b89c1 folded before Flop (didn't bet)
Seat 5: Hero folded before Flop (didn't bet)
Seat 6: 598d859f showed [Jh Js] and lost with Pair of Jacks and Pair of Nines


Poker Hand #RC3334435121: Hold'em No Limit ($0.02/$0.05) - 2025/02/17 20:29:41
Table 'RushAndCash600381' 6-max Seat #1 is the button
Seat 1: d1f305bd ($4.11 in chips)
Seat 2: Hero ($8.57 in chips)
Seat 3: 9f09d482 ($6.82 in chips)
Seat 4: 8c3789e ($6.39 in chips)
Seat 5: 94706c35 ($14.57 in chips)
Seat 6: 29471264 ($4.98 in chips)
Hero: posts small blind $0.02
9f09d482: posts big blind $0.05
*** HOLE CARDS ***
Dealt to d1f305bd 
Dealt to Hero [Kh 4c]
Dealt to 9f09d482 
Dealt to 8c3789e 
Dealt to 94706c35 
Dealt to 29471264 
8c3789e: folds
94706c35: folds
29471264: folds
d1f305bd: folds
Hero: folds
Uncalled bet ($0.03) returned to 9f09d482
*** SHOWDOWN ***
9f09d482 collected $0.04 from pot
*** SUMMARY ***
Total pot $0.04 | Rake $0 | Jackpot $0 | Bingo $0 | Fortune $0 | Tax $0
Seat 1: d1f305bd (button) folded before Flop (didn't bet)
Seat 2: Hero (small blind) folded before Flop
Seat 3: 9f09d482 (big blind) collected ($0.04)
Seat 4: 8c3789e folded before Flop (didn't bet)
Seat 5: 94706c35 folded before Flop (didn't bet)
Seat 6: 29471264 folded before Flop (didn't bet)


Poker Hand #RC3334435096: Hold'em No Limit ($0.02/$0.05) - 2025/02/17 20:29:37
Table 'RushAndCash600356' 6-max Seat #1 is the button
Seat 1: 16081ce9 ($10.66 in chips)
Seat 2: dea8bb2e ($5.63 in chips)
Seat 3: 3b85f8e6 ($12.31 in chips)
Seat 4: f553bfb4 ($7.04 in chips)
Seat 5: 8896706d ($5.92 in chips)
Seat 6: Hero ($8.57 in chips)
dea8bb2e: posts small blind $0.02
3b85f8e6: posts big blind $0.05
*** HOLE CARDS ***
Dealt to 16081ce9 
Dealt to dea8bb2e 
Dealt to 3b85f8e6 
Dealt to f553bfb4 
Dealt to 8896706d 
Dealt to Hero [8d 6c]
f553bfb4: folds
8896706d: folds
Hero: folds
16081ce9: folds
dea8bb2e: folds
Uncalled bet ($0.03) returned to 3b85f8e6
*** SHOWDOWN ***
3b85f8e6 collected $0.04 from pot
*** SUMMARY ***
Total pot $0.04 | Rake $0 | Jackpot $0 | Bingo $0 | Fortune $0 | Tax $0
Seat 1: 16081ce9 (button) folded before Flop (didn't bet)
Seat 2: dea8bb2e (small blind) folded before Flop
Seat 3: 3b85f8e6 (big blind) collected ($0.04)
Seat 4: f553bfb4 folded before Flop (didn't bet)
Seat 5: 8896706d folded before Flop (didn't bet)
Seat 6: Hero folded before Flop (didn't bet)


Poker Hand #RC3334435075: Hold'em No Limit ($0.02/$0.05) - 2025/02/17 20:29:34
Table 'RushAndCash600335' 6-max Seat #1 is the button
Seat 1: Hero ($8.57 in chips)
Seat 2: 9ec2ef41 ($8.14 in chips)
Seat 3: 727998e7 ($7.38 in chips)
Seat 4: 1165d8f0 ($5 in chips)
Seat 5: 12cda2e0 ($17.26 in chips)
Seat 6: 36753d76 ($5.25 in chips)
9ec2ef41: posts small blind $0.02
727998e7: posts big blind $0.05
*** HOLE CARDS ***
Dealt to Hero [9h 8s]
Dealt to 9ec2ef41 
Dealt to 727998e7 
Dealt to 1165d8f0 
Dealt to 12cda2e0 
Dealt to 36753d76 
1165d8f0: folds
12cda2e0: raises $0.05 to $0.1
36753d76: folds
Hero: folds
9ec2ef41: folds
727998e7: folds
Uncalled bet ($0.05) returned to 12cda2e0
*** SHOWDOWN ***
12cda2e0 collected $0.12 from pot
*** SUMMARY ***
Total pot $0.12 | Rake $0 | Jackpot $0 | Bingo $0 | Fortune $0 | Tax $0
Seat 1: Hero (button) folded before Flop (didn't bet)
Seat 2: 9ec2ef41 (small blind) folded before Flop
Seat 3: 727998e7 (big blind) folded before Flop
Seat 4: 1165d8f0 folded before Flop (didn't bet)
Seat 5: 12cda2e0 collected ($0.12)
Seat 6: 36753d76 folded before Flop (didn't bet)


Poker Hand #RC3334435047: Hold'em No Limit ($0.02/$0.05) - 2025/02/17 20:29:30
Table 'RushAndCash600307' 6-max Seat #1 is the button
Seat 1: a2794999 ($7.9 in chips)
Seat 2: 29471264 ($5 in chips)
Seat 3: Hero ($8.62 in chips)
Seat 4: 7b6a3077 ($6.42 in chips)
Seat 5: 1a54a2fc ($5.02 in chips)
Seat 6: 92099542 ($10.54 in chips)
29471264: posts small blind $0.02
Hero: posts big blind $0.05
*** HOLE CARDS ***
Dealt to a2794999 
Dealt to 29471264 
Dealt to Hero [4c Kd]
Dealt to 7b6a3077 
Dealt to 1a54a2fc 
Dealt to 92099542 
7b6a3077: raises $0.1 to $0.15
1a54a2fc: folds
92099542: folds
a2794999: folds
29471264: folds
Hero: folds
Uncalled bet ($0.1) returned to 7b6a3077
*** SHOWDOWN ***
7b6a3077 collected $0.12 from pot
*** SUMMARY ***
Total pot $0.12 | Rake $0 | Jackpot $0 | Bingo $0 | Fortune $0 | Tax $0
Seat 1: a2794999 (button) folded before Flop (didn't bet)
Seat 2: 29471264 (small blind) folded before Flop
Seat 3: Hero (big blind) folded before Flop
Seat 4: 7b6a3077 collected ($0.12)
Seat 5: 1a54a2fc folded before Flop (didn't bet)
Seat 6: 92099542 folded before Flop (didn't bet)


Poker Hand #RC3334434853: Hold'em No Limit ($0.02/$0.05) - 2025/02/17 20:28:59
Table 'RushAndCash600113' 6-max Seat #1 is the button
Seat 1: cf7f09c2 ($10.56 in chips)
Seat 2: Hero ($9.34 in chips)
Seat 3: 9a69a3a0 ($5 in chips)
Seat 4: 64e5de41 ($5.32 in chips)
Seat 5: c8e834fc ($3.85 in chips)
Seat 6: 5a37a767 ($5.69 in chips)
Hero: posts small blind $0.02
9a69a3a0: posts big blind $0.05
*** HOLE CARDS ***
Dealt to cf7f09c2 
Dealt to Hero [Ah Qd]
Dealt to 9a69a3a0 
Dealt to 64e5de41 
Dealt to c8e834fc 
Dealt to 5a37a767 
64e5de41: folds
c8e834fc: raises $0.05 to $0.1
5a37a767: folds
cf7f09c2: folds
Hero: raises $0.32 to $0.42
9a69a3a0: folds
c8e834fc: calls $0.32
*** FLOP *** [3d Kd 4c]
Hero: bets $0.3
c8e834fc: calls $0.3
*** TURN *** [3d Kd 4c] [6c]
Hero: checks
c8e834fc: bets $0.75
Hero: folds
Uncalled bet ($0.75) returned to c8e834fc
*** SHOWDOWN ***
c8e834fc collected $1.42 from pot
*** SUMMARY ***
Total pot $1.49 | Rake $0.07 | Jackpot $0 | Bingo $0 | Fortune $0 | Tax $0
Board [3d Kd 4c 6c]
Seat 1: cf7f09c2 (button) folded before Flop (didn't bet)
Seat 2: Hero (small blind) folded on the Turn
Seat 3: 9a69a3a0 (big blind) folded before Flop
Seat 4: 64e5de41 folded before Flop (didn't bet)
Seat 5: c8e834fc won ($1.42)
Seat 6: 5a37a767 folded before Flop (didn't bet)


Poker Hand #RC3334434829: Hold'em No Limit ($0.02/$0.05) - 2025/02/17 20:28:55
Table 'RushAndCash600089' 6-max Seat #1 is the button
Seat 1: 3ad61ed1 ($5.44 in chips)
Seat 2: 1a54a2fc ($5 in chips)
Seat 3: 803e9f05 ($6.44 in chips)
Seat 4: Hero ($9.34 in chips)
Seat 5: 50d9f656 ($5.93 in chips)
Seat 6: c24b20b9 ($17.7 in chips)
1a54a2fc: posts small blind $0.02
803e9f05: posts big blind $0.05
*** HOLE CARDS ***
Dealt to 3ad61ed1 
Dealt to 1a54a2fc 
Dealt to 803e9f05 
Dealt to Hero [Qc 6d]
Dealt to 50d9f656 
Dealt to c24b20b9 
Hero: folds
50d9f656: folds
c24b20b9: folds
3ad61ed1: folds
1a54a2fc: folds
Uncalled bet ($0.03) returned to 803e9f05
*** SHOWDOWN ***
803e9f05 collected $0.04 from pot
*** SUMMARY ***
Total pot $0.04 | Rake $0 | Jackpot $0 | Bingo $0 | Fortune $0 | Tax $0
Seat 1: 3ad61ed1 (button) folded before Flop (didn't bet)
Seat 2: 1a54a2fc (small blind) folded before Flop
Seat 3: 803e9f05 (big blind) collected ($0.04)
Seat 4: Hero folded before Flop (didn't bet)
Seat 5: 50d9f656 folded before Flop (didn't bet)
Seat 6: c24b20b9 folded before Flop (didn't bet)


Poker Hand #RC3334434807: Hold'em No Limit ($0.02/$0.05) - 2025/02/17 20:28:52
Table 'RushAndCash600067' 6-max Seat #1 is the button
Seat 1: c95c6ae6 ($14.11 in chips)
Seat 2: 1696890b ($5.23 in chips)
Seat 3: 570c97fe ($5.19 in chips)
Seat 4: 5f8248c5 ($3.73 in chips)
Seat 5: 79df293 ($5.13 in chips)
Seat 6: Hero ($9.34 in chips)
1696890b: posts small blind $0.02
570c97fe: posts big blind $0.05
*** HOLE CARDS ***
Dealt to c95c6ae6 
Dealt to 1696890b 
Dealt to 570c97fe 
Dealt to 5f8248c5 
Dealt to 79df293 
Dealt to Hero [8s 2s]
5f8248c5: folds
79df293: folds
Hero: folds
c95c6ae6: folds
1696890b: raises $0.1 to $0.15
570c97fe: calls $0.1
*** FLOP *** [8d Kc Tc]
1696890b: bets $0.25
570c97fe: folds
Uncalled bet ($0.25) returned to 1696890b
*** SHOWDOWN ***
1696890b collected $0.29 from pot
*** SUMMARY ***
Total pot $0.3 | Rake $0.01 | Jackpot $0 | Bingo $0 | Fortune $0 | Tax $0
Board [8d Kc Tc]
Seat 1: c95c6ae6 (button) folded before Flop (didn't bet)
Seat 2: 1696890b (small blind) won ($0.29)
Seat 3: 570c97fe (big blind) folded on the Flop
Seat 4: 5f8248c5 folded before Flop (didn't bet)
Seat 5: 79df293 folded before Flop (didn't bet)
Seat 6: Hero folded before Flop (didn't bet)


Poker Hand #RC3334374698: Hold'em No Limit ($0.02/$0.05) - 2025/02/17 20:28:37
Table 'RushAndCash599958' 6-max Seat #1 is the button
Seat 1: 12cda2e0 ($17.1 in chips)
Seat 2: 68b3fe79 ($5.53 in chips)
Seat 3: Hero ($9.32 in chips)
Seat 4: 56cefdc9 ($2.92 in chips)
Seat 5: e183d966 ($6.03 in chips)
Seat 6: 94c257a9 ($4.93 in chips)
68b3fe79: posts small blind $0.02
Hero: posts big blind $0.05
*** HOLE CARDS ***
Dealt to 12cda2e0 
Dealt to 68b3fe79 
Dealt to Hero [Qc 7c]
Dealt to 56cefdc9 
Dealt to e183d966 
Dealt to 94c257a9 
56cefdc9: folds
e183d966: folds
94c257a9: folds
12cda2e0: folds
68b3fe79: folds
Uncalled bet ($0.03) returned to Hero
*** SHOWDOWN ***
Hero collected $0.04 from pot
*** SUMMARY ***
Total pot $0.04 | Rake $0 | Jackpot $0 | Bingo $0 | Fortune $0 | Tax $0
Seat 1: 12cda2e0 (button) folded before Flop (didn't bet)
Seat 2: 68b3fe79 (small blind) folded before Flop
Seat 3: Hero (big blind) collected ($0.04)
Seat 4: 56cefdc9 folded before Flop (didn't bet)
Seat 5: e183d966 folded before Flop (didn't bet)
Seat 6: 94c257a9 folded before Flop (didn't bet)


Poker Hand #RC3334374675: Hold'em No Limit ($0.02/$0.05) - 2025/02/17 20:28:34
Table 'RushAndCash599935' 6-max Seat #1 is the button
Seat 1: Hero ($9.32 in chips)
Seat 2: f171b990 ($6.12 in chips)
Seat 3: c4eb9775 ($17.59 in chips)
Seat 4: bb702030 ($8.02 in chips)
Seat 5: 436ecab0 ($2.7 in chips)
Seat 6: f5fcc522 ($10.55 in chips)
f171b990: posts small blind $0.02
c4eb9775: posts big blind $0.05
*** HOLE CARDS ***
Dealt to Hero [Ad 5c]
Dealt to f171b990 
Dealt to c4eb9775 
Dealt to bb702030 
Dealt to 436ecab0 
Dealt to f5fcc522 
bb702030: folds
436ecab0: folds
f5fcc522: folds
Hero: folds
f171b990: raises $0.07 to $0.12
c4eb9775: folds
Uncalled bet ($0.07) returned to f171b990
*** SHOWDOWN ***
f171b990 collected $0.1 from pot
*** SUMMARY ***
Total pot $0.1 | Rake $0 | Jackpot $0 | Bingo $0 | Fortune $0 | Tax $0
Seat 1: Hero (button) folded before Flop (didn't bet)
Seat 2: f171b990 (small blind) collected ($0.1)
Seat 3: c4eb9775 (big blind) folded before Flop
Seat 4: bb702030 folded before Flop (didn't bet)
Seat 5: 436ecab0 folded before Flop (didn't bet)
Seat 6: f5fcc522 folded before Flop (didn't bet)


Poker Hand #RC3334374653: Hold'em No Limit ($0.02/$0.05) - 2025/02/17 20:28:31
Table 'RushAndCash599913' 6-max Seat #1 is the button
Seat 1: c4eb9775 ($17.59 in chips)
Seat 2: 7a5bf293 ($6.85 in chips)
Seat 3: d201e5fe ($6.54 in chips)
Seat 4: Hero ($9.32 in chips)
Seat 5: 9babc997 ($5.49 in chips)
Seat 6: a6f4352b ($5.04 in chips)
7a5bf293: posts small blind $0.02
d201e5fe: posts big blind $0.05
*** HOLE CARDS ***
Dealt to c4eb9775 
Dealt to 7a5bf293 
Dealt to d201e5fe 
Dealt to Hero [Th 7s]
Dealt to 9babc997 
Dealt to a6f4352b 
Hero: folds
9babc997: raises $0.07 to $0.12
a6f4352b: folds
c4eb9775: folds
7a5bf293: folds
d201e5fe: folds
Uncalled bet ($0.07) returned to 9babc997
*** SHOWDOWN ***
9babc997 collected $0.12 from pot
*** SUMMARY ***
Total pot $0.12 | Rake $0 | Jackpot $0 | Bingo $0 | Fortune $0 | Tax $0
Seat 1: c4eb9775 (button) folded before Flop (didn't bet)
Seat 2: 7a5bf293 (small blind) folded before Flop
Seat 3: d201e5fe (big blind) folded before Flop
Seat 4: Hero folded before Flop (didn't bet)
Seat 5: 9babc997 collected ($0.12)
Seat 6: a6f4352b folded before Flop (didn't bet)


Poker Hand #RC3334374633: Hold'em No Limit ($0.02/$0.05) - 2025/02/17 20:28:28
Table 'RushAndCash599893' 6-max Seat #1 is the button
Seat 1: 8508a44f ($5 in chips)
Seat 2: df0ebddc ($5.09 in chips)
Seat 3: 84b68722 ($18.32 in chips)
Seat 4: 3ffd6491 ($5.46 in chips)
Seat 5: Hero ($9.32 in chips)
Seat 6: 14620cce ($15.92 in chips)
df0ebddc: posts small blind $0.02
84b68722: posts big blind $0.05
*** HOLE CARDS ***
Dealt to 8508a44f 
Dealt to df0ebddc 
Dealt to 84b68722 
Dealt to 3ffd6491 
Dealt to Hero [4d 5h]
Dealt to 14620cce 
3ffd6491: folds
Hero: folds
14620cce: raises $0.08 to $0.13
8508a44f: folds
df0ebddc: folds
84b68722: folds
Uncalled bet ($0.08) returned to 14620cce
*** SHOWDOWN ***
14620cce collected $0.12 from pot
*** SUMMARY ***
Total pot $0.12 | Rake $0 | Jackpot $0 | Bingo $0 | Fortune $0 | Tax $0
Seat 1: 8508a44f (button) folded before Flop (didn't bet)
Seat 2: df0ebddc (small blind) folded before Flop
Seat 3: 84b68722 (big blind) folded before Flop
Seat 4: 3ffd6491 folded before Flop (didn't bet)
Seat 5: Hero folded before Flop (didn't bet)
Seat 6: 14620cce collected ($0.12)


Poker Hand #RC3334374613: Hold'em No Limit ($0.02/$0.05) - 2025/02/17 20:28:25
Table 'RushAndCash599873' 6-max Seat #1 is the button
Seat 1: 4c5ef89 ($14.59 in chips)
Seat 2: 73df9e15 ($5.57 in chips)
Seat 3: 856cc88a ($4.97 in chips)
Seat 4: f8db84a ($5.1 in chips)
Seat 5: Hero ($9.32 in chips)
Seat 6: 16081ce9 ($10.66 in chips)
73df9e15: posts small blind $0.02
856cc88a: posts big blind $0.05
*** HOLE CARDS ***
Dealt to 4c5ef89 
Dealt to 73df9e15 
Dealt to 856cc88a 
Dealt to f8db84a 
Dealt to Hero [3d Kc]
Dealt to 16081ce9 
f8db84a: raises $0.06 to $0.11
Hero: folds
16081ce9: folds
4c5ef89: folds
73df9e15: folds
856cc88a: folds
Uncalled bet ($0.06) returned to f8db84a
*** SHOWDOWN ***
f8db84a collected $0.12 from pot
*** SUMMARY ***
Total pot $0.12 | Rake $0 | Jackpot $0 | Bingo $0 | Fortune $0 | Tax $0
Seat 1: 4c5ef89 (button) folded before Flop (didn't bet)
Seat 2: 73df9e15 (small blind) folded before Flop
Seat 3: 856cc88a (big blind) folded before Flop
Seat 4: f8db84a collected ($0.12)
Seat 5: Hero folded before Flop (didn't bet)
Seat 6: 16081ce9 folded before Flop (didn't bet)


Poker Hand #RC3334374592: Hold'em No Limit ($0.02/$0.05) - 2025/02/17 20:28:22
Table 'RushAndCash599852' 6-max Seat #1 is the button
Seat 1: Hero ($9.32 in chips)
Seat 2: ed38df5e ($5 in chips)
Seat 3: 32d40ce0 ($6.58 in chips)
Seat 4: e3c5673f ($4.93 in chips)
Seat 5: e3608384 ($5.39 in chips)
Seat 6: bfef046a ($5.07 in chips)
ed38df5e: posts small blind $0.02
32d40ce0: posts big blind $0.05
*** HOLE CARDS ***
Dealt to Hero [2s 8s]
Dealt to ed38df5e 
Dealt to 32d40ce0 
Dealt to e3c5673f 
Dealt to e3608384 
Dealt to bfef046a 
e3c5673f: folds
e3608384: folds
bfef046a: folds
Hero: folds
ed38df5e: folds
Uncalled bet ($0.03) returned to 32d40ce0
*** SHOWDOWN ***
32d40ce0 collected $0.04 from pot
*** SUMMARY ***
Total pot $0.04 | Rake $0 | Jackpot $0 | Bingo $0 | Fortune $0 | Tax $0
Seat 1: Hero (button) folded before Flop (didn't bet)
Seat 2: ed38df5e (small blind) folded before Flop
Seat 3: 32d40ce0 (big blind) collected ($0.04)
Seat 4: e3c5673f folded before Flop (didn't bet)
Seat 5: e3608384 folded before Flop (didn't bet)
Seat 6: bfef046a folded before Flop (didn't bet)


Poker Hand #RC3334374569: Hold'em No Limit ($0.02/$0.05) - 2025/02/17 20:28:19
Table 'RushAndCash599829' 6-max Seat #1 is the button
Seat 1: 1f7fd8bc ($6.08 in chips)
Seat 2: Hero ($9.34 in chips)
Seat 3: e4d8df1d ($6.6 in chips)
Seat 4: bfef046a ($5.07 in chips)
Seat 5: 64e5de41 ($5.39 in chips)
Seat 6: 12cda2e0 ($17.12 in chips)
Hero: posts small blind $0.02
e4d8df1d: posts big blind $0.05
*** HOLE CARDS ***
Dealt to 1f7fd8bc 
Dealt to Hero [7h 6s]
Dealt to e4d8df1d 
Dealt to bfef046a 
Dealt to 64e5de41 
Dealt to 12cda2e0 
bfef046a: folds
64e5de41: folds
12cda2e0: folds
1f7fd8bc: folds
Hero: folds
Uncalled bet ($0.03) returned to e4d8df1d
*** SHOWDOWN ***
e4d8df1d collected $0.04 from pot
*** SUMMARY ***
Total pot $0.04 | Rake $0 | Jackpot $0 | Bingo $0 | Fortune $0 | Tax $0
Seat 1: 1f7fd8bc (button) folded before Flop (didn't bet)
Seat 2: Hero (small blind) folded before Flop
Seat 3: e4d8df1d (big blind) collected ($0.04)
Seat 4: bfef046a folded before Flop (didn't bet)
Seat 5: 64e5de41 folded before Flop (didn't bet)
Seat 6: 12cda2e0 folded before Flop (didn't bet)


Poker Hand #RC3334374517: Hold'em No Limit ($0.02/$0.05) - 2025/02/17 20:28:10
Table 'RushAndCash599777' 6-max Seat #1 is the button
Seat 1: 48fa5407 ($5 in chips)
Seat 2: d32b2e06 ($9.81 in chips)
Seat 3: Hero ($9.39 in chips)
Seat 4: 1d2427ef ($5.87 in chips)
Seat 5: 82656056 ($5.26 in chips)
Seat 6: 8ffbb474 ($7.3 in chips)
d32b2e06: posts small blind $0.02
Hero: posts big blind $0.05
*** HOLE CARDS ***
Dealt to 48fa5407 
Dealt to d32b2e06 
Dealt to Hero [2d 5s]
Dealt to 1d2427ef 
Dealt to 82656056 
Dealt to 8ffbb474 
1d2427ef: folds
82656056: raises $0.06 to $0.11
8ffbb474: folds
48fa5407: folds
d32b2e06: folds
Hero: folds
Uncalled bet ($0.06) returned to 82656056
*** SHOWDOWN ***
82656056 collected $0.12 from pot
*** SUMMARY ***
Total pot $0.12 | Rake $0 | Jackpot $0 | Bingo $0 | Fortune $0 | Tax $0
Seat 1: 48fa5407 (button) folded before Flop (didn't bet)
Seat 2: d32b2e06 (small blind) folded before Flop
Seat 3: Hero (big blind) folded before Flop
Seat 4: 1d2427ef folded before Flop (didn't bet)
Seat 5: 82656056 collected ($0.12)
Seat 6: 8ffbb474 folded before Flop (didn't bet)


Poker Hand #RC3334374483: Hold'em No Limit ($0.02/$0.05) - 2025/02/17 20:28:05
Table 'RushAndCash599743' 6-max Seat #1 is the button
Seat 1: 123dc5ea ($5 in chips)
Seat 2: 8cbee864 ($5.16 in chips)
Seat 3: e3c5673f ($5 in chips)
Seat 4: Hero ($9.39 in chips)
Seat 5: 64e5de41 ($5.46 in chips)
Seat 6: 14620cce ($15.94 in chips)
8cbee864: posts small blind $0.02
e3c5673f: posts big blind $0.05
*** HOLE CARDS ***
Dealt to 123dc5ea 
Dealt to 8cbee864 
Dealt to e3c5673f 
Dealt to Hero [8c As]
Dealt to 64e5de41 
Dealt to 14620cce 
Hero: folds
64e5de41: folds
14620cce: folds
123dc5ea: folds
8cbee864: raises $0.07 to $0.12
e3c5673f: folds
Uncalled bet ($0.07) returned to 8cbee864
*** SHOWDOWN ***
8cbee864 collected $0.1 from pot
*** SUMMARY ***
Total pot $0.1 | Rake $0 | Jackpot $0 | Bingo $0 | Fortune $0 | Tax $0
Seat 1: 123dc5ea (button) folded before Flop (didn't bet)
Seat 2: 8cbee864 (small blind) collected ($0.1)
Seat 3: e3c5673f (big blind) folded before Flop
Seat 4: Hero folded before Flop (didn't bet)
Seat 5: 64e5de41 folded before Flop (didn't bet)
Seat 6: 14620cce folded before Flop (didn't bet)


Poker Hand #RC3334374465: Hold'em No Limit ($0.02/$0.05) - 2025/02/17 20:28:02
Table 'RushAndCash599725' 6-max Seat #1 is the button
Seat 1: Hero ($9.39 in chips)
Seat 2: 8ec32764 ($5.61 in chips)
Seat 3: 577aa3d3 ($4.37 in chips)
Seat 4: 14620cce ($15.94 in chips)
Seat 5: 1a2d8f33 ($5.86 in chips)
Seat 6: 1ed08fba ($15.13 in chips)
8ec32764: posts small blind $0.02
577aa3d3: posts big blind $0.05
*** HOLE CARDS ***
Dealt to Hero [Qc 5h]
Dealt to 8ec32764 
Dealt to 577aa3d3 
Dealt to 14620cce 
Dealt to 1a2d8f33 
Dealt to 1ed08fba 
14620cce: folds
1a2d8f33: folds
1ed08fba: folds
Hero: folds
8ec32764: raises $0.07 to $0.12
577aa3d3: folds
Uncalled bet ($0.07) returned to 8ec32764
*** SHOWDOWN ***
8ec32764 collected $0.1 from pot
*** SUMMARY ***
Total pot $0.1 | Rake $0 | Jackpot $0 | Bingo $0 | Fortune $0 | Tax $0
Seat 1: Hero (button) folded before Flop (didn't bet)
Seat 2: 8ec32764 (small blind) collected ($0.1)
Seat 3: 577aa3d3 (big blind) folded before Flop
Seat 4: 14620cce folded before Flop (didn't bet)
Seat 5: 1a2d8f33 folded before Flop (didn't bet)
Seat 6: 1ed08fba folded before Flop (didn't bet)


Poker Hand #RC3334374446: Hold'em No Limit ($0.02/$0.05) - 2025/02/17 20:27:59
Table 'RushAndCash599706' 6-max Seat #1 is the button
Seat 1: cf85f0e5 ($4.93 in chips)
Seat 2: 53c3b7da ($4.09 in chips)
Seat 3: 8c3789e ($6.39 in chips)
Seat 4: Hero ($9.39 in chips)
Seat 5: d1f305bd ($4.93 in chips)
Seat 6: 918d412c ($5.09 in chips)
53c3b7da: posts small blind $0.02
8c3789e: posts big blind $0.05
*** HOLE CARDS ***
Dealt to cf85f0e5 
Dealt to 53c3b7da 
Dealt to 8c3789e 
Dealt to Hero [9s Jc]
Dealt to d1f305bd 
Dealt to 918d412c 
Hero: folds
d1f305bd: folds
918d412c: raises $0.05 to $0.1
cf85f0e5: calls $0.1
53c3b7da: folds
8c3789e: folds
*** FLOP *** [5s As Jd]
918d412c: checks
cf85f0e5: bets $0.14
918d412c: calls $0.14
*** TURN *** [5s As Jd] [Js]
918d412c: checks
cf85f0e5: bets $0.28
918d412c: folds
Uncalled bet ($0.28) returned to cf85f0e5
*** SHOWDOWN ***
cf85f0e5 collected $0.53 from pot
*** SUMMARY ***
Total pot $0.55 | Rake $0.02 | Jackpot $0 | Bingo $0 | Fortune $0 | Tax $0
Board [5s As Jd Js]
Seat 1: cf85f0e5 (button) won ($0.53)
Seat 2: 53c3b7da (small blind) folded before Flop
Seat 3: 8c3789e (big blind) folded before Flop
Seat 4: Hero folded before Flop (didn't bet)
Seat 5: d1f305bd folded before Flop (didn't bet)
Seat 6: 918d412c folded on the Turn


Poker Hand #RC3334374428: Hold'em No Limit ($0.02/$0.05) - 2025/02/17 20:27:56
Table 'RushAndCash599688' 6-max Seat #1 is the button
Seat 1: d58b99ca ($6.78 in chips)
Seat 2: bc6bd004 ($5.53 in chips)
Seat 3: Hero ($9.44 in chips)
Seat 4: 731e166b ($5.83 in chips)
Seat 5: 194ee370 ($4.99 in chips)
Seat 6: f1f26d78 ($9.8 in chips)
bc6bd004: posts small blind $0.02
Hero: posts big blind $0.05
*** HOLE CARDS ***
Dealt to d58b99ca 
Dealt to bc6bd004 
Dealt to Hero [8h Js]
Dealt to 731e166b 
Dealt to 194ee370 
Dealt to f1f26d78 
731e166b: folds
194ee370: folds
f1f26d78: raises $0.05 to $0.1
d58b99ca: folds
bc6bd004: folds
Hero: folds
Uncalled bet ($0.05) returned to f1f26d78
*** SHOWDOWN ***
f1f26d78 collected $0.12 from pot
*** SUMMARY ***
Total pot $0.12 | Rake $0 | Jackpot $0 | Bingo $0 | Fortune $0 | Tax $0
Seat 1: d58b99ca (button) folded before Flop (didn't bet)
Seat 2: bc6bd004 (small blind) folded before Flop
Seat 3: Hero (big blind) folded before Flop
Seat 4: 731e166b folded before Flop (didn't bet)
Seat 5: 194ee370 folded before Flop (didn't bet)
Seat 6: f1f26d78 collected ($0.12)


Poker Hand #RC3334374408: Hold'em No Limit ($0.02/$0.05) - 2025/02/17 20:27:53
Table 'RushAndCash599668' 6-max Seat #1 is the button
Seat 1: 1d2427ef ($5.87 in chips)
Seat 2: Hero ($9.46 in chips)
Seat 3: 904f2b1b ($5.4 in chips)
Seat 4: 9013f95e ($13.43 in chips)
Seat 5: 4238ab48 ($4.76 in chips)
Seat 6: b67f7812 ($10.58 in chips)
Hero: posts small blind $0.02
904f2b1b: posts big blind $0.05
*** HOLE CARDS ***
Dealt to 1d2427ef 
Dealt to Hero [3c 2c]
Dealt to 904f2b1b 
Dealt to 9013f95e 
Dealt to 4238ab48 
Dealt to b67f7812 
9013f95e: folds
4238ab48: raises $0.06 to $0.11
b67f7812: calls $0.11
1d2427ef: folds
Hero: folds
904f2b1b: folds
*** FLOP *** [2s 7c 6c]
4238ab48: bets $0.1
b67f7812: raises $0.25 to $0.35
4238ab48: calls $0.25
*** TURN *** [2s 7c 6c] [7h]
4238ab48: checks
b67f7812: bets $0.75
4238ab48: folds
Uncalled bet ($0.75) returned to b67f7812
*** SHOWDOWN ***
b67f7812 collected $0.94 from pot
*** SUMMARY ***
Total pot $0.99 | Rake $0.05 | Jackpot $0 | Bingo $0 | Fortune $0 | Tax $0
Board [2s 7c 6c 7h]
Seat 1: 1d2427ef (button) folded before Flop (didn't bet)
Seat 2: Hero (small blind) folded before Flop
Seat 3: 904f2b1b (big blind) folded before Flop
Seat 4: 9013f95e folded before Flop (didn't bet)
Seat 5: 4238ab48 folded on the Turn
Seat 6: b67f7812 won ($0.94)


Poker Hand #RC3334374192: Hold'em No Limit ($0.02/$0.05) - 2025/02/17 20:27:17
Table 'RushAndCash599452' 6-max Seat #1 is the button
Seat 1: f95a8210 ($7.56 in chips)
Seat 2: d201e5fe ($6.58 in chips)
Seat 3: 6c8cb957 ($5.07 in chips)
Seat 4: ab35fc95 ($6.15 in chips)
Seat 5: Hero ($9.35 in chips)
Seat 6: 42fca4f9 ($5.03 in chips)
d201e5fe: posts small blind $0.02
6c8cb957: posts big blind $0.05
*** HOLE CARDS ***
Dealt to f95a8210 
Dealt to d201e5fe 
Dealt to 6c8cb957 
Dealt to ab35fc95 
Dealt to Hero [Ah 9h]
Dealt to 42fca4f9 
ab35fc95: folds
Hero: raises $0.05 to $0.1
42fca4f9: folds
f95a8210: folds
d201e5fe: folds
6c8cb957: calls $0.05
*** FLOP *** [8h 7s As]
6c8cb957: checks
Hero: checks
*** TURN *** [8h 7s As] [4d]
6c8cb957: checks
Hero: bets $0.12
6c8cb957: folds
Uncalled bet ($0.12) returned to Hero
*** SHOWDOWN ***
Hero collected $0.21 from pot
*** SUMMARY ***
Total pot $0.22 | Rake $0.01 | Jackpot $0 | Bingo $0 | Fortune $0 | Tax $0
Board [8h 7s As 4d]
Seat 1: f95a8210 (button) folded before Flop (didn't bet)
Seat 2: d201e5fe (small blind) folded before Flop
Seat 3: 6c8cb957 (big blind) folded on the Turn
Seat 4: ab35fc95 folded before Flop (didn't bet)
Seat 5: Hero won ($0.21)
Seat 6: 42fca4f9 folded before Flop (didn't bet)


Poker Hand #RC3334374169: Hold'em No Limit ($0.02/$0.05) - 2025/02/17 20:27:14
Table 'RushAndCash599429' 6-max Seat #1 is the button
Seat 1: 72fa4c0f ($2.8 in chips)
Seat 2: cc01248b ($5.96 in chips)
Seat 3: 59f12f9f ($5 in chips)
Seat 4: ee5bb31d ($5.09 in chips)
Seat 5: 194ee370 ($5.11 in chips)
Seat 6: Hero ($9.35 in chips)
cc01248b: posts small blind $0.02
59f12f9f: posts big blind $0.05
*** HOLE CARDS ***
Dealt to 72fa4c0f 
Dealt to cc01248b 
Dealt to 59f12f9f 
Dealt to ee5bb31d 
Dealt to 194ee370 
Dealt to Hero [5h 7h]
ee5bb31d: folds
194ee370: folds
Hero: folds
72fa4c0f: folds
cc01248b: raises $0.07 to $0.12
59f12f9f: calls $0.07
*** FLOP *** [Qs 7c Kc]
cc01248b: checks
59f12f9f: checks
*** TURN *** [Qs 7c Kc] [7d]
cc01248b: bets $0.08
59f12f9f: calls $0.08
*** RIVER *** [Qs 7c Kc 7d] [4s]
cc01248b: checks
59f12f9f: bets $0.27
cc01248b: calls $0.27
59f12f9f: shows [9c Ts] (Pair of Sevens)
cc01248b: shows [5s As] (Pair of Sevens)
*** SHOWDOWN ***
cc01248b collected $0.9 from pot
*** SUMMARY ***
Total pot $0.94 | Rake $0.04 | Jackpot $0 | Bingo $0 | Fortune $0 | Tax $0
Board [Qs 7c Kc 7d 4s]
Seat 1: 72fa4c0f (button) folded before Flop (didn't bet)
Seat 2: cc01248b (small blind) showed [5s As] and won ($0.9) with Pair of Sevens
Seat 3: 59f12f9f (big blind) showed [9c Ts] and lost with Pair of Sevens
Seat 4: ee5bb31d folded before Flop (didn't bet)
Seat 5: 194ee370 folded before Flop (didn't bet)
Seat 6: Hero folded before Flop (didn't bet)


Poker Hand #RC3334374146: Hold'em No Limit ($0.02/$0.05) - 2025/02/17 20:27:11
Table 'RushAndCash599406' 6-max Seat #1 is the button
Seat 1: deccd7eb ($5 in chips)
Seat 2: 8a2a3713 ($4.28 in chips)
Seat 3: c62b7a0b ($20.55 in chips)
Seat 4: 6c122cb5 ($6.84 in chips)
Seat 5: 59f12f9f ($5 in chips)
Seat 6: Hero ($9.35 in chips)
8a2a3713: posts small blind $0.02
c62b7a0b: posts big blind $0.05
*** HOLE CARDS ***
Dealt to deccd7eb 
Dealt to 8a2a3713 
Dealt to c62b7a0b 
Dealt to 6c122cb5 
Dealt to 59f12f9f 
Dealt to Hero [Qh 9s]
6c122cb5: folds
59f12f9f: folds
Hero: folds
deccd7eb: folds
8a2a3713: folds
Uncalled bet ($0.03) returned to c62b7a0b
*** SHOWDOWN ***
c62b7a0b collected $0.04 from pot
*** SUMMARY ***
Total pot $0.04 | Rake $0 | Jackpot $0 | Bingo $0 | Fortune $0 | Tax $0
Seat 1: deccd7eb (button) folded before Flop (didn't bet)
Seat 2: 8a2a3713 (small blind) folded before Flop
Seat 3: c62b7a0b (big blind) collected ($0.04)
Seat 4: 6c122cb5 folded before Flop (didn't bet)
Seat 5: 59f12f9f folded before Flop (didn't bet)
Seat 6: Hero folded before Flop (didn't bet)


Poker Hand #RC3334374123: Hold'em No Limit ($0.02/$0.05) - 2025/02/17 20:27:07
Table 'RushAndCash599383' 6-max Seat #1 is the button
Seat 1: 1cc07d8b ($5.74 in chips)
Seat 2: Hero ($9.37 in chips)
Seat 3: 4238ab48 ($4.81 in chips)
Seat 4: 287f8174 ($5.3 in chips)
Seat 5: 85ef1c62 ($5.18 in chips)
Seat 6: 14b45b97 ($10.46 in chips)
Hero: posts small blind $0.02
4238ab48: posts big blind $0.05
*** HOLE CARDS ***
Dealt to 1cc07d8b 
Dealt to Hero [5d 9d]
Dealt to 4238ab48 
Dealt to 287f8174 
Dealt to 85ef1c62 
Dealt to 14b45b97 
287f8174: folds
85ef1c62: folds
14b45b97: folds
1cc07d8b: folds
Hero: folds
Uncalled bet ($0.03) returned to 4238ab48
*** SHOWDOWN ***
4238ab48 collected $0.04 from pot
*** SUMMARY ***
Total pot $0.04 | Rake $0 | Jackpot $0 | Bingo $0 | Fortune $0 | Tax $0
Seat 1: 1cc07d8b (button) folded before Flop (didn't bet)
Seat 2: Hero (small blind) folded before Flop
Seat 3: 4238ab48 (big blind) collected ($0.04)
Seat 4: 287f8174 folded before Flop (didn't bet)
Seat 5: 85ef1c62 folded before Flop (didn't bet)
Seat 6: 14b45b97 folded before Flop (didn't bet)


Poker Hand #RC3334373759: Hold'em No Limit ($0.02/$0.05) - 2025/02/17 20:26:14
Table 'RushAndCash599019' 6-max Seat #1 is the button
Seat 1: 7b6a3077 ($6.26 in chips)
Seat 2: 59d71fcc ($4.95 in chips)
Seat 3: Hero ($9.54 in chips)
Seat 4: d51a15ca ($3.8 in chips)
Seat 5: 9babc997 ($5.56 in chips)
Seat 6: 9a4345c8 ($18.12 in chips)
59d71fcc: posts small blind $0.02
Hero: posts big blind $0.05
*** HOLE CARDS ***
Dealt to 7b6a3077 
Dealt to 59d71fcc 
Dealt to Hero [Ks Ts]
Dealt to d51a15ca 
Dealt to 9babc997 
Dealt to 9a4345c8 
d51a15ca: folds
9babc997: folds
9a4345c8: raises $0.05 to $0.1
7b6a3077: folds
59d71fcc: folds
Hero: calls $0.05
*** FLOP *** [6d Ad Jh]
Hero: checks
9a4345c8: bets $0.07
Hero: calls $0.07
*** TURN *** [6d Ad Jh] [3d]
Hero: checks
9a4345c8: checks
*** RIVER *** [6d Ad Jh 3d] [Ac]
Hero: checks
9a4345c8: checks
Hero: shows [Ks Ts] (Pair of Aces)
9a4345c8: shows [7c 6c] (Pair of Aces and Pair of Sixes)
*** SHOWDOWN ***
9a4345c8 collected $0.35 from pot
*** SUMMARY ***
Total pot $0.36 | Rake $0.01 | Jackpot $0 | Bingo $0 | Fortune $0 | Tax $0
Board [6d Ad Jh 3d Ac]
Seat 1: 7b6a3077 (button) folded before Flop (didn't bet)
Seat 2: 59d71fcc (small blind) folded before Flop
Seat 3: Hero (big blind) showed [Ks Ts] and lost with Pair of Aces
Seat 4: d51a15ca folded before Flop (didn't bet)
Seat 5: 9babc997 folded before Flop (didn't bet)
Seat 6: 9a4345c8 showed [7c 6c] and won ($0.35) with Pair of Aces and Pair of Sixes


Poker Hand #RC3334373739: Hold'em No Limit ($0.02/$0.05) - 2025/02/17 20:26:11
Table 'RushAndCash598999' 6-max Seat #1 is the button
Seat 1: 803e9f05 ($6.32 in chips)
Seat 2: 856cc88a ($5.18 in chips)
Seat 3: 8a2a3713 ($4.51 in chips)
Seat 4: 52f43d28 ($7.1 in chips)
Seat 5: 1063406 ($6.77 in chips)
Seat 6: Hero ($9.54 in chips)
856cc88a: posts small blind $0.02
8a2a3713: posts big blind $0.05
*** HOLE CARDS ***
Dealt to 803e9f05 
Dealt to 856cc88a 
Dealt to 8a2a3713 
Dealt to 52f43d28 
Dealt to 1063406 
Dealt to Hero [4c 2c]
52f43d28: folds
1063406: folds
Hero: folds
803e9f05: raises $0.05 to $0.1
856cc88a: folds
8a2a3713: folds
Uncalled bet ($0.05) returned to 803e9f05
*** SHOWDOWN ***
803e9f05 collected $0.12 from pot
*** SUMMARY ***
Total pot $0.12 | Rake $0 | Jackpot $0 | Bingo $0 | Fortune $0 | Tax $0
Seat 1: 803e9f05 (button) collected ($0.12)
Seat 2: 856cc88a (small blind) folded before Flop
Seat 3: 8a2a3713 (big blind) folded before Flop
Seat 4: 52f43d28 folded before Flop (didn't bet)
Seat 5: 1063406 folded before Flop (didn't bet)
Seat 6: Hero folded before Flop (didn't bet)


Poker Hand #RC3334373711: Hold'em No Limit ($0.02/$0.05) - 2025/02/17 20:26:07
Table 'RushAndCash598971' 6-max Seat #1 is the button
Seat 1: Hero ($9.54 in chips)
Seat 2: 3469fa26 ($6.02 in chips)
Seat 3: af002596 ($6.22 in chips)
Seat 4: 9b1a3dd2 ($6.81 in chips)
Seat 5: 692e3a83 ($12.57 in chips)
Seat 6: c2f5c77 ($4.4 in chips)
3469fa26: posts small blind $0.02
af002596: posts big blind $0.05
*** HOLE CARDS ***
Dealt to Hero [3c 6c]
Dealt to 3469fa26 
Dealt to af002596 
Dealt to 9b1a3dd2 
Dealt to 692e3a83 
Dealt to c2f5c77 
9b1a3dd2: folds
692e3a83: folds
c2f5c77: folds
Hero: folds
3469fa26: raises $0.05 to $0.1
af002596: raises $0.25 to $0.35
3469fa26: calls $0.25
*** FLOP *** [3h 7h 3s]
3469fa26: checks
af002596: bets $0.21
3469fa26: calls $0.21
*** TURN *** [3h 7h 3s] [3d]
3469fa26: checks
af002596: bets $0.5
3469fa26: calls $0.5
*** RIVER *** [3h 7h 3s 3d] [9c]
3469fa26: checks
af002596: bets $1.59
3469fa26: calls $1.59
af002596: shows [8s Qs] (Three Treys)
3469fa26: shows [Qc 9d] (Treys Full over Nines)
*** SHOWDOWN ***
3469fa26 collected $5.08 from pot
*** SUMMARY ***
Total pot $5.3 | Rake $0.15 | Jackpot $0.07 | Bingo $0 | Fortune $0 | Tax $0
Board [3h 7h 3s 3d 9c]
Seat 1: Hero (button) folded before Flop (didn't bet)
Seat 2: 3469fa26 (small blind) showed [Qc 9d] and won ($5.08) with Treys Full over Nines
Seat 3: af002596 (big blind) showed [8s Qs] and lost with Three Treys
Seat 4: 9b1a3dd2 folded before Flop (didn't bet)
Seat 5: 692e3a83 folded before Flop (didn't bet)
Seat 6: c2f5c77 folded before Flop (didn't bet)


Poker Hand #RC3334373580: Hold'em No Limit ($0.02/$0.05) - 2025/02/17 20:25:47
Table 'RushAndCash598840' 6-max Seat #1 is the button
Seat 1: e352a329 ($5.27 in chips)
Seat 2: a2794999 ($6.48 in chips)
Seat 3: ef7b5599 ($15.89 in chips)
Seat 4: 68b3fe79 ($5.13 in chips)
Seat 5: 1937cebf ($5.16 in chips)
Seat 6: Hero ($9.64 in chips)
a2794999: posts small blind $0.02
ef7b5599: posts big blind $0.05
*** HOLE CARDS ***
Dealt to e352a329 
Dealt to a2794999 
Dealt to ef7b5599 
Dealt to 68b3fe79 
Dealt to 1937cebf 
Dealt to Hero [Th Ad]
68b3fe79: folds
1937cebf: folds
Hero: raises $0.05 to $0.1
e352a329: raises $0.26 to $0.36
a2794999: folds
ef7b5599: folds
Hero: folds
Uncalled bet ($0.26) returned to e352a329
*** SHOWDOWN ***
e352a329 collected $0.26 from pot
*** SUMMARY ***
Total pot $0.27 | Rake $0.01 | Jackpot $0 | Bingo $0 | Fortune $0 | Tax $0
Seat 1: e352a329 (button) collected ($0.26)
Seat 2: a2794999 (small blind) folded before Flop
Seat 3: ef7b5599 (big blind) folded before Flop
Seat 4: 68b3fe79 folded before Flop (didn't bet)
Seat 5: 1937cebf folded before Flop (didn't bet)
Seat 6: Hero folded before Flop


Poker Hand #RC3334373558: Hold'em No Limit ($0.02/$0.05) - 2025/02/17 20:25:44
Table 'RushAndCash598818' 6-max Seat #1 is the button
Seat 1: 69c3afd2 ($4.8 in chips)
Seat 2: e26361cd ($8.02 in chips)
Seat 3: d1e15d55 ($7.17 in chips)
Seat 4: Hero ($9.64 in chips)
Seat 5: b67f7812 ($10.06 in chips)
Seat 6: b9e511a ($22.33 in chips)
e26361cd: posts small blind $0.02
d1e15d55: posts big blind $0.05
*** HOLE CARDS ***
Dealt to 69c3afd2 
Dealt to e26361cd 
Dealt to d1e15d55 
Dealt to Hero [3s Jc]
Dealt to b67f7812 
Dealt to b9e511a 
Hero: folds
b67f7812: folds
b9e511a: folds
69c3afd2: folds
e26361cd: folds
Uncalled bet ($0.03) returned to d1e15d55
*** SHOWDOWN ***
d1e15d55 collected $0.04 from pot
*** SUMMARY ***
Total pot $0.04 | Rake $0 | Jackpot $0 | Bingo $0 | Fortune $0 | Tax $0
Seat 1: 69c3afd2 (button) folded before Flop (didn't bet)
Seat 2: e26361cd (small blind) folded before Flop
Seat 3: d1e15d55 (big blind) collected ($0.04)
Seat 4: Hero folded before Flop (didn't bet)
Seat 5: b67f7812 folded before Flop (didn't bet)
Seat 6: b9e511a folded before Flop (didn't bet)


Poker Hand #RC3334373537: Hold'em No Limit ($0.02/$0.05) - 2025/02/17 20:25:41
Table 'RushAndCash598797' 6-max Seat #1 is the button
Seat 1: 187f2194 ($5.55 in chips)
Seat 2: Hero ($9.66 in chips)
Seat 3: 61b789ce ($5.14 in chips)
Seat 4: 9e314792 ($4.73 in chips)
Seat 5: 9f149588 ($5 in chips)
Seat 6: 3c1ddc3a ($7.61 in chips)
Hero: posts small blind $0.02
61b789ce: posts big blind $0.05
*** HOLE CARDS ***
Dealt to 187f2194 
Dealt to Hero [3s 6d]
Dealt to 61b789ce 
Dealt to 9e314792 
Dealt to 9f149588 
Dealt to 3c1ddc3a 
9e314792: folds
9f149588: folds
3c1ddc3a: folds
187f2194: folds
Hero: folds
Uncalled bet ($0.03) returned to 61b789ce
*** SHOWDOWN ***
61b789ce collected $0.04 from pot
*** SUMMARY ***
Total pot $0.04 | Rake $0 | Jackpot $0 | Bingo $0 | Fortune $0 | Tax $0
Seat 1: 187f2194 (button) folded before Flop (didn't bet)
Seat 2: Hero (small blind) folded before Flop
Seat 3: 61b789ce (big blind) collected ($0.04)
Seat 4: 9e314792 folded before Flop (didn't bet)
Seat 5: 9f149588 folded before Flop (didn't bet)
Seat 6: 3c1ddc3a folded before Flop (didn't bet)


Poker Hand #RC3334373514: Hold'em No Limit ($0.02/$0.05) - 2025/02/17 20:25:37
Table 'RushAndCash598774' 6-max Seat #1 is the button
Seat 1: Hero ($9.66 in chips)
Seat 2: 3c1ddc3a ($7.63 in chips)
Seat 3: 256281be ($5 in chips)
Seat 4: 742ccfee ($3.17 in chips)
Seat 5: 18cb11a ($6.3 in chips)
Seat 6: 6f4a31af ($5 in chips)
3c1ddc3a: posts small blind $0.02
256281be: posts big blind $0.05
*** HOLE CARDS ***
Dealt to Hero [7s 5d]
Dealt to 3c1ddc3a 
Dealt to 256281be 
Dealt to 742ccfee 
Dealt to 18cb11a 
Dealt to 6f4a31af 
742ccfee: raises $0.05 to $0.1
18cb11a: folds
6f4a31af: folds
Hero: folds
3c1ddc3a: folds
256281be: folds
Uncalled bet ($0.05) returned to 742ccfee
*** SHOWDOWN ***
742ccfee collected $0.12 from pot
*** SUMMARY ***
Total pot $0.12 | Rake $0 | Jackpot $0 | Bingo $0 | Fortune $0 | Tax $0
Seat 1: Hero (button) folded before Flop (didn't bet)
Seat 2: 3c1ddc3a (small blind) folded before Flop
Seat 3: 256281be (big blind) folded before Flop
Seat 4: 742ccfee collected ($0.12)
Seat 5: 18cb11a folded before Flop (didn't bet)
Seat 6: 6f4a31af folded before Flop (didn't bet)


Poker Hand #RC3334373323: Hold'em No Limit ($0.02/$0.05) - 2025/02/17 20:25:07
Table 'RushAndCash598583' 6-max Seat #1 is the button
Seat 1: 1063406 ($6.88 in chips)
Seat 2: 9684e9f0 ($5.11 in chips)
Seat 3: Hero ($9.77 in chips)
Seat 4: 18cb11a ($6.18 in chips)
Seat 5: 6191b99d ($2.03 in chips)
Seat 6: 9ed6ffbf ($4.82 in chips)
9684e9f0: posts small blind $0.02
Hero: posts big blind $0.05
*** HOLE CARDS ***
Dealt to 1063406 
Dealt to 9684e9f0 
Dealt to Hero [7h Kh]
Dealt to 18cb11a 
Dealt to 6191b99d 
Dealt to 9ed6ffbf 
18cb11a: raises $0.06 to $0.11
6191b99d: folds
9ed6ffbf: folds
1063406: folds
9684e9f0: folds
Hero: calls $0.06
*** FLOP *** [8s 8d Ad]
Hero: checks
18cb11a: bets $0.08
Hero: folds
Uncalled bet ($0.08) returned to 18cb11a
*** SHOWDOWN ***
18cb11a collected $0.23 from pot
*** SUMMARY ***
Total pot $0.24 | Rake $0.01 | Jackpot $0 | Bingo $0 | Fortune $0 | Tax $0
Board [8s 8d Ad]
Seat 1: 1063406 (button) folded before Flop (didn't bet)
Seat 2: 9684e9f0 (small blind) folded before Flop
Seat 3: Hero (big blind) folded on the Flop
Seat 4: 18cb11a won ($0.23)
Seat 5: 6191b99d folded before Flop (didn't bet)
Seat 6: 9ed6ffbf folded before Flop (didn't bet)


Poker Hand #RC3334373067: Hold'em No Limit ($0.02/$0.05) - 2025/02/17 20:24:27
Table 'RushAndCash598327' 6-max Seat #1 is the button
Seat 1: 6eae6bcb ($7.45 in chips)
Seat 2: 198f6b0e ($5.13 in chips)
Seat 3: 9684e9f0 ($5 in chips)
Seat 4: 18cb11a ($6.33 in chips)
Seat 5: Hero ($9.87 in chips)
Seat 6: 9864109b ($5.24 in chips)
198f6b0e: posts small blind $0.02
9684e9f0: posts big blind $0.05
*** HOLE CARDS ***
Dealt to 6eae6bcb 
Dealt to 198f6b0e 
Dealt to 9684e9f0 
Dealt to 18cb11a 
Dealt to Hero [Ad 8d]
Dealt to 9864109b 
18cb11a: folds
Hero: raises $0.05 to $0.1
9864109b: folds
6eae6bcb: folds
198f6b0e: folds
9684e9f0: calls $0.05
*** FLOP *** [Kd 3s 9s]
9684e9f0: checks
Hero: checks
*** TURN *** [Kd 3s 9s] [5s]
9684e9f0: checks
Hero: checks
*** RIVER *** [Kd 3s 9s 5s] [Qh]
9684e9f0: bets $0.22
Hero: folds
Uncalled bet ($0.22) returned to 9684e9f0
*** SHOWDOWN ***
9684e9f0 collected $0.21 from pot
*** SUMMARY ***
Total pot $0.22 | Rake $0.01 | Jackpot $0 | Bingo $0 | Fortune $0 | Tax $0
Board [Kd 3s 9s 5s Qh]
Seat 1: 6eae6bcb (button) folded before Flop (didn't bet)
Seat 2: 198f6b0e (small blind) folded before Flop
Seat 3: 9684e9f0 (big blind) won ($0.21)
Seat 4: 18cb11a folded before Flop (didn't bet)
Seat 5: Hero folded on the River
Seat 6: 9864109b folded before Flop (didn't bet)


Poker Hand #RC3334372996: Hold'em No Limit ($0.02/$0.05) - 2025/02/17 20:24:16
Table 'RushAndCash598256' 6-max Seat #1 is the button
Seat 1: 64e5de41 ($5.28 in chips)
Seat 2: 45d33c76 ($7.59 in chips)
Seat 3: b44ff266 ($6.06 in chips)
Seat 4: 68e67dc8 ($5.62 in chips)
Seat 5: Hero ($9.8 in chips)
Seat 6: 87205baf ($9.16 in chips)
45d33c76: posts small blind $0.02
b44ff266: posts big blind $0.05
*** HOLE CARDS ***
Dealt to 64e5de41 
Dealt to 45d33c76 
Dealt to b44ff266 
Dealt to 68e67dc8 
Dealt to Hero [Jd Kd]
Dealt to 87205baf 
68e67dc8: folds
Hero: raises $0.05 to $0.1
87205baf: folds
64e5de41: folds
45d33c76: folds
b44ff266: folds
Uncalled bet ($0.05) returned to Hero
*** SHOWDOWN ***
Hero collected $0.12 from pot
*** SUMMARY ***
Total pot $0.12 | Rake $0 | Jackpot $0 | Bingo $0 | Fortune $0 | Tax $0
Seat 1: 64e5de41 (button) folded before Flop (didn't bet)
Seat 2: 45d33c76 (small blind) folded before Flop
Seat 3: b44ff266 (big blind) folded before Flop
Seat 4: 68e67dc8 folded before Flop (didn't bet)
Seat 5: Hero collected ($0.12)
Seat 6: 87205baf folded before Flop (didn't bet)


Poker Hand #RC3334372976: Hold'em No Limit ($0.02/$0.05) - 2025/02/17 20:24:13
Table 'RushAndCash598236' 6-max Seat #1 is the button
Seat 1: Hero ($9.8 in chips)
Seat 2: 4dd12e47 ($4.87 in chips)
Seat 3: 5cbe391a ($6.17 in chips)
Seat 4: 8896706d ($5.07 in chips)
Seat 5: b3aefb75 ($10.99 in chips)
Seat 6: 48dc6454 ($3.44 in chips)
4dd12e47: posts small blind $0.02
5cbe391a: posts big blind $0.05
*** HOLE CARDS ***
Dealt to Hero [9c 3s]
Dealt to 4dd12e47 
Dealt to 5cbe391a 
Dealt to 8896706d 
Dealt to b3aefb75 
Dealt to 48dc6454 
8896706d: raises $0.05 to $0.1
b3aefb75: folds
48dc6454: folds
Hero: folds
4dd12e47: calls $0.08
5cbe391a: folds
*** FLOP *** [As 7c Jh]
4dd12e47: checks
8896706d: bets $0.09
4dd12e47: folds
Uncalled bet ($0.09) returned to 8896706d
*** SHOWDOWN ***
8896706d collected $0.24 from pot
*** SUMMARY ***
Total pot $0.25 | Rake $0.01 | Jackpot $0 | Bingo $0 | Fortune $0 | Tax $0
Board [As 7c Jh]
Seat 1: Hero (button) folded before Flop (didn't bet)
Seat 2: 4dd12e47 (small blind) folded on the Flop
Seat 3: 5cbe391a (big blind) folded before Flop
Seat 4: 8896706d won ($0.24)
Seat 5: b3aefb75 folded before Flop (didn't bet)
Seat 6: 48dc6454 folded before Flop (didn't bet)


Poker Hand #RC3334372924: Hold'em No Limit ($0.02/$0.05) - 2025/02/17 20:24:05
Table 'RushAndCash598184' 6-max Seat #1 is the button
Seat 1: 1e290a15 ($10.08 in chips)
Seat 2: 1063406 ($6.98 in chips)
Seat 3: Hero ($9.85 in chips)
Seat 4: 84b68722 ($18.92 in chips)
Seat 5: 37558bf9 ($5.53 in chips)
Seat 6: bbd60b52 ($16.12 in chips)
1063406: posts small blind $0.02
Hero: posts big blind $0.05
*** HOLE CARDS ***
Dealt to 1e290a15 
Dealt to 1063406 
Dealt to Hero [Kc 8h]
Dealt to 84b68722 
Dealt to 37558bf9 
Dealt to bbd60b52 
84b68722: folds
37558bf9: folds
bbd60b52: folds
1e290a15: folds
1063406: raises $0.1 to $0.15
Hero: folds
Uncalled bet ($0.1) returned to 1063406
*** SHOWDOWN ***
1063406 collected $0.1 from pot
*** SUMMARY ***
Total pot $0.1 | Rake $0 | Jackpot $0 | Bingo $0 | Fortune $0 | Tax $0
Seat 1: 1e290a15 (button) folded before Flop (didn't bet)
Seat 2: 1063406 (small blind) collected ($0.1)
Seat 3: Hero (big blind) folded before Flop
Seat 4: 84b68722 folded before Flop (didn't bet)
Seat 5: 37558bf9 folded before Flop (didn't bet)
Seat 6: bbd60b52 folded before Flop (didn't bet)


Poker Hand #RC3334372904: Hold'em No Limit ($0.02/$0.05) - 2025/02/17 20:24:02
Table 'RushAndCash598164' 6-max Seat #1 is the button
Seat 1: 9d364714 ($5 in chips)
Seat 2: 9ff32da5 ($2.79 in chips)
Seat 3: 816260d0 ($5 in chips)
Seat 4: 7af747dc ($8.59 in chips)
Seat 5: 9a69a3a0 ($5 in chips)
Seat 6: Hero ($9.85 in chips)
9ff32da5: posts small blind $0.02
816260d0: posts big blind $0.05
*** HOLE CARDS ***
Dealt to 9d364714 
Dealt to 9ff32da5 
Dealt to 816260d0 
Dealt to 7af747dc 
Dealt to 9a69a3a0 
Dealt to Hero [3h Ad]
7af747dc: folds
9a69a3a0: raises $0.05 to $0.1
Hero: folds
9d364714: folds
9ff32da5: folds
816260d0: folds
Uncalled bet ($0.05) returned to 9a69a3a0
*** SHOWDOWN ***
9a69a3a0 collected $0.12 from pot
*** SUMMARY ***
Total pot $0.12 | Rake $0 | Jackpot $0 | Bingo $0 | Fortune $0 | Tax $0
Seat 1: 9d364714 (button) folded before Flop (didn't bet)
Seat 2: 9ff32da5 (small blind) folded before Flop
Seat 3: 816260d0 (big blind) folded before Flop
Seat 4: 7af747dc folded before Flop (didn't bet)
Seat 5: 9a69a3a0 collected ($0.12)
Seat 6: Hero folded before Flop (didn't bet)


Poker Hand #RC3334372711: Hold'em No Limit ($0.02/$0.05) - 2025/02/17 20:23:30
Table 'RushAndCash597971' 6-max Seat #1 is the button
Seat 1: 93dfef8b ($5 in chips)
Seat 2: fa40c39c ($6.49 in chips)
Seat 3: 61b789ce ($5.07 in chips)
Seat 4: edbb0bb6 ($5 in chips)
Seat 5: 45833808 ($6.3 in chips)
Seat 6: Hero ($9.95 in chips)
fa40c39c: posts small blind $0.02
61b789ce: posts big blind $0.05
*** HOLE CARDS ***
Dealt to 93dfef8b 
Dealt to fa40c39c 
Dealt to 61b789ce 
Dealt to edbb0bb6 
Dealt to 45833808 
Dealt to Hero [Tc Jc]
edbb0bb6: folds
45833808: raises $0.05 to $0.1
Hero: calls $0.1
93dfef8b: folds
fa40c39c: folds
61b789ce: folds
*** FLOP *** [8h 8s 5d]
45833808: checks
Hero: checks
*** TURN *** [8h 8s 5d] [4c]
45833808: checks
Hero: checks
*** RIVER *** [8h 8s 5d 4c] [2d]
45833808: checks
Hero: checks
45833808: shows [9d Ad] (Pair of Eights)
Hero: shows [Tc Jc] (Pair of Eights)
*** SHOWDOWN ***
45833808 collected $0.26 from pot
*** SUMMARY ***
Total pot $0.27 | Rake $0.01 | Jackpot $0 | Bingo $0 | Fortune $0 | Tax $0
Board [8h 8s 5d 4c 2d]
Seat 1: 93dfef8b (button) folded before Flop (didn't bet)
Seat 2: fa40c39c (small blind) folded before Flop
Seat 3: 61b789ce (big blind) folded before Flop
Seat 4: edbb0bb6 folded before Flop (didn't bet)
Seat 5: 45833808 showed [9d Ad] and won ($0.26) with Pair of Eights
Seat 6: Hero showed [Tc Jc] and lost with Pair of Eights


Poker Hand #RC3334371887: Hold'em No Limit ($0.02/$0.05) - 2025/02/17 20:21:17
Table 'RushAndCash597147' 6-max Seat #1 is the button
Seat 1: 55d86a7e ($9.24 in chips)
Seat 2: Hero ($9.97 in chips)
Seat 3: 9a69a3a0 ($5 in chips)
Seat 4: 46997984 ($5.58 in chips)
Seat 5: dbf5f543 ($7.36 in chips)
Seat 6: da25c79c ($5.25 in chips)
Hero: posts small blind $0.02
9a69a3a0: posts big blind $0.05
*** HOLE CARDS ***
Dealt to 55d86a7e 
Dealt to Hero [Kd 4d]
Dealt to 9a69a3a0 
Dealt to 46997984 
Dealt to dbf5f543 
Dealt to da25c79c 
46997984: raises $0.1 to $0.15
dbf5f543: folds
da25c79c: folds
55d86a7e: folds
Hero: folds
9a69a3a0: folds
Uncalled bet ($0.1) returned to 46997984
*** SHOWDOWN ***
46997984 collected $0.12 from pot
*** SUMMARY ***
Total pot $0.12 | Rake $0 | Jackpot $0 | Bingo $0 | Fortune $0 | Tax $0
Seat 1: 55d86a7e (button) folded before Flop (didn't bet)
Seat 2: Hero (small blind) folded before Flop
Seat 3: 9a69a3a0 (big blind) folded before Flop
Seat 4: 46997984 collected ($0.12)
Seat 5: dbf5f543 folded before Flop (didn't bet)
Seat 6: da25c79c folded before Flop (didn't bet)


Poker Hand #RC3334371838: Hold'em No Limit ($0.02/$0.05) - 2025/02/17 20:21:08
Table 'RushAndCash597098' 6-max Seat #1 is the button
Seat 1: 53c3b7da ($5 in chips)
Seat 2: e72c7748 ($5 in chips)
Seat 3: 61b789ce ($5 in chips)
Seat 4: 1937cebf ($5.12 in chips)
Seat 5: b501555b ($9.85 in chips)
Seat 6: Hero ($9.97 in chips)
e72c7748: posts small blind $0.02
61b789ce: posts big blind $0.05
*** HOLE CARDS ***
Dealt to 53c3b7da 
Dealt to e72c7748 
Dealt to 61b789ce 
Dealt to 1937cebf 
Dealt to b501555b 
Dealt to Hero [4d Kd]
1937cebf: folds
b501555b: folds
Hero: folds
53c3b7da: raises $0.06 to $0.11
e72c7748: folds
61b789ce: calls $0.06
*** FLOP *** [7d 8c 6s]
61b789ce: checks
53c3b7da: checks
*** TURN *** [7d 8c 6s] [2s]
61b789ce: checks
53c3b7da: bets $0.12
61b789ce: folds
Uncalled bet ($0.12) returned to 53c3b7da
*** SHOWDOWN ***
53c3b7da collected $0.23 from pot
*** SUMMARY ***
Total pot $0.24 | Rake $0.01 | Jackpot $0 | Bingo $0 | Fortune $0 | Tax $0
Board [7d 8c 6s 2s]
Seat 1: 53c3b7da (button) won ($0.23)
Seat 2: e72c7748 (small blind) folded before Flop
Seat 3: 61b789ce (big blind) folded on the Turn
Seat 4: 1937cebf folded before Flop (didn't bet)
Seat 5: b501555b folded before Flop (didn't bet)
Seat 6: Hero folded before Flop (didn't bet)


Poker Hand #RC3334371822: Hold'em No Limit ($0.02/$0.05) - 2025/02/17 20:21:05
Table 'RushAndCash597082' 6-max Seat #1 is the button
Seat 1: 5197516b ($6.9 in chips)
Seat 2: 634fda30 ($8.61 in chips)
Seat 3: c6158c9d ($7.25 in chips)
Seat 4: e632d40b ($5.44 in chips)
Seat 5: Hero ($9.97 in chips)
Seat 6: 92099542 ($4.79 in chips)
634fda30: posts small blind $0.02
c6158c9d: posts big blind $0.05
*** HOLE CARDS ***
Dealt to 5197516b 
Dealt to 634fda30 
Dealt to c6158c9d 
Dealt to e632d40b 
Dealt to Hero [Jc 2s]
Dealt to 92099542 
e632d40b: folds
Hero: folds
92099542: folds
5197516b: folds
634fda30: raises $0.05 to $0.1
c6158c9d: calls $0.05
*** FLOP *** [2h Js 9c]
634fda30: checks
c6158c9d: checks
*** TURN *** [2h Js 9c] [8c]
634fda30: bets $0.1
c6158c9d: calls $0.1
*** RIVER *** [2h Js 9c 8c] [8s]
634fda30: bets $0.3
c6158c9d: folds
Uncalled bet ($0.3) returned to 634fda30
*** SHOWDOWN ***
634fda30 collected $0.38 from pot
*** SUMMARY ***
Total pot $0.4 | Rake $0.02 | Jackpot $0 | Bingo $0 | Fortune $0 | Tax $0
Board [2h Js 9c 8c 8s]
Seat 1: 5197516b (button) folded before Flop (didn't bet)
Seat 2: 634fda30 (small blind) won ($0.38)
Seat 3: c6158c9d (big blind) folded on the River
Seat 4: e632d40b folded before Flop (didn't bet)
Seat 5: Hero folded before Flop (didn't bet)
Seat 6: 92099542 folded before Flop (didn't bet)


Poker Hand #RC3334371758: Hold'em No Limit ($0.02/$0.05) - 2025/02/17 20:20:55
Table 'RushAndCash597018' 6-max Seat #1 is the button
Seat 1: d58b99ca ($7.83 in chips)
Seat 2: 5f1cdd27 ($5.2 in chips)
Seat 3: Hero ($9.95 in chips)
Seat 4: f25a1768 ($8.49 in chips)
Seat 5: c9ea832 ($7.58 in chips)
Seat 6: a1e98d09 ($4.64 in chips)
5f1cdd27: posts small blind $0.02
Hero: posts big blind $0.05
*** HOLE CARDS ***
Dealt to d58b99ca 
Dealt to 5f1cdd27 
Dealt to Hero [4c 8c]
Dealt to f25a1768 
Dealt to c9ea832 
Dealt to a1e98d09 
f25a1768: folds
c9ea832: folds
a1e98d09: folds
d58b99ca: folds
5f1cdd27: folds
Uncalled bet ($0.03) returned to Hero
*** SHOWDOWN ***
Hero collected $0.04 from pot
*** SUMMARY ***
Total pot $0.04 | Rake $0 | Jackpot $0 | Bingo $0 | Fortune $0 | Tax $0
Seat 1: d58b99ca (button) folded before Flop (didn't bet)
Seat 2: 5f1cdd27 (small blind) folded before Flop
Seat 3: Hero (big blind) collected ($0.04)
Seat 4: f25a1768 folded before Flop (didn't bet)
Seat 5: c9ea832 folded before Flop (didn't bet)
Seat 6: a1e98d09 folded before Flop (didn't bet)


Poker Hand #RC3334371707: Hold'em No Limit ($0.02/$0.05) - 2025/02/17 20:20:47
Table 'RushAndCash596967' 6-max Seat #1 is the button
Seat 1: Hero ($9.95 in chips)
Seat 2: f1f26d78 ($9.33 in chips)
Seat 3: 92099542 ($4.79 in chips)
Seat 4: c812cddb ($13.02 in chips)
Seat 5: 59f12f9f ($5.37 in chips)
Seat 6: 83c366a4 ($5 in chips)
f1f26d78: posts small blind $0.02
92099542: posts big blind $0.05
*** HOLE CARDS ***
Dealt to Hero [5s 8c]
Dealt to f1f26d78 
Dealt to 92099542 
Dealt to c812cddb 
Dealt to 59f12f9f 
Dealt to 83c366a4 
c812cddb: folds
59f12f9f: folds
83c366a4: folds
Hero: folds
f1f26d78: folds
Uncalled bet ($0.03) returned to 92099542
*** SHOWDOWN ***
92099542 collected $0.04 from pot
*** SUMMARY ***
Total pot $0.04 | Rake $0 | Jackpot $0 | Bingo $0 | Fortune $0 | Tax $0
Seat 1: Hero (button) folded before Flop (didn't bet)
Seat 2: f1f26d78 (small blind) folded before Flop
Seat 3: 92099542 (big blind) collected ($0.04)
Seat 4: c812cddb folded before Flop (didn't bet)
Seat 5: 59f12f9f folded before Flop (didn't bet)
Seat 6: 83c366a4 folded before Flop (didn't bet)


Poker Hand #RC3334371591: Hold'em No Limit ($0.02/$0.05) - 2025/02/17 20:20:27
Table 'RushAndCash596851' 6-max Seat #1 is the button
Seat 1: 7f79d927 ($11.21 in chips)
Seat 2: 9a4345c8 ($17.75 in chips)
Seat 3: bc6bd004 ($5 in chips)
Seat 4: 4c8dd192 ($9.72 in chips)
Seat 5: Hero ($9.88 in chips)
Seat 6: b0d0d63c ($6.49 in chips)
9a4345c8: posts small blind $0.02
bc6bd004: posts big blind $0.05
*** HOLE CARDS ***
Dealt to 7f79d927 
Dealt to 9a4345c8 
Dealt to bc6bd004 
Dealt to 4c8dd192 
Dealt to Hero [Ks Qh]
Dealt to b0d0d63c 
4c8dd192: folds
Hero: raises $0.05 to $0.1
b0d0d63c: folds
7f79d927: folds
9a4345c8: folds
bc6bd004: folds
Uncalled bet ($0.05) returned to Hero
*** SHOWDOWN ***
Hero collected $0.12 from pot
*** SUMMARY ***
Total pot $0.12 | Rake $0 | Jackpot $0 | Bingo $0 | Fortune $0 | Tax $0
Seat 1: 7f79d927 (button) folded before Flop (didn't bet)
Seat 2: 9a4345c8 (small blind) folded before Flop
Seat 3: bc6bd004 (big blind) folded before Flop
Seat 4: 4c8dd192 folded before Flop (didn't bet)
Seat 5: Hero collected ($0.12)
Seat 6: b0d0d63c folded before Flop (didn't bet)


Poker Hand #RC3334371565: Hold'em No Limit ($0.02/$0.05) - 2025/02/17 20:20:23
Table 'RushAndCash596825' 6-max Seat #1 is the button
Seat 1: 46997984 ($5.82 in chips)
Seat 2: Hero ($9.9 in chips)
Seat 3: b00c4f8 ($9.3 in chips)
Seat 4: 6af54020 ($6.3 in chips)
Seat 5: 6662e866 ($16.76 in chips)
Seat 6: 6c122cb5 ($6.56 in chips)
Hero: posts small blind $0.02
b00c4f8: posts big blind $0.05
*** HOLE CARDS ***
Dealt to 46997984 
Dealt to Hero [5s Jh]
Dealt to b00c4f8 
Dealt to 6af54020 
Dealt to 6662e866 
Dealt to 6c122cb5 
6af54020: folds
6662e866: folds
6c122cb5: folds
46997984: raises $0.1 to $0.15
Hero: folds
b00c4f8: calls $0.1
*** FLOP *** [3c 9d Qh]
b00c4f8: checks
46997984: bets $0.11
b00c4f8: calls $0.11
*** TURN *** [3c 9d Qh] [6s]
b00c4f8: checks
46997984: checks
*** RIVER *** [3c 9d Qh 6s] [As]
b00c4f8: bets $0.41
46997984: folds
Uncalled bet ($0.41) returned to b00c4f8
*** SHOWDOWN ***
b00c4f8 collected $0.52 from pot
*** SUMMARY ***
Total pot $0.54 | Rake $0.02 | Jackpot $0 | Bingo $0 | Fortune $0 | Tax $0
Board [3c 9d Qh 6s As]
Seat 1: 46997984 (button) folded on the River
Seat 2: Hero (small blind) folded before Flop
Seat 3: b00c4f8 (big blind) won ($0.52)
Seat 4: 6af54020 folded before Flop (didn't bet)
Seat 5: 6662e866 folded before Flop (didn't bet)
Seat 6: 6c122cb5 folded before Flop (didn't bet)


Poker Hand #RC3334371546: Hold'em No Limit ($0.02/$0.05) - 2025/02/17 20:20:20
Table 'RushAndCash596806' 6-max Seat #1 is the button
Seat 1: 872a76d3 ($5.17 in chips)
Seat 2: 6eba7b35 ($5.54 in chips)
Seat 3: 9f09d482 ($5.53 in chips)
Seat 4: Hero ($9.9 in chips)
Seat 5: 16081ce9 ($11.81 in chips)
Seat 6: 4e3196ec ($5 in chips)
6eba7b35: posts small blind $0.02
9f09d482: posts big blind $0.05
*** HOLE CARDS ***
Dealt to 872a76d3 
Dealt to 6eba7b35 
Dealt to 9f09d482 
Dealt to Hero [5c 8c]
Dealt to 16081ce9 
Dealt to 4e3196ec 
Hero: folds
16081ce9: raises $0.05 to $0.1
4e3196ec: folds
872a76d3: raises $0.28 to $0.38
6eba7b35: folds
9f09d482: folds
16081ce9: folds
Uncalled bet ($0.28) returned to 872a76d3
*** SHOWDOWN ***
872a76d3 collected $0.26 from pot
*** SUMMARY ***
Total pot $0.27 | Rake $0.01 | Jackpot $0 | Bingo $0 | Fortune $0 | Tax $0
Seat 1: 872a76d3 (button) collected ($0.26)
Seat 2: 6eba7b35 (small blind) folded before Flop
Seat 3: 9f09d482 (big blind) folded before Flop
Seat 4: Hero folded before Flop (didn't bet)
Seat 5: 16081ce9 folded before Flop
Seat 6: 4e3196ec folded before Flop (didn't bet)


Poker Hand #RC3334371528: Hold'em No Limit ($0.02/$0.05) - 2025/02/17 20:20:17
Table 'RushAndCash596788' 6-max Seat #1 is the button
Seat 1: Hero ($9.9 in chips)
Seat 2: 84b68722 ($18.57 in chips)
Seat 3: 918d412c ($2.94 in chips)
Seat 4: d5283567 ($13.37 in chips)
Seat 5: 9f149588 ($5 in chips)
Seat 6: 7cfb455f ($6.02 in chips)
84b68722: posts small blind $0.02
918d412c: posts big blind $0.05
*** HOLE CARDS ***
Dealt to Hero [5h 6s]
Dealt to 84b68722 
Dealt to 918d412c 
Dealt to d5283567 
Dealt to 9f149588 
Dealt to 7cfb455f 
d5283567: folds
9f149588: folds
7cfb455f: folds
Hero: folds
84b68722: folds
Uncalled bet ($0.03) returned to 918d412c
*** SHOWDOWN ***
918d412c collected $0.04 from pot
*** SUMMARY ***
Total pot $0.04 | Rake $0 | Jackpot $0 | Bingo $0 | Fortune $0 | Tax $0
Seat 1: Hero (button) folded before Flop (didn't bet)
Seat 2: 84b68722 (small blind) folded before Flop
Seat 3: 918d412c (big blind) collected ($0.04)
Seat 4: d5283567 folded before Flop (didn't bet)
Seat 5: 9f149588 folded before Flop (didn't bet)
Seat 6: 7cfb455f folded before Flop (didn't bet)


Poker Hand #RC3334371508: Hold'em No Limit ($0.02/$0.05) - 2025/02/17 20:20:13
Table 'RushAndCash596768' 6-max Seat #1 is the button
Seat 1: c45332c4 ($5.52 in chips)
Seat 2: dc32cc03 ($5.08 in chips)
Seat 3: ccd13bc4 ($11.23 in chips)
Seat 4: 7cfb455f ($6.02 in chips)
Seat 5: 6c0f6dbf ($7.2 in chips)
Seat 6: Hero ($9.9 in chips)
dc32cc03: posts small blind $0.02
ccd13bc4: posts big blind $0.05
*** HOLE CARDS ***
Dealt to c45332c4 
Dealt to dc32cc03 
Dealt to ccd13bc4 
Dealt to 7cfb455f 
Dealt to 6c0f6dbf 
Dealt to Hero [9h 2d]
7cfb455f: folds
6c0f6dbf: raises $0.07 to $0.12
Hero: folds
c45332c4: folds
dc32cc03: folds
ccd13bc4: folds
Uncalled bet ($0.07) returned to 6c0f6dbf
*** SHOWDOWN ***
6c0f6dbf collected $0.12 from pot
*** SUMMARY ***
Total pot $0.12 | Rake $0 | Jackpot $0 | Bingo $0 | Fortune $0 | Tax $0
Seat 1: c45332c4 (button) folded before Flop (didn't bet)
Seat 2: dc32cc03 (small blind) folded before Flop
Seat 3: ccd13bc4 (big blind) folded before Flop
Seat 4: 7cfb455f folded before Flop (didn't bet)
Seat 5: 6c0f6dbf collected ($0.12)
Seat 6: Hero folded before Flop (didn't bet)


Poker Hand #RC3334371486: Hold'em No Limit ($0.02/$0.05) - 2025/02/17 20:20:10
Table 'RushAndCash596746' 6-max Seat #1 is the button
Seat 1: f23e7bad ($10.32 in chips)
Seat 2: Hero ($9.92 in chips)
Seat 3: 7b1c045a ($5.47 in chips)
Seat 4: b9d877b0 ($5.45 in chips)
Seat 5: f682e86b ($4.93 in chips)
Seat 6: e50ea5d4 ($10.44 in chips)
Hero: posts small blind $0.02
7b1c045a: posts big blind $0.05
*** HOLE CARDS ***
Dealt to f23e7bad 
Dealt to Hero [6c 5s]
Dealt to 7b1c045a 
Dealt to b9d877b0 
Dealt to f682e86b 
Dealt to e50ea5d4 
b9d877b0: folds
f682e86b: raises $0.06 to $0.11
e50ea5d4: folds
f23e7bad: folds
Hero: folds
7b1c045a: calls $0.06
*** FLOP *** [Th Qh 6s]
7b1c045a: checks
f682e86b: bets $0.1
7b1c045a: calls $0.1
*** TURN *** [Th Qh 6s] [5c]
7b1c045a: checks
f682e86b: bets $0.25
7b1c045a: calls $0.25
*** RIVER *** [Th Qh 6s 5c] [As]
7b1c045a: checks
f682e86b: checks
7b1c045a: shows [Jc Tc] (Pair of Tens)
f682e86b: shows [Qc Js] (Pair of Queens)
*** SHOWDOWN ***
f682e86b collected $0.9 from pot
*** SUMMARY ***
Total pot $0.94 | Rake $0.04 | Jackpot $0 | Bingo $0 | Fortune $0 | Tax $0
Board [Th Qh 6s 5c As]
Seat 1: f23e7bad (button) folded before Flop (didn't bet)
Seat 2: Hero (small blind) folded before Flop
Seat 3: 7b1c045a (big blind) showed [Jc Tc] and lost with Pair of Tens
Seat 4: b9d877b0 folded before Flop (didn't bet)
Seat 5: f682e86b showed [Qc Js] and won ($0.9) with Pair of Queens
Seat 6: e50ea5d4 folded before Flop (didn't bet)


Poker Hand #RC3334371468: Hold'em No Limit ($0.02/$0.05) - 2025/02/17 20:20:07
Table 'RushAndCash596728' 6-max Seat #1 is the button
Seat 1: 796ed2b8 ($5.28 in chips)
Seat 2: ee5bb31d ($5.53 in chips)
Seat 3: 1f187ba0 ($3.9 in chips)
Seat 4: e69e22e ($5 in chips)
Seat 5: Hero ($9.92 in chips)
Seat 6: 10a7b2c7 ($4.76 in chips)
ee5bb31d: posts small blind $0.02
1f187ba0: posts big blind $0.05
*** HOLE CARDS ***
Dealt to 796ed2b8 
Dealt to ee5bb31d 
Dealt to 1f187ba0 
Dealt to e69e22e 
Dealt to Hero [Jc 4d]
Dealt to 10a7b2c7 
e69e22e: folds
Hero: folds
10a7b2c7: folds
796ed2b8: raises $0.08 to $0.13
ee5bb31d: folds
1f187ba0: calls $0.08
*** FLOP *** [Qd Jd 5d]
1f187ba0: checks
796ed2b8: bets $0.1
1f187ba0: raises $0.24 to $0.34
796ed2b8: calls $0.24
*** TURN *** [Qd Jd 5d] [7h]
1f187ba0: bets $0.72
796ed2b8: folds
Uncalled bet ($0.72) returned to 1f187ba0
*** SHOWDOWN ***
1f187ba0 collected $0.92 from pot
*** SUMMARY ***
Total pot $0.96 | Rake $0.04 | Jackpot $0 | Bingo $0 | Fortune $0 | Tax $0
Board [Qd Jd 5d 7h]
Seat 1: 796ed2b8 (button) folded on the Turn
Seat 2: ee5bb31d (small blind) folded before Flop
Seat 3: 1f187ba0 (big blind) won ($0.92)
Seat 4: e69e22e folded before Flop (didn't bet)
Seat 5: Hero folded before Flop (didn't bet)
Seat 6: 10a7b2c7 folded before Flop (didn't bet)


Poker Hand #RC3334371448: Hold'em No Limit ($0.02/$0.05) - 2025/02/17 20:20:04
Table 'RushAndCash596708' 6-max Seat #1 is the button
Seat 1: bb702030 ($5 in chips)
Seat 2: 8e39de43 ($5.07 in chips)
Seat 3: Hero ($9.97 in chips)
Seat 4: 4c5ef89 ($13.54 in chips)
Seat 5: 5a37a767 ($5 in chips)
Seat 6: 995c838b ($6.03 in chips)
8e39de43: posts small blind $0.02
Hero: posts big blind $0.05
*** HOLE CARDS ***
Dealt to bb702030 
Dealt to 8e39de43 
Dealt to Hero [2d 5h]
Dealt to 4c5ef89 
Dealt to 5a37a767 
Dealt to 995c838b 
4c5ef89: folds
5a37a767: folds
995c838b: folds
bb702030: folds
8e39de43: raises $0.08 to $0.13
Hero: folds
Uncalled bet ($0.08) returned to 8e39de43
*** SHOWDOWN ***
8e39de43 collected $0.1 from pot
*** SUMMARY ***
Total pot $0.1 | Rake $0 | Jackpot $0 | Bingo $0 | Fortune $0 | Tax $0
Seat 1: bb702030 (button) folded before Flop (didn't bet)
Seat 2: 8e39de43 (small blind) collected ($0.1)
Seat 3: Hero (big blind) folded before Flop
Seat 4: 4c5ef89 folded before Flop (didn't bet)
Seat 5: 5a37a767 folded before Flop (didn't bet)
Seat 6: 995c838b folded before Flop (didn't bet)


Poker Hand #RC3334371417: Hold'em No Limit ($0.02/$0.05) - 2025/02/17 20:19:58
Table 'RushAndCash596677' 6-max Seat #1 is the button
Seat 1: d57e790f ($5.24 in chips)
Seat 2: d58b99ca ($7.95 in chips)
Seat 3: 573eb753 ($5.77 in chips)
Seat 4: 6f8bb9d1 ($5 in chips)
Seat 5: 93dfef8b ($5.1 in chips)
Seat 6: Hero ($9.97 in chips)
d58b99ca: posts small blind $0.02
573eb753: posts big blind $0.05
*** HOLE CARDS ***
Dealt to d57e790f 
Dealt to d58b99ca 
Dealt to 573eb753 
Dealt to 6f8bb9d1 
Dealt to 93dfef8b 
Dealt to Hero [2d 5c]
6f8bb9d1: folds
93dfef8b: folds
Hero: folds
d57e790f: raises $0.08 to $0.13
d58b99ca: folds
573eb753: folds
Uncalled bet ($0.08) returned to d57e790f
*** SHOWDOWN ***
d57e790f collected $0.12 from pot
*** SUMMARY ***
Total pot $0.12 | Rake $0 | Jackpot $0 | Bingo $0 | Fortune $0 | Tax $0
Seat 1: d57e790f (button) collected ($0.12)
Seat 2: d58b99ca (small blind) folded before Flop
Seat 3: 573eb753 (big blind) folded before Flop
Seat 4: 6f8bb9d1 folded before Flop (didn't bet)
Seat 5: 93dfef8b folded before Flop (didn't bet)
Seat 6: Hero folded before Flop (didn't bet)


Poker Hand #RC3334371396: Hold'em No Limit ($0.02/$0.05) - 2025/02/17 20:19:54
Table 'RushAndCash596656' 6-max Seat #1 is the button
Seat 1: 3fdb54c2 ($5.59 in chips)
Seat 2: 8b8c31e1 ($5.48 in chips)
Seat 3: e4d8df1d ($5.54 in chips)
Seat 4: Hero ($9.97 in chips)
Seat 5: 95fac4b9 ($10.69 in chips)
Seat 6: b439c64b ($5.49 in chips)
8b8c31e1: posts small blind $0.02
e4d8df1d: posts big blind $0.05
*** HOLE CARDS ***
Dealt to 3fdb54c2 
Dealt to 8b8c31e1 
Dealt to e4d8df1d 
Dealt to Hero [3c 4h]
Dealt to 95fac4b9 
Dealt to b439c64b 
Hero: folds
95fac4b9: folds
b439c64b: folds
3fdb54c2: raises $0.07 to $0.12
8b8c31e1: folds
e4d8df1d: folds
Uncalled bet ($0.07) returned to 3fdb54c2
*** SHOWDOWN ***
3fdb54c2 collected $0.12 from pot
*** SUMMARY ***
Total pot $0.12 | Rake $0 | Jackpot $0 | Bingo $0 | Fortune $0 | Tax $0
Seat 1: 3fdb54c2 (button) collected ($0.12)
Seat 2: 8b8c31e1 (small blind) folded before Flop
Seat 3: e4d8df1d (big blind) folded before Flop
Seat 4: Hero folded before Flop (didn't bet)
Seat 5: 95fac4b9 folded before Flop (didn't bet)
Seat 6: b439c64b folded before Flop (didn't bet)


Poker Hand #RC3334371310: Hold'em No Limit ($0.02/$0.05) - 2025/02/17 20:19:38
Table 'RushAndCash596570' 6-max Seat #1 is the button
Seat 1: 95fac4b9 ($10.69 in chips)
Seat 2: b34012ac ($5.56 in chips)
Seat 3: 54fe77bd ($5.77 in chips)
Seat 4: 4a9ada0d ($5.05 in chips)
Seat 5: Hero ($9.97 in chips)
Seat 6: 8ffbb474 ($11.45 in chips)
b34012ac: posts small blind $0.02
54fe77bd: posts big blind $0.05
*** HOLE CARDS ***
Dealt to 95fac4b9 
Dealt to b34012ac 
Dealt to 54fe77bd 
Dealt to 4a9ada0d 
Dealt to Hero [Jh 9s]
Dealt to 8ffbb474 
4a9ada0d: folds
Hero: folds
8ffbb474: folds
95fac4b9: folds
b34012ac: raises $0.1 to $0.15
54fe77bd: calls $0.1
*** FLOP *** [5s 4c Qs]
b34012ac: bets $0.15
54fe77bd: folds
Uncalled bet ($0.15) returned to b34012ac
*** SHOWDOWN ***
b34012ac collected $0.29 from pot
*** SUMMARY ***
Total pot $0.3 | Rake $0.01 | Jackpot $0 | Bingo $0 | Fortune $0 | Tax $0
Board [5s 4c Qs]
Seat 1: 95fac4b9 (button) folded before Flop (didn't bet)
Seat 2: b34012ac (small blind) won ($0.29)
Seat 3: 54fe77bd (big blind) folded on the Flop
Seat 4: 4a9ada0d folded before Flop (didn't bet)
Seat 5: Hero folded before Flop (didn't bet)
Seat 6: 8ffbb474 folded before Flop (didn't bet)


Poker Hand #RC3334371267: Hold'em No Limit ($0.02/$0.05) - 2025/02/17 20:19:30
Table 'RushAndCash596527' 6-max Seat #1 is the button
Seat 1: e5f214e5 ($7.89 in chips)
Seat 2: 6e73d15 ($5.42 in chips)
Seat 3: Hero ($9.95 in chips)
Seat 4: cacae660 ($3.9 in chips)
Seat 5: a28ca95c ($11.9 in chips)
Seat 6: 8ec32764 ($5.11 in chips)
6e73d15: posts small blind $0.02
Hero: posts big blind $0.05
*** HOLE CARDS ***
Dealt to e5f214e5 
Dealt to 6e73d15 
Dealt to Hero [8c Tc]
Dealt to cacae660 
Dealt to a28ca95c 
Dealt to 8ec32764 
cacae660: folds
a28ca95c: folds
8ec32764: folds
e5f214e5: folds
6e73d15: folds
Uncalled bet ($0.03) returned to Hero
*** SHOWDOWN ***
Hero collected $0.04 from pot
*** SUMMARY ***
Total pot $0.04 | Rake $0 | Jackpot $0 | Bingo $0 | Fortune $0 | Tax $0
Seat 1: e5f214e5 (button) folded before Flop (didn't bet)
Seat 2: 6e73d15 (small blind) folded before Flop
Seat 3: Hero (big blind) collected ($0.04)
Seat 4: cacae660 folded before Flop (didn't bet)
Seat 5: a28ca95c folded before Flop (didn't bet)
Seat 6: 8ec32764 folded before Flop (didn't bet)


Poker Hand #RC3334371249: Hold'em No Limit ($0.02/$0.05) - 2025/02/17 20:19:27
Table 'RushAndCash596509' 6-max Seat #1 is the button
Seat 1: 2e8ab509 ($5.21 in chips)
Seat 2: Hero ($9.97 in chips)
Seat 3: 8c6b70e4 ($5 in chips)
Seat 4: 48dc6454 ($4.5 in chips)
Seat 5: d793d8f ($6.5 in chips)
Seat 6: a28ca95c ($11.9 in chips)
Hero: posts small blind $0.02
8c6b70e4: posts big blind $0.05
*** HOLE CARDS ***
Dealt to 2e8ab509 
Dealt to Hero [8h Kc]
Dealt to 8c6b70e4 
Dealt to 48dc6454 
Dealt to d793d8f 
Dealt to a28ca95c 
48dc6454: folds
d793d8f: raises $0.05 to $0.1
a28ca95c: folds
2e8ab509: folds
Hero: folds
8c6b70e4: folds
Uncalled bet ($0.05) returned to d793d8f
*** SHOWDOWN ***
d793d8f collected $0.12 from pot
*** SUMMARY ***
Total pot $0.12 | Rake $0 | Jackpot $0 | Bingo $0 | Fortune $0 | Tax $0
Seat 1: 2e8ab509 (button) folded before Flop (didn't bet)
Seat 2: Hero (small blind) folded before Flop
Seat 3: 8c6b70e4 (big blind) folded before Flop
Seat 4: 48dc6454 folded before Flop (didn't bet)
Seat 5: d793d8f collected ($0.12)
Seat 6: a28ca95c folded before Flop (didn't bet)


Poker Hand #RC3334371224: Hold'em No Limit ($0.02/$0.05) - 2025/02/17 20:19:23
Table 'RushAndCash596484' 6-max Seat #1 is the button
Seat 1: Hero ($9.97 in chips)
Seat 2: 8ec32764 ($5.18 in chips)
Seat 3: 3b8ae104 ($7.3 in chips)
Seat 4: df0ebddc ($5.07 in chips)
Seat 5: 71e00d83 ($9.85 in chips)
Seat 6: f71501ed ($6.7 in chips)
8ec32764: posts small blind $0.02
3b8ae104: posts big blind $0.05
*** HOLE CARDS ***
Dealt to Hero [4h 9c]
Dealt to 8ec32764 
Dealt to 3b8ae104 
Dealt to df0ebddc 
Dealt to 71e00d83 
Dealt to f71501ed 
df0ebddc: raises $0.06 to $0.11
71e00d83: calls $0.11
f71501ed: folds
Hero: folds
8ec32764: folds
3b8ae104: folds
*** FLOP *** [4d 7d 3d]
df0ebddc: checks
71e00d83: checks
*** TURN *** [4d 7d 3d] [5s]
df0ebddc: checks
71e00d83: checks
*** RIVER *** [4d 7d 3d 5s] [7c]
df0ebddc: bets $0.1
71e00d83: calls $0.1
df0ebddc: shows [Js Jc] (Pair of Jacks and Pair of Sevens)
71e00d83: shows [Jh Ac] (Pair of Sevens)
*** SHOWDOWN ***
df0ebddc collected $0.47 from pot
*** SUMMARY ***
Total pot $0.49 | Rake $0.02 | Jackpot $0 | Bingo $0 | Fortune $0 | Tax $0
Board [4d 7d 3d 5s 7c]
Seat 1: Hero (button) folded before Flop (didn't bet)
Seat 2: 8ec32764 (small blind) folded before Flop
Seat 3: 3b8ae104 (big blind) folded before Flop
Seat 4: df0ebddc showed [Js Jc] and won ($0.47) with Pair of Jacks and Pair of Sevens
Seat 5: 71e00d83 showed [Jh Ac] and lost with Pair of Sevens
Seat 6: f71501ed folded before Flop (didn't bet)


Poker Hand #RC3334371121: Hold'em No Limit ($0.02/$0.05) - 2025/02/17 20:19:05
Table 'RushAndCash596381' 6-max Seat #1 is the button
Seat 1: 1165d8f0 ($5.79 in chips)
Seat 2: 9e314792 ($5.01 in chips)
Seat 3: c62b7a0b ($19.79 in chips)
Seat 4: 626359de ($5 in chips)
Seat 5: Hero ($9.97 in chips)
Seat 6: d738c756 ($1.72 in chips)
9e314792: posts small blind $0.02
c62b7a0b: posts big blind $0.05
*** HOLE CARDS ***
Dealt to 1165d8f0 
Dealt to 9e314792 
Dealt to c62b7a0b 
Dealt to 626359de 
Dealt to Hero [6s 3d]
Dealt to d738c756 
626359de: raises $0.08 to $0.13
Hero: folds
d738c756: calls $0.13
1165d8f0: folds
9e314792: calls $0.11
c62b7a0b: folds
*** FLOP *** [Kh Ah 5c]
9e314792: checks
626359de: bets $0.15
d738c756: calls $0.15
9e314792: calls $0.15
*** TURN *** [Kh Ah 5c] [7s]
9e314792: checks
626359de: bets $0.67
d738c756: calls $0.67
9e314792: folds
*** RIVER *** [Kh Ah 5c 7s] [2c]
626359de: bets $1.68
d738c756: calls $0.77 and is all-in
Uncalled bet ($0.91) returned to 626359de
626359de: shows [As Kd] (Pair of Aces and Pair of Kings)
d738c756: shows [5h 5s] (Three Fives)
*** SHOWDOWN ***
d738c756 collected $3.48 from pot
*** SUMMARY ***
Total pot $3.77 | Rake $0.22 | Jackpot $0.07 | Bingo $0 | Fortune $0 | Tax $0
Board [Kh Ah 5c 7s 2c]
Seat 1: 1165d8f0 (button) folded before Flop (didn't bet)
Seat 2: 9e314792 (small blind) folded on the Turn
Seat 3: c62b7a0b (big blind) folded before Flop
Seat 4: 626359de showed [As Kd] and lost with Pair of Aces and Pair of Kings
Seat 5: Hero folded before Flop (didn't bet)
Seat 6: d738c756 showed [5h 5s] and won ($3.48) with Three Fives


Poker Hand #RC3334371100: Hold'em No Limit ($0.02/$0.05) - 2025/02/17 20:19:02
Table 'RushAndCash596360' 6-max Seat #1 is the button
Seat 1: 27020fb4 ($5.84 in chips)
Seat 2: fe0566a4 ($12.72 in chips)
Seat 3: 856cc88a ($5.19 in chips)
Seat 4: Hero ($9.97 in chips)
Seat 5: b439c64b ($5.35 in chips)
Seat 6: 24c4874c ($4.93 in chips)
fe0566a4: posts small blind $0.02
856cc88a: posts big blind $0.05
*** HOLE CARDS ***
Dealt to 27020fb4 
Dealt to fe0566a4 
Dealt to 856cc88a 
Dealt to Hero [9d Jh]
Dealt to b439c64b 
Dealt to 24c4874c 
Hero: folds
b439c64b: folds
24c4874c: folds
27020fb4: raises $0.06 to $0.11
fe0566a4: calls $0.09
856cc88a: calls $0.06
*** FLOP *** [Qc 6h 8s]
fe0566a4: checks
856cc88a: checks
27020fb4: checks
*** TURN *** [Qc 6h 8s] [8h]
fe0566a4: bets $0.15
856cc88a: calls $0.15
27020fb4: folds
*** RIVER *** [Qc 6h 8s 8h] [7h]
fe0566a4: bets $0.15
856cc88a: raises $0.15 to $0.3
fe0566a4: calls $0.15
856cc88a: shows [Th Ah] (Ace High Flush)
fe0566a4: shows [Ad 8d] (Three Eights)
*** SHOWDOWN ***
856cc88a collected $1.17 from pot
*** SUMMARY ***
Total pot $1.23 | Rake $0.06 | Jackpot $0 | Bingo $0 | Fortune $0 | Tax $0
Board [Qc 6h 8s 8h 7h]
Seat 1: 27020fb4 (button) folded on the Turn
Seat 2: fe0566a4 (small blind) showed [Ad 8d] and lost with Three Eights
Seat 3: 856cc88a (big blind) showed [Th Ah] and won ($1.17) with Ace High Flush
Seat 4: Hero folded before Flop (didn't bet)
Seat 5: b439c64b folded before Flop (didn't bet)
Seat 6: 24c4874c folded before Flop (didn't bet)


Poker Hand #RC3334371080: Hold'em No Limit ($0.02/$0.05) - 2025/02/17 20:18:59
Table 'RushAndCash596340' 6-max Seat #1 is the button
Seat 1: 32d40ce0 ($6.54 in chips)
Seat 2: e632d40b ($5.67 in chips)
Seat 3: 5c64b878 ($5.51 in chips)
Seat 4: 95fac4b9 ($10.12 in chips)
Seat 5: Hero ($9.97 in chips)
Seat 6: 61f5d558 ($4.78 in chips)
e632d40b: posts small blind $0.02
5c64b878: posts big blind $0.05
*** HOLE CARDS ***
Dealt to 32d40ce0 
Dealt to e632d40b 
Dealt to 5c64b878 
Dealt to 95fac4b9 
Dealt to Hero [7s 3c]
Dealt to 61f5d558 
95fac4b9: folds
Hero: folds
61f5d558: raises $0.12 to $0.17
32d40ce0: folds
e632d40b: folds
5c64b878: folds
Uncalled bet ($0.12) returned to 61f5d558
*** SHOWDOWN ***
61f5d558 collected $0.12 from pot
*** SUMMARY ***
Total pot $0.12 | Rake $0 | Jackpot $0 | Bingo $0 | Fortune $0 | Tax $0
Seat 1: 32d40ce0 (button) folded before Flop (didn't bet)
Seat 2: e632d40b (small blind) folded before Flop
Seat 3: 5c64b878 (big blind) folded before Flop
Seat 4: 95fac4b9 folded before Flop (didn't bet)
Seat 5: Hero folded before Flop (didn't bet)
Seat 6: 61f5d558 collected ($0.12)


Poker Hand #RC3334371059: Hold'em No Limit ($0.02/$0.05) - 2025/02/17 20:18:55
Table 'RushAndCash596319' 6-max Seat #1 is the button
Seat 1: Hero ($9.97 in chips)
Seat 2: 7f79d927 ($11.95 in chips)
Seat 3: 2b6388ee ($5.13 in chips)
Seat 4: 89f1fee1 ($5.36 in chips)
Seat 5: 5c980949 ($5.44 in chips)
Seat 6: 735c4afd ($5 in chips)
7f79d927: posts small blind $0.02
2b6388ee: posts big blind $0.05
*** HOLE CARDS ***
Dealt to Hero [3c Kd]
Dealt to 7f79d927 
Dealt to 2b6388ee 
Dealt to 89f1fee1 
Dealt to 5c980949 
Dealt to 735c4afd 
89f1fee1: folds
5c980949: folds
735c4afd: raises $0.05 to $0.1
Hero: folds
7f79d927: folds
2b6388ee: calls $0.05
*** FLOP *** [5d Td 3h]
2b6388ee: checks
735c4afd: bets $0.1
2b6388ee: calls $0.1
*** TURN *** [5d Td 3h] [8d]
2b6388ee: bets $0.14
735c4afd: folds
Uncalled bet ($0.14) returned to 2b6388ee
*** SHOWDOWN ***
2b6388ee collected $0.4 from pot
*** SUMMARY ***
Total pot $0.42 | Rake $0.02 | Jackpot $0 | Bingo $0 | Fortune $0 | Tax $0
Board [5d Td 3h 8d]
Seat 1: Hero (button) folded before Flop (didn't bet)
Seat 2: 7f79d927 (small blind) folded before Flop
Seat 3: 2b6388ee (big blind) won ($0.4)
Seat 4: 89f1fee1 folded before Flop (didn't bet)
Seat 5: 5c980949 folded before Flop (didn't bet)
Seat 6: 735c4afd folded on the Turn


Poker Hand #RC3334371038: Hold'em No Limit ($0.02/$0.05) - 2025/02/17 20:18:51
Table 'RushAndCash596298' 6-max Seat #1 is the button
Seat 1: 9a633d8d ($8.31 in chips)
Seat 2: Hero ($9.99 in chips)
Seat 3: b501555b ($9.25 in chips)
Seat 4: ef63200d ($5.78 in chips)
Seat 5: bb702030 ($5.24 in chips)
Seat 6: 75145cfe ($5 in chips)
Hero: posts small blind $0.02
b501555b: posts big blind $0.05
*** HOLE CARDS ***
Dealt to 9a633d8d 
Dealt to Hero [6h 4s]
Dealt to b501555b 
Dealt to ef63200d 
Dealt to bb702030 
Dealt to 75145cfe 
ef63200d: folds
bb702030: folds
75145cfe: folds
9a633d8d: raises $0.07 to $0.12
Hero: folds
b501555b: folds
Uncalled bet ($0.07) returned to 9a633d8d
*** SHOWDOWN ***
9a633d8d collected $0.12 from pot
*** SUMMARY ***
Total pot $0.12 | Rake $0 | Jackpot $0 | Bingo $0 | Fortune $0 | Tax $0
Seat 1: 9a633d8d (button) collected ($0.12)
Seat 2: Hero (small blind) folded before Flop
Seat 3: b501555b (big blind) folded before Flop
Seat 4: ef63200d folded before Flop (didn't bet)
Seat 5: bb702030 folded before Flop (didn't bet)
Seat 6: 75145cfe folded before Flop (didn't bet)


Poker Hand #RC3334371016: Hold'em No Limit ($0.02/$0.05) - 2025/02/17 20:18:48
Table 'RushAndCash596276' 6-max Seat #1 is the button
Seat 1: 64e5de41 ($5 in chips)
Seat 2: 3f8d18aa ($7.61 in chips)
Seat 3: Hero ($10.04 in chips)
Seat 4: ef63200d ($5.78 in chips)
Seat 5: 5381eb4c ($5.07 in chips)
Seat 6: 9f09d482 ($5.36 in chips)
3f8d18aa: posts small blind $0.02
Hero: posts big blind $0.05
*** HOLE CARDS ***
Dealt to 64e5de41 
Dealt to 3f8d18aa 
Dealt to Hero [8d Ah]
Dealt to ef63200d 
Dealt to 5381eb4c 
Dealt to 9f09d482 
ef63200d: folds
5381eb4c: raises $0.08 to $0.13
9f09d482: raises $0.22 to $0.35
64e5de41: folds
3f8d18aa: folds
Hero: folds
5381eb4c: folds
Uncalled bet ($0.22) returned to 9f09d482
*** SHOWDOWN ***
9f09d482 collected $0.32 from pot
*** SUMMARY ***
Total pot $0.33 | Rake $0.01 | Jackpot $0 | Bingo $0 | Fortune $0 | Tax $0
Seat 1: 64e5de41 (button) folded before Flop (didn't bet)
Seat 2: 3f8d18aa (small blind) folded before Flop
Seat 3: Hero (big blind) folded before Flop
Seat 4: ef63200d folded before Flop (didn't bet)
Seat 5: 5381eb4c folded before Flop
Seat 6: 9f09d482 collected ($0.32)


Poker Hand #RC3334370980: Hold'em No Limit ($0.02/$0.05) - 2025/02/17 20:18:42
Table 'RushAndCash596240' 6-max Seat #1 is the button
Seat 1: b112bc0b ($5.83 in chips)
Seat 2: 84b68722 ($19.01 in chips)
Seat 3: c066ebc7 ($5.14 in chips)
Seat 4: ab35fc95 ($6.76 in chips)
Seat 5: 2b6388ee ($5.13 in chips)
Seat 6: Hero ($10.04 in chips)
84b68722: posts small blind $0.02
c066ebc7: posts big blind $0.05
*** HOLE CARDS ***
Dealt to b112bc0b 
Dealt to 84b68722 
Dealt to c066ebc7 
Dealt to ab35fc95 
Dealt to 2b6388ee 
Dealt to Hero [Ah 4s]
ab35fc95: folds
2b6388ee: folds
Hero: folds
b112bc0b: folds
84b68722: raises $0.05 to $0.1
c066ebc7: folds
Uncalled bet ($0.05) returned to 84b68722
*** SHOWDOWN ***
84b68722 collected $0.1 from pot
*** SUMMARY ***
Total pot $0.1 | Rake $0 | Jackpot $0 | Bingo $0 | Fortune $0 | Tax $0
Seat 1: b112bc0b (button) folded before Flop (didn't bet)
Seat 2: 84b68722 (small blind) collected ($0.1)
Seat 3: c066ebc7 (big blind) folded before Flop
Seat 4: ab35fc95 folded before Flop (didn't bet)
Seat 5: 2b6388ee folded before Flop (didn't bet)
Seat 6: Hero folded before Flop (didn't bet)


Poker Hand #RC3334370948: Hold'em No Limit ($0.02/$0.05) - 2025/02/17 20:18:37
Table 'RushAndCash596208' 6-max Seat #1 is the button
Seat 1: 64e5de41 ($5 in chips)
Seat 2: 1a2d8f33 ($5.76 in chips)
Seat 3: e4d8df1d ($5.62 in chips)
Seat 4: d913286e ($6.45 in chips)
Seat 5: Hero ($10.04 in chips)
Seat 6: 598d859f ($9.31 in chips)
1a2d8f33: posts small blind $0.02
e4d8df1d: posts big blind $0.05
*** HOLE CARDS ***
Dealt to 64e5de41 
Dealt to 1a2d8f33 
Dealt to e4d8df1d 
Dealt to d913286e 
Dealt to Hero [Td 2d]
Dealt to 598d859f 
d913286e: folds
Hero: folds
598d859f: raises $0.08 to $0.13
64e5de41: folds
1a2d8f33: folds
e4d8df1d: calls $0.08
*** FLOP *** [3d 5c 8s]
e4d8df1d: checks
598d859f: bets $0.14
e4d8df1d: folds
Uncalled bet ($0.14) returned to 598d859f
*** SHOWDOWN ***
598d859f collected $0.27 from pot
*** SUMMARY ***
Total pot $0.28 | Rake $0.01 | Jackpot $0 | Bingo $0 | Fortune $0 | Tax $0
Board [3d 5c 8s]
Seat 1: 64e5de41 (button) folded before Flop (didn't bet)
Seat 2: 1a2d8f33 (small blind) folded before Flop
Seat 3: e4d8df1d (big blind) folded on the Flop
Seat 4: d913286e folded before Flop (didn't bet)
Seat 5: Hero folded before Flop (didn't bet)
Seat 6: 598d859f won ($0.27)


Poker Hand #RC3334370928: Hold'em No Limit ($0.02/$0.05) - 2025/02/17 20:18:33
Table 'RushAndCash596188' 6-max Seat #1 is the button
Seat 1: 5f8248c5 ($3.11 in chips)
Seat 2: Hero ($10.06 in chips)
Seat 3: 229ec9a7 ($5.61 in chips)
Seat 4: 598d859f ($9.31 in chips)
Seat 5: 1a2d8f33 ($5.76 in chips)
Seat 6: f4c45632 ($9.93 in chips)
Hero: posts small blind $0.02
229ec9a7: posts big blind $0.05
*** HOLE CARDS ***
Dealt to 5f8248c5 
Dealt to Hero [7d 9h]
Dealt to 229ec9a7 
Dealt to 598d859f 
Dealt to 1a2d8f33 
Dealt to f4c45632 
598d859f: folds
1a2d8f33: folds
f4c45632: folds
5f8248c5: raises $0.05 to $0.1
Hero: folds
229ec9a7: calls $0.05
*** FLOP *** [2d 5c 4s]
229ec9a7: checks
5f8248c5: checks
*** TURN *** [2d 5c 4s] [4h]
229ec9a7: checks
5f8248c5: checks
*** RIVER *** [2d 5c 4s 4h] [2c]
229ec9a7: bets $0.16
5f8248c5: folds
Uncalled bet ($0.16) returned to 229ec9a7
*** SHOWDOWN ***
229ec9a7 collected $0.21 from pot
*** SUMMARY ***
Total pot $0.22 | Rake $0.01 | Jackpot $0 | Bingo $0 | Fortune $0 | Tax $0
Board [2d 5c 4s 4h 2c]
Seat 1: 5f8248c5 (button) folded on the River
Seat 2: Hero (small blind) folded before Flop
Seat 3: 229ec9a7 (big blind) won ($0.21)
Seat 4: 598d859f folded before Flop (didn't bet)
Seat 5: 1a2d8f33 folded before Flop (didn't bet)
Seat 6: f4c45632 folded before Flop (didn't bet)


Poker Hand #RC3334370909: Hold'em No Limit ($0.02/$0.05) - 2025/02/17 20:18:30
Table 'RushAndCash596169' 6-max Seat #1 is the button
Seat 1: Hero ($9.99 in chips)
Seat 2: 3ddfb60d ($5.71 in chips)
Seat 3: 24d6dfa4 ($7.45 in chips)
Seat 4: e92b360e ($11.4 in chips)
Seat 5: bb702030 ($5.17 in chips)
Seat 6: 3c1ddc3a ($6.22 in chips)
3ddfb60d: posts small blind $0.02
24d6dfa4: posts big blind $0.05
*** HOLE CARDS ***
Dealt to Hero [Kc 6s]
Dealt to 3ddfb60d 
Dealt to 24d6dfa4 
Dealt to e92b360e 
Dealt to bb702030 
Dealt to 3c1ddc3a 
e92b360e: folds
bb702030: raises $0.05 to $0.1
3c1ddc3a: folds
Hero: folds
3ddfb60d: folds
24d6dfa4: folds
Uncalled bet ($0.05) returned to bb702030
*** SHOWDOWN ***
bb702030 collected $0.12 from pot
*** SUMMARY ***
Total pot $0.12 | Rake $0 | Jackpot $0 | Bingo $0 | Fortune $0 | Tax $0
Seat 1: Hero (button) folded before Flop (didn't bet)
Seat 2: 3ddfb60d (small blind) folded before Flop
Seat 3: 24d6dfa4 (big blind) folded before Flop
Seat 4: e92b360e folded before Flop (didn't bet)
Seat 5: bb702030 collected ($0.12)
Seat 6: 3c1ddc3a folded before Flop (didn't bet)


Poker Hand #RC3334370892: Hold'em No Limit ($0.02/$0.05) - 2025/02/17 20:18:27
Table 'RushAndCash596152' 6-max Seat #1 is the button
Seat 1: 2f033106 ($7.92 in chips)
Seat 2: 9864109b ($5.17 in chips)
Seat 3: Hero ($10.04 in chips)
Seat 4: 16f2e5ce ($7.81 in chips)
Seat 5: e26361cd ($5.2 in chips)
Seat 6: 59f12f9f ($5 in chips)
9864109b: posts small blind $0.02
Hero: posts big blind $0.05
*** HOLE CARDS ***
Dealt to 2f033106 
Dealt to 9864109b 
Dealt to Hero [2s 3c]
Dealt to 16f2e5ce 
Dealt to e26361cd 
Dealt to 59f12f9f 
16f2e5ce: folds
e26361cd: folds
59f12f9f: folds
2f033106: folds
9864109b: folds
Uncalled bet ($0.03) returned to Hero
*** SHOWDOWN ***
Hero collected $0.04 from pot
*** SUMMARY ***
Total pot $0.04 | Rake $0 | Jackpot $0 | Bingo $0 | Fortune $0 | Tax $0
Seat 1: 2f033106 (button) folded before Flop (didn't bet)
Seat 2: 9864109b (small blind) folded before Flop
Seat 3: Hero (big blind) collected ($0.04)
Seat 4: 16f2e5ce folded before Flop (didn't bet)
Seat 5: e26361cd folded before Flop (didn't bet)
Seat 6: 59f12f9f folded before Flop (didn't bet)


Poker Hand #RC3334370535: Hold'em No Limit ($0.02/$0.05) - 2025/02/17 20:17:24
Table 'RushAndCash595795' 6-max Seat #1 is the button
Seat 1: 3936a67a ($5.02 in chips)
Seat 2: 9564515b ($4.89 in chips)
Seat 3: 572aa7ad ($5.12 in chips)
Seat 4: 1a2d8f33 ($5.67 in chips)
Seat 5: Hero ($6.81 in chips)
Seat 6: 202d973b ($5 in chips)
9564515b: posts small blind $0.02
572aa7ad: posts big blind $0.05
*** HOLE CARDS ***
Dealt to 3936a67a 
Dealt to 9564515b 
Dealt to 572aa7ad 
Dealt to 1a2d8f33 
Dealt to Hero [Kc Ks]
Dealt to 202d973b 
1a2d8f33: folds
Hero: raises $0.05 to $0.1
202d973b: calls $0.1
3936a67a: folds
9564515b: calls $0.08
572aa7ad: raises $0.27 to $0.37
Hero: raises $0.71 to $1.08
202d973b: folds
9564515b: calls $0.98
572aa7ad: folds
*** FLOP *** [Ah 8s 7c]
9564515b: checks
Hero: bets $0.88
9564515b: raises $2.93 to $3.81 and is all-in
Hero: calls $2.93
9564515b: shows [9s Ts] (Ace-High)
Hero: shows [Kc Ks] (Pair of Kings)
*** TURN *** [Ah 8s 7c] [4h]
Hero: Chooses to EV Cashout
*** RIVER *** [Ah 8s 7c 4h] [Th]
Hero: Pays Cashout Risk ($1.91)
*** SHOWDOWN ***
Hero collected $10.03 from pot
*** SUMMARY ***
Total pot $10.25 | Rake $0.15 | Jackpot $0.07 | Bingo $0 | Fortune $0 | Tax $0
Board [Ah 8s 7c 4h Th]
Seat 1: 3936a67a (button) folded before Flop (didn't bet)
Seat 2: 9564515b (small blind) showed [9s Ts] and lost with Pair of Tens
Seat 3: 572aa7ad (big blind) folded before Flop
Seat 4: 1a2d8f33 folded before Flop (didn't bet)
Seat 5: Hero showed [Kc Ks] and won ($10.03) with Pair of Kings, Cashout Risk ($1.91)
Seat 6: 202d973b folded before Flop


Poker Hand #RC3334370515: Hold'em No Limit ($0.02/$0.05) - 2025/02/17 20:17:20
Table 'RushAndCash595775' 6-max Seat #1 is the button
Seat 1: fc8b0177 ($6.28 in chips)
Seat 2: a75233d9 ($5 in chips)
Seat 3: 4e3c3196 ($21.28 in chips)
Seat 4: c10d502a ($8.91 in chips)
Seat 5: Hero ($6.81 in chips)
Seat 6: df0ebddc ($5 in chips)
a75233d9: posts small blind $0.02
4e3c3196: posts big blind $0.05
*** HOLE CARDS ***
Dealt to fc8b0177 
Dealt to a75233d9 
Dealt to 4e3c3196 
Dealt to c10d502a 
Dealt to Hero [9c 5h]
Dealt to df0ebddc 
c10d502a: folds
Hero: folds
df0ebddc: raises $0.06 to $0.11
fc8b0177: folds
a75233d9: folds
4e3c3196: folds
Uncalled bet ($0.06) returned to df0ebddc
*** SHOWDOWN ***
df0ebddc collected $0.12 from pot
*** SUMMARY ***
Total pot $0.12 | Rake $0 | Jackpot $0 | Bingo $0 | Fortune $0 | Tax $0
Seat 1: fc8b0177 (button) folded before Flop (didn't bet)
Seat 2: a75233d9 (small blind) folded before Flop
Seat 3: 4e3c3196 (big blind) folded before Flop
Seat 4: c10d502a folded before Flop (didn't bet)
Seat 5: Hero folded before Flop (didn't bet)
Seat 6: df0ebddc collected ($0.12)


Poker Hand #RC3334370497: Hold'em No Limit ($0.02/$0.05) - 2025/02/17 20:17:17
Table 'RushAndCash595757' 6-max Seat #1 is the button
Seat 1: f553bfb4 ($5.12 in chips)
Seat 2: 10a7b2c7 ($4.68 in chips)
Seat 3: bb702030 ($5.37 in chips)
Seat 4: Hero ($6.81 in chips)
Seat 5: b67f7812 ($5.07 in chips)
Seat 6: f93eeed5 ($6.73 in chips)
10a7b2c7: posts small blind $0.02
bb702030: posts big blind $0.05
*** HOLE CARDS ***
Dealt to f553bfb4 
Dealt to 10a7b2c7 
Dealt to bb702030 
Dealt to Hero [Kh 7d]
Dealt to b67f7812 
Dealt to f93eeed5 
Hero: folds
b67f7812: raises $0.05 to $0.1
f93eeed5: raises $0.21 to $0.31
f553bfb4: folds
10a7b2c7: folds
bb702030: folds
b67f7812: calls $0.21
*** FLOP *** [Jc Js 8s]
b67f7812: checks
f93eeed5: bets $0.23
b67f7812: calls $0.23
*** TURN *** [Jc Js 8s] [2s]
b67f7812: checks
f93eeed5: checks
*** RIVER *** [Jc Js 8s 2s] [9c]
b67f7812: checks
f93eeed5: checks
b67f7812: shows [5c Ac] (Pair of Jacks)
f93eeed5: shows [6c 6d] (Pair of Jacks and Pair of Sixes)
*** SHOWDOWN ***
f93eeed5 collected $1.1 from pot
*** SUMMARY ***
Total pot $1.15 | Rake $0.05 | Jackpot $0 | Bingo $0 | Fortune $0 | Tax $0
Board [Jc Js 8s 2s 9c]
Seat 1: f553bfb4 (button) folded before Flop (didn't bet)
Seat 2: 10a7b2c7 (small blind) folded before Flop
Seat 3: bb702030 (big blind) folded before Flop
Seat 4: Hero folded before Flop (didn't bet)
Seat 5: b67f7812 showed [5c Ac] and lost with Pair of Jacks
Seat 6: f93eeed5 showed [6c 6d] and won ($1.1) with Pair of Jacks and Pair of Sixes


Poker Hand #RC3334370467: Hold'em No Limit ($0.02/$0.05) - 2025/02/17 20:17:12
Table 'RushAndCash595727' 6-max Seat #1 is the button
Seat 1: 9c77f9cb ($5.2 in chips)
Seat 2: 7b1c045a ($5.78 in chips)
Seat 3: 2f4d445 ($3.74 in chips)
Seat 4: f0deee96 ($3.79 in chips)
Seat 5: Hero ($6.81 in chips)
Seat 6: b44ff266 ($6.21 in chips)
7b1c045a: posts small blind $0.02
2f4d445: posts big blind $0.05
*** HOLE CARDS ***
Dealt to 9c77f9cb 
Dealt to 7b1c045a 
Dealt to 2f4d445 
Dealt to f0deee96 
Dealt to Hero [4h Js]
Dealt to b44ff266 
f0deee96: folds
Hero: folds
b44ff266: folds
9c77f9cb: calls $0.05
7b1c045a: calls $0.03
2f4d445: checks
*** FLOP *** [Qd 3h 8h]
7b1c045a: checks
2f4d445: checks
9c77f9cb: bets $0.08
7b1c045a: calls $0.08
2f4d445: folds
*** TURN *** [Qd 3h 8h] [7c]
7b1c045a: checks
9c77f9cb: bets $0.16
7b1c045a: folds
Uncalled bet ($0.16) returned to 9c77f9cb
*** SHOWDOWN ***
9c77f9cb collected $0.3 from pot
*** SUMMARY ***
Total pot $0.31 | Rake $0.01 | Jackpot $0 | Bingo $0 | Fortune $0 | Tax $0
Board [Qd 3h 8h 7c]
Seat 1: 9c77f9cb (button) won ($0.3)
Seat 2: 7b1c045a (small blind) folded on the Turn
Seat 3: 2f4d445 (big blind) folded on the Flop
Seat 4: f0deee96 folded before Flop (didn't bet)
Seat 5: Hero folded before Flop (didn't bet)
Seat 6: b44ff266 folded before Flop (didn't bet)


Poker Hand #RC3334370183: Hold'em No Limit ($0.02/$0.05) - 2025/02/17 20:16:21
Table 'RushAndCash595443' 6-max Seat #1 is the button
Seat 1: Hero ($5 in chips)
Seat 2: 6dcd0788 ($5 in chips)
Seat 3: 8c3789e ($7.48 in chips)
Seat 4: 2f4d445 ($5.7 in chips)
Seat 5: 35fb946f ($5.11 in chips)
Seat 6: 3b701823 ($5 in chips)
6dcd0788: posts small blind $0.02
8c3789e: posts big blind $0.05
*** HOLE CARDS ***
Dealt to Hero [Qh Ad]
Dealt to 6dcd0788 
Dealt to 8c3789e 
Dealt to 2f4d445 
Dealt to 35fb946f 
Dealt to 3b701823 
2f4d445: raises $0.1 to $0.15
35fb946f: folds
3b701823: folds
Hero: raises $0.29 to $0.44
6dcd0788: folds
8c3789e: folds
2f4d445: calls $0.29
*** FLOP *** [Qs 8s Ac]
2f4d445: bets $0.72
Hero: calls $0.72
*** TURN *** [Qs 8s Ac] [Qd]
2f4d445: checks
Hero: checks
*** RIVER *** [Qs 8s Ac Qd] [4d]
2f4d445: checks
Hero: bets $0.8
2f4d445: calls $0.8
Hero: shows [Qh Ad] (Queens Full over Aces)
2f4d445: shows [As Js] (Pair of Aces and Pair of Queens)
*** SHOWDOWN ***
Hero collected $3.77 from pot
*** SUMMARY ***
Total pot $3.99 | Rake $0.15 | Jackpot $0.07 | Bingo $0 | Fortune $0 | Tax $0
Board [Qs 8s Ac Qd 4d]
Seat 1: Hero (button) showed [Qh Ad] and won ($3.77) with Queens Full over Aces
Seat 2: 6dcd0788 (small blind) folded before Flop
Seat 3: 8c3789e (big blind) folded before Flop
Seat 4: 2f4d445 showed [As Js] and lost with Pair of Aces and Pair of Queens
Seat 5: 35fb946f folded before Flop (didn't bet)
Seat 6: 3b701823 folded before Flop (didn't bet)


Poker Hand #RC3334370165: Hold'em No Limit ($0.02/$0.05) - 2025/02/17 20:16:18
Table 'RushAndCash595425' 6-max Seat #1 is the button
Seat 1: bfc75c9 ($12.18 in chips)
Seat 2: Hero ($5 in chips)
Seat 3: 6af54020 ($5.84 in chips)
Seat 4: 3f990854 ($5.28 in chips)
Seat 5: 35fb946f ($5.11 in chips)
Seat 6: 65ef6dfc ($5.9 in chips)
Hero: posts small blind $0.02
6af54020: posts big blind $0.05
*** HOLE CARDS ***
Dealt to bfc75c9 
Dealt to Hero [3s Ks]
Dealt to 6af54020 
Dealt to 3f990854 
Dealt to 35fb946f 
Dealt to 65ef6dfc 
3f990854: folds
35fb946f: folds
65ef6dfc: folds
bfc75c9: folds
Hero: folds
Uncalled bet ($0.03) returned to 6af54020
*** SHOWDOWN ***
6af54020 collected $0.04 from pot
*** SUMMARY ***
Total pot $0.04 | Rake $0 | Jackpot $0 | Bingo $0 | Fortune $0 | Tax $0
Seat 1: bfc75c9 (button) folded before Flop (didn't bet)
Seat 2: Hero (small blind) folded before Flop
Seat 3: 6af54020 (big blind) collected ($0.04)
Seat 4: 3f990854 folded before Flop (didn't bet)
Seat 5: 35fb946f folded before Flop (didn't bet)
Seat 6: 65ef6dfc folded before Flop (didn't bet)


Poker Hand #RC3334370150: Hold'em No Limit ($0.02/$0.05) - 2025/02/17 20:16:14
Table 'RushAndCash595410' 6-max Seat #1 is the button
Seat 1: 10a7b2c7 ($3.85 in chips)
Seat 2: e5f214e5 ($8.01 in chips)
Seat 3: Hero ($5 in chips)
Seat 4: b34012ac ($5.47 in chips)
Seat 5: e2777133 ($6.68 in chips)
Seat 6: 491e0e63 ($5.05 in chips)
e5f214e5: posts small blind $0.02
Hero: posts big blind $0.05
*** HOLE CARDS ***
Dealt to 10a7b2c7 
Dealt to e5f214e5 
Dealt to Hero [6h Jd]
Dealt to b34012ac 
Dealt to e2777133 
Dealt to 491e0e63 
b34012ac: folds
e2777133: folds
491e0e63: raises $0.08 to $0.13
10a7b2c7: folds
e5f214e5: folds
Hero: folds
Uncalled bet ($0.08) returned to 491e0e63
*** SHOWDOWN ***
491e0e63 collected $0.12 from pot
*** SUMMARY ***
Total pot $0.12 | Rake $0 | Jackpot $0 | Bingo $0 | Fortune $0 | Tax $0
Seat 1: 10a7b2c7 (button) folded before Flop (didn't bet)
Seat 2: e5f214e5 (small blind) folded before Flop
Seat 3: Hero (big blind) folded before Flop
Seat 4: b34012ac folded before Flop (didn't bet)
Seat 5: e2777133 folded before Flop (didn't bet)
Seat 6: 491e0e63 collected ($0.12)


Poker Hand #RC3334370068: Hold'em No Limit ($0.02/$0.05) - 2025/02/17 20:15:55
Table 'RushAndCash595328' 6-max Seat #1 is the button
Seat 1: bddf8e1e ($12.24 in chips)
Seat 2: 48dc6454 ($5 in chips)
Seat 3: cfe19c20 ($5.84 in chips)
Seat 4: fcad3124 ($5 in chips)
Seat 5: Hero ($5 in chips)
Seat 6: 436ecab0 ($4.46 in chips)
48dc6454: posts small blind $0.02
cfe19c20: posts big blind $0.05
*** HOLE CARDS ***
Dealt to bddf8e1e 
Dealt to 48dc6454 
Dealt to cfe19c20 
Dealt to fcad3124 
Dealt to Hero [Ks Ts]
Dealt to 436ecab0 
fcad3124: folds
Hero: raises $0.05 to $0.1
436ecab0: folds
bddf8e1e: raises $0.24 to $0.34
48dc6454: folds
cfe19c20: folds
Hero: folds
Uncalled bet ($0.24) returned to bddf8e1e
*** SHOWDOWN ***
bddf8e1e collected $0.26 from pot
*** SUMMARY ***
Total pot $0.27 | Rake $0.01 | Jackpot $0 | Bingo $0 | Fortune $0 | Tax $0
Seat 1: bddf8e1e (button) collected ($0.26)
Seat 2: 48dc6454 (small blind) folded before Flop
Seat 3: cfe19c20 (big blind) folded before Flop
Seat 4: fcad3124 folded before Flop (didn't bet)
Seat 5: Hero folded before Flop
Seat 6: 436ecab0 folded before Flop (didn't bet)


Poker Hand #RC3334370051: Hold'em No Limit ($0.02/$0.05) - 2025/02/17 20:15:53
Table 'RushAndCash595311' 6-max Seat #1 is the button
Seat 1: d9a113f2 ($5.09 in chips)
Seat 2: 1a2d8f33 ($5.12 in chips)
Seat 3: c066ebc7 ($5.09 in chips)
Seat 4: Hero ($5 in chips)
Seat 5: cfe19c20 ($5.84 in chips)
Seat 6: 2678c032 ($10.49 in chips)
1a2d8f33: posts small blind $0.02
c066ebc7: posts big blind $0.05
*** HOLE CARDS ***
Dealt to d9a113f2 
Dealt to 1a2d8f33 
Dealt to c066ebc7 
Dealt to Hero [2c 6s]
Dealt to cfe19c20 
Dealt to 2678c032 
Hero: folds
cfe19c20: folds
2678c032: raises $0.05 to $0.1
d9a113f2: folds
1a2d8f33: raises $0.34 to $0.44
c066ebc7: folds
2678c032: folds
Uncalled bet ($0.34) returned to 1a2d8f33
*** SHOWDOWN ***
1a2d8f33 collected $0.24 from pot
*** SUMMARY ***
Total pot $0.25 | Rake $0.01 | Jackpot $0 | Bingo $0 | Fortune $0 | Tax $0
Seat 1: d9a113f2 (button) folded before Flop (didn't bet)
Seat 2: 1a2d8f33 (small blind) collected ($0.24)
Seat 3: c066ebc7 (big blind) folded before Flop
Seat 4: Hero folded before Flop (didn't bet)
Seat 5: cfe19c20 folded before Flop (didn't bet)
Seat 6: 2678c032 folded before Flop


Poker Hand #RC3334370016: Hold'em No Limit ($0.02/$0.05) - 2025/02/17 20:15:45
Table 'RushAndCash595276' 6-max Seat #1 is the button
Seat 1: Hero ($5 in chips)
Seat 2: 38a4c833 ($11.96 in chips)
Seat 3: 30c2b6c7 ($4.89 in chips)
Seat 4: 24d6dfa4 ($8.11 in chips)
Seat 5: 64e5de41 ($5 in chips)
Seat 6: 84f270f8 ($5 in chips)
38a4c833: posts small blind $0.02
30c2b6c7: posts big blind $0.05
*** HOLE CARDS ***
Dealt to Hero [3h Jc]
Dealt to 38a4c833 
Dealt to 30c2b6c7 
Dealt to 24d6dfa4 
Dealt to 64e5de41 
Dealt to 84f270f8 
24d6dfa4: folds
64e5de41: raises $0.05 to $0.1
84f270f8: folds
Hero: folds
38a4c833: folds
30c2b6c7: raises $0.2 to $0.3
64e5de41: calls $0.2
*** FLOP *** [6c Kh 8d]
30c2b6c7: bets $0.21
64e5de41: folds
Uncalled bet ($0.21) returned to 30c2b6c7
*** SHOWDOWN ***
30c2b6c7 collected $0.59 from pot
*** SUMMARY ***
Total pot $0.62 | Rake $0.03 | Jackpot $0 | Bingo $0 | Fortune $0 | Tax $0
Board [6c Kh 8d]
Seat 1: Hero (button) folded before Flop (didn't bet)
Seat 2: 38a4c833 (small blind) folded before Flop
Seat 3: 30c2b6c7 (big blind) won ($0.59)
Seat 4: 24d6dfa4 folded before Flop (didn't bet)
Seat 5: 64e5de41 folded on the Flop
Seat 6: 84f270f8 folded before Flop (didn't bet)


Poker Hand #RC3334369998: Hold'em No Limit ($0.02/$0.05) - 2025/02/17 20:15:41
Table 'RushAndCash595258' 6-max Seat #1 is the button
Seat 1: 1a2d8f33 ($5.12 in chips)
Seat 2: b50c086 ($5.8 in chips)
Seat 3: Hero ($5 in chips)
Seat 4: 69d7bf2c ($3.94 in chips)
Seat 5: 9013f95e ($12.02 in chips)
Seat 6: 19bd4ba3 ($5.29 in chips)
b50c086: posts small blind $0.02
Hero: posts big blind $0.05
*** HOLE CARDS ***
Dealt to 1a2d8f33 
Dealt to b50c086 
Dealt to Hero [9h 5h]
Dealt to 69d7bf2c 
Dealt to 9013f95e 
Dealt to 19bd4ba3 
69d7bf2c: folds
9013f95e: folds
19bd4ba3: raises $0.05 to $0.1
1a2d8f33: folds
b50c086: folds
Hero: folds
Uncalled bet ($0.05) returned to 19bd4ba3
*** SHOWDOWN ***
19bd4ba3 collected $0.12 from pot
*** SUMMARY ***
Total pot $0.12 | Rake $0 | Jackpot $0 | Bingo $0 | Fortune $0 | Tax $0
Seat 1: 1a2d8f33 (button) folded before Flop (didn't bet)
Seat 2: b50c086 (small blind) folded before Flop
Seat 3: Hero (big blind) folded before Flop
Seat 4: 69d7bf2c folded before Flop (didn't bet)
Seat 5: 9013f95e folded before Flop (didn't bet)
Seat 6: 19bd4ba3 collected ($0.12)


Poker Hand #RC3334369984: Hold'em No Limit ($0.02/$0.05) - 2025/02/17 20:15:38
Table 'RushAndCash595244' 6-max Seat #1 is the button
Seat 1: 3469fa26 ($5.53 in chips)
Seat 2: f7a73a71 ($4 in chips)
Seat 3: 90eacfa0 ($5 in chips)
Seat 4: Hero ($5 in chips)
Seat 5: 16f2e5ce ($8.3 in chips)
Seat 6: bddf8e1e ($12.29 in chips)
f7a73a71: posts small blind $0.02
90eacfa0: posts big blind $0.05
*** HOLE CARDS ***
Dealt to 3469fa26 
Dealt to f7a73a71 
Dealt to 90eacfa0 
Dealt to Hero [9d 8c]
Dealt to 16f2e5ce 
Dealt to bddf8e1e 
Hero: folds
16f2e5ce: folds
bddf8e1e: folds
3469fa26: calls $0.05
f7a73a71: raises $0.07 to $0.12
90eacfa0: folds
3469fa26: calls $0.07
*** FLOP *** [7s Qs 8h]
f7a73a71: bets $0.1
3469fa26: folds
Uncalled bet ($0.1) returned to f7a73a71
*** SHOWDOWN ***
f7a73a71 collected $0.28 from pot
*** SUMMARY ***
Total pot $0.29 | Rake $0.01 | Jackpot $0 | Bingo $0 | Fortune $0 | Tax $0
Board [7s Qs 8h]
Seat 1: 3469fa26 (button) folded on the Flop
Seat 2: f7a73a71 (small blind) won ($0.28)
Seat 3: 90eacfa0 (big blind) folded before Flop
Seat 4: Hero folded before Flop (didn't bet)
Seat 5: 16f2e5ce folded before Flop (didn't bet)
Seat 6: bddf8e1e folded before Flop (didn't bet)


Poker Hand #RC3334369972: Hold'em No Limit ($0.02/$0.05) - 2025/02/17 20:15:34
Table 'RushAndCash595232' 6-max Seat #1 is the button
Seat 1: 64e5de41 ($5 in chips)
Seat 2: Hero ($5 in chips)
Seat 3: 528e419 ($14.93 in chips)
Seat 4: 120fe547 ($4.24 in chips)
Seat 5: 99af2b58 ($10.91 in chips)
Seat 6: 459728f6 ($5.66 in chips)
Hero: posts small blind $0.02
528e419: posts big blind $0.05
*** HOLE CARDS ***
Dealt to 64e5de41 
Dealt to Hero [Kd 7s]
Dealt to 528e419 
Dealt to 120fe547 
Dealt to 99af2b58 
Dealt to 459728f6 
120fe547: folds
99af2b58: folds
459728f6: raises $0.08 to $0.13
64e5de41: folds
Hero: folds
528e419: folds
Uncalled bet ($0.08) returned to 459728f6
*** SHOWDOWN ***
459728f6 collected $0.12 from pot
*** SUMMARY ***
Total pot $0.12 | Rake $0 | Jackpot $0 | Bingo $0 | Fortune $0 | Tax $0
Seat 1: 64e5de41 (button) folded before Flop (didn't bet)
Seat 2: Hero (small blind) folded before Flop
Seat 3: 528e419 (big blind) folded before Flop
Seat 4: 120fe547 folded before Flop (didn't bet)
Seat 5: 99af2b58 folded before Flop (didn't bet)
Seat 6: 459728f6 collected ($0.12)


Poker Hand #RC3334369957: Hold'em No Limit ($0.02/$0.05) - 2025/02/17 20:15:31
Table 'RushAndCash595217' 6-max Seat #1 is the button
Seat 1: 436ecab0 ($4.51 in chips)
Seat 2: 7cfb455f ($5.72 in chips)
Seat 3: 1e76a4d8 ($5.97 in chips)
Seat 4: 100d4f9e ($5.73 in chips)
Seat 5: Hero ($5 in chips)
Seat 6: 2f8cd08f ($5.05 in chips)
7cfb455f: posts small blind $0.02
1e76a4d8: posts big blind $0.05
*** HOLE CARDS ***
Dealt to 436ecab0 
Dealt to 7cfb455f 
Dealt to 1e76a4d8 
Dealt to 100d4f9e 
Dealt to Hero [5h Qh]
Dealt to 2f8cd08f 
100d4f9e: folds
Hero: folds
2f8cd08f: folds
436ecab0: calls $0.05
7cfb455f: calls $0.03
1e76a4d8: raises $0.29 to $0.34
436ecab0: folds
7cfb455f: folds
Uncalled bet ($0.29) returned to 1e76a4d8
*** SHOWDOWN ***
1e76a4d8 collected $0.15 from pot
*** SUMMARY ***
Total pot $0.15 | Rake $0 | Jackpot $0 | Bingo $0 | Fortune $0 | Tax $0
Seat 1: 436ecab0 (button) folded before Flop
Seat 2: 7cfb455f (small blind) folded before Flop
Seat 3: 1e76a4d8 (big blind) collected ($0.15)
Seat 4: 100d4f9e folded before Flop (didn't bet)
Seat 5: Hero folded before Flop (didn't bet)
Seat 6: 2f8cd08f folded before Flop (didn't bet)


Poker Hand #RC3334369942: Hold'em No Limit ($0.02/$0.05) - 2025/02/17 20:15:28
Table 'RushAndCash595202' 6-max Seat #1 is the button
Seat 1: 23a94355 ($5.39 in chips)
Seat 2: 25b4d6e7 ($11.46 in chips)
Seat 3: 18cb11a ($6.82 in chips)
Seat 4: d86379c5 ($6.25 in chips)
Seat 5: Hero ($5 in chips)
Seat 6: e3b51b04 ($5.46 in chips)
25b4d6e7: posts small blind $0.02
18cb11a: posts big blind $0.05
*** HOLE CARDS ***
Dealt to 23a94355 
Dealt to 25b4d6e7 
Dealt to 18cb11a 
Dealt to d86379c5 
Dealt to Hero [2d Ks]
Dealt to e3b51b04 
d86379c5: folds
Hero: folds
e3b51b04: raises $0.05 to $0.1
23a94355: raises $0.21 to $0.31
25b4d6e7: raises $0.75 to $1.06
18cb11a: folds
e3b51b04: folds
23a94355: calls $0.75
*** FLOP *** [7s Ah 3h]
25b4d6e7: bets $1.04
23a94355: raises $3.29 to $4.33 and is all-in
25b4d6e7: folds
Uncalled bet ($3.29) returned to 23a94355
*** SHOWDOWN ***
23a94355 collected $4.13 from pot
*** SUMMARY ***
Total pot $4.35 | Rake $0.15 | Jackpot $0.07 | Bingo $0 | Fortune $0 | Tax $0
Board [7s Ah 3h]
Seat 1: 23a94355 (button) won ($4.13)
Seat 2: 25b4d6e7 (small blind) folded on the Flop
Seat 3: 18cb11a (big blind) folded before Flop
Seat 4: d86379c5 folded before Flop (didn't bet)
Seat 5: Hero folded before Flop (didn't bet)
Seat 6: e3b51b04 folded before Flop


Poker Hand #RC3334369910: Hold'em No Limit ($0.02/$0.05) - 2025/02/17 20:15:22
Table 'RushAndCash595170' 6-max Seat #1 is the button
Seat 1: Hero ($5 in chips)
Seat 2: 87d9de00 ($3.83 in chips)
Seat 3: b34012ac ($5.33 in chips)
Seat 4: dbf5f543 ($7.83 in chips)
Seat 5: e5903036 ($16.95 in chips)
Seat 6: 5c64b878 ($6.08 in chips)
87d9de00: posts small blind $0.02
b34012ac: posts big blind $0.05
*** HOLE CARDS ***
Dealt to Hero [9d Qs]
Dealt to 87d9de00 
Dealt to b34012ac 
Dealt to dbf5f543 
Dealt to e5903036 
Dealt to 5c64b878 
dbf5f543: folds
e5903036: folds
5c64b878: folds
Hero: folds
87d9de00: folds
Uncalled bet ($0.03) returned to b34012ac
*** SHOWDOWN ***
b34012ac collected $0.04 from pot
*** SUMMARY ***
Total pot $0.04 | Rake $0 | Jackpot $0 | Bingo $0 | Fortune $0 | Tax $0
Seat 1: Hero (button) folded before Flop (didn't bet)
Seat 2: 87d9de00 (small blind) folded before Flop
Seat 3: b34012ac (big blind) collected ($0.04)
Seat 4: dbf5f543 folded before Flop (didn't bet)
Seat 5: e5903036 folded before Flop (didn't bet)
Seat 6: 5c64b878 folded before Flop (didn't bet)


Poker Hand #RC3334369885: Hold'em No Limit ($0.02/$0.05) - 2025/02/17 20:15:17
Table 'RushAndCash595145' 6-max Seat #1 is the button
Seat 1: 6c0f6dbf ($6.64 in chips)
Seat 2: 7c57f010 ($7.69 in chips)
Seat 3: 7aa85a40 ($5.05 in chips)
Seat 4: Hero ($5 in chips)
Seat 5: 650e9dc7 ($6.5 in chips)
Seat 6: 6d2abfa5 ($5.01 in chips)
7c57f010: posts small blind $0.02
7aa85a40: posts big blind $0.05
*** HOLE CARDS ***
Dealt to 6c0f6dbf 
Dealt to 7c57f010 
Dealt to 7aa85a40 
Dealt to Hero [7d 8s]
Dealt to 650e9dc7 
Dealt to 6d2abfa5 
Hero: folds
650e9dc7: folds
6d2abfa5: folds
6c0f6dbf: raises $0.07 to $0.12
7c57f010: folds
7aa85a40: calls $0.07
*** FLOP *** [4c Qd 9h]
7aa85a40: checks
6c0f6dbf: checks
*** TURN *** [4c Qd 9h] [8c]
7aa85a40: bets $0.13
6c0f6dbf: calls $0.13
*** RIVER *** [4c Qd 9h 8c] [Kc]
7aa85a40: checks
6c0f6dbf: bets $0.34
7aa85a40: folds
Uncalled bet ($0.34) returned to 6c0f6dbf
*** SHOWDOWN ***
6c0f6dbf collected $0.5 from pot
*** SUMMARY ***
Total pot $0.52 | Rake $0.02 | Jackpot $0 | Bingo $0 | Fortune $0 | Tax $0
Board [4c Qd 9h 8c Kc]
Seat 1: 6c0f6dbf (button) won ($0.5)
Seat 2: 7c57f010 (small blind) folded before Flop
Seat 3: 7aa85a40 (big blind) folded on the River
Seat 4: Hero folded before Flop (didn't bet)
Seat 5: 650e9dc7 folded before Flop (didn't bet)
Seat 6: 6d2abfa5 folded before Flop (didn't bet)


Poker Hand #RC3334369537: Hold'em No Limit ($0.02/$0.05) - 2025/02/17 20:14:18
Table 'RushAndCash594797' 6-max Seat #1 is the button
Seat 1: 6d2abfa5 ($5.14 in chips)
Seat 2: Hero ($5 in chips)
Seat 3: c812cddb ($12.64 in chips)
Seat 4: c585480d ($5 in chips)
Seat 5: 1165d8f0 ($6.09 in chips)
Seat 6: bfc75c9 ($12.11 in chips)
Hero: posts small blind $0.02
c812cddb: posts big blind $0.05
*** HOLE CARDS ***
Dealt to 6d2abfa5 
Dealt to Hero [9c 9h]
Dealt to c812cddb 
Dealt to c585480d 
Dealt to 1165d8f0 
Dealt to bfc75c9 
c585480d: folds
1165d8f0: folds
bfc75c9: folds
6d2abfa5: raises $0.08 to $0.13
Hero: calls $0.11
c812cddb: calls $0.08
*** FLOP *** [7c 2d Qh]
Hero: checks
c812cddb: checks
6d2abfa5: checks
*** TURN *** [7c 2d Qh] [Js]
Hero: checks
c812cddb: checks
6d2abfa5: checks
*** RIVER *** [7c 2d Qh Js] [Ah]
Hero: checks
c812cddb: checks
6d2abfa5: checks
Hero: shows [9c 9h] (Pair of Nines)
c812cddb: shows [As 6s] (Pair of Aces)
6d2abfa5: shows [Tc Ts] (Pair of Tens)
*** SHOWDOWN ***
c812cddb collected $0.37 from pot
*** SUMMARY ***
Total pot $0.39 | Rake $0.02 | Jackpot $0 | Bingo $0 | Fortune $0 | Tax $0
Board [7c 2d Qh Js Ah]
Seat 1: 6d2abfa5 (button) showed [Tc Ts] and lost with Pair of Tens
Seat 2: Hero (small blind) showed [9c 9h] and lost with Pair of Nines
Seat 3: c812cddb (big blind) showed [As 6s] and won ($0.37) with Pair of Aces
Seat 4: c585480d folded before Flop (didn't bet)
Seat 5: 1165d8f0 folded before Flop (didn't bet)
Seat 6: bfc75c9 folded before Flop (didn't bet)


Poker Hand #RC3334369512: Hold'em No Limit ($0.02/$0.05) - 2025/02/17 20:14:14
Table 'RushAndCash594772' 6-max Seat #1 is the button
Seat 1: 2eb4439f ($5 in chips)
Seat 2: 742ccfee ($2.43 in chips)
Seat 3: Hero ($5 in chips)
Seat 4: 735c4afd ($5 in chips)
Seat 5: 8dbd0a2d ($5 in chips)
Seat 6: 29471264 ($7.06 in chips)
742ccfee: posts small blind $0.02
Hero: posts big blind $0.05
*** HOLE CARDS ***
Dealt to 2eb4439f 
Dealt to 742ccfee 
Dealt to Hero [Jh 2c]
Dealt to 735c4afd 
Dealt to 8dbd0a2d 
Dealt to 29471264 
735c4afd: folds
8dbd0a2d: folds
29471264: folds
2eb4439f: raises $0.07 to $0.12
742ccfee: folds
Hero: folds
Uncalled bet ($0.07) returned to 2eb4439f
*** SHOWDOWN ***
2eb4439f collected $0.12 from pot
*** SUMMARY ***
Total pot $0.12 | Rake $0 | Jackpot $0 | Bingo $0 | Fortune $0 | Tax $0
Seat 1: 2eb4439f (button) collected ($0.12)
Seat 2: 742ccfee (small blind) folded before Flop
Seat 3: Hero (big blind) folded before Flop
Seat 4: 735c4afd folded before Flop (didn't bet)
Seat 5: 8dbd0a2d folded before Flop (didn't bet)
Seat 6: 29471264 folded before Flop (didn't bet)


Poker Hand #RC3334369457: Hold'em No Limit ($0.02/$0.05) - 2025/02/17 20:14:05
Table 'RushAndCash594717' 6-max Seat #1 is the button
Seat 1: dc8a69b2 ($5 in chips)
Seat 2: 36753d76 ($5.44 in chips)
Seat 3: 65ef6dfc ($6.55 in chips)
Seat 4: Hero ($5 in chips)
Seat 5: f25a1768 ($7.87 in chips)
Seat 6: 75091df4 ($9.15 in chips)
36753d76: posts small blind $0.02
65ef6dfc: posts big blind $0.05
*** HOLE CARDS ***
Dealt to dc8a69b2 
Dealt to 36753d76 
Dealt to 65ef6dfc 
Dealt to Hero [7s Jd]
Dealt to f25a1768 
Dealt to 75091df4 
Hero: folds
f25a1768: folds
75091df4: folds
dc8a69b2: folds
36753d76: folds
Uncalled bet ($0.03) returned to 65ef6dfc
*** SHOWDOWN ***
65ef6dfc collected $0.04 from pot
*** SUMMARY ***
Total pot $0.04 | Rake $0 | Jackpot $0 | Bingo $0 | Fortune $0 | Tax $0
Seat 1: dc8a69b2 (button) folded before Flop (didn't bet)
Seat 2: 36753d76 (small blind) folded before Flop
Seat 3: 65ef6dfc (big blind) collected ($0.04)
Seat 4: Hero folded before Flop (didn't bet)
Seat 5: f25a1768 folded before Flop (didn't bet)
Seat 6: 75091df4 folded before Flop (didn't bet)


Poker Hand #RC3334369440: Hold'em No Limit ($0.02/$0.05) - 2025/02/17 20:14:02
Table 'RushAndCash594700' 6-max Seat #1 is the button
Seat 1: dc32cc03 ($5.26 in chips)
Seat 2: 8be10cd0 ($5.43 in chips)
Seat 3: 3ddfb60d ($5 in chips)
Seat 4: f110529a ($11.53 in chips)
Seat 5: Hero ($5 in chips)
Seat 6: 25b4d6e7 ($11.58 in chips)
8be10cd0: posts small blind $0.02
3ddfb60d: posts big blind $0.05
*** HOLE CARDS ***
Dealt to dc32cc03 
Dealt to 8be10cd0 
Dealt to 3ddfb60d 
Dealt to f110529a 
Dealt to Hero [7h 6d]
Dealt to 25b4d6e7 
f110529a: folds
Hero: folds
25b4d6e7: folds
dc32cc03: raises $0.05 to $0.1
8be10cd0: folds
3ddfb60d: calls $0.05
*** FLOP *** [Td Qh 8d]
3ddfb60d: checks
dc32cc03: bets $0.09
3ddfb60d: calls $0.09
*** TURN *** [Td Qh 8d] [5c]
3ddfb60d: checks
dc32cc03: bets $0.29
3ddfb60d: calls $0.29
*** RIVER *** [Td Qh 8d 5c] [Kh]
3ddfb60d: checks
dc32cc03: checks
3ddfb60d: shows [8c 7s] (Pair of Eights)
dc32cc03: shows [Jc Kd] (Pair of Kings)
*** SHOWDOWN ***
dc32cc03 collected $0.94 from pot
*** SUMMARY ***
Total pot $0.98 | Rake $0.04 | Jackpot $0 | Bingo $0 | Fortune $0 | Tax $0
Board [Td Qh 8d 5c Kh]
Seat 1: dc32cc03 (button) showed [Jc Kd] and won ($0.94) with Pair of Kings
Seat 2: 8be10cd0 (small blind) folded before Flop
Seat 3: 3ddfb60d (big blind) showed [8c 7s] and lost with Pair of Eights
Seat 4: f110529a folded before Flop (didn't bet)
Seat 5: Hero folded before Flop (didn't bet)
Seat 6: 25b4d6e7 folded before Flop (didn't bet)


Poker Hand #RC3334369406: Hold'em No Limit ($0.02/$0.05) - 2025/02/17 20:13:57
Table 'RushAndCash594666' 6-max Seat #1 is the button
Seat 1: 75a97e80 ($18.7 in chips)
Seat 2: 38a4c833 ($11.78 in chips)
Seat 3: a3bb23ae ($7.03 in chips)
Seat 4: Hero ($5 in chips)
Seat 5: 88c03c05 ($5.25 in chips)
Seat 6: 144ea2b0 ($5.18 in chips)
38a4c833: posts small blind $0.02
a3bb23ae: posts big blind $0.05
*** HOLE CARDS ***
Dealt to 75a97e80 
Dealt to 38a4c833 
Dealt to a3bb23ae 
Dealt to Hero [4d Ks]
Dealt to 88c03c05 
Dealt to 144ea2b0 
Hero: folds
88c03c05: folds
144ea2b0: folds
75a97e80: raises $0.1 to $0.15
38a4c833: folds
a3bb23ae: folds
Uncalled bet ($0.1) returned to 75a97e80
*** SHOWDOWN ***
75a97e80 collected $0.12 from pot
*** SUMMARY ***
Total pot $0.12 | Rake $0 | Jackpot $0 | Bingo $0 | Fortune $0 | Tax $0
Seat 1: 75a97e80 (button) collected ($0.12)
Seat 2: 38a4c833 (small blind) folded before Flop
Seat 3: a3bb23ae (big blind) folded before Flop
Seat 4: Hero folded before Flop (didn't bet)
Seat 5: 88c03c05 folded before Flop (didn't bet)
Seat 6: 144ea2b0 folded before Flop (didn't bet)


Poker Hand #RC3334369377: Hold'em No Limit ($0.02/$0.05) - 2025/02/17 20:13:52
Table 'RushAndCash594637' 6-max Seat #1 is the button
Seat 1: aa5b23ed ($5.82 in chips)
Seat 2: Hero ($5 in chips)
Seat 3: 87d5083b ($13.73 in chips)
Seat 4: 88c03c05 ($5.25 in chips)
Seat 5: 93735ac4 ($4.32 in chips)
Seat 6: e9a8e2e6 ($6.54 in chips)
Hero: posts small blind $0.02
87d5083b: posts big blind $0.05
*** HOLE CARDS ***
Dealt to aa5b23ed 
Dealt to Hero [7c Tc]
Dealt to 87d5083b 
Dealt to 88c03c05 
Dealt to 93735ac4 
Dealt to e9a8e2e6 
88c03c05: folds
93735ac4: folds
e9a8e2e6: folds
aa5b23ed: folds
Hero: folds
Uncalled bet ($0.03) returned to 87d5083b
*** SHOWDOWN ***
87d5083b collected $0.04 from pot
*** SUMMARY ***
Total pot $0.04 | Rake $0 | Jackpot $0 | Bingo $0 | Fortune $0 | Tax $0
Seat 1: aa5b23ed (button) folded before Flop (didn't bet)
Seat 2: Hero (small blind) folded before Flop
Seat 3: 87d5083b (big blind) collected ($0.04)
Seat 4: 88c03c05 folded before Flop (didn't bet)
Seat 5: 93735ac4 folded before Flop (didn't bet)
Seat 6: e9a8e2e6 folded before Flop (didn't bet)


Poker Hand #RC3334369352: Hold'em No Limit ($0.02/$0.05) - 2025/02/17 20:13:48
Table 'RushAndCash594612' 6-max Seat #1 is the button
Seat 1: 82010c93 ($4.49 in chips)
Seat 2: 825e110f ($5.24 in chips)
Seat 3: Hero ($5 in chips)
Seat 4: 36753d76 ($5.46 in chips)
Seat 5: 656af102 ($6.79 in chips)
Seat 6: 207d9345 ($16.96 in chips)
825e110f: posts small blind $0.02
Hero: posts big blind $0.05
*** HOLE CARDS ***
Dealt to 82010c93 
Dealt to 825e110f 
Dealt to Hero [6c Jd]
Dealt to 36753d76 
Dealt to 656af102 
Dealt to 207d9345 
36753d76: folds
656af102: folds
207d9345: raises $0.06 to $0.11
82010c93: folds
825e110f: folds
Hero: folds
Uncalled bet ($0.06) returned to 207d9345
*** SHOWDOWN ***
207d9345 collected $0.12 from pot
*** SUMMARY ***
Total pot $0.12 | Rake $0 | Jackpot $0 | Bingo $0 | Fortune $0 | Tax $0
Seat 1: 82010c93 (button) folded before Flop (didn't bet)
Seat 2: 825e110f (small blind) folded before Flop
Seat 3: Hero (big blind) folded before Flop
Seat 4: 36753d76 folded before Flop (didn't bet)
Seat 5: 656af102 folded before Flop (didn't bet)
Seat 6: 207d9345 collected ($0.12)


Poker Hand #RC3334369324: Hold'em No Limit ($0.02/$0.05) - 2025/02/17 20:13:43
Table 'RushAndCash594584' 6-max Seat #1 is the button
Seat 1: Hero ($5 in chips)
Seat 2: 61f5d558 ($8.96 in chips)
Seat 3: 27020fb4 ($5.99 in chips)
Seat 4: 8ffbb474 ($10.97 in chips)
Seat 5: b9ba5363 ($7.4 in chips)
Seat 6: 5f8248c5 ($2.1 in chips)
61f5d558: posts small blind $0.02
27020fb4: posts big blind $0.05
*** HOLE CARDS ***
Dealt to Hero [Qh 6d]
Dealt to 61f5d558 
Dealt to 27020fb4 
Dealt to 8ffbb474 
Dealt to b9ba5363 
Dealt to 5f8248c5 
8ffbb474: folds
b9ba5363: folds
5f8248c5: calls $0.05
Hero: folds
61f5d558: raises $0.05 to $0.1
27020fb4: calls $0.05
5f8248c5: calls $0.05
*** FLOP *** [Tc 8d Qs]
61f5d558: checks
27020fb4: checks
5f8248c5: checks
*** TURN *** [Tc 8d Qs] [Ah]
61f5d558: checks
27020fb4: checks
5f8248c5: bets $0.15
61f5d558: folds
27020fb4: calls $0.15
*** RIVER *** [Tc 8d Qs Ah] [2h]
27020fb4: checks
5f8248c5: checks
27020fb4: shows [Ac 5s] (Pair of Aces)
5f8248c5: shows [As Ts] (Pair of Aces and Pair of Tens)
*** SHOWDOWN ***
5f8248c5 collected $0.57 from pot
*** SUMMARY ***
Total pot $0.6 | Rake $0.03 | Jackpot $0 | Bingo $0 | Fortune $0 | Tax $0
Board [Tc 8d Qs Ah 2h]
Seat 1: Hero (button) folded before Flop (didn't bet)
Seat 2: 61f5d558 (small blind) folded on the Turn
Seat 3: 27020fb4 (big blind) showed [Ac 5s] and lost with Pair of Aces
Seat 4: 8ffbb474 folded before Flop (didn't bet)
Seat 5: b9ba5363 folded before Flop (didn't bet)
Seat 6: 5f8248c5 showed [As Ts] and won ($0.57) with Pair of Aces and Pair of Tens


Poker Hand #RC3334369137: Hold'em No Limit ($0.02/$0.05) - 2025/02/17 20:13:11
Table 'RushAndCash594397' 6-max Seat #1 is the button
Seat 1: a6844910 ($3.72 in chips)
Seat 2: 38f4cc4d ($5.47 in chips)
Seat 3: 8a2a3713 ($4.84 in chips)
Seat 4: a58a1862 ($5.45 in chips)
Seat 5: Hero ($5.07 in chips)
Seat 6: 573eb753 ($4.23 in chips)
38f4cc4d: posts small blind $0.02
8a2a3713: posts big blind $0.05
*** HOLE CARDS ***
Dealt to a6844910 
Dealt to 38f4cc4d 
Dealt to 8a2a3713 
Dealt to a58a1862 
Dealt to Hero [Ah Jh]
Dealt to 573eb753 
a58a1862: folds
Hero: raises $0.05 to $0.1
573eb753: raises $0.23 to $0.33
a6844910: folds
38f4cc4d: folds
8a2a3713: folds
Hero: calls $0.23
*** FLOP *** [2d 9d 5c]
Hero: checks
573eb753: bets $0.5
Hero: folds
Uncalled bet ($0.5) returned to 573eb753
*** SHOWDOWN ***
573eb753 collected $0.7 from pot
*** SUMMARY ***
Total pot $0.73 | Rake $0.03 | Jackpot $0 | Bingo $0 | Fortune $0 | Tax $0
Board [2d 9d 5c]
Seat 1: a6844910 (button) folded before Flop (didn't bet)
Seat 2: 38f4cc4d (small blind) folded before Flop
Seat 3: 8a2a3713 (big blind) folded before Flop
Seat 4: a58a1862 folded before Flop (didn't bet)
Seat 5: Hero folded on the Flop
Seat 6: 573eb753 won ($0.7)


Poker Hand #RC3334369116: Hold'em No Limit ($0.02/$0.05) - 2025/02/17 20:13:08
Table 'RushAndCash594376' 6-max Seat #1 is the button
Seat 1: 939e7cc4 ($5.12 in chips)
Seat 2: e9a8e2e6 ($6.49 in chips)
Seat 3: 90fb5891 ($11.82 in chips)
Seat 4: Hero ($5.07 in chips)
Seat 5: 10a7b2c7 ($4.66 in chips)
Seat 6: 3f990854 ($5.09 in chips)
e9a8e2e6: posts small blind $0.02
90fb5891: posts big blind $0.05
*** HOLE CARDS ***
Dealt to 939e7cc4 
Dealt to e9a8e2e6 
Dealt to 90fb5891 
Dealt to Hero [4c Jd]
Dealt to 10a7b2c7 
Dealt to 3f990854 
Hero: folds
10a7b2c7: folds
3f990854: folds
939e7cc4: folds
e9a8e2e6: raises $0.08 to $0.13
90fb5891: folds
Uncalled bet ($0.08) returned to e9a8e2e6
*** SHOWDOWN ***
e9a8e2e6 collected $0.1 from pot
*** SUMMARY ***
Total pot $0.1 | Rake $0 | Jackpot $0 | Bingo $0 | Fortune $0 | Tax $0
Seat 1: 939e7cc4 (button) folded before Flop (didn't bet)
Seat 2: e9a8e2e6 (small blind) collected ($0.1)
Seat 3: 90fb5891 (big blind) folded before Flop
Seat 4: Hero folded before Flop (didn't bet)
Seat 5: 10a7b2c7 folded before Flop (didn't bet)
Seat 6: 3f990854 folded before Flop (didn't bet)


Poker Hand #RC3334369086: Hold'em No Limit ($0.02/$0.05) - 2025/02/17 20:13:04
Table 'RushAndCash594346' 6-max Seat #1 is the button
Seat 1: 68b3fe79 ($5.56 in chips)
Seat 2: 7f79d927 ($5.8 in chips)
Seat 3: f1f26d78 ($10.66 in chips)
Seat 4: 93cbff75 ($5.32 in chips)
Seat 5: b42dd6b5 ($5.98 in chips)
Seat 6: Hero ($5.07 in chips)
7f79d927: posts small blind $0.02
f1f26d78: posts big blind $0.05
*** HOLE CARDS ***
Dealt to 68b3fe79 
Dealt to 7f79d927 
Dealt to f1f26d78 
Dealt to 93cbff75 
Dealt to b42dd6b5 
Dealt to Hero [4c Td]
93cbff75: folds
b42dd6b5: folds
Hero: folds
68b3fe79: folds
7f79d927: folds
Uncalled bet ($0.03) returned to f1f26d78
*** SHOWDOWN ***
f1f26d78 collected $0.04 from pot
*** SUMMARY ***
Total pot $0.04 | Rake $0 | Jackpot $0 | Bingo $0 | Fortune $0 | Tax $0
Seat 1: 68b3fe79 (button) folded before Flop (didn't bet)
Seat 2: 7f79d927 (small blind) folded before Flop
Seat 3: f1f26d78 (big blind) collected ($0.04)
Seat 4: 93cbff75 folded before Flop (didn't bet)
Seat 5: b42dd6b5 folded before Flop (didn't bet)
Seat 6: Hero folded before Flop (didn't bet)


Poker Hand #RC3334369008: Hold'em No Limit ($0.02/$0.05) - 2025/02/17 20:12:51
Table 'RushAndCash594268' 6-max Seat #1 is the button
Seat 1: Hero ($5.07 in chips)
Seat 2: 9babc997 ($3.98 in chips)
Seat 3: a9cbe77d ($5.25 in chips)
Seat 4: 33527257 ($5.52 in chips)
Seat 5: 5c8c19b7 ($5.19 in chips)
Seat 6: b50c086 ($5 in chips)
9babc997: posts small blind $0.02
a9cbe77d: posts big blind $0.05
*** HOLE CARDS ***
Dealt to Hero [4s As]
Dealt to 9babc997 
Dealt to a9cbe77d 
Dealt to 33527257 
Dealt to 5c8c19b7 
Dealt to b50c086 
33527257: folds
5c8c19b7: raises $0.05 to $0.1
b50c086: folds
Hero: folds
9babc997: folds
a9cbe77d: folds
Uncalled bet ($0.05) returned to 5c8c19b7
*** SHOWDOWN ***
5c8c19b7 collected $0.12 from pot
*** SUMMARY ***
Total pot $0.12 | Rake $0 | Jackpot $0 | Bingo $0 | Fortune $0 | Tax $0
Seat 1: Hero (button) folded before Flop (didn't bet)
Seat 2: 9babc997 (small blind) folded before Flop
Seat 3: a9cbe77d (big blind) folded before Flop
Seat 4: 33527257 folded before Flop (didn't bet)
Seat 5: 5c8c19b7 collected ($0.12)
Seat 6: b50c086 folded before Flop (didn't bet)


Poker Hand #RC3334368950: Hold'em No Limit ($0.02/$0.05) - 2025/02/17 20:12:43
Table 'RushAndCash594210' 6-max Seat #1 is the button
Seat 1: 89541a5a ($5.56 in chips)
Seat 2: Hero ($5.09 in chips)
Seat 3: 45d33c76 ($7.2 in chips)
Seat 4: 65ef6dfc ($6.46 in chips)
Seat 5: 4ad8869b ($5.16 in chips)
Seat 6: 88c03c05 ($5.41 in chips)
Hero: posts small blind $0.02
45d33c76: posts big blind $0.05
*** HOLE CARDS ***
Dealt to 89541a5a 
Dealt to Hero [Jc Ts]
Dealt to 45d33c76 
Dealt to 65ef6dfc 
Dealt to 4ad8869b 
Dealt to 88c03c05 
65ef6dfc: folds
4ad8869b: folds
88c03c05: folds
89541a5a: folds
Hero: folds
Uncalled bet ($0.03) returned to 45d33c76
*** SHOWDOWN ***
45d33c76 collected $0.04 from pot
*** SUMMARY ***
Total pot $0.04 | Rake $0 | Jackpot $0 | Bingo $0 | Fortune $0 | Tax $0
Seat 1: 89541a5a (button) folded before Flop (didn't bet)
Seat 2: Hero (small blind) folded before Flop
Seat 3: 45d33c76 (big blind) collected ($0.04)
Seat 4: 65ef6dfc folded before Flop (didn't bet)
Seat 5: 4ad8869b folded before Flop (didn't bet)
Seat 6: 88c03c05 folded before Flop (didn't bet)


Poker Hand #RC3334368930: Hold'em No Limit ($0.02/$0.05) - 2025/02/17 20:12:40
Table 'RushAndCash594190' 6-max Seat #1 is the button
Seat 1: fe532acc ($5.32 in chips)
Seat 2: a0c50ee7 ($5.51 in chips)
Seat 3: Hero ($5.14 in chips)
Seat 4: ca3f06a5 ($9.57 in chips)
Seat 5: 99af2b58 ($11.57 in chips)
Seat 6: 5201dded ($5.93 in chips)
a0c50ee7: posts small blind $0.02
Hero: posts big blind $0.05
*** HOLE CARDS ***
Dealt to fe532acc 
Dealt to a0c50ee7 
Dealt to Hero [2d Ah]
Dealt to ca3f06a5 
Dealt to 99af2b58 
Dealt to 5201dded 
ca3f06a5: folds
99af2b58: folds
5201dded: folds
fe532acc: raises $0.08 to $0.13
a0c50ee7: folds
Hero: folds
Uncalled bet ($0.08) returned to fe532acc
*** SHOWDOWN ***
fe532acc collected $0.12 from pot
*** SUMMARY ***
Total pot $0.12 | Rake $0 | Jackpot $0 | Bingo $0 | Fortune $0 | Tax $0
Seat 1: fe532acc (button) collected ($0.12)
Seat 2: a0c50ee7 (small blind) folded before Flop
Seat 3: Hero (big blind) folded before Flop
Seat 4: ca3f06a5 folded before Flop (didn't bet)
Seat 5: 99af2b58 folded before Flop (didn't bet)
Seat 6: 5201dded folded before Flop (didn't bet)


Poker Hand #RC3334368903: Hold'em No Limit ($0.02/$0.05) - 2025/02/17 20:12:36
Table 'RushAndCash594163' 6-max Seat #1 is the button
Seat 1: 3f990854 ($5.02 in chips)
Seat 2: fe532acc ($5.34 in chips)
Seat 3: 11caa266 ($9.11 in chips)
Seat 4: Hero ($5.14 in chips)
Seat 5: 904f2b1b ($4.84 in chips)
Seat 6: 10a7b2c7 ($4.59 in chips)
fe532acc: posts small blind $0.02
11caa266: posts big blind $0.05
*** HOLE CARDS ***
Dealt to 3f990854 
Dealt to fe532acc 
Dealt to 11caa266 
Dealt to Hero [8h Ac]
Dealt to 904f2b1b 
Dealt to 10a7b2c7 
Hero: folds
904f2b1b: folds
10a7b2c7: raises $0.05 to $0.1
3f990854: folds
fe532acc: folds
11caa266: folds
Uncalled bet ($0.05) returned to 10a7b2c7
*** SHOWDOWN ***
10a7b2c7 collected $0.12 from pot
*** SUMMARY ***
Total pot $0.12 | Rake $0 | Jackpot $0 | Bingo $0 | Fortune $0 | Tax $0
Seat 1: 3f990854 (button) folded before Flop (didn't bet)
Seat 2: fe532acc (small blind) folded before Flop
Seat 3: 11caa266 (big blind) folded before Flop
Seat 4: Hero folded before Flop (didn't bet)
Seat 5: 904f2b1b folded before Flop (didn't bet)
Seat 6: 10a7b2c7 collected ($0.12)


Poker Hand #RC3334368876: Hold'em No Limit ($0.02/$0.05) - 2025/02/17 20:12:31
Table 'RushAndCash594136' 6-max Seat #1 is the button
Seat 1: 42140536 ($3.57 in chips)
Seat 2: 9467aa1 ($7.59 in chips)
Seat 3: d0475ba7 ($6.09 in chips)
Seat 4: ef7b5599 ($7.69 in chips)
Seat 5: b167a4a5 ($15.65 in chips)
Seat 6: Hero ($5.14 in chips)
9467aa1: posts small blind $0.02
d0475ba7: posts big blind $0.05
*** HOLE CARDS ***
Dealt to 42140536 
Dealt to 9467aa1 
Dealt to d0475ba7 
Dealt to ef7b5599 
Dealt to b167a4a5 
Dealt to Hero [9c 7c]
ef7b5599: folds
b167a4a5: folds
Hero: folds
42140536: folds
9467aa1: raises $0.06 to $0.11
d0475ba7: calls $0.06
*** FLOP *** [Ts Ks Js]
9467aa1: bets $0.06
d0475ba7: folds
Uncalled bet ($0.06) returned to 9467aa1
*** SHOWDOWN ***
9467aa1 collected $0.21 from pot
*** SUMMARY ***
Total pot $0.22 | Rake $0.01 | Jackpot $0 | Bingo $0 | Fortune $0 | Tax $0
Board [Ts Ks Js]
Seat 1: 42140536 (button) folded before Flop (didn't bet)
Seat 2: 9467aa1 (small blind) won ($0.21)
Seat 3: d0475ba7 (big blind) folded on the Flop
Seat 4: ef7b5599 folded before Flop (didn't bet)
Seat 5: b167a4a5 folded before Flop (didn't bet)
Seat 6: Hero folded before Flop (didn't bet)


Poker Hand #RC3334368690: Hold'em No Limit ($0.02/$0.05) - 2025/02/17 20:12:02
Table 'RushAndCash593950' 6-max Seat #1 is the button
Seat 1: f1f26d78 ($10.73 in chips)
Seat 2: 7525b38a ($13.57 in chips)
Seat 3: 9467aa1 ($7.69 in chips)
Seat 4: Hero ($5.03 in chips)
Seat 5: 3469fa26 ($5 in chips)
Seat 6: e5903036 ($14.48 in chips)
7525b38a: posts small blind $0.02
9467aa1: posts big blind $0.05
*** HOLE CARDS ***
Dealt to f1f26d78 
Dealt to 7525b38a 
Dealt to 9467aa1 
Dealt to Hero [9c Tc]
Dealt to 3469fa26 
Dealt to e5903036 
Hero: raises $0.05 to $0.1
3469fa26: folds
e5903036: folds
f1f26d78: folds
7525b38a: folds
9467aa1: calls $0.05
*** FLOP *** [Kc 2c 6s]
9467aa1: checks
Hero: bets $0.08
9467aa1: folds
Uncalled bet ($0.08) returned to Hero
*** SHOWDOWN ***
Hero collected $0.21 from pot
*** SUMMARY ***
Total pot $0.22 | Rake $0.01 | Jackpot $0 | Bingo $0 | Fortune $0 | Tax $0
Board [Kc 2c 6s]
Seat 1: f1f26d78 (button) folded before Flop (didn't bet)
Seat 2: 7525b38a (small blind) folded before Flop
Seat 3: 9467aa1 (big blind) folded on the Flop
Seat 4: Hero won ($0.21)
Seat 5: 3469fa26 folded before Flop (didn't bet)
Seat 6: e5903036 folded before Flop (didn't bet)


Poker Hand #RC3334368608: Hold'em No Limit ($0.02/$0.05) - 2025/02/17 20:11:49
Table 'RushAndCash593868' 6-max Seat #1 is the button
Seat 1: Hero ($5.16 in chips)
Seat 2: 87d5083b ($15.3 in chips)
Seat 3: 65ef6dfc ($6.46 in chips)
Seat 4: 4f52eeee ($29.73 in chips)
Seat 5: 33527257 ($5.45 in chips)
Seat 6: 6d2abfa5 ($5.82 in chips)
87d5083b: posts small blind $0.02
65ef6dfc: posts big blind $0.05
*** HOLE CARDS ***
Dealt to Hero [Jd Td]
Dealt to 87d5083b 
Dealt to 65ef6dfc 
Dealt to 4f52eeee 
Dealt to 33527257 
Dealt to 6d2abfa5 
4f52eeee: raises $0.08 to $0.13
33527257: folds
6d2abfa5: folds
Hero: calls $0.13
87d5083b: raises $0.61 to $0.74
65ef6dfc: folds
4f52eeee: calls $0.61
Hero: folds
*** FLOP *** [9s Th 6h]
87d5083b: checks
4f52eeee: bets $0.85
87d5083b: calls $0.85
*** TURN *** [9s Th 6h] [5s]
87d5083b: checks
4f52eeee: bets $2.15
87d5083b: folds
Uncalled bet ($2.15) returned to 4f52eeee
*** SHOWDOWN ***
4f52eeee collected $3.14 from pot
*** SUMMARY ***
Total pot $3.36 | Rake $0.15 | Jackpot $0.07 | Bingo $0 | Fortune $0 | Tax $0
Board [9s Th 6h 5s]
Seat 1: Hero (button) folded before Flop
Seat 2: 87d5083b (small blind) folded on the Turn
Seat 3: 65ef6dfc (big blind) folded before Flop
Seat 4: 4f52eeee won ($3.14)
Seat 5: 33527257 folded before Flop (didn't bet)
Seat 6: 6d2abfa5 folded before Flop (didn't bet)


Poker Hand #RC3334368347: Hold'em No Limit ($0.02/$0.05) - 2025/02/17 20:11:11
Table 'RushAndCash593607' 6-max Seat #1 is the button
Seat 1: 65ef6dfc ($6.61 in chips)
Seat 2: add80e2d ($5.14 in chips)
Seat 3: Hero ($5 in chips)
Seat 4: e2777133 ($6.51 in chips)
Seat 5: eb412629 ($5.02 in chips)
Seat 6: 626511c8 ($4.76 in chips)
add80e2d: posts small blind $0.02
Hero: posts big blind $0.05
*** HOLE CARDS ***
Dealt to 65ef6dfc 
Dealt to add80e2d 
Dealt to Hero [8c 7c]
Dealt to e2777133 
Dealt to eb412629 
Dealt to 626511c8 
e2777133: folds
eb412629: folds
626511c8: folds
65ef6dfc: raises $0.1 to $0.15
add80e2d: folds
Hero: calls $0.1
*** FLOP *** [Qh 7d Jc]
Hero: checks
65ef6dfc: checks
*** TURN *** [Qh 7d Jc] [3s]
Hero: checks
65ef6dfc: checks
*** RIVER *** [Qh 7d Jc 3s] [Ts]
Hero: checks
65ef6dfc: checks
Hero: shows [8c 7c] (Pair of Sevens)
65ef6dfc: shows [6h Kh] (King-High)
*** SHOWDOWN ***
Hero collected $0.31 from pot
*** SUMMARY ***
Total pot $0.32 | Rake $0.01 | Jackpot $0 | Bingo $0 | Fortune $0 | Tax $0
Board [Qh 7d Jc 3s Ts]
Seat 1: 65ef6dfc (button) showed [6h Kh] and lost with King-High
Seat 2: add80e2d (small blind) folded before Flop
Seat 3: Hero (big blind) showed [8c 7c] and won ($0.31) with Pair of Sevens
Seat 4: e2777133 folded before Flop (didn't bet)
Seat 5: eb412629 folded before Flop (didn't bet)
Seat 6: 626511c8 folded before Flop (didn't bet)


Poker Hand #RC3334368317: Hold'em No Limit ($0.02/$0.05) - 2025/02/17 20:11:06
Table 'RushAndCash593577' 6-max Seat #1 is the button
Seat 1: 9c9041e6 ($5 in chips)
Seat 2: Hero ($5 in chips)
Seat 3: 918d412c ($3.87 in chips)
Seat 4: 144ea2b0 ($5.72 in chips)
Seat 5: 24d6dfa4 ($9.42 in chips)
Seat 6: 52b3e671 ($5.91 in chips)
Hero: posts small blind $0.02
918d412c: posts big blind $0.05
*** HOLE CARDS ***
Dealt to 9c9041e6 
Dealt to Hero [Qh 7s]
Dealt to 918d412c 
Dealt to 144ea2b0 
Dealt to 24d6dfa4 
Dealt to 52b3e671 
144ea2b0: folds
24d6dfa4: folds
52b3e671: raises $0.1 to $0.15
9c9041e6: folds
Hero: folds
918d412c: folds
Uncalled bet ($0.1) returned to 52b3e671
*** SHOWDOWN ***
52b3e671 collected $0.12 from pot
*** SUMMARY ***
Total pot $0.12 | Rake $0 | Jackpot $0 | Bingo $0 | Fortune $0 | Tax $0
Seat 1: 9c9041e6 (button) folded before Flop (didn't bet)
Seat 2: Hero (small blind) folded before Flop
Seat 3: 918d412c (big blind) folded before Flop
Seat 4: 144ea2b0 folded before Flop (didn't bet)
Seat 5: 24d6dfa4 folded before Flop (didn't bet)
Seat 6: 52b3e671 collected ($0.12)


Poker Hand #RC3334368295: Hold'em No Limit ($0.02/$0.05) - 2025/02/17 20:11:03
Table 'RushAndCash593555' 6-max Seat #1 is the button
Seat 1: f4988477 ($9.62 in chips)
Seat 2: c585480d ($5.42 in chips)
Seat 3: 860b5247 ($8.72 in chips)
Seat 4: Hero ($5 in chips)
Seat 5: 11caa266 ($9.46 in chips)
Seat 6: 2c0804e1 ($7.54 in chips)
c585480d: posts small blind $0.02
860b5247: posts big blind $0.05
*** HOLE CARDS ***
Dealt to f4988477 
Dealt to c585480d 
Dealt to 860b5247 
Dealt to Hero [Qs 9h]
Dealt to 11caa266 
Dealt to 2c0804e1 
Hero: folds
11caa266: folds
2c0804e1: folds
f4988477: folds
c585480d: raises $0.1 to $0.15
860b5247: raises $0.3 to $0.45
c585480d: folds
Uncalled bet ($0.3) returned to 860b5247
*** SHOWDOWN ***
860b5247 collected $0.29 from pot
*** SUMMARY ***
Total pot $0.3 | Rake $0.01 | Jackpot $0 | Bingo $0 | Fortune $0 | Tax $0
Seat 1: f4988477 (button) folded before Flop (didn't bet)
Seat 2: c585480d (small blind) folded before Flop
Seat 3: 860b5247 (big blind) collected ($0.29)
Seat 4: Hero folded before Flop (didn't bet)
Seat 5: 11caa266 folded before Flop (didn't bet)
Seat 6: 2c0804e1 folded before Flop (didn't bet)


Poker Hand #RC3334367961: Hold'em No Limit ($0.02/$0.05) - 2025/02/17 20:10:12
Table 'RushAndCash593221' 6-max Seat #1 is the button
Seat 1: c2002ddb ($6.87 in chips)
Seat 2: 6183e175 ($17.81 in chips)
Seat 3: f8067dc5 ($6.33 in chips)
Seat 4: 8a2a3713 ($5.62 in chips)
Seat 5: Hero ($5 in chips)
Seat 6: d97dda86 ($5.23 in chips)
6183e175: posts small blind $0.02
f8067dc5: posts big blind $0.05
*** HOLE CARDS ***
Dealt to c2002ddb 
Dealt to 6183e175 
Dealt to f8067dc5 
Dealt to 8a2a3713 
Dealt to Hero [Qh Ac]
Dealt to d97dda86 
8a2a3713: folds
Hero: raises $0.05 to $0.1
d97dda86: folds
c2002ddb: calls $0.1
6183e175: folds
f8067dc5: folds
*** FLOP *** [9h 3h Kh]
Hero: bets $0.1
c2002ddb: calls $0.1
*** TURN *** [9h 3h Kh] [9s]
Hero: bets $0.24
c2002ddb: calls $0.24
*** RIVER *** [9h 3h Kh 9s] [3c]
Hero: checks
c2002ddb: bets $6.43 and is all-in
Hero: folds
Uncalled bet ($6.43) returned to c2002ddb
*** SHOWDOWN ***
c2002ddb collected $0.9 from pot
*** SUMMARY ***
Total pot $0.95 | Rake $0.05 | Jackpot $0 | Bingo $0 | Fortune $0 | Tax $0
Board [9h 3h Kh 9s 3c]
Seat 1: c2002ddb (button) won ($0.9)
Seat 2: 6183e175 (small blind) folded before Flop
Seat 3: f8067dc5 (big blind) folded before Flop
Seat 4: 8a2a3713 folded before Flop (didn't bet)
Seat 5: Hero folded on the River
Seat 6: d97dda86 folded before Flop (didn't bet)


Poker Hand #RC3334367936: Hold'em No Limit ($0.02/$0.05) - 2025/02/17 20:10:09
Table 'RushAndCash593196' 6-max Seat #1 is the button
Seat 1: Hero ($5 in chips)
Seat 2: c9ea832 ($6.49 in chips)
Seat 3: 86768906 ($5 in chips)
Seat 4: 69d7bf2c ($5.25 in chips)
Seat 5: 1a2d8f33 ($5.07 in chips)
Seat 6: 5fe62400 ($6.07 in chips)
c9ea832: posts small blind $0.02
86768906: posts big blind $0.05
*** HOLE CARDS ***
Dealt to Hero [Ah 2c]
Dealt to c9ea832 
Dealt to 86768906 
Dealt to 69d7bf2c 
Dealt to 1a2d8f33 
Dealt to 5fe62400 
69d7bf2c: raises $0.08 to $0.13
1a2d8f33: folds
5fe62400: folds
Hero: folds
c9ea832: folds
86768906: folds
Uncalled bet ($0.08) returned to 69d7bf2c
*** SHOWDOWN ***
69d7bf2c collected $0.12 from pot
*** SUMMARY ***
Total pot $0.12 | Rake $0 | Jackpot $0 | Bingo $0 | Fortune $0 | Tax $0
Seat 1: Hero (button) folded before Flop (didn't bet)
Seat 2: c9ea832 (small blind) folded before Flop
Seat 3: 86768906 (big blind) folded before Flop
Seat 4: 69d7bf2c collected ($0.12)
Seat 5: 1a2d8f33 folded before Flop (didn't bet)
Seat 6: 5fe62400 folded before Flop (didn't bet)


Poker Hand #RC3334367914: Hold'em No Limit ($0.02/$0.05) - 2025/02/17 20:10:06
Table 'RushAndCash593174' 6-max Seat #1 is the button
Seat 1: dbb7a28 ($5.41 in chips)
Seat 2: c62b7a0b ($19.33 in chips)
Seat 3: 3a23fe14 ($4.93 in chips)
Seat 4: Hero ($5 in chips)
Seat 5: b0d0d63c ($5 in chips)
Seat 6: d1cd1071 ($13.59 in chips)
c62b7a0b: posts small blind $0.02
3a23fe14: posts big blind $0.05
*** HOLE CARDS ***
Dealt to dbb7a28 
Dealt to c62b7a0b 
Dealt to 3a23fe14 
Dealt to Hero [6d 5s]
Dealt to b0d0d63c 
Dealt to d1cd1071 
Hero: folds
b0d0d63c: raises $0.05 to $0.1
d1cd1071: folds
dbb7a28: folds
c62b7a0b: raises $0.3 to $0.4
3a23fe14: folds
b0d0d63c: calls $0.3
*** FLOP *** [Qs 4h Tc]
c62b7a0b: bets $0.29
b0d0d63c: calls $0.29
*** TURN *** [Qs 4h Tc] [3h]
c62b7a0b: checks
b0d0d63c: bets $0.72
c62b7a0b: raises $0.72 to $1.44
b0d0d63c: folds
Uncalled bet ($0.72) returned to c62b7a0b
*** SHOWDOWN ***
c62b7a0b collected $2.66 from pot
*** SUMMARY ***
Total pot $2.87 | Rake $0.14 | Jackpot $0.07 | Bingo $0 | Fortune $0 | Tax $0
Board [Qs 4h Tc 3h]
Seat 1: dbb7a28 (button) folded before Flop (didn't bet)
Seat 2: c62b7a0b (small blind) won ($2.66)
Seat 3: 3a23fe14 (big blind) folded before Flop
Seat 4: Hero folded before Flop (didn't bet)
Seat 5: b0d0d63c folded on the Turn
Seat 6: d1cd1071 folded before Flop (didn't bet)


Poker Hand #RC3334367891: Hold'em No Limit ($0.02/$0.05) - 2025/02/17 20:10:03
Table 'RushAndCash593151' 6-max Seat #1 is the button
Seat 1: df0ebddc ($5.62 in chips)
Seat 2: Hero ($5.02 in chips)
Seat 3: eaafe260 ($5 in chips)
Seat 4: b1aa19ba ($5.07 in chips)
Seat 5: 6d2abfa5 ($5.89 in chips)
Seat 6: 8ec32764 ($5.31 in chips)
Hero: posts small blind $0.02
eaafe260: posts big blind $0.05
*** HOLE CARDS ***
Dealt to df0ebddc 
Dealt to Hero [4s Kd]
Dealt to eaafe260 
Dealt to b1aa19ba 
Dealt to 6d2abfa5 
Dealt to 8ec32764 
b1aa19ba: folds
6d2abfa5: folds
8ec32764: folds
df0ebddc: folds
Hero: folds
Uncalled bet ($0.03) returned to eaafe260
*** SHOWDOWN ***
eaafe260 collected $0.04 from pot
*** SUMMARY ***
Total pot $0.04 | Rake $0 | Jackpot $0 | Bingo $0 | Fortune $0 | Tax $0
Seat 1: df0ebddc (button) folded before Flop (didn't bet)
Seat 2: Hero (small blind) folded before Flop
Seat 3: eaafe260 (big blind) collected ($0.04)
Seat 4: b1aa19ba folded before Flop (didn't bet)
Seat 5: 6d2abfa5 folded before Flop (didn't bet)
Seat 6: 8ec32764 folded before Flop (didn't bet)


Poker Hand #RC3334367865: Hold'em No Limit ($0.02/$0.05) - 2025/02/17 20:09:59
Table 'RushAndCash593125' 6-max Seat #1 is the button
Seat 1: 9598e06a ($6.05 in chips)
Seat 2: 30c2b6c7 ($5.12 in chips)
Seat 3: Hero ($5.07 in chips)
Seat 4: 65ef6dfc ($5.31 in chips)
Seat 5: c182b1a3 ($5.15 in chips)
Seat 6: 3100dcf0 ($5.28 in chips)
30c2b6c7: posts small blind $0.02
Hero: posts big blind $0.05
*** HOLE CARDS ***
Dealt to 9598e06a 
Dealt to 30c2b6c7 
Dealt to Hero [2s Kc]
Dealt to 65ef6dfc 
Dealt to c182b1a3 
Dealt to 3100dcf0 
65ef6dfc: folds
c182b1a3: raises $0.05 to $0.1
3100dcf0: folds
9598e06a: folds
30c2b6c7: folds
Hero: folds
Uncalled bet ($0.05) returned to c182b1a3
*** SHOWDOWN ***
c182b1a3 collected $0.12 from pot
*** SUMMARY ***
Total pot $0.12 | Rake $0 | Jackpot $0 | Bingo $0 | Fortune $0 | Tax $0
Seat 1: 9598e06a (button) folded before Flop (didn't bet)
Seat 2: 30c2b6c7 (small blind) folded before Flop
Seat 3: Hero (big blind) folded before Flop
Seat 4: 65ef6dfc folded before Flop (didn't bet)
Seat 5: c182b1a3 collected ($0.12)
Seat 6: 3100dcf0 folded before Flop (didn't bet)


Poker Hand #RC3334367843: Hold'em No Limit ($0.02/$0.05) - 2025/02/17 20:09:56
Table 'RushAndCash593103' 6-max Seat #1 is the button
Seat 1: 9b2bd2a6 ($8.24 in chips)
Seat 2: ea485a4d ($5.05 in chips)
Seat 3: 16081ce9 ($10.18 in chips)
Seat 4: 7cf45cbd ($7.76 in chips)
Seat 5: 6f96f8db ($4.85 in chips)
Seat 6: Hero ($5.07 in chips)
ea485a4d: posts small blind $0.02
16081ce9: posts big blind $0.05
*** HOLE CARDS ***
Dealt to 9b2bd2a6 
Dealt to ea485a4d 
Dealt to 16081ce9 
Dealt to 7cf45cbd 
Dealt to 6f96f8db 
Dealt to Hero [4c Qh]
7cf45cbd: folds
6f96f8db: folds
Hero: folds
9b2bd2a6: raises $0.05 to $0.1
ea485a4d: folds
16081ce9: calls $0.05
*** FLOP *** [Qs 7c Kc]
16081ce9: checks
9b2bd2a6: bets $0.08
16081ce9: folds
Uncalled bet ($0.08) returned to 9b2bd2a6
*** SHOWDOWN ***
9b2bd2a6 collected $0.21 from pot
*** SUMMARY ***
Total pot $0.22 | Rake $0.01 | Jackpot $0 | Bingo $0 | Fortune $0 | Tax $0
Board [Qs 7c Kc]
Seat 1: 9b2bd2a6 (button) won ($0.21)
Seat 2: ea485a4d (small blind) folded before Flop
Seat 3: 16081ce9 (big blind) folded on the Flop
Seat 4: 7cf45cbd folded before Flop (didn't bet)
Seat 5: 6f96f8db folded before Flop (didn't bet)
Seat 6: Hero folded before Flop (didn't bet)


Poker Hand #RC3334367790: Hold'em No Limit ($0.02/$0.05) - 2025/02/17 20:09:47
Table 'RushAndCash593050' 6-max Seat #1 is the button
Seat 1: 8be10cd0 ($5.07 in chips)
Seat 2: 33527257 ($5 in chips)
Seat 3: 18cb11a ($7.35 in chips)
Seat 4: fb6c913 ($3.69 in chips)
Seat 5: Hero ($5.07 in chips)
Seat 6: fe0566a4 ($6.46 in chips)
33527257: posts small blind $0.02
18cb11a: posts big blind $0.05
*** HOLE CARDS ***
Dealt to 8be10cd0 
Dealt to 33527257 
Dealt to 18cb11a 
Dealt to fb6c913 
Dealt to Hero [7d Td]
Dealt to fe0566a4 
fb6c913: folds
Hero: folds
fe0566a4: raises $0.05 to $0.1
8be10cd0: folds
33527257: raises $0.38 to $0.48
18cb11a: folds
fe0566a4: raises $0.76 to $1.24
33527257: calls $0.76
*** FLOP *** [Qh 3h Ks]
33527257: checks
fe0566a4: bets $1.27
33527257: calls $1.27
*** TURN *** [Qh 3h Ks] [2h]
33527257: checks
fe0566a4: bets $3.81
33527257: calls $2.49 and is all-in
Uncalled bet ($1.32) returned to fe0566a4
fe0566a4: shows [Kc Kd] (Three Kings)
33527257: shows [As Ah] (Pair of Aces)
*** RIVER *** [Qh 3h Ks 2h] [3d]
*** SHOWDOWN ***
fe0566a4 collected $9.83 from pot
*** SUMMARY ***
Total pot $10.05 | Rake $0.15 | Jackpot $0.07 | Bingo $0 | Fortune $0 | Tax $0
Board [Qh 3h Ks 2h 3d]
Seat 1: 8be10cd0 (button) folded before Flop (didn't bet)
Seat 2: 33527257 (small blind) showed [As Ah] and lost with Pair of Aces and Pair of Treys
Seat 3: 18cb11a (big blind) folded before Flop
Seat 4: fb6c913 folded before Flop (didn't bet)
Seat 5: Hero folded before Flop (didn't bet)
Seat 6: fe0566a4 showed [Kc Kd] and won ($9.83) with Kings Full over Treys


Poker Hand #RC3334367770: Hold'em No Limit ($0.02/$0.05) - 2025/02/17 20:09:43
Table 'RushAndCash593030' 6-max Seat #1 is the button
Seat 1: 45d33c76 ($7.08 in chips)
Seat 2: 6af54020 ($5.81 in chips)
Seat 3: 25b4d6e7 ($11.68 in chips)
Seat 4: 4ad8869b ($5.21 in chips)
Seat 5: 730098b8 ($6.15 in chips)
Seat 6: Hero ($5.07 in chips)
6af54020: posts small blind $0.02
25b4d6e7: posts big blind $0.05
*** HOLE CARDS ***
Dealt to 45d33c76 
Dealt to 6af54020 
Dealt to 25b4d6e7 
Dealt to 4ad8869b 
Dealt to 730098b8 
Dealt to Hero [9d 5s]
4ad8869b: folds
730098b8: raises $0.08 to $0.13
Hero: folds
45d33c76: folds
6af54020: folds
25b4d6e7: folds
Uncalled bet ($0.08) returned to 730098b8
*** SHOWDOWN ***
730098b8 collected $0.12 from pot
*** SUMMARY ***
Total pot $0.12 | Rake $0 | Jackpot $0 | Bingo $0 | Fortune $0 | Tax $0
Seat 1: 45d33c76 (button) folded before Flop (didn't bet)
Seat 2: 6af54020 (small blind) folded before Flop
Seat 3: 25b4d6e7 (big blind) folded before Flop
Seat 4: 4ad8869b folded before Flop (didn't bet)
Seat 5: 730098b8 collected ($0.12)
Seat 6: Hero folded before Flop (didn't bet)


Poker Hand #RC3334367548: Hold'em No Limit ($0.02/$0.05) - 2025/02/17 20:09:07
Table 'RushAndCash592808' 6-max Seat #1 is the button
Seat 1: Hero ($5 in chips)
Seat 2: d32b2e06 ($5.67 in chips)
Seat 3: 45d33c76 ($7.13 in chips)
Seat 4: 939e7cc4 ($4.95 in chips)
Seat 5: 7cf45cbd ($7.58 in chips)
Seat 6: cacae660 ($4.78 in chips)
d32b2e06: posts small blind $0.02
45d33c76: posts big blind $0.05
*** HOLE CARDS ***
Dealt to Hero [9c Qs]
Dealt to d32b2e06 
Dealt to 45d33c76 
Dealt to 939e7cc4 
Dealt to 7cf45cbd 
Dealt to cacae660 
939e7cc4: folds
7cf45cbd: folds
cacae660: folds
Hero: raises $0.05 to $0.1
d32b2e06: folds
45d33c76: folds
Uncalled bet ($0.05) returned to Hero
*** SHOWDOWN ***
Hero collected $0.12 from pot
*** SUMMARY ***
Total pot $0.12 | Rake $0 | Jackpot $0 | Bingo $0 | Fortune $0 | Tax $0
Seat 1: Hero (button) collected ($0.12)
Seat 2: d32b2e06 (small blind) folded before Flop
Seat 3: 45d33c76 (big blind) folded before Flop
Seat 4: 939e7cc4 folded before Flop (didn't bet)
Seat 5: 7cf45cbd folded before Flop (didn't bet)
Seat 6: cacae660 folded before Flop (didn't bet)


Poker Hand #RC3334367527: Hold'em No Limit ($0.02/$0.05) - 2025/02/17 20:09:04
Table 'RushAndCash592787' 6-max Seat #1 is the button
Seat 1: deccd7eb ($5 in chips)
Seat 2: Hero ($5 in chips)
Seat 3: 8c3789e ($7.85 in chips)
Seat 4: 6ab8e60e ($9.29 in chips)
Seat 5: 7f3dcda7 ($7.83 in chips)
Seat 6: eb412629 ($4.8 in chips)
Hero: posts small blind $0.02
8c3789e: posts big blind $0.05
*** HOLE CARDS ***
Dealt to deccd7eb 
Dealt to Hero [7s 3h]
Dealt to 8c3789e 
Dealt to 6ab8e60e 
Dealt to 7f3dcda7 
Dealt to eb412629 
6ab8e60e: folds
7f3dcda7: folds
eb412629: folds
deccd7eb: raises $0.06 to $0.11
Hero: folds
8c3789e: calls $0.06
*** FLOP *** [9c Ah Jh]
8c3789e: checks
deccd7eb: bets $0.12
8c3789e: folds
Uncalled bet ($0.12) returned to deccd7eb
*** SHOWDOWN ***
deccd7eb collected $0.23 from pot
*** SUMMARY ***
Total pot $0.24 | Rake $0.01 | Jackpot $0 | Bingo $0 | Fortune $0 | Tax $0
Board [9c Ah Jh]
Seat 1: deccd7eb (button) won ($0.23)
Seat 2: Hero (small blind) folded before Flop
Seat 3: 8c3789e (big blind) folded on the Flop
Seat 4: 6ab8e60e folded before Flop (didn't bet)
Seat 5: 7f3dcda7 folded before Flop (didn't bet)
Seat 6: eb412629 folded before Flop (didn't bet)


Poker Hand #RC3334367503: Hold'em No Limit ($0.02/$0.05) - 2025/02/17 20:09:00
Table 'RushAndCash592763' 6-max Seat #1 is the button
Seat 1: 69d7bf2c ($5.25 in chips)
Seat 2: ef63200d ($5.68 in chips)
Seat 3: Hero ($5 in chips)
Seat 4: a14fa66b ($0.74 in chips)
Seat 5: 90b5d23c ($5.05 in chips)
Seat 6: 1dbab20d ($5 in chips)
ef63200d: posts small blind $0.02
Hero: posts big blind $0.05
*** HOLE CARDS ***
Dealt to 69d7bf2c 
Dealt to ef63200d 
Dealt to Hero [7d 4s]
Dealt to a14fa66b 
Dealt to 90b5d23c 
Dealt to 1dbab20d 
a14fa66b: folds
90b5d23c: folds
1dbab20d: raises $0.08 to $0.13
69d7bf2c: folds
ef63200d: folds
Hero: folds
Uncalled bet ($0.08) returned to 1dbab20d
*** SHOWDOWN ***
1dbab20d collected $0.12 from pot
*** SUMMARY ***
Total pot $0.12 | Rake $0 | Jackpot $0 | Bingo $0 | Fortune $0 | Tax $0
Seat 1: 69d7bf2c (button) folded before Flop (didn't bet)
Seat 2: ef63200d (small blind) folded before Flop
Seat 3: Hero (big blind) folded before Flop
Seat 4: a14fa66b folded before Flop (didn't bet)
Seat 5: 90b5d23c folded before Flop (didn't bet)
Seat 6: 1dbab20d collected ($0.12)


Poker Hand #RC3334367481: Hold'em No Limit ($0.02/$0.05) - 2025/02/17 20:08:57
Table 'RushAndCash592741' 6-max Seat #1 is the button
Seat 1: fa84cc2d ($14.18 in chips)
Seat 2: 8617620c ($11.59 in chips)
Seat 3: bf15fd4d ($2.36 in chips)
Seat 4: 90b5d23c ($5.05 in chips)
Seat 5: 6d5fa70b ($5.59 in chips)
Seat 6: Hero ($5 in chips)
8617620c: posts small blind $0.02
bf15fd4d: posts big blind $0.05
*** HOLE CARDS ***
Dealt to fa84cc2d 
Dealt to 8617620c 
Dealt to bf15fd4d 
Dealt to 90b5d23c 
Dealt to 6d5fa70b 
Dealt to Hero [6h 7s]
90b5d23c: folds
6d5fa70b: folds
Hero: folds
fa84cc2d: raises $0.07 to $0.12
8617620c: folds
bf15fd4d: calls $0.07
*** FLOP *** [Ts Jc Qd]
bf15fd4d: bets $0.2
fa84cc2d: calls $0.2
*** TURN *** [Ts Jc Qd] [3d]
bf15fd4d: bets $0.66
fa84cc2d: folds
Uncalled bet ($0.66) returned to bf15fd4d
*** SHOWDOWN ***
bf15fd4d collected $0.63 from pot
*** SUMMARY ***
Total pot $0.66 | Rake $0.03 | Jackpot $0 | Bingo $0 | Fortune $0 | Tax $0
Board [Ts Jc Qd 3d]
Seat 1: fa84cc2d (button) folded on the Turn
Seat 2: 8617620c (small blind) folded before Flop
Seat 3: bf15fd4d (big blind) won ($0.63)
Seat 4: 90b5d23c folded before Flop (didn't bet)
Seat 5: 6d5fa70b folded before Flop (didn't bet)
Seat 6: Hero folded before Flop (didn't bet)


Poker Hand #RC3334367461: Hold'em No Limit ($0.02/$0.05) - 2025/02/17 20:08:54
Table 'RushAndCash592721' 6-max Seat #1 is the button
Seat 1: 598d859f ($5.32 in chips)
Seat 2: 27baaa05 ($5.28 in chips)
Seat 3: b42dd6b5 ($5.65 in chips)
Seat 4: 702267b4 ($9.29 in chips)
Seat 5: Hero ($5 in chips)
Seat 6: 4f52eeee ($36.8 in chips)
27baaa05: posts small blind $0.02
b42dd6b5: posts big blind $0.05
*** HOLE CARDS ***
Dealt to 598d859f 
Dealt to 27baaa05 
Dealt to b42dd6b5 
Dealt to 702267b4 
Dealt to Hero [Qs Tc]
Dealt to 4f52eeee 
702267b4: folds
Hero: folds
4f52eeee: folds
598d859f: raises $0.08 to $0.13
27baaa05: folds
b42dd6b5: folds
Uncalled bet ($0.08) returned to 598d859f
*** SHOWDOWN ***
598d859f collected $0.12 from pot
*** SUMMARY ***
Total pot $0.12 | Rake $0 | Jackpot $0 | Bingo $0 | Fortune $0 | Tax $0
Seat 1: 598d859f (button) collected ($0.12)
Seat 2: 27baaa05 (small blind) folded before Flop
Seat 3: b42dd6b5 (big blind) folded before Flop
Seat 4: 702267b4 folded before Flop (didn't bet)
Seat 5: Hero folded before Flop (didn't bet)
Seat 6: 4f52eeee folded before Flop (didn't bet)


Poker Hand #RC3334367436: Hold'em No Limit ($0.02/$0.05) - 2025/02/17 20:08:51
Table 'RushAndCash592696' 6-max Seat #1 is the button
Seat 1: 959ea87c ($6.8 in chips)
Seat 2: e632d40b ($5.32 in chips)
Seat 3: 27baaa05 ($5.33 in chips)
Seat 4: Hero ($5 in chips)
Seat 5: dc9e794c ($5.07 in chips)
Seat 6: ded3640 ($5.51 in chips)
e632d40b: posts small blind $0.02
27baaa05: posts big blind $0.05
*** HOLE CARDS ***
Dealt to 959ea87c 
Dealt to e632d40b 
Dealt to 27baaa05 
Dealt to Hero [3c 7h]
Dealt to dc9e794c 
Dealt to ded3640 
Hero: folds
dc9e794c: raises $0.05 to $0.1
ded3640: folds
959ea87c: folds
e632d40b: folds
27baaa05: folds
Uncalled bet ($0.05) returned to dc9e794c
*** SHOWDOWN ***
dc9e794c collected $0.12 from pot
*** SUMMARY ***
Total pot $0.12 | Rake $0 | Jackpot $0 | Bingo $0 | Fortune $0 | Tax $0
Seat 1: 959ea87c (button) folded before Flop (didn't bet)
Seat 2: e632d40b (small blind) folded before Flop
Seat 3: 27baaa05 (big blind) folded before Flop
Seat 4: Hero folded before Flop (didn't bet)
Seat 5: dc9e794c collected ($0.12)
Seat 6: ded3640 folded before Flop (didn't bet)


Poker Hand #RC3334367412: Hold'em No Limit ($0.02/$0.05) - 2025/02/17 20:08:47
Table 'RushAndCash592672' 6-max Seat #1 is the button
Seat 1: f0d8a680 ($5 in chips)
Seat 2: 18cb11a ($7.66 in chips)
Seat 3: 37af72de ($4.17 in chips)
Seat 4: 24c4874c ($4.8 in chips)
Seat 5: Hero ($5 in chips)
Seat 6: e5f214e5 ($8.75 in chips)
18cb11a: posts small blind $0.02
37af72de: posts big blind $0.05
*** HOLE CARDS ***
Dealt to f0d8a680 
Dealt to 18cb11a 
Dealt to 37af72de 
Dealt to 24c4874c 
Dealt to Hero [3c Qc]
Dealt to e5f214e5 
24c4874c: folds
Hero: folds
e5f214e5: folds
f0d8a680: folds
18cb11a: folds
Uncalled bet ($0.03) returned to 37af72de
*** SHOWDOWN ***
37af72de collected $0.04 from pot
*** SUMMARY ***
Total pot $0.04 | Rake $0 | Jackpot $0 | Bingo $0 | Fortune $0 | Tax $0
Seat 1: f0d8a680 (button) folded before Flop (didn't bet)
Seat 2: 18cb11a (small blind) folded before Flop
Seat 3: 37af72de (big blind) collected ($0.04)
Seat 4: 24c4874c folded before Flop (didn't bet)
Seat 5: Hero folded before Flop (didn't bet)
Seat 6: e5f214e5 folded before Flop (didn't bet)


Poker Hand #RC3334367389: Hold'em No Limit ($0.02/$0.05) - 2025/02/17 20:08:43
Table 'RushAndCash592649' 6-max Seat #1 is the button
Seat 1: a6ca20e7 ($32.98 in chips)
Seat 2: Hero ($5 in chips)
Seat 3: 30c2b6c7 ($5 in chips)
Seat 4: 3c1ddc3a ($5.25 in chips)
Seat 5: e92b360e ($9.28 in chips)
Seat 6: 2678c032 ($9.29 in chips)
Hero: posts small blind $0.02
30c2b6c7: posts big blind $0.05
*** HOLE CARDS ***
Dealt to a6ca20e7 
Dealt to Hero [5h 4c]
Dealt to 30c2b6c7 
Dealt to 3c1ddc3a 
Dealt to e92b360e 
Dealt to 2678c032 
3c1ddc3a: raises $0.05 to $0.1
e92b360e: raises $0.27 to $0.37
2678c032: raises $0.33 to $0.7
a6ca20e7: folds
Hero: folds
30c2b6c7: folds
3c1ddc3a: folds
e92b360e: folds
Uncalled bet ($0.33) returned to 2678c032
*** SHOWDOWN ***
2678c032 collected $0.87 from pot
*** SUMMARY ***
Total pot $0.91 | Rake $0.04 | Jackpot $0 | Bingo $0 | Fortune $0 | Tax $0
Seat 1: a6ca20e7 (button) folded before Flop (didn't bet)
Seat 2: Hero (small blind) folded before Flop
Seat 3: 30c2b6c7 (big blind) folded before Flop
Seat 4: 3c1ddc3a folded before Flop
Seat 5: e92b360e folded before Flop
Seat 6: 2678c032 collected ($0.87)


Poker Hand #RC3334367368: Hold'em No Limit ($0.02/$0.05) - 2025/02/17 20:08:40
Table 'RushAndCash592628' 6-max Seat #1 is the button
Seat 1: Hero ($5 in chips)
Seat 2: f4c45632 ($5.12 in chips)
Seat 3: fa499268 ($5 in chips)
Seat 4: e94f5acb ($13.09 in chips)
Seat 5: 84fb210c ($8.86 in chips)
Seat 6: 702267b4 ($9.31 in chips)
f4c45632: posts small blind $0.02
fa499268: posts big blind $0.05
*** HOLE CARDS ***
Dealt to Hero [8c 5h]
Dealt to f4c45632 
Dealt to fa499268 
Dealt to e94f5acb 
Dealt to 84fb210c 
Dealt to 702267b4 
e94f5acb: raises $0.05 to $0.1
84fb210c: folds
702267b4: folds
Hero: folds
f4c45632: folds
fa499268: folds
Uncalled bet ($0.05) returned to e94f5acb
*** SHOWDOWN ***
e94f5acb collected $0.12 from pot
*** SUMMARY ***
Total pot $0.12 | Rake $0 | Jackpot $0 | Bingo $0 | Fortune $0 | Tax $0
Seat 1: Hero (button) folded before Flop (didn't bet)
Seat 2: f4c45632 (small blind) folded before Flop
Seat 3: fa499268 (big blind) folded before Flop
Seat 4: e94f5acb collected ($0.12)
Seat 5: 84fb210c folded before Flop (didn't bet)
Seat 6: 702267b4 folded before Flop (didn't bet)


Poker Hand #RC3334367343: Hold'em No Limit ($0.02/$0.05) - 2025/02/17 20:08:37
Table 'RushAndCash592603' 6-max Seat #1 is the button
Seat 1: e74a324 ($5 in chips)
Seat 2: 5f1cdd27 ($5.02 in chips)
Seat 3: Hero ($5 in chips)
Seat 4: af9eb074 ($5.46 in chips)
Seat 5: 1a99fcb9 ($9.76 in chips)
Seat 6: 84fb210c ($8.86 in chips)
5f1cdd27: posts small blind $0.02
Hero: posts big blind $0.05
*** HOLE CARDS ***
Dealt to e74a324 
Dealt to 5f1cdd27 
Dealt to Hero [6d Kc]
Dealt to af9eb074 
Dealt to 1a99fcb9 
Dealt to 84fb210c 
af9eb074: folds
1a99fcb9: folds
84fb210c: folds
e74a324: folds
5f1cdd27: raises $0.05 to $0.1
Hero: folds
Uncalled bet ($0.05) returned to 5f1cdd27
*** SHOWDOWN ***
5f1cdd27 collected $0.1 from pot
*** SUMMARY ***
Total pot $0.1 | Rake $0 | Jackpot $0 | Bingo $0 | Fortune $0 | Tax $0
Seat 1: e74a324 (button) folded before Flop (didn't bet)
Seat 2: 5f1cdd27 (small blind) collected ($0.1)
Seat 3: Hero (big blind) folded before Flop
Seat 4: af9eb074 folded before Flop (didn't bet)
Seat 5: 1a99fcb9 folded before Flop (didn't bet)
Seat 6: 84fb210c folded before Flop (didn't bet)


Poker Hand #RC3334367313: Hold'em No Limit ($0.02/$0.05) - 2025/02/17 20:08:32
Table 'RushAndCash592573' 6-max Seat #1 is the button
Seat 1: e670889d ($5.98 in chips)
Seat 2: 93dfef8b ($5.07 in chips)
Seat 3: d64896fd ($11.04 in chips)
Seat 4: eea81bce ($5.77 in chips)
Seat 5: Hero ($5 in chips)
Seat 6: a28ca95c ($8.57 in chips)
93dfef8b: posts small blind $0.02
d64896fd: posts big blind $0.05
*** HOLE CARDS ***
Dealt to e670889d 
Dealt to 93dfef8b 
Dealt to d64896fd 
Dealt to eea81bce 
Dealt to Hero [2c Kh]
Dealt to a28ca95c 
eea81bce: folds
Hero: folds
a28ca95c: folds
e670889d: raises $0.08 to $0.13
93dfef8b: folds
d64896fd: calls $0.08
*** FLOP *** [4h 3d 4s]
d64896fd: checks
e670889d: bets $0.14
d64896fd: calls $0.14
*** TURN *** [4h 3d 4s] [Ks]
d64896fd: checks
e670889d: bets $0.37
d64896fd: folds
Uncalled bet ($0.37) returned to e670889d
*** SHOWDOWN ***
e670889d collected $0.54 from pot
*** SUMMARY ***
Total pot $0.56 | Rake $0.02 | Jackpot $0 | Bingo $0 | Fortune $0 | Tax $0
Board [4h 3d 4s Ks]
Seat 1: e670889d (button) won ($0.54)
Seat 2: 93dfef8b (small blind) folded before Flop
Seat 3: d64896fd (big blind) folded on the Turn
Seat 4: eea81bce folded before Flop (didn't bet)
Seat 5: Hero folded before Flop (didn't bet)
Seat 6: a28ca95c folded before Flop (didn't bet)


Poker Hand #RC3334367239: Hold'em No Limit ($0.02/$0.05) - 2025/02/17 20:08:21
Table 'RushAndCash592499' 6-max Seat #1 is the button
Seat 1: 5f1cdd27 ($5 in chips)
Seat 2: 6183e175 ($18.6 in chips)
Seat 3: 825e110f ($5 in chips)
Seat 4: 16a87f9d ($8.14 in chips)
Seat 5: Hero ($5 in chips)
Seat 6: 63499226 ($3.71 in chips)
6183e175: posts small blind $0.02
825e110f: posts big blind $0.05
*** HOLE CARDS ***
Dealt to 5f1cdd27 
Dealt to 6183e175 
Dealt to 825e110f 
Dealt to 16a87f9d 
Dealt to Hero [Kd 8d]
Dealt to 63499226 
16a87f9d: folds
Hero: folds
63499226: folds
5f1cdd27: folds
6183e175: folds
Uncalled bet ($0.03) returned to 825e110f
*** SHOWDOWN ***
825e110f collected $0.04 from pot
*** SUMMARY ***
Total pot $0.04 | Rake $0 | Jackpot $0 | Bingo $0 | Fortune $0 | Tax $0
Seat 1: 5f1cdd27 (button) folded before Flop (didn't bet)
Seat 2: 6183e175 (small blind) folded before Flop
Seat 3: 825e110f (big blind) collected ($0.04)
Seat 4: 16a87f9d folded before Flop (didn't bet)
Seat 5: Hero folded before Flop (didn't bet)
Seat 6: 63499226 folded before Flop (didn't bet)


Poker Hand #RC3334367218: Hold'em No Limit ($0.02/$0.05) - 2025/02/17 20:08:17
Table 'RushAndCash592478' 6-max Seat #1 is the button
Seat 1: Hero ($5 in chips)
Seat 2: a8b128fb ($13.97 in chips)
Seat 3: 7c99618c ($9.5 in chips)
Seat 4: 675a7b76 ($6.43 in chips)
Seat 5: 55d86a7e ($11.84 in chips)
Seat 6: 5c64b878 ($5 in chips)
a8b128fb: posts small blind $0.02
7c99618c: posts big blind $0.05
*** HOLE CARDS ***
Dealt to Hero [5s 2d]
Dealt to a8b128fb 
Dealt to 7c99618c 
Dealt to 675a7b76 
Dealt to 55d86a7e 
Dealt to 5c64b878 
675a7b76: folds
55d86a7e: folds
5c64b878: raises $0.05 to $0.1
Hero: folds
a8b128fb: folds
7c99618c: folds
Uncalled bet ($0.05) returned to 5c64b878
*** SHOWDOWN ***
5c64b878 collected $0.12 from pot
*** SUMMARY ***
Total pot $0.12 | Rake $0 | Jackpot $0 | Bingo $0 | Fortune $0 | Tax $0
Seat 1: Hero (button) folded before Flop (didn't bet)
Seat 2: a8b128fb (small blind) folded before Flop
Seat 3: 7c99618c (big blind) folded before Flop
Seat 4: 675a7b76 folded before Flop (didn't bet)
Seat 5: 55d86a7e folded before Flop (didn't bet)
Seat 6: 5c64b878 collected ($0.12)


Poker Hand #RC3334366948: Hold'em No Limit ($0.02/$0.05) - 2025/02/17 20:07:34
Table 'RushAndCash592208' 6-max Seat #1 is the button
Seat 1: fb6c913 ($3.52 in chips)
Seat 2: Hero ($5.42 in chips)
Seat 3: 929700a0 ($5.39 in chips)
Seat 4: 4e3c3196 ($23.92 in chips)
Seat 5: de9a9b83 ($6.29 in chips)
Seat 6: 281bedb1 ($5.04 in chips)
Hero: posts small blind $0.02
929700a0: posts big blind $0.05
*** HOLE CARDS ***
Dealt to fb6c913 
Dealt to Hero [Qd Ah]
Dealt to 929700a0 
Dealt to 4e3c3196 
Dealt to de9a9b83 
Dealt to 281bedb1 
4e3c3196: folds
de9a9b83: folds
281bedb1: raises $0.05 to $0.1
fb6c913: folds
Hero: raises $0.32 to $0.42
929700a0: folds
281bedb1: calls $0.32
*** FLOP *** [8s 5d 6d]
Hero: checks
281bedb1: bets $0.45
Hero: folds
Uncalled bet ($0.45) returned to 281bedb1
*** SHOWDOWN ***
281bedb1 collected $0.85 from pot
*** SUMMARY ***
Total pot $0.89 | Rake $0.04 | Jackpot $0 | Bingo $0 | Fortune $0 | Tax $0
Board [8s 5d 6d]
Seat 1: fb6c913 (button) folded before Flop (didn't bet)
Seat 2: Hero (small blind) folded on the Flop
Seat 3: 929700a0 (big blind) folded before Flop
Seat 4: 4e3c3196 folded before Flop (didn't bet)
Seat 5: de9a9b83 folded before Flop (didn't bet)
Seat 6: 281bedb1 won ($0.85)


Poker Hand #RC3334366928: Hold'em No Limit ($0.02/$0.05) - 2025/02/17 20:07:31
Table 'RushAndCash592188' 6-max Seat #1 is the button
Seat 1: ddd69667 ($5.54 in chips)
Seat 2: ed44755e ($5 in chips)
Seat 3: Hero ($5.47 in chips)
Seat 4: 9ad857e5 ($6.02 in chips)
Seat 5: 8f8d8059 ($17.25 in chips)
Seat 6: 5bb791c6 ($5.27 in chips)
ed44755e: posts small blind $0.02
Hero: posts big blind $0.05
*** HOLE CARDS ***
Dealt to ddd69667 
Dealt to ed44755e 
Dealt to Hero [8d 5c]
Dealt to 9ad857e5 
Dealt to 8f8d8059 
Dealt to 5bb791c6 
9ad857e5: raises $0.05 to $0.1
8f8d8059: calls $0.1
5bb791c6: folds
ddd69667: raises $0.5 to $0.6
ed44755e: folds
Hero: folds
9ad857e5: folds
8f8d8059: folds
Uncalled bet ($0.5) returned to ddd69667
*** SHOWDOWN ***
ddd69667 collected $0.36 from pot
*** SUMMARY ***
Total pot $0.37 | Rake $0.01 | Jackpot $0 | Bingo $0 | Fortune $0 | Tax $0
Seat 1: ddd69667 (button) collected ($0.36)
Seat 2: ed44755e (small blind) folded before Flop
Seat 3: Hero (big blind) folded before Flop
Seat 4: 9ad857e5 folded before Flop
Seat 5: 8f8d8059 folded before Flop
Seat 6: 5bb791c6 folded before Flop (didn't bet)


Poker Hand #RC3334366870: Hold'em No Limit ($0.02/$0.05) - 2025/02/17 20:07:21
Table 'RushAndCash592130' 6-max Seat #1 is the button
Seat 1: f93eeed5 ($5.07 in chips)
Seat 2: 11caa266 ($9.4 in chips)
Seat 3: f71501ed ($6.6 in chips)
Seat 4: 7fc44808 ($6.16 in chips)
Seat 5: 5bb791c6 ($5.27 in chips)
Seat 6: Hero ($5.47 in chips)
11caa266: posts small blind $0.02
f71501ed: posts big blind $0.05
*** HOLE CARDS ***
Dealt to f93eeed5 
Dealt to 11caa266 
Dealt to f71501ed 
Dealt to 7fc44808 
Dealt to 5bb791c6 
Dealt to Hero [6s 4s]
7fc44808: folds
5bb791c6: folds
Hero: folds
f93eeed5: folds
11caa266: raises $0.1 to $0.15
f71501ed: folds
Uncalled bet ($0.1) returned to 11caa266
*** SHOWDOWN ***
11caa266 collected $0.1 from pot
*** SUMMARY ***
Total pot $0.1 | Rake $0 | Jackpot $0 | Bingo $0 | Fortune $0 | Tax $0
Seat 1: f93eeed5 (button) folded before Flop (didn't bet)
Seat 2: 11caa266 (small blind) collected ($0.1)
Seat 3: f71501ed (big blind) folded before Flop
Seat 4: 7fc44808 folded before Flop (didn't bet)
Seat 5: 5bb791c6 folded before Flop (didn't bet)
Seat 6: Hero folded before Flop (didn't bet)


Poker Hand #RC3334366549: Hold'em No Limit ($0.02/$0.05) - 2025/02/17 20:06:31
Table 'RushAndCash591809' 6-max Seat #1 is the button
Seat 1: ed41f291 ($5.51 in chips)
Seat 2: e632d40b ($5.46 in chips)
Seat 3: 16a87f9d ($8.1 in chips)
Seat 4: Hero ($5 in chips)
Seat 5: ef82d036 ($21.73 in chips)
Seat 6: 11caa266 ($9.84 in chips)
e632d40b: posts small blind $0.02
16a87f9d: posts big blind $0.05
*** HOLE CARDS ***
Dealt to ed41f291 
Dealt to e632d40b 
Dealt to 16a87f9d 
Dealt to Hero [Jd Js]
Dealt to ef82d036 
Dealt to 11caa266 
Hero: raises $0.05 to $0.1
ef82d036: folds
11caa266: calls $0.1
ed41f291: folds
e632d40b: folds
16a87f9d: folds
*** FLOP *** [5h 2c 8h]
Hero: bets $0.1
11caa266: calls $0.1
*** TURN *** [5h 2c 8h] [4s]
Hero: bets $0.24
11caa266: calls $0.24
*** RIVER *** [5h 2c 8h 4s] [Qd]
Hero: checks
11caa266: checks
Hero: shows [Jd Js] (Pair of Jacks)
11caa266: shows [Ac 5c] (Pair of Fives)
*** SHOWDOWN ***
Hero collected $0.91 from pot
*** SUMMARY ***
Total pot $0.95 | Rake $0.04 | Jackpot $0 | Bingo $0 | Fortune $0 | Tax $0
Board [5h 2c 8h 4s Qd]
Seat 1: ed41f291 (button) folded before Flop (didn't bet)
Seat 2: e632d40b (small blind) folded before Flop
Seat 3: 16a87f9d (big blind) folded before Flop
Seat 4: Hero showed [Jd Js] and won ($0.91) with Pair of Jacks
Seat 5: ef82d036 folded before Flop (didn't bet)
Seat 6: 11caa266 showed [Ac 5c] and lost with Pair of Fives


Poker Hand #RC3334366516: Hold'em No Limit ($0.02/$0.05) - 2025/02/17 20:06:26
Table 'RushAndCash591776' 6-max Seat #1 is the button
Seat 1: 6f7140f6 ($5.14 in chips)
Seat 2: 6183e175 ($18.1 in chips)
Seat 3: 5f1cdd27 ($5.09 in chips)
Seat 4: fdc3ee5c ($3.56 in chips)
Seat 5: 48dc6454 ($5.83 in chips)
Seat 6: Hero ($5 in chips)
6183e175: posts small blind $0.02
5f1cdd27: posts big blind $0.05
*** HOLE CARDS ***
Dealt to 6f7140f6 
Dealt to 6183e175 
Dealt to 5f1cdd27 
Dealt to fdc3ee5c 
Dealt to 48dc6454 
Dealt to Hero [Ad 2d]
fdc3ee5c: folds
48dc6454: folds
Hero: folds
6f7140f6: raises $0.07 to $0.12
6183e175: folds
5f1cdd27: folds
Uncalled bet ($0.07) returned to 6f7140f6
*** SHOWDOWN ***
6f7140f6 collected $0.12 from pot
*** SUMMARY ***
Total pot $0.12 | Rake $0 | Jackpot $0 | Bingo $0 | Fortune $0 | Tax $0
Seat 1: 6f7140f6 (button) collected ($0.12)
Seat 2: 6183e175 (small blind) folded before Flop
Seat 3: 5f1cdd27 (big blind) folded before Flop
Seat 4: fdc3ee5c folded before Flop (didn't bet)
Seat 5: 48dc6454 folded before Flop (didn't bet)
Seat 6: Hero folded before Flop (didn't bet)


Poker Hand #RC3334366494: Hold'em No Limit ($0.02/$0.05) - 2025/02/17 20:06:23
Table 'RushAndCash591754' 6-max Seat #1 is the button
Seat 1: b76b457c ($10.18 in chips)
Seat 2: 2b6388ee ($5.82 in chips)
Seat 3: 6183e175 ($18.15 in chips)
Seat 4: Hero ($5 in chips)
Seat 5: a0a16222 ($7.06 in chips)
Seat 6: 5f1cdd27 ($5.09 in chips)
2b6388ee: posts small blind $0.02
6183e175: posts big blind $0.05
*** HOLE CARDS ***
Dealt to b76b457c 
Dealt to 2b6388ee 
Dealt to 6183e175 
Dealt to Hero [7d 8c]
Dealt to a0a16222 
Dealt to 5f1cdd27 
Hero: folds
a0a16222: folds
5f1cdd27: folds
b76b457c: raises $0.06 to $0.11
2b6388ee: folds
6183e175: folds
Uncalled bet ($0.06) returned to b76b457c
*** SHOWDOWN ***
b76b457c collected $0.12 from pot
*** SUMMARY ***
Total pot $0.12 | Rake $0 | Jackpot $0 | Bingo $0 | Fortune $0 | Tax $0
Seat 1: b76b457c (button) collected ($0.12)
Seat 2: 2b6388ee (small blind) folded before Flop
Seat 3: 6183e175 (big blind) folded before Flop
Seat 4: Hero folded before Flop (didn't bet)
Seat 5: a0a16222 folded before Flop (didn't bet)
Seat 6: 5f1cdd27 folded before Flop (didn't bet)


Poker Hand #RC3334366471: Hold'em No Limit ($0.02/$0.05) - 2025/02/17 20:06:19
Table 'RushAndCash591731' 6-max Seat #1 is the button
Seat 1: Hero ($5 in chips)
Seat 2: b76b457c ($10.2 in chips)
Seat 3: 7b9998a4 ($5 in chips)
Seat 4: 742ccfee ($2.22 in chips)
Seat 5: f423ee1f ($6.79 in chips)
Seat 6: 3100dcf0 ($5 in chips)
b76b457c: posts small blind $0.02
7b9998a4: posts big blind $0.05
*** HOLE CARDS ***
Dealt to Hero [Th 2h]
Dealt to b76b457c 
Dealt to 7b9998a4 
Dealt to 742ccfee 
Dealt to f423ee1f 
Dealt to 3100dcf0 
742ccfee: raises $0.05 to $0.1
f423ee1f: folds
3100dcf0: calls $0.1
Hero: folds
b76b457c: folds
7b9998a4: folds
*** FLOP *** [8d Jc Qc]
742ccfee: bets $0.27
3100dcf0: calls $0.27
*** TURN *** [8d Jc Qc] [2c]
742ccfee: checks
3100dcf0: checks
*** RIVER *** [8d Jc Qc 2c] [6c]
742ccfee: checks
3100dcf0: checks
742ccfee: shows [Ks Kh] (Pair of Kings)
3100dcf0: shows [Td Ad] (Ace-High)
*** SHOWDOWN ***
742ccfee collected $0.77 from pot
*** SUMMARY ***
Total pot $0.81 | Rake $0.04 | Jackpot $0 | Bingo $0 | Fortune $0 | Tax $0
Board [8d Jc Qc 2c 6c]
Seat 1: Hero (button) folded before Flop (didn't bet)
Seat 2: b76b457c (small blind) folded before Flop
Seat 3: 7b9998a4 (big blind) folded before Flop
Seat 4: 742ccfee showed [Ks Kh] and won ($0.77) with Pair of Kings
Seat 5: f423ee1f folded before Flop (didn't bet)
Seat 6: 3100dcf0 showed [Td Ad] and lost with Ace-High


Poker Hand #RC3334366359: Hold'em No Limit ($0.02/$0.05) - 2025/02/17 20:06:02
Table 'RushAndCash591619' 6-max Seat #1 is the button
Seat 1: cbb57b8 ($11.79 in chips)
Seat 2: Hero ($5 in chips)
Seat 3: 577aa3d3 ($5.92 in chips)
Seat 4: f4988477 ($9.05 in chips)
Seat 5: 13cd8f70 ($5.07 in chips)
Seat 6: f5fcc522 ($10.29 in chips)
Hero: posts small blind $0.02
577aa3d3: posts big blind $0.05
*** HOLE CARDS ***
Dealt to cbb57b8 
Dealt to Hero [Ah 8h]
Dealt to 577aa3d3 
Dealt to f4988477 
Dealt to 13cd8f70 
Dealt to f5fcc522 
f4988477: folds
13cd8f70: folds
f5fcc522: folds
cbb57b8: raises $0.06 to $0.11
Hero: folds
577aa3d3: folds
Uncalled bet ($0.06) returned to cbb57b8
*** SHOWDOWN ***
cbb57b8 collected $0.12 from pot
*** SUMMARY ***
Total pot $0.12 | Rake $0 | Jackpot $0 | Bingo $0 | Fortune $0 | Tax $0
Seat 1: cbb57b8 (button) collected ($0.12)
Seat 2: Hero (small blind) folded before Flop
Seat 3: 577aa3d3 (big blind) folded before Flop
Seat 4: f4988477 folded before Flop (didn't bet)
Seat 5: 13cd8f70 folded before Flop (didn't bet)
Seat 6: f5fcc522 folded before Flop (didn't bet)


Poker Hand #RC3334366269: Hold'em No Limit ($0.02/$0.05) - 2025/02/17 20:05:49
Table 'RushAndCash591529' 6-max Seat #1 is the button
Seat 1: 18af90c ($8.46 in chips)
Seat 2: 120fe547 ($5 in chips)
Seat 3: Hero ($5 in chips)
Seat 4: 656af102 ($5.21 in chips)
Seat 5: d1cd1071 ($13.12 in chips)
Seat 6: 3e4f729d ($1.8 in chips)
120fe547: posts small blind $0.02
Hero: posts big blind $0.05
*** HOLE CARDS ***
Dealt to 18af90c 
Dealt to 120fe547 
Dealt to Hero [2c 3d]
Dealt to 656af102 
Dealt to d1cd1071 
Dealt to 3e4f729d 
656af102: folds
d1cd1071: folds
3e4f729d: raises $0.05 to $0.1
18af90c: folds
120fe547: folds
Hero: folds
Uncalled bet ($0.05) returned to 3e4f729d
*** SHOWDOWN ***
3e4f729d collected $0.12 from pot
*** SUMMARY ***
Total pot $0.12 | Rake $0 | Jackpot $0 | Bingo $0 | Fortune $0 | Tax $0
Seat 1: 18af90c (button) folded before Flop (didn't bet)
Seat 2: 120fe547 (small blind) folded before Flop
Seat 3: Hero (big blind) folded before Flop
Seat 4: 656af102 folded before Flop (didn't bet)
Seat 5: d1cd1071 folded before Flop (didn't bet)
Seat 6: 3e4f729d collected ($0.12)


