Poker Hand #RC3334603835: Hold'em No Limit ($0.02/$0.05) - 2025/02/17 21:51:48
Table 'RushAndCash639095' 6-max Seat #1 is the button
Seat 1: 87afea2d ($4.66 in chips)
Seat 2: fdbac393 ($15.44 in chips)
Seat 3: Hero ($5.35 in chips)
Seat 4: 1eba8bdc ($5 in chips)
Seat 5: b4cd57cf ($8.48 in chips)
Seat 6: 4ec50768 ($5.68 in chips)
fdbac393: posts small blind $0.02
Hero: posts big blind $0.05
*** HOLE CARDS ***
Dealt to 87afea2d 
Dealt to fdbac393 
Dealt to Hero [Ks 2c]
Dealt to 1eba8bdc 
Dealt to b4cd57cf 
Dealt to 4ec50768 
1eba8bdc: folds
b4cd57cf: folds
4ec50768: raises $0.06 to $0.11
87afea2d: folds
fdbac393: folds
Hero: folds
Uncalled bet ($0.06) returned to 4ec50768
*** SHOWDOWN ***
4ec50768 collected $0.12 from pot
*** SUMMARY ***
Total pot $0.12 | Rake $0 | Jackpot $0 | Bingo $0 | Fortune $0 | Tax $0
Seat 1: 87afea2d (button) folded before Flop (didn't bet)
Seat 2: fdbac393 (small blind) folded before Flop
Seat 3: Hero (big blind) folded before Flop
Seat 4: 1eba8bdc folded before Flop (didn't bet)
Seat 5: b4cd57cf folded before Flop (didn't bet)
Seat 6: 4ec50768 collected ($0.12)


Poker Hand #RC3334603769: Hold'em No Limit ($0.02/$0.05) - 2025/02/17 21:51:40
Table 'RushAndCash639029' 6-max Seat #1 is the button
Seat 1: Hero ($5.28 in chips)
Seat 2: b2069524 ($6.57 in chips)
Seat 3: e61a8cfb ($4.59 in chips)
Seat 4: 687fd17d ($4.07 in chips)
Seat 5: 951a45c3 ($5.07 in chips)
Seat 6: cc91d9ca ($10.26 in chips)
b2069524: posts small blind $0.02
e61a8cfb: posts big blind $0.05
*** HOLE CARDS ***
Dealt to Hero [6d 6s]
Dealt to b2069524 
Dealt to e61a8cfb 
Dealt to 687fd17d 
Dealt to 951a45c3 
Dealt to cc91d9ca 
687fd17d: folds
951a45c3: folds
cc91d9ca: folds
Hero: raises $0.05 to $0.1
b2069524: folds
e61a8cfb: folds
Uncalled bet ($0.05) returned to Hero
*** SHOWDOWN ***
Hero collected $0.12 from pot
*** SUMMARY ***
Total pot $0.12 | Rake $0 | Jackpot $0 | Bingo $0 | Fortune $0 | Tax $0
Seat 1: Hero (button) collected ($0.12)
Seat 2: b2069524 (small blind) folded before Flop
Seat 3: e61a8cfb (big blind) folded before Flop
Seat 4: 687fd17d folded before Flop (didn't bet)
Seat 5: 951a45c3 folded before Flop (didn't bet)
Seat 6: cc91d9ca folded before Flop (didn't bet)


Poker Hand #RC3334603631: Hold'em No Limit ($0.02/$0.05) - 2025/02/17 21:51:24
Table 'RushAndCash638891' 6-max Seat #1 is the button
Seat 1: f8081566 ($2.79 in chips)
Seat 2: ef7b5599 ($37.31 in chips)
Seat 3: 15e6cce1 ($5.07 in chips)
Seat 4: 100d4f9e ($5 in chips)
Seat 5: 8023de0f ($8.22 in chips)
Seat 6: Hero ($5.21 in chips)
ef7b5599: posts small blind $0.02
15e6cce1: posts big blind $0.05
*** HOLE CARDS ***
Dealt to f8081566 
Dealt to ef7b5599 
Dealt to 15e6cce1 
Dealt to 100d4f9e 
Dealt to 8023de0f 
Dealt to Hero [8s 8d]
100d4f9e: folds
8023de0f: folds
Hero: raises $0.05 to $0.1
f8081566: folds
ef7b5599: folds
15e6cce1: folds
Uncalled bet ($0.05) returned to Hero
*** SHOWDOWN ***
Hero collected $0.12 from pot
*** SUMMARY ***
Total pot $0.12 | Rake $0 | Jackpot $0 | Bingo $0 | Fortune $0 | Tax $0
Seat 1: f8081566 (button) folded before Flop (didn't bet)
Seat 2: ef7b5599 (small blind) folded before Flop
Seat 3: 15e6cce1 (big blind) folded before Flop
Seat 4: 100d4f9e folded before Flop (didn't bet)
Seat 5: 8023de0f folded before Flop (didn't bet)
Seat 6: Hero collected ($0.12)


Poker Hand #RC3334603575: Hold'em No Limit ($0.02/$0.05) - 2025/02/17 21:51:17
Table 'RushAndCash638835' 6-max Seat #1 is the button
Seat 1: 381c6d82 ($23.34 in chips)
Seat 2: Hero ($5.16 in chips)
Seat 3: 8844d1ba ($7.31 in chips)
Seat 4: 12ef643d ($4.57 in chips)
Seat 5: 2ec306f3 ($2.82 in chips)
Seat 6: 87d5083b ($21.08 in chips)
Hero: posts small blind $0.02
8844d1ba: posts big blind $0.05
*** HOLE CARDS ***
Dealt to 381c6d82 
Dealt to Hero [Jd 7d]
Dealt to 8844d1ba 
Dealt to 12ef643d 
Dealt to 2ec306f3 
Dealt to 87d5083b 
12ef643d: folds
2ec306f3: folds
87d5083b: folds
381c6d82: raises $0.08 to $0.13
Hero: folds
8844d1ba: folds
Uncalled bet ($0.08) returned to 381c6d82
*** SHOWDOWN ***
381c6d82 collected $0.12 from pot
*** SUMMARY ***
Total pot $0.12 | Rake $0 | Jackpot $0 | Bingo $0 | Fortune $0 | Tax $0
Seat 1: 381c6d82 (button) collected ($0.12)
Seat 2: Hero (small blind) folded before Flop
Seat 3: 8844d1ba (big blind) folded before Flop
Seat 4: 12ef643d folded before Flop (didn't bet)
Seat 5: 2ec306f3 folded before Flop (didn't bet)
Seat 6: 87d5083b folded before Flop (didn't bet)


Poker Hand #RC3334603507: Hold'em No Limit ($0.02/$0.05) - 2025/02/17 21:51:09
Table 'RushAndCash638767' 6-max Seat #1 is the button
Seat 1: 33554b00 ($5.69 in chips)
Seat 2: d8f38484 ($5.12 in chips)
Seat 3: Hero ($5.21 in chips)
Seat 4: f4ed7f83 ($10.49 in chips)
Seat 5: fa7bb2c5 ($7.97 in chips)
Seat 6: f17680c7 ($5.48 in chips)
d8f38484: posts small blind $0.02
Hero: posts big blind $0.05
*** HOLE CARDS ***
Dealt to 33554b00 
Dealt to d8f38484 
Dealt to Hero [9s 7d]
Dealt to f4ed7f83 
Dealt to fa7bb2c5 
Dealt to f17680c7 
f4ed7f83: folds
fa7bb2c5: folds
f17680c7: folds
33554b00: folds
d8f38484: folds
Uncalled bet ($0.03) returned to Hero
*** SHOWDOWN ***
Hero collected $0.04 from pot
*** SUMMARY ***
Total pot $0.04 | Rake $0 | Jackpot $0 | Bingo $0 | Fortune $0 | Tax $0
Seat 1: 33554b00 (button) folded before Flop (didn't bet)
Seat 2: d8f38484 (small blind) folded before Flop
Seat 3: Hero (big blind) collected ($0.04)
Seat 4: f4ed7f83 folded before Flop (didn't bet)
Seat 5: fa7bb2c5 folded before Flop (didn't bet)
Seat 6: f17680c7 folded before Flop (didn't bet)


Poker Hand #RC3334603480: Hold'em No Limit ($0.02/$0.05) - 2025/02/17 21:51:06
Table 'RushAndCash638740' 6-max Seat #1 is the button
Seat 1: 480ec583 ($5.31 in chips)
Seat 2: c131479 ($5.07 in chips)
Seat 3: 598d859f ($14.81 in chips)
Seat 4: ec2814be ($5.56 in chips)
Seat 5: Hero ($5.21 in chips)
Seat 6: d04ecf ($6.64 in chips)
c131479: posts small blind $0.02
598d859f: posts big blind $0.05
*** HOLE CARDS ***
Dealt to 480ec583 
Dealt to c131479 
Dealt to 598d859f 
Dealt to ec2814be 
Dealt to Hero [7s Kd]
Dealt to d04ecf 
ec2814be: folds
Hero: folds
d04ecf: folds
480ec583: folds
c131479: folds
Uncalled bet ($0.03) returned to 598d859f
*** SHOWDOWN ***
598d859f collected $0.04 from pot
*** SUMMARY ***
Total pot $0.04 | Rake $0 | Jackpot $0 | Bingo $0 | Fortune $0 | Tax $0
Seat 1: 480ec583 (button) folded before Flop (didn't bet)
Seat 2: c131479 (small blind) folded before Flop
Seat 3: 598d859f (big blind) collected ($0.04)
Seat 4: ec2814be folded before Flop (didn't bet)
Seat 5: Hero folded before Flop (didn't bet)
Seat 6: d04ecf folded before Flop (didn't bet)


Poker Hand #RC3334603388: Hold'em No Limit ($0.02/$0.05) - 2025/02/17 21:50:55
Table 'RushAndCash638648' 6-max Seat #1 is the button
Seat 1: 826a79b4 ($5.16 in chips)
Seat 2: eec21fa8 ($1.95 in chips)
Seat 3: Hero ($5.19 in chips)
Seat 4: 3be0e562 ($8.15 in chips)
Seat 5: 2642904 ($6.47 in chips)
Seat 6: 1640de52 ($23 in chips)
eec21fa8: posts small blind $0.02
Hero: posts big blind $0.05
*** HOLE CARDS ***
Dealt to 826a79b4 
Dealt to eec21fa8 
Dealt to Hero [Jd Ah]
Dealt to 3be0e562 
Dealt to 2642904 
Dealt to 1640de52 
3be0e562: folds
2642904: folds
1640de52: folds
826a79b4: folds
eec21fa8: folds
Uncalled bet ($0.03) returned to Hero
*** SHOWDOWN ***
Hero collected $0.04 from pot
*** SUMMARY ***
Total pot $0.04 | Rake $0 | Jackpot $0 | Bingo $0 | Fortune $0 | Tax $0
Seat 1: 826a79b4 (button) folded before Flop (didn't bet)
Seat 2: eec21fa8 (small blind) folded before Flop
Seat 3: Hero (big blind) collected ($0.04)
Seat 4: 3be0e562 folded before Flop (didn't bet)
Seat 5: 2642904 folded before Flop (didn't bet)
Seat 6: 1640de52 folded before Flop (didn't bet)


Poker Hand #RC3334603145: Hold'em No Limit ($0.02/$0.05) - 2025/02/17 21:50:31
Table 'RushAndCash638405' 6-max Seat #1 is the button
Seat 1: 55e0d4fe ($8.85 in chips)
Seat 2: ae4e82ab ($5.91 in chips)
Seat 3: 20045c1 ($10.63 in chips)
Seat 4: 1095926a ($9.2 in chips)
Seat 5: Hero ($5 in chips)
Seat 6: f691c1c2 ($5.23 in chips)
ae4e82ab: posts small blind $0.02
20045c1: posts big blind $0.05
*** HOLE CARDS ***
Dealt to 55e0d4fe 
Dealt to ae4e82ab 
Dealt to 20045c1 
Dealt to 1095926a 
Dealt to Hero [Ad Kd]
Dealt to f691c1c2 
1095926a: raises $0.08 to $0.13
Hero: raises $0.25 to $0.38
f691c1c2: folds
55e0d4fe: folds
ae4e82ab: folds
20045c1: folds
1095926a: folds
Uncalled bet ($0.25) returned to Hero
*** SHOWDOWN ***
Hero collected $0.32 from pot
*** SUMMARY ***
Total pot $0.33 | Rake $0.01 | Jackpot $0 | Bingo $0 | Fortune $0 | Tax $0
Seat 1: 55e0d4fe (button) folded before Flop (didn't bet)
Seat 2: ae4e82ab (small blind) folded before Flop
Seat 3: 20045c1 (big blind) folded before Flop
Seat 4: 1095926a folded before Flop
Seat 5: Hero collected ($0.32)
Seat 6: f691c1c2 folded before Flop (didn't bet)


Poker Hand #RC3334603107: Hold'em No Limit ($0.02/$0.05) - 2025/02/17 21:50:27
Table 'RushAndCash638367' 6-max Seat #1 is the button
Seat 1: a223d3ca ($5.14 in chips)
Seat 2: 42065dde ($9.28 in chips)
Seat 3: Hero ($5.03 in chips)
Seat 4: 24aff26b ($5.28 in chips)
Seat 5: b87651f7 ($5.03 in chips)
Seat 6: 1941fa92 ($4.68 in chips)
42065dde: posts small blind $0.02
Hero: posts big blind $0.05
*** HOLE CARDS ***
Dealt to a223d3ca 
Dealt to 42065dde 
Dealt to Hero [2s Kc]
Dealt to 24aff26b 
Dealt to b87651f7 
Dealt to 1941fa92 
24aff26b: folds
b87651f7: folds
1941fa92: raises $0.05 to $0.1
a223d3ca: folds
42065dde: folds
Hero: folds
Uncalled bet ($0.05) returned to 1941fa92
*** SHOWDOWN ***
1941fa92 collected $0.12 from pot
*** SUMMARY ***
Total pot $0.12 | Rake $0 | Jackpot $0 | Bingo $0 | Fortune $0 | Tax $0
Seat 1: a223d3ca (button) folded before Flop (didn't bet)
Seat 2: 42065dde (small blind) folded before Flop
Seat 3: Hero (big blind) folded before Flop
Seat 4: 24aff26b folded before Flop (didn't bet)
Seat 5: b87651f7 folded before Flop (didn't bet)
Seat 6: 1941fa92 collected ($0.12)


Poker Hand #RC3334603026: Hold'em No Limit ($0.02/$0.05) - 2025/02/17 21:50:19
Table 'RushAndCash638286' 6-max Seat #1 is the button
Seat 1: Hero ($5.03 in chips)
Seat 2: 57b30b18 ($5.02 in chips)
Seat 3: d46eb2ef ($5 in chips)
Seat 4: a32bdeef ($5 in chips)
Seat 5: a86de18f ($2.73 in chips)
Seat 6: 5dca9e3f ($5.58 in chips)
57b30b18: posts small blind $0.02
d46eb2ef: posts big blind $0.05
*** HOLE CARDS ***
Dealt to Hero [3h 2d]
Dealt to 57b30b18 
Dealt to d46eb2ef 
Dealt to a32bdeef 
Dealt to a86de18f 
Dealt to 5dca9e3f 
a32bdeef: folds
a86de18f: folds
5dca9e3f: folds
Hero: folds
57b30b18: raises $0.11 to $0.16
d46eb2ef: raises $0.24 to $0.4
57b30b18: folds
Uncalled bet ($0.24) returned to d46eb2ef
*** SHOWDOWN ***
d46eb2ef collected $0.31 from pot
*** SUMMARY ***
Total pot $0.32 | Rake $0.01 | Jackpot $0 | Bingo $0 | Fortune $0 | Tax $0
Seat 1: Hero (button) folded before Flop (didn't bet)
Seat 2: 57b30b18 (small blind) folded before Flop
Seat 3: d46eb2ef (big blind) collected ($0.31)
Seat 4: a32bdeef folded before Flop (didn't bet)
Seat 5: a86de18f folded before Flop (didn't bet)
Seat 6: 5dca9e3f folded before Flop (didn't bet)


Poker Hand #RC3334602994: Hold'em No Limit ($0.02/$0.05) - 2025/02/17 21:50:15
Table 'RushAndCash638254' 6-max Seat #1 is the button
Seat 1: 39a65b3b ($4.27 in chips)
Seat 2: Hero ($5.05 in chips)
Seat 3: ceba5aa2 ($5 in chips)
Seat 4: f8081566 ($3.44 in chips)
Seat 5: fd055f75 ($9.69 in chips)
Seat 6: 10cdb6a1 ($5.02 in chips)
Hero: posts small blind $0.02
ceba5aa2: posts big blind $0.05
*** HOLE CARDS ***
Dealt to 39a65b3b 
Dealt to Hero [6s 2d]
Dealt to ceba5aa2 
Dealt to f8081566 
Dealt to fd055f75 
Dealt to 10cdb6a1 
f8081566: folds
fd055f75: raises $0.08 to $0.13
10cdb6a1: folds
39a65b3b: folds
Hero: folds
ceba5aa2: calls $0.08
*** FLOP *** [Qh Kh 6d]
ceba5aa2: checks
fd055f75: checks
*** TURN *** [Qh Kh 6d] [5c]
ceba5aa2: checks
fd055f75: bets $0.2
ceba5aa2: calls $0.2
*** RIVER *** [Qh Kh 6d 5c] [Jd]
ceba5aa2: checks
fd055f75: checks
ceba5aa2: shows [8s 7s] (King-High)
fd055f75: shows [6c Ac] (Pair of Sixes)
*** SHOWDOWN ***
fd055f75 collected $0.65 from pot
*** SUMMARY ***
Total pot $0.68 | Rake $0.03 | Jackpot $0 | Bingo $0 | Fortune $0 | Tax $0
Board [Qh Kh 6d 5c Jd]
Seat 1: 39a65b3b (button) folded before Flop (didn't bet)
Seat 2: Hero (small blind) folded before Flop
Seat 3: ceba5aa2 (big blind) showed [8s 7s] and lost with King-High
Seat 4: f8081566 folded before Flop (didn't bet)
Seat 5: fd055f75 showed [6c Ac] and won ($0.65) with Pair of Sixes
Seat 6: 10cdb6a1 folded before Flop (didn't bet)


Poker Hand #RC3334602956: Hold'em No Limit ($0.02/$0.05) - 2025/02/17 21:50:12
Table 'RushAndCash638216' 6-max Seat #1 is the button
Seat 1: Hero ($5.05 in chips)
Seat 2: 110fdc96 ($6.53 in chips)
Seat 3: a91946aa ($2.18 in chips)
Seat 4: a19fb924 ($7.72 in chips)
Seat 5: d66a5020 ($6.24 in chips)
Seat 6: c83a952b ($5.36 in chips)
110fdc96: posts small blind $0.02
a91946aa: posts big blind $0.05
*** HOLE CARDS ***
Dealt to Hero [9s 8h]
Dealt to 110fdc96 
Dealt to a91946aa 
Dealt to a19fb924 
Dealt to d66a5020 
Dealt to c83a952b 
a19fb924: folds
d66a5020: folds
c83a952b: raises $0.05 to $0.1
Hero: folds
110fdc96: folds
a91946aa: calls $0.05
*** FLOP *** [Jd 4d 6c]
a91946aa: checks
c83a952b: bets $0.08
a91946aa: raises $0.21 to $0.29
c83a952b: calls $0.21
*** TURN *** [Jd 4d 6c] [Jh]
a91946aa: checks
c83a952b: checks
*** RIVER *** [Jd 4d 6c Jh] [6s]
a91946aa: bets $0.6
c83a952b: folds
Uncalled bet ($0.6) returned to a91946aa
*** SHOWDOWN ***
a91946aa collected $0.76 from pot
*** SUMMARY ***
Total pot $0.8 | Rake $0.04 | Jackpot $0 | Bingo $0 | Fortune $0 | Tax $0
Board [Jd 4d 6c Jh 6s]
Seat 1: Hero (button) folded before Flop (didn't bet)
Seat 2: 110fdc96 (small blind) folded before Flop
Seat 3: a91946aa (big blind) won ($0.76)
Seat 4: a19fb924 folded before Flop (didn't bet)
Seat 5: d66a5020 folded before Flop (didn't bet)
Seat 6: c83a952b folded on the River


Poker Hand #RC3334602925: Hold'em No Limit ($0.02/$0.05) - 2025/02/17 21:50:09
Table 'RushAndCash638185' 6-max Seat #1 is the button
Seat 1: da930a8e ($5.42 in chips)
Seat 2: 95d29c49 ($5.49 in chips)
Seat 3: 927781da ($5.11 in chips)
Seat 4: Hero ($5.05 in chips)
Seat 5: a34fb22a ($9.79 in chips)
Seat 6: 37865b6f ($5.95 in chips)
95d29c49: posts small blind $0.02
927781da: posts big blind $0.05
*** HOLE CARDS ***
Dealt to da930a8e 
Dealt to 95d29c49 
Dealt to 927781da 
Dealt to Hero [6d Kd]
Dealt to a34fb22a 
Dealt to 37865b6f 
Hero: folds
a34fb22a: folds
37865b6f: raises $0.05 to $0.1
da930a8e: raises $0.21 to $0.31
95d29c49: folds
927781da: folds
37865b6f: calls $0.21
*** FLOP *** [9d 7h 7s]
37865b6f: bets $0.17
da930a8e: folds
Uncalled bet ($0.17) returned to 37865b6f
*** SHOWDOWN ***
37865b6f collected $0.66 from pot
*** SUMMARY ***
Total pot $0.69 | Rake $0.03 | Jackpot $0 | Bingo $0 | Fortune $0 | Tax $0
Board [9d 7h 7s]
Seat 1: da930a8e (button) folded on the Flop
Seat 2: 95d29c49 (small blind) folded before Flop
Seat 3: 927781da (big blind) folded before Flop
Seat 4: Hero folded before Flop (didn't bet)
Seat 5: a34fb22a folded before Flop (didn't bet)
Seat 6: 37865b6f won ($0.66)


Poker Hand #RC3334602891: Hold'em No Limit ($0.02/$0.05) - 2025/02/17 21:50:05
Table 'RushAndCash638151' 6-max Seat #1 is the button
Seat 1: Hero ($5.05 in chips)
Seat 2: df1d9475 ($5 in chips)
Seat 3: da5bd304 ($5.1 in chips)
Seat 4: 381c6d82 ($23.33 in chips)
Seat 5: ba72b338 ($5 in chips)
Seat 6: 658c386e ($5 in chips)
df1d9475: posts small blind $0.02
da5bd304: posts big blind $0.05
*** HOLE CARDS ***
Dealt to Hero [5s 3c]
Dealt to df1d9475 
Dealt to da5bd304 
Dealt to 381c6d82 
Dealt to ba72b338 
Dealt to 658c386e 
381c6d82: folds
ba72b338: folds
658c386e: folds
Hero: folds
df1d9475: folds
Uncalled bet ($0.03) returned to da5bd304
*** SHOWDOWN ***
da5bd304 collected $0.04 from pot
*** SUMMARY ***
Total pot $0.04 | Rake $0 | Jackpot $0 | Bingo $0 | Fortune $0 | Tax $0
Seat 1: Hero (button) folded before Flop (didn't bet)
Seat 2: df1d9475 (small blind) folded before Flop
Seat 3: da5bd304 (big blind) collected ($0.04)
Seat 4: 381c6d82 folded before Flop (didn't bet)
Seat 5: ba72b338 folded before Flop (didn't bet)
Seat 6: 658c386e folded before Flop (didn't bet)


Poker Hand #RC3334602849: Hold'em No Limit ($0.02/$0.05) - 2025/02/17 21:50:01
Table 'RushAndCash638109' 6-max Seat #1 is the button
Seat 1: ff01bdba ($12.99 in chips)
Seat 2: 3be0e562 ($8.08 in chips)
Seat 3: fe818b1b ($5 in chips)
Seat 4: 62fdcc3c ($9.74 in chips)
Seat 5: Hero ($5.05 in chips)
Seat 6: c24b20b9 ($17.31 in chips)
3be0e562: posts small blind $0.02
fe818b1b: posts big blind $0.05
*** HOLE CARDS ***
Dealt to ff01bdba 
Dealt to 3be0e562 
Dealt to fe818b1b 
Dealt to 62fdcc3c 
Dealt to Hero [Ts 5d]
Dealt to c24b20b9 
62fdcc3c: raises $0.05 to $0.1
Hero: folds
c24b20b9: folds
ff01bdba: folds
3be0e562: folds
fe818b1b: folds
Uncalled bet ($0.05) returned to 62fdcc3c
*** SHOWDOWN ***
62fdcc3c collected $0.12 from pot
*** SUMMARY ***
Total pot $0.12 | Rake $0 | Jackpot $0 | Bingo $0 | Fortune $0 | Tax $0
Seat 1: ff01bdba (button) folded before Flop (didn't bet)
Seat 2: 3be0e562 (small blind) folded before Flop
Seat 3: fe818b1b (big blind) folded before Flop
Seat 4: 62fdcc3c collected ($0.12)
Seat 5: Hero folded before Flop (didn't bet)
Seat 6: c24b20b9 folded before Flop (didn't bet)


Poker Hand #RC3334602815: Hold'em No Limit ($0.02/$0.05) - 2025/02/17 21:49:58
Table 'RushAndCash638075' 6-max Seat #1 is the button
Seat 1: cc91d9ca ($10.37 in chips)
Seat 2: 12ef643d ($4.14 in chips)
Seat 3: 4de437bd ($3.33 in chips)
Seat 4: 927781da ($5.11 in chips)
Seat 5: fd236f26 ($5.97 in chips)
Seat 6: Hero ($5.05 in chips)
12ef643d: posts small blind $0.02
4de437bd: posts big blind $0.05
*** HOLE CARDS ***
Dealt to cc91d9ca 
Dealt to 12ef643d 
Dealt to 4de437bd 
Dealt to 927781da 
Dealt to fd236f26 
Dealt to Hero [Tc 5d]
927781da: folds
fd236f26: raises $0.05 to $0.1
Hero: folds
cc91d9ca: folds
12ef643d: folds
4de437bd: folds
Uncalled bet ($0.05) returned to fd236f26
*** SHOWDOWN ***
fd236f26 collected $0.12 from pot
*** SUMMARY ***
Total pot $0.12 | Rake $0 | Jackpot $0 | Bingo $0 | Fortune $0 | Tax $0
Seat 1: cc91d9ca (button) folded before Flop (didn't bet)
Seat 2: 12ef643d (small blind) folded before Flop
Seat 3: 4de437bd (big blind) folded before Flop
Seat 4: 927781da folded before Flop (didn't bet)
Seat 5: fd236f26 collected ($0.12)
Seat 6: Hero folded before Flop (didn't bet)


Poker Hand #RC3334602788: Hold'em No Limit ($0.02/$0.05) - 2025/02/17 21:49:54
Table 'RushAndCash638048' 6-max Seat #1 is the button
Seat 1: 4922466d ($4.93 in chips)
Seat 2: Hero ($5.07 in chips)
Seat 3: c606a534 ($12.15 in chips)
Seat 4: bfef046a ($7.03 in chips)
Seat 5: b9ae439d ($7.11 in chips)
Seat 6: 81f29d91 ($6.49 in chips)
Hero: posts small blind $0.02
c606a534: posts big blind $0.05
*** HOLE CARDS ***
Dealt to 4922466d 
Dealt to Hero [3h Qd]
Dealt to c606a534 
Dealt to bfef046a 
Dealt to b9ae439d 
Dealt to 81f29d91 
bfef046a: folds
b9ae439d: folds
81f29d91: folds
4922466d: folds
Hero: folds
Uncalled bet ($0.03) returned to c606a534
*** SHOWDOWN ***
c606a534 collected $0.04 from pot
*** SUMMARY ***
Total pot $0.04 | Rake $0 | Jackpot $0 | Bingo $0 | Fortune $0 | Tax $0
Seat 1: 4922466d (button) folded before Flop (didn't bet)
Seat 2: Hero (small blind) folded before Flop
Seat 3: c606a534 (big blind) collected ($0.04)
Seat 4: bfef046a folded before Flop (didn't bet)
Seat 5: b9ae439d folded before Flop (didn't bet)
Seat 6: 81f29d91 folded before Flop (didn't bet)


Poker Hand #RC3334602582: Hold'em No Limit ($0.02/$0.05) - 2025/02/17 21:49:32
Table 'RushAndCash637842' 6-max Seat #1 is the button
Seat 1: 5f1cdd27 ($8 in chips)
Seat 2: 8072ab30 ($5.41 in chips)
Seat 3: Hero ($5 in chips)
Seat 4: d870506c ($5.55 in chips)
Seat 5: 7d556318 ($5 in chips)
Seat 6: b6ef8553 ($5.12 in chips)
8072ab30: posts small blind $0.02
Hero: posts big blind $0.05
*** HOLE CARDS ***
Dealt to 5f1cdd27 
Dealt to 8072ab30 
Dealt to Hero [6h 6s]
Dealt to d870506c 
Dealt to 7d556318 
Dealt to b6ef8553 
d870506c: folds
7d556318: folds
b6ef8553: raises $0.05 to $0.1
5f1cdd27: folds
8072ab30: folds
Hero: calls $0.05
*** FLOP *** [7c 8c Js]
Hero: checks
b6ef8553: bets $0.11
Hero: folds
Uncalled bet ($0.11) returned to b6ef8553
*** SHOWDOWN ***
b6ef8553 collected $0.21 from pot
*** SUMMARY ***
Total pot $0.22 | Rake $0.01 | Jackpot $0 | Bingo $0 | Fortune $0 | Tax $0
Board [7c 8c Js]
Seat 1: 5f1cdd27 (button) folded before Flop (didn't bet)
Seat 2: 8072ab30 (small blind) folded before Flop
Seat 3: Hero (big blind) folded on the Flop
Seat 4: d870506c folded before Flop (didn't bet)
Seat 5: 7d556318 folded before Flop (didn't bet)
Seat 6: b6ef8553 won ($0.21)


Poker Hand #RC3334602551: Hold'em No Limit ($0.02/$0.05) - 2025/02/17 21:49:28
Table 'RushAndCash637811' 6-max Seat #1 is the button
Seat 1: 577aa3d3 ($9.7 in chips)
Seat 2: c24b20b9 ($17.38 in chips)
Seat 3: Hero ($5 in chips)
Seat 4: d8f38484 ($5.38 in chips)
Seat 5: e570b14c ($5 in chips)
Seat 6: 4262311b ($9.44 in chips)
c24b20b9: posts small blind $0.02
Hero: posts big blind $0.05
*** HOLE CARDS ***
Dealt to 577aa3d3 
Dealt to c24b20b9 
Dealt to Hero [Ad 5h]
Dealt to d8f38484 
Dealt to e570b14c 
Dealt to 4262311b 
d8f38484: folds
e570b14c: folds
4262311b: folds
577aa3d3: folds
c24b20b9: folds
Uncalled bet ($0.03) returned to Hero
*** SHOWDOWN ***
Hero collected $0.04 from pot
*** SUMMARY ***
Total pot $0.04 | Rake $0 | Jackpot $0 | Bingo $0 | Fortune $0 | Tax $0
Seat 1: 577aa3d3 (button) folded before Flop (didn't bet)
Seat 2: c24b20b9 (small blind) folded before Flop
Seat 3: Hero (big blind) collected ($0.04)
Seat 4: d8f38484 folded before Flop (didn't bet)
Seat 5: e570b14c folded before Flop (didn't bet)
Seat 6: 4262311b folded before Flop (didn't bet)


Poker Hand #RC3334602523: Hold'em No Limit ($0.02/$0.05) - 2025/02/17 21:49:25
Table 'RushAndCash637783' 6-max Seat #1 is the button
Seat 1: 687fd17d ($4.76 in chips)
Seat 2: d44882bc ($5.11 in chips)
Seat 3: a730170a ($5.3 in chips)
Seat 4: f07c337a ($5.27 in chips)
Seat 5: Hero ($5 in chips)
Seat 6: 48912120 ($6.12 in chips)
d44882bc: posts small blind $0.02
a730170a: posts big blind $0.05
*** HOLE CARDS ***
Dealt to 687fd17d 
Dealt to d44882bc 
Dealt to a730170a 
Dealt to f07c337a 
Dealt to Hero [6s 5d]
Dealt to 48912120 
f07c337a: folds
Hero: folds
48912120: folds
687fd17d: folds
d44882bc: folds
Uncalled bet ($0.03) returned to a730170a
*** SHOWDOWN ***
a730170a collected $0.04 from pot
*** SUMMARY ***
Total pot $0.04 | Rake $0 | Jackpot $0 | Bingo $0 | Fortune $0 | Tax $0
Seat 1: 687fd17d (button) folded before Flop (didn't bet)
Seat 2: d44882bc (small blind) folded before Flop
Seat 3: a730170a (big blind) collected ($0.04)
Seat 4: f07c337a folded before Flop (didn't bet)
Seat 5: Hero folded before Flop (didn't bet)
Seat 6: 48912120 folded before Flop (didn't bet)


Poker Hand #RC3334602466: Hold'em No Limit ($0.02/$0.05) - 2025/02/17 21:49:18
Table 'RushAndCash637726' 6-max Seat #1 is the button
Seat 1: 5f0ff48e ($5.31 in chips)
Seat 2: d917dee0 ($5.33 in chips)
Seat 3: 50b3f230 ($6.34 in chips)
Seat 4: ef8af083 ($5.32 in chips)
Seat 5: Hero ($5 in chips)
Seat 6: d737deb4 ($10.79 in chips)
d917dee0: posts small blind $0.02
50b3f230: posts big blind $0.05
*** HOLE CARDS ***
Dealt to 5f0ff48e 
Dealt to d917dee0 
Dealt to 50b3f230 
Dealt to ef8af083 
Dealt to Hero [5h 2h]
Dealt to d737deb4 
ef8af083: folds
Hero: folds
d737deb4: folds
5f0ff48e: folds
d917dee0: folds
Uncalled bet ($0.03) returned to 50b3f230
*** SHOWDOWN ***
50b3f230 collected $0.04 from pot
*** SUMMARY ***
Total pot $0.04 | Rake $0 | Jackpot $0 | Bingo $0 | Fortune $0 | Tax $0
Seat 1: 5f0ff48e (button) folded before Flop (didn't bet)
Seat 2: d917dee0 (small blind) folded before Flop
Seat 3: 50b3f230 (big blind) collected ($0.04)
Seat 4: ef8af083 folded before Flop (didn't bet)
Seat 5: Hero folded before Flop (didn't bet)
Seat 6: d737deb4 folded before Flop (didn't bet)


Poker Hand #RC3334602439: Hold'em No Limit ($0.02/$0.05) - 2025/02/17 21:49:15
Table 'RushAndCash637699' 6-max Seat #1 is the button
Seat 1: 657ee1fc ($14.97 in chips)
Seat 2: f6f5ad07 ($5.7 in chips)
Seat 3: aa2d17c0 ($7.8 in chips)
Seat 4: e8992002 ($13.58 in chips)
Seat 5: Hero ($5 in chips)
Seat 6: c59158f3 ($5.93 in chips)
f6f5ad07: posts small blind $0.02
aa2d17c0: posts big blind $0.05
*** HOLE CARDS ***
Dealt to 657ee1fc 
Dealt to f6f5ad07 
Dealt to aa2d17c0 
Dealt to e8992002 
Dealt to Hero [Ts 9c]
Dealt to c59158f3 
e8992002: folds
Hero: folds
c59158f3: folds
657ee1fc: raises $0.07 to $0.12
f6f5ad07: folds
aa2d17c0: folds
Uncalled bet ($0.07) returned to 657ee1fc
*** SHOWDOWN ***
657ee1fc collected $0.12 from pot
*** SUMMARY ***
Total pot $0.12 | Rake $0 | Jackpot $0 | Bingo $0 | Fortune $0 | Tax $0
Seat 1: 657ee1fc (button) collected ($0.12)
Seat 2: f6f5ad07 (small blind) folded before Flop
Seat 3: aa2d17c0 (big blind) folded before Flop
Seat 4: e8992002 folded before Flop (didn't bet)
Seat 5: Hero folded before Flop (didn't bet)
Seat 6: c59158f3 folded before Flop (didn't bet)


Poker Hand #RC3334602411: Hold'em No Limit ($0.02/$0.05) - 2025/02/17 21:49:12
Table 'RushAndCash637671' 6-max Seat #1 is the button
Seat 1: ecc6fd67 ($5 in chips)
Seat 2: Hero ($5 in chips)
Seat 3: e570b14c ($5 in chips)
Seat 4: a63aa4b7 ($15.62 in chips)
Seat 5: b00277eb ($4.93 in chips)
Seat 6: 8cef9d5b ($6.11 in chips)
Hero: posts small blind $0.02
e570b14c: posts big blind $0.05
*** HOLE CARDS ***
Dealt to ecc6fd67 
Dealt to Hero [5s 8d]
Dealt to e570b14c 
Dealt to a63aa4b7 
Dealt to b00277eb 
Dealt to 8cef9d5b 
a63aa4b7: folds
b00277eb: folds
8cef9d5b: folds
ecc6fd67: folds
Hero: folds
Uncalled bet ($0.03) returned to e570b14c
*** SHOWDOWN ***
e570b14c collected $0.04 from pot
*** SUMMARY ***
Total pot $0.04 | Rake $0 | Jackpot $0 | Bingo $0 | Fortune $0 | Tax $0
Seat 1: ecc6fd67 (button) folded before Flop (didn't bet)
Seat 2: Hero (small blind) folded before Flop
Seat 3: e570b14c (big blind) collected ($0.04)
Seat 4: a63aa4b7 folded before Flop (didn't bet)
Seat 5: b00277eb folded before Flop (didn't bet)
Seat 6: 8cef9d5b folded before Flop (didn't bet)


Poker Hand #RC3334602386: Hold'em No Limit ($0.02/$0.05) - 2025/02/17 21:49:09
Table 'RushAndCash637646' 6-max Seat #1 is the button
Seat 1: 3e301744 ($10.45 in chips)
Seat 2: 50b3f230 ($6.36 in chips)
Seat 3: f198691e ($5.32 in chips)
Seat 4: Hero ($5 in chips)
Seat 5: 679a8f7 ($8.17 in chips)
Seat 6: df9e409d ($5.53 in chips)
50b3f230: posts small blind $0.02
f198691e: posts big blind $0.05
*** HOLE CARDS ***
Dealt to 3e301744 
Dealt to 50b3f230 
Dealt to f198691e 
Dealt to Hero [5s 8d]
Dealt to 679a8f7 
Dealt to df9e409d 
Hero: folds
679a8f7: folds
df9e409d: folds
3e301744: folds
50b3f230: folds
Uncalled bet ($0.03) returned to f198691e
*** SHOWDOWN ***
f198691e collected $0.04 from pot
*** SUMMARY ***
Total pot $0.04 | Rake $0 | Jackpot $0 | Bingo $0 | Fortune $0 | Tax $0
Seat 1: 3e301744 (button) folded before Flop (didn't bet)
Seat 2: 50b3f230 (small blind) folded before Flop
Seat 3: f198691e (big blind) collected ($0.04)
Seat 4: Hero folded before Flop (didn't bet)
Seat 5: 679a8f7 folded before Flop (didn't bet)
Seat 6: df9e409d folded before Flop (didn't bet)


Poker Hand #RC3334602353: Hold'em No Limit ($0.02/$0.05) - 2025/02/17 21:49:06
Table 'RushAndCash637613' 6-max Seat #1 is the button
Seat 1: 9da6ba55 ($9.65 in chips)
Seat 2: d58b99ca ($49.53 in chips)
Seat 3: Hero ($5 in chips)
Seat 4: 510f8c9f ($10.51 in chips)
Seat 5: a0ed5617 ($9.94 in chips)
Seat 6: b386a385 ($5.07 in chips)
d58b99ca: posts small blind $0.02
Hero: posts big blind $0.05
*** HOLE CARDS ***
Dealt to 9da6ba55 
Dealt to d58b99ca 
Dealt to Hero [3d Ac]
Dealt to 510f8c9f 
Dealt to a0ed5617 
Dealt to b386a385 
510f8c9f: folds
a0ed5617: raises $0.1 to $0.15
b386a385: folds
9da6ba55: calls $0.15
d58b99ca: folds
Hero: folds
*** FLOP *** [Jh 8d Jc]
a0ed5617: bets $0.13
9da6ba55: folds
Uncalled bet ($0.13) returned to a0ed5617
*** SHOWDOWN ***
a0ed5617 collected $0.36 from pot
*** SUMMARY ***
Total pot $0.37 | Rake $0.01 | Jackpot $0 | Bingo $0 | Fortune $0 | Tax $0
Board [Jh 8d Jc]
Seat 1: 9da6ba55 (button) folded on the Flop
Seat 2: d58b99ca (small blind) folded before Flop
Seat 3: Hero (big blind) folded before Flop
Seat 4: 510f8c9f folded before Flop (didn't bet)
Seat 5: a0ed5617 won ($0.36)
Seat 6: b386a385 folded before Flop (didn't bet)


Poker Hand #RC3334602029: Hold'em No Limit ($0.02/$0.05) - 2025/02/17 21:48:29
Table 'RushAndCash637289' 6-max Seat #1 is the button
Seat 1: a7365f1c ($6.48 in chips)
Seat 2: e59e5895 ($5.09 in chips)
Seat 3: f6f5ad07 ($5.09 in chips)
Seat 4: Hero ($5 in chips)
Seat 5: c6158c9d ($5.22 in chips)
Seat 6: da930a8e ($5 in chips)
e59e5895: posts small blind $0.02
f6f5ad07: posts big blind $0.05
*** HOLE CARDS ***
Dealt to a7365f1c 
Dealt to e59e5895 
Dealt to f6f5ad07 
Dealt to Hero [7h 7s]
Dealt to c6158c9d 
Dealt to da930a8e 
Hero: raises $0.05 to $0.1
c6158c9d: folds
da930a8e: folds
a7365f1c: folds
e59e5895: folds
f6f5ad07: raises $0.47 to $0.57
Hero: calls $0.47
*** FLOP *** [6d Ad 6s]
f6f5ad07: bets $0.39
Hero: folds
Uncalled bet ($0.39) returned to f6f5ad07
*** SHOWDOWN ***
f6f5ad07 collected $1.11 from pot
*** SUMMARY ***
Total pot $1.16 | Rake $0.05 | Jackpot $0 | Bingo $0 | Fortune $0 | Tax $0
Board [6d Ad 6s]
Seat 1: a7365f1c (button) folded before Flop (didn't bet)
Seat 2: e59e5895 (small blind) folded before Flop
Seat 3: f6f5ad07 (big blind) won ($1.11)
Seat 4: Hero folded on the Flop
Seat 5: c6158c9d folded before Flop (didn't bet)
Seat 6: da930a8e folded before Flop (didn't bet)


Poker Hand #RC3334601881: Hold'em No Limit ($0.02/$0.05) - 2025/02/17 21:48:13
Table 'RushAndCash637141' 6-max Seat #1 is the button
Seat 1: ac56502f ($4.54 in chips)
Seat 2: 4e3c3196 ($30.78 in chips)
Seat 3: a4bd9290 ($5.11 in chips)
Seat 4: Hero ($5 in chips)
Seat 5: ac140cb9 ($3.83 in chips)
Seat 6: 3b2a8270 ($10.55 in chips)
4e3c3196: posts small blind $0.02
a4bd9290: posts big blind $0.05
*** HOLE CARDS ***
Dealt to ac56502f 
Dealt to 4e3c3196 
Dealt to a4bd9290 
Dealt to Hero [Jc Ad]
Dealt to ac140cb9 
Dealt to 3b2a8270 
Hero: raises $0.05 to $0.1
ac140cb9: raises $0.2 to $0.3
3b2a8270: folds
ac56502f: folds
4e3c3196: folds
a4bd9290: folds
Hero: folds
Uncalled bet ($0.2) returned to ac140cb9
*** SHOWDOWN ***
ac140cb9 collected $0.26 from pot
*** SUMMARY ***
Total pot $0.27 | Rake $0.01 | Jackpot $0 | Bingo $0 | Fortune $0 | Tax $0
Seat 1: ac56502f (button) folded before Flop (didn't bet)
Seat 2: 4e3c3196 (small blind) folded before Flop
Seat 3: a4bd9290 (big blind) folded before Flop
Seat 4: Hero folded before Flop
Seat 5: ac140cb9 collected ($0.26)
Seat 6: 3b2a8270 folded before Flop (didn't bet)


Poker Hand #RC3334601849: Hold'em No Limit ($0.02/$0.05) - 2025/02/17 21:48:09
Table 'RushAndCash637109' 6-max Seat #1 is the button
Seat 1: Hero ($5 in chips)
Seat 2: 419eb9fb ($8.77 in chips)
Seat 3: 9e4602fe ($6.36 in chips)
Seat 4: 598d859f ($14.58 in chips)
Seat 5: fb8cc108 ($5.55 in chips)
Seat 6: c582715a ($7.28 in chips)
419eb9fb: posts small blind $0.02
9e4602fe: posts big blind $0.05
*** HOLE CARDS ***
Dealt to Hero [4s 7c]
Dealt to 419eb9fb 
Dealt to 9e4602fe 
Dealt to 598d859f 
Dealt to fb8cc108 
Dealt to c582715a 
598d859f: folds
fb8cc108: folds
c582715a: folds
Hero: folds
419eb9fb: folds
Uncalled bet ($0.03) returned to 9e4602fe
*** SHOWDOWN ***
9e4602fe collected $0.04 from pot
*** SUMMARY ***
Total pot $0.04 | Rake $0 | Jackpot $0 | Bingo $0 | Fortune $0 | Tax $0
Seat 1: Hero (button) folded before Flop (didn't bet)
Seat 2: 419eb9fb (small blind) folded before Flop
Seat 3: 9e4602fe (big blind) collected ($0.04)
Seat 4: 598d859f folded before Flop (didn't bet)
Seat 5: fb8cc108 folded before Flop (didn't bet)
Seat 6: c582715a folded before Flop (didn't bet)


Poker Hand #RC3334601818: Hold'em No Limit ($0.02/$0.05) - 2025/02/17 21:48:05
Table 'RushAndCash637078' 6-max Seat #1 is the button
Seat 1: a730170a ($5.01 in chips)
Seat 2: d58b99ca ($48.84 in chips)
Seat 3: 689138a4 ($5.49 in chips)
Seat 4: f0600331 ($7.32 in chips)
Seat 5: 6d5fa70b ($5 in chips)
Seat 6: Hero ($5 in chips)
d58b99ca: posts small blind $0.02
689138a4: posts big blind $0.05
*** HOLE CARDS ***
Dealt to a730170a 
Dealt to d58b99ca 
Dealt to 689138a4 
Dealt to f0600331 
Dealt to 6d5fa70b 
Dealt to Hero [9c 5c]
f0600331: folds
6d5fa70b: folds
Hero: folds
a730170a: folds
d58b99ca: raises $0.07 to $0.12
689138a4: calls $0.07
*** FLOP *** [Ah Qs Jc]
d58b99ca: bets $0.1
689138a4: calls $0.1
*** TURN *** [Ah Qs Jc] [7d]
d58b99ca: checks
689138a4: checks
*** RIVER *** [Ah Qs Jc 7d] [6c]
d58b99ca: bets $0.66
689138a4: folds
Uncalled bet ($0.66) returned to d58b99ca
*** SHOWDOWN ***
d58b99ca collected $0.42 from pot
*** SUMMARY ***
Total pot $0.44 | Rake $0.02 | Jackpot $0 | Bingo $0 | Fortune $0 | Tax $0
Board [Ah Qs Jc 7d 6c]
Seat 1: a730170a (button) folded before Flop (didn't bet)
Seat 2: d58b99ca (small blind) won ($0.42)
Seat 3: 689138a4 (big blind) folded on the River
Seat 4: f0600331 folded before Flop (didn't bet)
Seat 5: 6d5fa70b folded before Flop (didn't bet)
Seat 6: Hero folded before Flop (didn't bet)


Poker Hand #RC3334601585: Hold'em No Limit ($0.02/$0.05) - 2025/02/17 21:47:39
Table 'RushAndCash636845' 6-max Seat #1 is the button
Seat 1: b165f967 ($6.48 in chips)
Seat 2: Hero ($5 in chips)
Seat 3: 88068d2c ($5.43 in chips)
Seat 4: 9e4602fe ($6.22 in chips)
Seat 5: 72b3f81 ($5.98 in chips)
Seat 6: 51719807 ($4.98 in chips)
Hero: posts small blind $0.02
88068d2c: posts big blind $0.05
*** HOLE CARDS ***
Dealt to b165f967 
Dealt to Hero [Js Kh]
Dealt to 88068d2c 
Dealt to 9e4602fe 
Dealt to 72b3f81 
Dealt to 51719807 
9e4602fe: raises $0.05 to $0.1
72b3f81: folds
51719807: folds
b165f967: folds
Hero: calls $0.08
88068d2c: folds
*** FLOP *** [6h 8d 6c]
Hero: checks
9e4602fe: checks
*** TURN *** [6h 8d 6c] [Th]
Hero: checks
9e4602fe: bets $0.19
Hero: folds
Uncalled bet ($0.19) returned to 9e4602fe
*** SHOWDOWN ***
9e4602fe collected $0.24 from pot
*** SUMMARY ***
Total pot $0.25 | Rake $0.01 | Jackpot $0 | Bingo $0 | Fortune $0 | Tax $0
Board [6h 8d 6c Th]
Seat 1: b165f967 (button) folded before Flop (didn't bet)
Seat 2: Hero (small blind) folded on the Turn
Seat 3: 88068d2c (big blind) folded before Flop
Seat 4: 9e4602fe won ($0.24)
Seat 5: 72b3f81 folded before Flop (didn't bet)
Seat 6: 51719807 folded before Flop (didn't bet)


Poker Hand #RC3334601036: Hold'em No Limit ($0.02/$0.05) - 2025/02/17 21:46:38
Table 'RushAndCash636296' 6-max Seat #1 is the button
Seat 1: c3ae0b9c ($5.07 in chips)
Seat 2: 91ad3969 ($13.15 in chips)
Seat 3: 50d79ef5 ($6.12 in chips)
Seat 4: 345ce3dc ($5.16 in chips)
Seat 5: Hero ($8.05 in chips)
Seat 6: 704863d2 ($5.24 in chips)
91ad3969: posts small blind $0.02
50d79ef5: posts big blind $0.05
*** HOLE CARDS ***
Dealt to c3ae0b9c 
Dealt to 91ad3969 
Dealt to 50d79ef5 
Dealt to 345ce3dc 
Dealt to Hero [Kd Kc]
Dealt to 704863d2 
345ce3dc: folds
Hero: raises $0.05 to $0.1
704863d2: raises $0.21 to $0.31
c3ae0b9c: folds
91ad3969: folds
50d79ef5: folds
Hero: calls $0.21
*** FLOP *** [Jc Th 7s]
Hero: checks
704863d2: bets $0.52
Hero: calls $0.52
*** TURN *** [Jc Th 7s] [3c]
Hero: checks
704863d2: bets $4.41 and is all-in
Hero: calls $4.41
704863d2: shows [Td Jd] (Pair of Jacks and Pair of Tens)
Hero: shows [Kd Kc] (Pair of Kings)
*** RIVER *** [Jc Th 7s 3c] [6d]
*** SHOWDOWN ***
704863d2 collected $10.23 from pot
*** SUMMARY ***
Total pot $10.55 | Rake $0.25 | Jackpot $0.07 | Bingo $0 | Fortune $0 | Tax $0
Board [Jc Th 7s 3c 6d]
Seat 1: c3ae0b9c (button) folded before Flop (didn't bet)
Seat 2: 91ad3969 (small blind) folded before Flop
Seat 3: 50d79ef5 (big blind) folded before Flop
Seat 4: 345ce3dc folded before Flop (didn't bet)
Seat 5: Hero showed [Kd Kc] and lost with Pair of Kings
Seat 6: 704863d2 showed [Td Jd] and won ($10.23) with Pair of Jacks and Pair of Tens


Poker Hand #RC3334601009: Hold'em No Limit ($0.02/$0.05) - 2025/02/17 21:46:35
Table 'RushAndCash636269' 6-max Seat #1 is the button
Seat 1: cea9730b ($7.81 in chips)
Seat 2: Hero ($8.07 in chips)
Seat 3: 56d81d8 ($5.58 in chips)
Seat 4: b2e12d09 ($5 in chips)
Seat 5: 4262311b ($9.71 in chips)
Seat 6: 1662188f ($5.9 in chips)
Hero: posts small blind $0.02
56d81d8: posts big blind $0.05
*** HOLE CARDS ***
Dealt to cea9730b 
Dealt to Hero [9c 3d]
Dealt to 56d81d8 
Dealt to b2e12d09 
Dealt to 4262311b 
Dealt to 1662188f 
b2e12d09: raises $0.08 to $0.13
4262311b: raises $0.24 to $0.37
1662188f: folds
cea9730b: folds
Hero: folds
56d81d8: folds
b2e12d09: folds
Uncalled bet ($0.24) returned to 4262311b
*** SHOWDOWN ***
4262311b collected $0.32 from pot
*** SUMMARY ***
Total pot $0.33 | Rake $0.01 | Jackpot $0 | Bingo $0 | Fortune $0 | Tax $0
Seat 1: cea9730b (button) folded before Flop (didn't bet)
Seat 2: Hero (small blind) folded before Flop
Seat 3: 56d81d8 (big blind) folded before Flop
Seat 4: b2e12d09 folded before Flop
Seat 5: 4262311b collected ($0.32)
Seat 6: 1662188f folded before Flop (didn't bet)


Poker Hand #RC3334600922: Hold'em No Limit ($0.02/$0.05) - 2025/02/17 21:46:25
Table 'RushAndCash636182' 6-max Seat #1 is the button
Seat 1: 32972137 ($5 in chips)
Seat 2: 3d2b2789 ($5.55 in chips)
Seat 3: 39a65b3b ($5 in chips)
Seat 4: c24b20b9 ($17.46 in chips)
Seat 5: Hero ($8 in chips)
Seat 6: ec2814be ($5 in chips)
3d2b2789: posts small blind $0.02
39a65b3b: posts big blind $0.05
*** HOLE CARDS ***
Dealt to 32972137 
Dealt to 3d2b2789 
Dealt to 39a65b3b 
Dealt to c24b20b9 
Dealt to Hero [Ah Ts]
Dealt to ec2814be 
c24b20b9: folds
Hero: raises $0.05 to $0.1
ec2814be: folds
32972137: folds
3d2b2789: folds
39a65b3b: folds
Uncalled bet ($0.05) returned to Hero
*** SHOWDOWN ***
Hero collected $0.12 from pot
*** SUMMARY ***
Total pot $0.12 | Rake $0 | Jackpot $0 | Bingo $0 | Fortune $0 | Tax $0
Seat 1: 32972137 (button) folded before Flop (didn't bet)
Seat 2: 3d2b2789 (small blind) folded before Flop
Seat 3: 39a65b3b (big blind) folded before Flop
Seat 4: c24b20b9 folded before Flop (didn't bet)
Seat 5: Hero collected ($0.12)
Seat 6: ec2814be folded before Flop (didn't bet)


Poker Hand #RC3334600867: Hold'em No Limit ($0.02/$0.05) - 2025/02/17 21:46:19
Table 'RushAndCash636127' 6-max Seat #1 is the button
Seat 1: e17748e2 ($5.07 in chips)
Seat 2: c81ca578 ($5.11 in chips)
Seat 3: 689138a4 ($5.4 in chips)
Seat 4: f56d4922 ($5.18 in chips)
Seat 5: f07c337a ($4.26 in chips)
Seat 6: Hero ($8 in chips)
c81ca578: posts small blind $0.02
689138a4: posts big blind $0.05
*** HOLE CARDS ***
Dealt to e17748e2 
Dealt to c81ca578 
Dealt to 689138a4 
Dealt to f56d4922 
Dealt to f07c337a 
Dealt to Hero [Jc Kh]
f56d4922: folds
f07c337a: raises $0.05 to $0.1
Hero: folds
e17748e2: folds
c81ca578: folds
689138a4: calls $0.05
*** FLOP *** [Ad 3c 2h]
689138a4: checks
f07c337a: bets $0.11
689138a4: calls $0.11
*** TURN *** [Ad 3c 2h] [9c]
689138a4: checks
f07c337a: checks
*** RIVER *** [Ad 3c 2h 9c] [6s]
689138a4: checks
f07c337a: bets $0.33
689138a4: folds
Uncalled bet ($0.33) returned to f07c337a
*** SHOWDOWN ***
f07c337a collected $0.42 from pot
*** SUMMARY ***
Total pot $0.44 | Rake $0.02 | Jackpot $0 | Bingo $0 | Fortune $0 | Tax $0
Board [Ad 3c 2h 9c 6s]
Seat 1: e17748e2 (button) folded before Flop (didn't bet)
Seat 2: c81ca578 (small blind) folded before Flop
Seat 3: 689138a4 (big blind) folded on the River
Seat 4: f56d4922 folded before Flop (didn't bet)
Seat 5: f07c337a won ($0.42)
Seat 6: Hero folded before Flop (didn't bet)


Poker Hand #RC3334600814: Hold'em No Limit ($0.02/$0.05) - 2025/02/17 21:46:13
Table 'RushAndCash636074' 6-max Seat #1 is the button
Seat 1: b59fc0b9 ($5.11 in chips)
Seat 2: 23c23672 ($5.22 in chips)
Seat 3: e5dc0403 ($5 in chips)
Seat 4: Hero ($8 in chips)
Seat 5: 89c4e71b ($5.17 in chips)
Seat 6: 7725a7cb ($5 in chips)
23c23672: posts small blind $0.02
e5dc0403: posts big blind $0.05
*** HOLE CARDS ***
Dealt to b59fc0b9 
Dealt to 23c23672 
Dealt to e5dc0403 
Dealt to Hero [7s 3h]
Dealt to 89c4e71b 
Dealt to 7725a7cb 
Hero: folds
89c4e71b: folds
7725a7cb: folds
b59fc0b9: folds
23c23672: raises $0.1 to $0.15
e5dc0403: folds
Uncalled bet ($0.1) returned to 23c23672
*** SHOWDOWN ***
23c23672 collected $0.1 from pot
*** SUMMARY ***
Total pot $0.1 | Rake $0 | Jackpot $0 | Bingo $0 | Fortune $0 | Tax $0
Seat 1: b59fc0b9 (button) folded before Flop (didn't bet)
Seat 2: 23c23672 (small blind) collected ($0.1)
Seat 3: e5dc0403 (big blind) folded before Flop
Seat 4: Hero folded before Flop (didn't bet)
Seat 5: 89c4e71b folded before Flop (didn't bet)
Seat 6: 7725a7cb folded before Flop (didn't bet)


Poker Hand #RC3334600784: Hold'em No Limit ($0.02/$0.05) - 2025/02/17 21:46:09
Table 'RushAndCash636044' 6-max Seat #1 is the button
Seat 1: 75d5d480 ($5 in chips)
Seat 2: 6a5a3ab6 ($3.53 in chips)
Seat 3: Hero ($8.05 in chips)
Seat 4: 62fdcc3c ($10.26 in chips)
Seat 5: 3d4f4b4c ($5 in chips)
Seat 6: 2b6ba85b ($4.93 in chips)
6a5a3ab6: posts small blind $0.02
Hero: posts big blind $0.05
*** HOLE CARDS ***
Dealt to 75d5d480 
Dealt to 6a5a3ab6 
Dealt to Hero [4h 9h]
Dealt to 62fdcc3c 
Dealt to 3d4f4b4c 
Dealt to 2b6ba85b 
62fdcc3c: raises $0.05 to $0.1
3d4f4b4c: folds
2b6ba85b: folds
75d5d480: folds
6a5a3ab6: folds
Hero: folds
Uncalled bet ($0.05) returned to 62fdcc3c
*** SHOWDOWN ***
62fdcc3c collected $0.12 from pot
*** SUMMARY ***
Total pot $0.12 | Rake $0 | Jackpot $0 | Bingo $0 | Fortune $0 | Tax $0
Seat 1: 75d5d480 (button) folded before Flop (didn't bet)
Seat 2: 6a5a3ab6 (small blind) folded before Flop
Seat 3: Hero (big blind) folded before Flop
Seat 4: 62fdcc3c collected ($0.12)
Seat 5: 3d4f4b4c folded before Flop (didn't bet)
Seat 6: 2b6ba85b folded before Flop (didn't bet)


Poker Hand #RC3334600754: Hold'em No Limit ($0.02/$0.05) - 2025/02/17 21:46:06
Table 'RushAndCash636014' 6-max Seat #1 is the button
Seat 1: f9d64f1a ($5.21 in chips)
Seat 2: 27baaa05 ($6.51 in chips)
Seat 3: ec2814be ($5 in chips)
Seat 4: 545ae247 ($8.16 in chips)
Seat 5: Hero ($8.05 in chips)
Seat 6: 787e1958 ($5.16 in chips)
27baaa05: posts small blind $0.02
ec2814be: posts big blind $0.05
*** HOLE CARDS ***
Dealt to f9d64f1a 
Dealt to 27baaa05 
Dealt to ec2814be 
Dealt to 545ae247 
Dealt to Hero [6d 4c]
Dealt to 787e1958 
545ae247: raises $0.08 to $0.13
Hero: folds
787e1958: folds
f9d64f1a: folds
27baaa05: folds
ec2814be: folds
Uncalled bet ($0.08) returned to 545ae247
*** SHOWDOWN ***
545ae247 collected $0.12 from pot
*** SUMMARY ***
Total pot $0.12 | Rake $0 | Jackpot $0 | Bingo $0 | Fortune $0 | Tax $0
Seat 1: f9d64f1a (button) folded before Flop (didn't bet)
Seat 2: 27baaa05 (small blind) folded before Flop
Seat 3: ec2814be (big blind) folded before Flop
Seat 4: 545ae247 collected ($0.12)
Seat 5: Hero folded before Flop (didn't bet)
Seat 6: 787e1958 folded before Flop (didn't bet)


Poker Hand #RC3334600706: Hold'em No Limit ($0.02/$0.05) - 2025/02/17 21:46:00
Table 'RushAndCash635966' 6-max Seat #1 is the button
Seat 1: 4e53b23f ($5.39 in chips)
Seat 2: Hero ($8.07 in chips)
Seat 3: 657ee1fc ($7.39 in chips)
Seat 4: 4afebef ($5.33 in chips)
Seat 5: 3bfcd529 ($9.58 in chips)
Seat 6: e6ee1d7f ($5.81 in chips)
Hero: posts small blind $0.02
657ee1fc: posts big blind $0.05
*** HOLE CARDS ***
Dealt to 4e53b23f 
Dealt to Hero [Td Ks]
Dealt to 657ee1fc 
Dealt to 4afebef 
Dealt to 3bfcd529 
Dealt to e6ee1d7f 
4afebef: folds
3bfcd529: raises $0.05 to $0.1
e6ee1d7f: folds
4e53b23f: folds
Hero: folds
657ee1fc: folds
Uncalled bet ($0.05) returned to 3bfcd529
*** SHOWDOWN ***
3bfcd529 collected $0.12 from pot
*** SUMMARY ***
Total pot $0.12 | Rake $0 | Jackpot $0 | Bingo $0 | Fortune $0 | Tax $0
Seat 1: 4e53b23f (button) folded before Flop (didn't bet)
Seat 2: Hero (small blind) folded before Flop
Seat 3: 657ee1fc (big blind) folded before Flop
Seat 4: 4afebef folded before Flop (didn't bet)
Seat 5: 3bfcd529 collected ($0.12)
Seat 6: e6ee1d7f folded before Flop (didn't bet)


Poker Hand #RC3334600671: Hold'em No Limit ($0.02/$0.05) - 2025/02/17 21:45:56
Table 'RushAndCash635931' 6-max Seat #1 is the button
Seat 1: c565c977 ($5.33 in chips)
Seat 2: 5dca9e3f ($5.02 in chips)
Seat 3: d0d9ce45 ($7.22 in chips)
Seat 4: 47b2c33d ($5.77 in chips)
Seat 5: Hero ($8.07 in chips)
Seat 6: 95d29c49 ($5.38 in chips)
5dca9e3f: posts small blind $0.02
d0d9ce45: posts big blind $0.05
*** HOLE CARDS ***
Dealt to c565c977 
Dealt to 5dca9e3f 
Dealt to d0d9ce45 
Dealt to 47b2c33d 
Dealt to Hero [2c 9d]
Dealt to 95d29c49 
47b2c33d: folds
Hero: folds
95d29c49: folds
c565c977: raises $0.05 to $0.1
5dca9e3f: folds
d0d9ce45: folds
Uncalled bet ($0.05) returned to c565c977
*** SHOWDOWN ***
c565c977 collected $0.12 from pot
*** SUMMARY ***
Total pot $0.12 | Rake $0 | Jackpot $0 | Bingo $0 | Fortune $0 | Tax $0
Seat 1: c565c977 (button) collected ($0.12)
Seat 2: 5dca9e3f (small blind) folded before Flop
Seat 3: d0d9ce45 (big blind) folded before Flop
Seat 4: 47b2c33d folded before Flop (didn't bet)
Seat 5: Hero folded before Flop (didn't bet)
Seat 6: 95d29c49 folded before Flop (didn't bet)


Poker Hand #RC3334600644: Hold'em No Limit ($0.02/$0.05) - 2025/02/17 21:45:53
Table 'RushAndCash635904' 6-max Seat #1 is the button
Seat 1: Hero ($8.07 in chips)
Seat 2: fd4703e3 ($1.48 in chips)
Seat 3: c3ae0b9c ($5.12 in chips)
Seat 4: 47b2c33d ($5.77 in chips)
Seat 5: 81f29d91 ($5.2 in chips)
Seat 6: 720edd8b ($2.13 in chips)
fd4703e3: posts small blind $0.02
c3ae0b9c: posts big blind $0.05
*** HOLE CARDS ***
Dealt to Hero [Td 6s]
Dealt to fd4703e3 
Dealt to c3ae0b9c 
Dealt to 47b2c33d 
Dealt to 81f29d91 
Dealt to 720edd8b 
47b2c33d: folds
81f29d91: raises $0.1 to $0.15
720edd8b: folds
Hero: folds
fd4703e3: raises $1.33 to $1.48 and is all-in
c3ae0b9c: folds
81f29d91: calls $1.33
fd4703e3: shows [Qs Kc]
81f29d91: shows [Jh As]
*** FLOP *** [9s 5s Ts]
*** TURN *** [9s 5s Ts] [7c]
*** RIVER *** [9s 5s Ts 7c] [9h]
*** SHOWDOWN ***
81f29d91 collected $2.8 from pot
*** SUMMARY ***
Total pot $3.01 | Rake $0.14 | Jackpot $0.07 | Bingo $0 | Fortune $0 | Tax $0
Board [9s 5s Ts 7c 9h]
Seat 1: Hero (button) folded before Flop (didn't bet)
Seat 2: fd4703e3 (small blind) showed [Qs Kc] and lost with Pair of Nines
Seat 3: c3ae0b9c (big blind) folded before Flop
Seat 4: 47b2c33d folded before Flop (didn't bet)
Seat 5: 81f29d91 showed [Jh As] and won ($2.8) with Pair of Nines
Seat 6: 720edd8b folded before Flop (didn't bet)


Poker Hand #RC3334600612: Hold'em No Limit ($0.02/$0.05) - 2025/02/17 21:45:49
Table 'RushAndCash635872' 6-max Seat #1 is the button
Seat 1: 198a1e4 ($7.92 in chips)
Seat 2: Hero ($8.09 in chips)
Seat 3: f53325ff ($5.14 in chips)
Seat 4: b28541cc ($4.43 in chips)
Seat 5: 875d33bf ($5 in chips)
Seat 6: ac140cb9 ($4.57 in chips)
Hero: posts small blind $0.02
f53325ff: posts big blind $0.05
*** HOLE CARDS ***
Dealt to 198a1e4 
Dealt to Hero [Td 4c]
Dealt to f53325ff 
Dealt to b28541cc 
Dealt to 875d33bf 
Dealt to ac140cb9 
b28541cc: folds
875d33bf: folds
ac140cb9: folds
198a1e4: folds
Hero: folds
Uncalled bet ($0.03) returned to f53325ff
*** SHOWDOWN ***
f53325ff collected $0.04 from pot
*** SUMMARY ***
Total pot $0.04 | Rake $0 | Jackpot $0 | Bingo $0 | Fortune $0 | Tax $0
Seat 1: 198a1e4 (button) folded before Flop (didn't bet)
Seat 2: Hero (small blind) folded before Flop
Seat 3: f53325ff (big blind) collected ($0.04)
Seat 4: b28541cc folded before Flop (didn't bet)
Seat 5: 875d33bf folded before Flop (didn't bet)
Seat 6: ac140cb9 folded before Flop (didn't bet)


Poker Hand #RC3334600526: Hold'em No Limit ($0.02/$0.05) - 2025/02/17 21:45:40
Table 'RushAndCash635786' 6-max Seat #1 is the button
Seat 1: bf7ff92b ($3.8 in chips)
Seat 2: 7eb5dbb3 ($12.43 in chips)
Seat 3: c723772e ($16.39 in chips)
Seat 4: 6e5afa4f ($2.57 in chips)
Seat 5: Hero ($8.09 in chips)
Seat 6: c9e4cf57 ($5.97 in chips)
7eb5dbb3: posts small blind $0.02
c723772e: posts big blind $0.05
*** HOLE CARDS ***
Dealt to bf7ff92b 
Dealt to 7eb5dbb3 
Dealt to c723772e 
Dealt to 6e5afa4f 
Dealt to Hero [9h 2d]
Dealt to c9e4cf57 
6e5afa4f: raises $0.1 to $0.15
Hero: folds
c9e4cf57: folds
bf7ff92b: folds
7eb5dbb3: folds
c723772e: folds
Uncalled bet ($0.1) returned to 6e5afa4f
*** SHOWDOWN ***
6e5afa4f collected $0.12 from pot
*** SUMMARY ***
Total pot $0.12 | Rake $0 | Jackpot $0 | Bingo $0 | Fortune $0 | Tax $0
Seat 1: bf7ff92b (button) folded before Flop (didn't bet)
Seat 2: 7eb5dbb3 (small blind) folded before Flop
Seat 3: c723772e (big blind) folded before Flop
Seat 4: 6e5afa4f collected ($0.12)
Seat 5: Hero folded before Flop (didn't bet)
Seat 6: c9e4cf57 folded before Flop (didn't bet)


Poker Hand #RC3334600498: Hold'em No Limit ($0.02/$0.05) - 2025/02/17 21:45:36
Table 'RushAndCash635758' 6-max Seat #1 is the button
Seat 1: Hero ($8.09 in chips)
Seat 2: 72b3f81 ($5.89 in chips)
Seat 3: ca7c2b72 ($5.25 in chips)
Seat 4: e0b522d5 ($3.75 in chips)
Seat 5: 442376ec ($5 in chips)
Seat 6: 4577a98c ($5.12 in chips)
72b3f81: posts small blind $0.02
ca7c2b72: posts big blind $0.05
*** HOLE CARDS ***
Dealt to Hero [Js 4d]
Dealt to 72b3f81 
Dealt to ca7c2b72 
Dealt to e0b522d5 
Dealt to 442376ec 
Dealt to 4577a98c 
e0b522d5: folds
442376ec: folds
4577a98c: folds
Hero: folds
72b3f81: folds
Uncalled bet ($0.03) returned to ca7c2b72
*** SHOWDOWN ***
ca7c2b72 collected $0.04 from pot
*** SUMMARY ***
Total pot $0.04 | Rake $0 | Jackpot $0 | Bingo $0 | Fortune $0 | Tax $0
Seat 1: Hero (button) folded before Flop (didn't bet)
Seat 2: 72b3f81 (small blind) folded before Flop
Seat 3: ca7c2b72 (big blind) collected ($0.04)
Seat 4: e0b522d5 folded before Flop (didn't bet)
Seat 5: 442376ec folded before Flop (didn't bet)
Seat 6: 4577a98c folded before Flop (didn't bet)


Poker Hand #RC3334600471: Hold'em No Limit ($0.02/$0.05) - 2025/02/17 21:45:33
Table 'RushAndCash635731' 6-max Seat #1 is the button
Seat 1: a678f821 ($11.82 in chips)
Seat 2: 419eb9fb ($9.32 in chips)
Seat 3: 3bfcd529 ($9.61 in chips)
Seat 4: Hero ($8.09 in chips)
Seat 5: 9fa2589a ($4.11 in chips)
Seat 6: abef7df7 ($2.23 in chips)
419eb9fb: posts small blind $0.02
3bfcd529: posts big blind $0.05
*** HOLE CARDS ***
Dealt to a678f821 
Dealt to 419eb9fb 
Dealt to 3bfcd529 
Dealt to Hero [5c Ks]
Dealt to 9fa2589a 
Dealt to abef7df7 
Hero: folds
9fa2589a: folds
abef7df7: folds
a678f821: raises $0.1 to $0.15
419eb9fb: folds
3bfcd529: folds
Uncalled bet ($0.1) returned to a678f821
*** SHOWDOWN ***
a678f821 collected $0.12 from pot
*** SUMMARY ***
Total pot $0.12 | Rake $0 | Jackpot $0 | Bingo $0 | Fortune $0 | Tax $0
Seat 1: a678f821 (button) collected ($0.12)
Seat 2: 419eb9fb (small blind) folded before Flop
Seat 3: 3bfcd529 (big blind) folded before Flop
Seat 4: Hero folded before Flop (didn't bet)
Seat 5: 9fa2589a folded before Flop (didn't bet)
Seat 6: abef7df7 folded before Flop (didn't bet)


Poker Hand #RC3334600442: Hold'em No Limit ($0.02/$0.05) - 2025/02/17 21:45:29
Table 'RushAndCash635702' 6-max Seat #1 is the button
Seat 1: d6280cb6 ($5 in chips)
Seat 2: 90bbba9f ($5.53 in chips)
Seat 3: 909d8acc ($5 in chips)
Seat 4: Hero ($8.09 in chips)
Seat 5: 5741d28a ($8.29 in chips)
Seat 6: 530477b2 ($5.02 in chips)
90bbba9f: posts small blind $0.02
909d8acc: posts big blind $0.05
*** HOLE CARDS ***
Dealt to d6280cb6 
Dealt to 90bbba9f 
Dealt to 909d8acc 
Dealt to Hero [6s 2d]
Dealt to 5741d28a 
Dealt to 530477b2 
Hero: folds
5741d28a: folds
530477b2: raises $0.05 to $0.1
d6280cb6: folds
90bbba9f: folds
909d8acc: calls $0.05
*** FLOP *** [Jd 8h 3d]
909d8acc: checks
530477b2: bets $0.08
909d8acc: folds
Uncalled bet ($0.08) returned to 530477b2
*** SHOWDOWN ***
530477b2 collected $0.21 from pot
*** SUMMARY ***
Total pot $0.22 | Rake $0.01 | Jackpot $0 | Bingo $0 | Fortune $0 | Tax $0
Board [Jd 8h 3d]
Seat 1: d6280cb6 (button) folded before Flop (didn't bet)
Seat 2: 90bbba9f (small blind) folded before Flop
Seat 3: 909d8acc (big blind) folded on the Flop
Seat 4: Hero folded before Flop (didn't bet)
Seat 5: 5741d28a folded before Flop (didn't bet)
Seat 6: 530477b2 won ($0.21)


Poker Hand #RC3334600417: Hold'em No Limit ($0.02/$0.05) - 2025/02/17 21:45:26
Table 'RushAndCash635677' 6-max Seat #1 is the button
Seat 1: 79d81faa ($8.46 in chips)
Seat 2: e0a9129e ($4.51 in chips)
Seat 3: a3698279 ($11.23 in chips)
Seat 4: Hero ($8.09 in chips)
Seat 5: 1a2d8f33 ($6.26 in chips)
Seat 6: 9fa2589a ($4.11 in chips)
e0a9129e: posts small blind $0.02
a3698279: posts big blind $0.05
*** HOLE CARDS ***
Dealt to 79d81faa 
Dealt to e0a9129e 
Dealt to a3698279 
Dealt to Hero [5c 9d]
Dealt to 1a2d8f33 
Dealt to 9fa2589a 
Hero: folds
1a2d8f33: folds
9fa2589a: folds
79d81faa: folds
e0a9129e: calls $0.03
a3698279: checks
*** FLOP *** [2h 7d 4c]
e0a9129e: checks
a3698279: checks
*** TURN *** [2h 7d 4c] [9h]
e0a9129e: bets $0.1
a3698279: calls $0.1
*** RIVER *** [2h 7d 4c 9h] [Js]
e0a9129e: checks
a3698279: bets $0.09
e0a9129e: folds
Uncalled bet ($0.09) returned to a3698279
*** SHOWDOWN ***
a3698279 collected $0.29 from pot
*** SUMMARY ***
Total pot $0.3 | Rake $0.01 | Jackpot $0 | Bingo $0 | Fortune $0 | Tax $0
Board [2h 7d 4c 9h Js]
Seat 1: 79d81faa (button) folded before Flop (didn't bet)
Seat 2: e0a9129e (small blind) folded on the River
Seat 3: a3698279 (big blind) won ($0.29)
Seat 4: Hero folded before Flop (didn't bet)
Seat 5: 1a2d8f33 folded before Flop (didn't bet)
Seat 6: 9fa2589a folded before Flop (didn't bet)


Poker Hand #RC3334600393: Hold'em No Limit ($0.02/$0.05) - 2025/02/17 21:45:23
Table 'RushAndCash635653' 6-max Seat #1 is the button
Seat 1: Hero ($8.09 in chips)
Seat 2: b165f967 ($5.55 in chips)
Seat 3: a75d2a3b ($5.9 in chips)
Seat 4: 6c641898 ($5.55 in chips)
Seat 5: 7c97092f ($6.42 in chips)
Seat 6: a5be70d9 ($13.5 in chips)
b165f967: posts small blind $0.02
a75d2a3b: posts big blind $0.05
*** HOLE CARDS ***
Dealt to Hero [2s Tc]
Dealt to b165f967 
Dealt to a75d2a3b 
Dealt to 6c641898 
Dealt to 7c97092f 
Dealt to a5be70d9 
6c641898: folds
7c97092f: folds
a5be70d9: raises $0.08 to $0.13
Hero: folds
b165f967: folds
a75d2a3b: calls $0.08
*** FLOP *** [4h 6h 2c]
a75d2a3b: checks
a5be70d9: checks
*** TURN *** [4h 6h 2c] [6d]
a75d2a3b: checks
a5be70d9: bets $0.21
a75d2a3b: folds
Uncalled bet ($0.21) returned to a5be70d9
*** SHOWDOWN ***
a5be70d9 collected $0.27 from pot
*** SUMMARY ***
Total pot $0.28 | Rake $0.01 | Jackpot $0 | Bingo $0 | Fortune $0 | Tax $0
Board [4h 6h 2c 6d]
Seat 1: Hero (button) folded before Flop (didn't bet)
Seat 2: b165f967 (small blind) folded before Flop
Seat 3: a75d2a3b (big blind) folded on the Turn
Seat 4: 6c641898 folded before Flop (didn't bet)
Seat 5: 7c97092f folded before Flop (didn't bet)
Seat 6: a5be70d9 won ($0.27)


Poker Hand #RC3334600361: Hold'em No Limit ($0.02/$0.05) - 2025/02/17 21:45:20
Table 'RushAndCash635621' 6-max Seat #1 is the button
Seat 1: d7a83a17 ($5.44 in chips)
Seat 2: 853dbdb5 ($3.51 in chips)
Seat 3: Hero ($8.14 in chips)
Seat 4: 91ad3969 ($13.39 in chips)
Seat 5: c9e4cf57 ($5.97 in chips)
Seat 6: bd7b1be4 ($5 in chips)
853dbdb5: posts small blind $0.02
Hero: posts big blind $0.05
*** HOLE CARDS ***
Dealt to d7a83a17 
Dealt to 853dbdb5 
Dealt to Hero [5d Jh]
Dealt to 91ad3969 
Dealt to c9e4cf57 
Dealt to bd7b1be4 
91ad3969: folds
c9e4cf57: folds
bd7b1be4: folds
d7a83a17: raises $0.08 to $0.13
853dbdb5: calls $0.11
Hero: folds
*** FLOP *** [Kd 8c Jd]
853dbdb5: checks
d7a83a17: bets $0.16
853dbdb5: calls $0.16
*** TURN *** [Kd 8c Jd] [Qd]
853dbdb5: checks
d7a83a17: bets $0.48
853dbdb5: raises $0.8 to $1.28
d7a83a17: raises $3.87 to $5.15 and is all-in
853dbdb5: calls $1.94 and is all-in
Uncalled bet ($1.93) returned to d7a83a17
d7a83a17: shows [6d Ad] (Ace High Flush)
853dbdb5: shows [7d 4d] (King High Flush)
*** RIVER *** [Kd 8c Jd Qd] [9c]
*** SHOWDOWN ***
d7a83a17 collected $6.75 from pot
*** SUMMARY ***
Total pot $7.07 | Rake $0.25 | Jackpot $0.07 | Bingo $0 | Fortune $0 | Tax $0
Board [Kd 8c Jd Qd 9c]
Seat 1: d7a83a17 (button) showed [6d Ad] and won ($6.75) with Ace High Flush
Seat 2: 853dbdb5 (small blind) showed [7d 4d] and lost with King High Flush
Seat 3: Hero (big blind) folded before Flop
Seat 4: 91ad3969 folded before Flop (didn't bet)
Seat 5: c9e4cf57 folded before Flop (didn't bet)
Seat 6: bd7b1be4 folded before Flop (didn't bet)


Poker Hand #RC3334600139: Hold'em No Limit ($0.02/$0.05) - 2025/02/17 21:44:54
Table 'RushAndCash635399' 6-max Seat #1 is the button
Seat 1: 21be8833 ($5.77 in chips)
Seat 2: 319021b1 ($5.07 in chips)
Seat 3: 10b5ea2f ($11.13 in chips)
Seat 4: Hero ($8.07 in chips)
Seat 5: 58065c52 ($5.38 in chips)
Seat 6: af130c3f ($5.16 in chips)
319021b1: posts small blind $0.02
10b5ea2f: posts big blind $0.05
*** HOLE CARDS ***
Dealt to 21be8833 
Dealt to 319021b1 
Dealt to 10b5ea2f 
Dealt to Hero [Jh Ac]
Dealt to 58065c52 
Dealt to af130c3f 
Hero: raises $0.05 to $0.1
58065c52: folds
af130c3f: folds
21be8833: folds
319021b1: folds
10b5ea2f: folds
Uncalled bet ($0.05) returned to Hero
*** SHOWDOWN ***
Hero collected $0.12 from pot
*** SUMMARY ***
Total pot $0.12 | Rake $0 | Jackpot $0 | Bingo $0 | Fortune $0 | Tax $0
Seat 1: 21be8833 (button) folded before Flop (didn't bet)
Seat 2: 319021b1 (small blind) folded before Flop
Seat 3: 10b5ea2f (big blind) folded before Flop
Seat 4: Hero collected ($0.12)
Seat 5: 58065c52 folded before Flop (didn't bet)
Seat 6: af130c3f folded before Flop (didn't bet)


Poker Hand #RC3334600110: Hold'em No Limit ($0.02/$0.05) - 2025/02/17 21:44:51
Table 'RushAndCash635370' 6-max Seat #1 is the button
Seat 1: 8cf3ad10 ($17.35 in chips)
Seat 2: ed18a71b ($7.01 in chips)
Seat 3: 167e28c4 ($7.99 in chips)
Seat 4: d47282a4 ($5.69 in chips)
Seat 5: 188c8947 ($6.03 in chips)
Seat 6: Hero ($8.07 in chips)
ed18a71b: posts small blind $0.02
167e28c4: posts big blind $0.05
*** HOLE CARDS ***
Dealt to 8cf3ad10 
Dealt to ed18a71b 
Dealt to 167e28c4 
Dealt to d47282a4 
Dealt to 188c8947 
Dealt to Hero [4s 9h]
d47282a4: raises $0.05 to $0.1
188c8947: folds
Hero: folds
8cf3ad10: folds
ed18a71b: raises $0.25 to $0.35
167e28c4: folds
d47282a4: calls $0.25
*** FLOP *** [Qs Ac As]
ed18a71b: bets $0.38
d47282a4: calls $0.38
*** TURN *** [Qs Ac As] [Td]
ed18a71b: checks
d47282a4: checks
*** RIVER *** [Qs Ac As Td] [6c]
ed18a71b: checks
d47282a4: checks
ed18a71b: shows [7h 7c] (Pair of Aces and Pair of Sevens)
d47282a4: shows [Qc Ts] (Pair of Aces and Pair of Queens)
*** SHOWDOWN ***
d47282a4 collected $1.36 from pot
*** SUMMARY ***
Total pot $1.51 | Rake $0.08 | Jackpot $0.07 | Bingo $0 | Fortune $0 | Tax $0
Board [Qs Ac As Td 6c]
Seat 1: 8cf3ad10 (button) folded before Flop (didn't bet)
Seat 2: ed18a71b (small blind) showed [7h 7c] and lost with Pair of Aces and Pair of Sevens
Seat 3: 167e28c4 (big blind) folded before Flop
Seat 4: d47282a4 showed [Qc Ts] and won ($1.36) with Pair of Aces and Pair of Queens
Seat 5: 188c8947 folded before Flop (didn't bet)
Seat 6: Hero folded before Flop (didn't bet)


Poker Hand #RC3334600071: Hold'em No Limit ($0.02/$0.05) - 2025/02/17 21:44:47
Table 'RushAndCash635331' 6-max Seat #1 is the button
Seat 1: Hero ($8.07 in chips)
Seat 2: a28ca95c ($24.18 in chips)
Seat 3: c27051e0 ($5.23 in chips)
Seat 4: dd3f46e9 ($5.1 in chips)
Seat 5: f8081566 ($6.8 in chips)
Seat 6: 787e1958 ($5 in chips)
a28ca95c: posts small blind $0.02
c27051e0: posts big blind $0.05
*** HOLE CARDS ***
Dealt to Hero [Jc 2s]
Dealt to a28ca95c 
Dealt to c27051e0 
Dealt to dd3f46e9 
Dealt to f8081566 
Dealt to 787e1958 
dd3f46e9: folds
f8081566: folds
787e1958: raises $0.06 to $0.11
Hero: folds
a28ca95c: folds
c27051e0: folds
Uncalled bet ($0.06) returned to 787e1958
*** SHOWDOWN ***
787e1958 collected $0.12 from pot
*** SUMMARY ***
Total pot $0.12 | Rake $0 | Jackpot $0 | Bingo $0 | Fortune $0 | Tax $0
Seat 1: Hero (button) folded before Flop (didn't bet)
Seat 2: a28ca95c (small blind) folded before Flop
Seat 3: c27051e0 (big blind) folded before Flop
Seat 4: dd3f46e9 folded before Flop (didn't bet)
Seat 5: f8081566 folded before Flop (didn't bet)
Seat 6: 787e1958 collected ($0.12)


Poker Hand #RC3334600031: Hold'em No Limit ($0.02/$0.05) - 2025/02/17 21:44:43
Table 'RushAndCash635291' 6-max Seat #1 is the button
Seat 1: b2966865 ($12.05 in chips)
Seat 2: Hero ($8.09 in chips)
Seat 3: 7b0814a4 ($4.53 in chips)
Seat 4: aadfce52 ($5.41 in chips)
Seat 5: c3ca6759 ($5 in chips)
Seat 6: 59c43665 ($4.2 in chips)
Hero: posts small blind $0.02
7b0814a4: posts big blind $0.05
*** HOLE CARDS ***
Dealt to b2966865 
Dealt to Hero [3d Kh]
Dealt to 7b0814a4 
Dealt to aadfce52 
Dealt to c3ca6759 
Dealt to 59c43665 
aadfce52: raises $0.06 to $0.11
c3ca6759: folds
59c43665: folds
b2966865: folds
Hero: folds
7b0814a4: calls $0.06
*** FLOP *** [2d 8d Jh]
7b0814a4: checks
aadfce52: bets $0.1
7b0814a4: calls $0.1
*** TURN *** [2d 8d Jh] [2c]
7b0814a4: checks
aadfce52: bets $0.4
7b0814a4: calls $0.4
*** RIVER *** [2d 8d Jh 2c] [Qd]
7b0814a4: checks
aadfce52: bets $1.12
7b0814a4: calls $1.12
aadfce52: shows [7d Ad] (Ace High Flush)
7b0814a4: shows [4s 8s] (Pair of Eights and Pair of Twos)
*** SHOWDOWN ***
aadfce52 collected $3.21 from pot
*** SUMMARY ***
Total pot $3.48 | Rake $0.2 | Jackpot $0.07 | Bingo $0 | Fortune $0 | Tax $0
Board [2d 8d Jh 2c Qd]
Seat 1: b2966865 (button) folded before Flop (didn't bet)
Seat 2: Hero (small blind) folded before Flop
Seat 3: 7b0814a4 (big blind) showed [4s 8s] and lost with Pair of Eights and Pair of Twos
Seat 4: aadfce52 showed [7d Ad] and won ($3.21) with Ace High Flush
Seat 5: c3ca6759 folded before Flop (didn't bet)
Seat 6: 59c43665 folded before Flop (didn't bet)


Poker Hand #RC3334599610: Hold'em No Limit ($0.02/$0.05) - 2025/02/17 21:43:56
Table 'RushAndCash634870' 6-max Seat #1 is the button
Seat 1: 8d0bc73f ($8.32 in chips)
Seat 2: a5be70d9 ($13.45 in chips)
Seat 3: Hero ($7.69 in chips)
Seat 4: fa7bb2c5 ($8.48 in chips)
Seat 5: 9fa2589a ($4.32 in chips)
Seat 6: 7b0814a4 ($4.95 in chips)
a5be70d9: posts small blind $0.02
Hero: posts big blind $0.05
*** HOLE CARDS ***
Dealt to 8d0bc73f 
Dealt to a5be70d9 
Dealt to Hero [As Ad]
Dealt to fa7bb2c5 
Dealt to 9fa2589a 
Dealt to 7b0814a4 
fa7bb2c5: folds
9fa2589a: folds
7b0814a4: calls $0.05
8d0bc73f: folds
a5be70d9: folds
Hero: raises $0.15 to $0.2
7b0814a4: calls $0.15
*** FLOP *** [Kc 4s Js]
Hero: checks
7b0814a4: checks
*** TURN *** [Kc 4s Js] [Ks]
Hero: bets $0.22
7b0814a4: calls $0.22
*** RIVER *** [Kc 4s Js Ks] [9s]
Hero: bets $0.44
7b0814a4: folds
Uncalled bet ($0.44) returned to Hero
*** SHOWDOWN ***
Hero collected $0.82 from pot
*** SUMMARY ***
Total pot $0.86 | Rake $0.04 | Jackpot $0 | Bingo $0 | Fortune $0 | Tax $0
Board [Kc 4s Js Ks 9s]
Seat 1: 8d0bc73f (button) folded before Flop (didn't bet)
Seat 2: a5be70d9 (small blind) folded before Flop
Seat 3: Hero (big blind) won ($0.82)
Seat 4: fa7bb2c5 folded before Flop (didn't bet)
Seat 5: 9fa2589a folded before Flop (didn't bet)
Seat 6: 7b0814a4 folded on the River


Poker Hand #RC3334599572: Hold'em No Limit ($0.02/$0.05) - 2025/02/17 21:43:51
Table 'RushAndCash634832' 6-max Seat #1 is the button
Seat 1: 3e3946b0 ($9.65 in chips)
Seat 2: c9f8ff1c ($5.48 in chips)
Seat 3: 3fac11ae ($5.47 in chips)
Seat 4: Hero ($7.69 in chips)
Seat 5: cea9730b ($8.79 in chips)
Seat 6: ba72b338 ($5.87 in chips)
c9f8ff1c: posts small blind $0.02
3fac11ae: posts big blind $0.05
*** HOLE CARDS ***
Dealt to 3e3946b0 
Dealt to c9f8ff1c 
Dealt to 3fac11ae 
Dealt to Hero [9h 7d]
Dealt to cea9730b 
Dealt to ba72b338 
Hero: folds
cea9730b: folds
ba72b338: raises $0.05 to $0.1
3e3946b0: folds
c9f8ff1c: folds
3fac11ae: folds
Uncalled bet ($0.05) returned to ba72b338
*** SHOWDOWN ***
ba72b338 collected $0.12 from pot
*** SUMMARY ***
Total pot $0.12 | Rake $0 | Jackpot $0 | Bingo $0 | Fortune $0 | Tax $0
Seat 1: 3e3946b0 (button) folded before Flop (didn't bet)
Seat 2: c9f8ff1c (small blind) folded before Flop
Seat 3: 3fac11ae (big blind) folded before Flop
Seat 4: Hero folded before Flop (didn't bet)
Seat 5: cea9730b folded before Flop (didn't bet)
Seat 6: ba72b338 collected ($0.12)


Poker Hand #RC3334599551: Hold'em No Limit ($0.02/$0.05) - 2025/02/17 21:43:48
Table 'RushAndCash634811' 6-max Seat #1 is the button
Seat 1: b2f44cb6 ($11.02 in chips)
Seat 2: 30d19f6e ($5 in chips)
Seat 3: d8f38484 ($5.87 in chips)
Seat 4: 53a8c2fd ($9.45 in chips)
Seat 5: 15125d65 ($20.65 in chips)
Seat 6: Hero ($7.69 in chips)
30d19f6e: posts small blind $0.02
d8f38484: posts big blind $0.05
*** HOLE CARDS ***
Dealt to b2f44cb6 
Dealt to 30d19f6e 
Dealt to d8f38484 
Dealt to 53a8c2fd 
Dealt to 15125d65 
Dealt to Hero [5s Jc]
53a8c2fd: raises $0.06 to $0.11
15125d65: folds
Hero: folds
b2f44cb6: folds
30d19f6e: folds
d8f38484: folds
Uncalled bet ($0.06) returned to 53a8c2fd
*** SHOWDOWN ***
53a8c2fd collected $0.12 from pot
*** SUMMARY ***
Total pot $0.12 | Rake $0 | Jackpot $0 | Bingo $0 | Fortune $0 | Tax $0
Seat 1: b2f44cb6 (button) folded before Flop (didn't bet)
Seat 2: 30d19f6e (small blind) folded before Flop
Seat 3: d8f38484 (big blind) folded before Flop
Seat 4: 53a8c2fd collected ($0.12)
Seat 5: 15125d65 folded before Flop (didn't bet)
Seat 6: Hero folded before Flop (didn't bet)


Poker Hand #RC3334599480: Hold'em No Limit ($0.02/$0.05) - 2025/02/17 21:43:40
Table 'RushAndCash634740' 6-max Seat #1 is the button
Seat 1: 9d687e0 ($3.46 in chips)
Seat 2: 3b2a8270 ($10.41 in chips)
Seat 3: 577aa3d3 ($9.67 in chips)
Seat 4: 34028f01 ($5.39 in chips)
Seat 5: ae52b2e0 ($5.87 in chips)
Seat 6: Hero ($7.69 in chips)
3b2a8270: posts small blind $0.02
577aa3d3: posts big blind $0.05
*** HOLE CARDS ***
Dealt to 9d687e0 
Dealt to 3b2a8270 
Dealt to 577aa3d3 
Dealt to 34028f01 
Dealt to ae52b2e0 
Dealt to Hero [Jh 9d]
34028f01: folds
ae52b2e0: raises $0.05 to $0.1
Hero: folds
9d687e0: folds
3b2a8270: folds
577aa3d3: folds
Uncalled bet ($0.05) returned to ae52b2e0
*** SHOWDOWN ***
ae52b2e0 collected $0.12 from pot
*** SUMMARY ***
Total pot $0.12 | Rake $0 | Jackpot $0 | Bingo $0 | Fortune $0 | Tax $0
Seat 1: 9d687e0 (button) folded before Flop (didn't bet)
Seat 2: 3b2a8270 (small blind) folded before Flop
Seat 3: 577aa3d3 (big blind) folded before Flop
Seat 4: 34028f01 folded before Flop (didn't bet)
Seat 5: ae52b2e0 collected ($0.12)
Seat 6: Hero folded before Flop (didn't bet)


Poker Hand #RC3334599443: Hold'em No Limit ($0.02/$0.05) - 2025/02/17 21:43:35
Table 'RushAndCash634703' 6-max Seat #1 is the button
Seat 1: 319021b1 ($5.14 in chips)
Seat 2: e76863c8 ($5.74 in chips)
Seat 3: Hero ($7.74 in chips)
Seat 4: 35fae52e ($5.33 in chips)
Seat 5: d037279c ($6.2 in chips)
Seat 6: ccabd9d2 ($4.33 in chips)
e76863c8: posts small blind $0.02
Hero: posts big blind $0.05
*** HOLE CARDS ***
Dealt to 319021b1 
Dealt to e76863c8 
Dealt to Hero [7s Qd]
Dealt to 35fae52e 
Dealt to d037279c 
Dealt to ccabd9d2 
35fae52e: folds
d037279c: raises $0.1 to $0.15
ccabd9d2: folds
319021b1: folds
e76863c8: calls $0.13
Hero: folds
*** FLOP *** [6c Js 3d]
e76863c8: bets $0.1
d037279c: calls $0.1
*** TURN *** [6c Js 3d] [Jc]
e76863c8: checks
d037279c: bets $0.33
e76863c8: calls $0.33
*** RIVER *** [6c Js 3d Jc] [7d]
e76863c8: checks
d037279c: checks
e76863c8: shows [6d 8d] (Pair of Jacks and Pair of Sixes)
d037279c: shows [Ah Qh] (Pair of Jacks)
*** SHOWDOWN ***
e76863c8 collected $1.15 from pot
*** SUMMARY ***
Total pot $1.21 | Rake $0.06 | Jackpot $0 | Bingo $0 | Fortune $0 | Tax $0
Board [6c Js 3d Jc 7d]
Seat 1: 319021b1 (button) folded before Flop (didn't bet)
Seat 2: e76863c8 (small blind) showed [6d 8d] and won ($1.15) with Pair of Jacks and Pair of Sixes
Seat 3: Hero (big blind) folded before Flop
Seat 4: 35fae52e folded before Flop (didn't bet)
Seat 5: d037279c showed [Ah Qh] and lost with Pair of Jacks
Seat 6: ccabd9d2 folded before Flop (didn't bet)


Poker Hand #RC3334599406: Hold'em No Limit ($0.02/$0.05) - 2025/02/17 21:43:31
Table 'RushAndCash634666' 6-max Seat #1 is the button
Seat 1: Hero ($7.74 in chips)
Seat 2: 6ab3ea38 ($5 in chips)
Seat 3: fd236f26 ($5.78 in chips)
Seat 4: c02adff2 ($5.33 in chips)
Seat 5: 5a40e20b ($5 in chips)
Seat 6: 9da6ba55 ($6.91 in chips)
6ab3ea38: posts small blind $0.02
fd236f26: posts big blind $0.05
*** HOLE CARDS ***
Dealt to Hero [4d 9s]
Dealt to 6ab3ea38 
Dealt to fd236f26 
Dealt to c02adff2 
Dealt to 5a40e20b 
Dealt to 9da6ba55 
c02adff2: folds
5a40e20b: folds
9da6ba55: folds
Hero: folds
6ab3ea38: folds
Uncalled bet ($0.03) returned to fd236f26
*** SHOWDOWN ***
fd236f26 collected $0.04 from pot
*** SUMMARY ***
Total pot $0.04 | Rake $0 | Jackpot $0 | Bingo $0 | Fortune $0 | Tax $0
Seat 1: Hero (button) folded before Flop (didn't bet)
Seat 2: 6ab3ea38 (small blind) folded before Flop
Seat 3: fd236f26 (big blind) collected ($0.04)
Seat 4: c02adff2 folded before Flop (didn't bet)
Seat 5: 5a40e20b folded before Flop (didn't bet)
Seat 6: 9da6ba55 folded before Flop (didn't bet)


Poker Hand #RC3334599378: Hold'em No Limit ($0.02/$0.05) - 2025/02/17 21:43:28
Table 'RushAndCash634638' 6-max Seat #1 is the button
Seat 1: Hero ($7.74 in chips)
Seat 2: f0463362 ($6.26 in chips)
Seat 3: ed18a71b ($7.27 in chips)
Seat 4: a4bd9290 ($5 in chips)
Seat 5: 8cef9d5b ($6.04 in chips)
Seat 6: 188c8947 ($6.09 in chips)
f0463362: posts small blind $0.02
ed18a71b: posts big blind $0.05
*** HOLE CARDS ***
Dealt to Hero [Ah 2h]
Dealt to f0463362 
Dealt to ed18a71b 
Dealt to a4bd9290 
Dealt to 8cef9d5b 
Dealt to 188c8947 
a4bd9290: folds
8cef9d5b: folds
188c8947: raises $0.07 to $0.12
Hero: folds
f0463362: folds
ed18a71b: folds
Uncalled bet ($0.07) returned to 188c8947
*** SHOWDOWN ***
188c8947 collected $0.12 from pot
*** SUMMARY ***
Total pot $0.12 | Rake $0 | Jackpot $0 | Bingo $0 | Fortune $0 | Tax $0
Seat 1: Hero (button) folded before Flop (didn't bet)
Seat 2: f0463362 (small blind) folded before Flop
Seat 3: ed18a71b (big blind) folded before Flop
Seat 4: a4bd9290 folded before Flop (didn't bet)
Seat 5: 8cef9d5b folded before Flop (didn't bet)
Seat 6: 188c8947 collected ($0.12)


Poker Hand #RC3334599351: Hold'em No Limit ($0.02/$0.05) - 2025/02/17 21:43:25
Table 'RushAndCash634611' 6-max Seat #1 is the button
Seat 1: 4a2c171f ($6.32 in chips)
Seat 2: Hero ($7.76 in chips)
Seat 3: 22643080 ($7.63 in chips)
Seat 4: c9baa38a ($5 in chips)
Seat 5: d03e7668 ($5.29 in chips)
Seat 6: e658d06d ($5.21 in chips)
Hero: posts small blind $0.02
22643080: posts big blind $0.05
*** HOLE CARDS ***
Dealt to 4a2c171f 
Dealt to Hero [4h 7d]
Dealt to 22643080 
Dealt to c9baa38a 
Dealt to d03e7668 
Dealt to e658d06d 
c9baa38a: folds
d03e7668: folds
e658d06d: raises $0.05 to $0.1
4a2c171f: raises $0.2 to $0.3
Hero: folds
22643080: folds
e658d06d: raises $0.65 to $0.95
4a2c171f: calls $0.65
*** FLOP *** [8d Kd 8h]
e658d06d: bets $0.75
4a2c171f: folds
Uncalled bet ($0.75) returned to e658d06d
*** SHOWDOWN ***
e658d06d collected $1.81 from pot
*** SUMMARY ***
Total pot $1.97 | Rake $0.09 | Jackpot $0.07 | Bingo $0 | Fortune $0 | Tax $0
Board [8d Kd 8h]
Seat 1: 4a2c171f (button) folded on the Flop
Seat 2: Hero (small blind) folded before Flop
Seat 3: 22643080 (big blind) folded before Flop
Seat 4: c9baa38a folded before Flop (didn't bet)
Seat 5: d03e7668 folded before Flop (didn't bet)
Seat 6: e658d06d won ($1.81)


Poker Hand #RC3334599322: Hold'em No Limit ($0.02/$0.05) - 2025/02/17 21:43:22
Table 'RushAndCash634582' 6-max Seat #1 is the button
Seat 1: c582715a ($7 in chips)
Seat 2: 814edd7 ($6.28 in chips)
Seat 3: 18fbcc2b ($1.89 in chips)
Seat 4: Hero ($7.76 in chips)
Seat 5: 493e7626 ($10.25 in chips)
Seat 6: 22643080 ($7.63 in chips)
814edd7: posts small blind $0.02
18fbcc2b: posts big blind $0.05
*** HOLE CARDS ***
Dealt to c582715a 
Dealt to 814edd7 
Dealt to 18fbcc2b 
Dealt to Hero [Td Qs]
Dealt to 493e7626 
Dealt to 22643080 
Hero: folds
493e7626: folds
22643080: folds
c582715a: raises $0.1 to $0.15
814edd7: folds
18fbcc2b: folds
Uncalled bet ($0.1) returned to c582715a
*** SHOWDOWN ***
c582715a collected $0.12 from pot
*** SUMMARY ***
Total pot $0.12 | Rake $0 | Jackpot $0 | Bingo $0 | Fortune $0 | Tax $0
Seat 1: c582715a (button) collected ($0.12)
Seat 2: 814edd7 (small blind) folded before Flop
Seat 3: 18fbcc2b (big blind) folded before Flop
Seat 4: Hero folded before Flop (didn't bet)
Seat 5: 493e7626 folded before Flop (didn't bet)
Seat 6: 22643080 folded before Flop (didn't bet)


Poker Hand #RC3334598807: Hold'em No Limit ($0.02/$0.05) - 2025/02/17 21:42:20
Table 'RushAndCash634067' 6-max Seat #1 is the button
Seat 1: 814edd7 ($5.46 in chips)
Seat 2: 720edd8b ($2.55 in chips)
Seat 3: 2da06ab0 ($5 in chips)
Seat 4: 4f7979c7 ($4.99 in chips)
Seat 5: Hero ($8.49 in chips)
Seat 6: d606d9 ($8.36 in chips)
720edd8b: posts small blind $0.02
2da06ab0: posts big blind $0.05
*** HOLE CARDS ***
Dealt to 814edd7 
Dealt to 720edd8b 
Dealt to 2da06ab0 
Dealt to 4f7979c7 
Dealt to Hero [Kc Ac]
Dealt to d606d9 
4f7979c7: folds
Hero: raises $0.05 to $0.1
d606d9: folds
814edd7: calls $0.1
720edd8b: folds
2da06ab0: calls $0.05
*** FLOP *** [7c Jd 8c]
2da06ab0: checks
Hero: bets $0.12
814edd7: calls $0.12
2da06ab0: calls $0.12
*** TURN *** [7c Jd 8c] [5d]
2da06ab0: checks
Hero: checks
814edd7: bets $0.51
2da06ab0: folds
Hero: calls $0.51
*** RIVER *** [7c Jd 8c 5d] [7s]
Hero: checks
814edd7: bets $0.85
Hero: folds
Uncalled bet ($0.85) returned to 814edd7
*** SHOWDOWN ***
814edd7 collected $1.55 from pot
*** SUMMARY ***
Total pot $1.7 | Rake $0.08 | Jackpot $0.07 | Bingo $0 | Fortune $0 | Tax $0
Board [7c Jd 8c 5d 7s]
Seat 1: 814edd7 (button) won ($1.55)
Seat 2: 720edd8b (small blind) folded before Flop
Seat 3: 2da06ab0 (big blind) folded on the Turn
Seat 4: 4f7979c7 folded before Flop (didn't bet)
Seat 5: Hero folded on the River
Seat 6: d606d9 folded before Flop (didn't bet)


Poker Hand #RC3334598710: Hold'em No Limit ($0.02/$0.05) - 2025/02/17 21:42:08
Table 'RushAndCash633970' 6-max Seat #1 is the button
Seat 1: 3ecb9f22 ($4.93 in chips)
Seat 2: 5ac336e3 ($6.03 in chips)
Seat 3: Hero ($8.47 in chips)
Seat 4: 6ab3ea38 ($5.01 in chips)
Seat 5: 8b7080d0 ($5.93 in chips)
Seat 6: 3b85f8e6 ($18.65 in chips)
5ac336e3: posts small blind $0.02
Hero: posts big blind $0.05
*** HOLE CARDS ***
Dealt to 3ecb9f22 
Dealt to 5ac336e3 
Dealt to Hero [Jh 2d]
Dealt to 6ab3ea38 
Dealt to 8b7080d0 
Dealt to 3b85f8e6 
6ab3ea38: folds
8b7080d0: folds
3b85f8e6: folds
3ecb9f22: folds
5ac336e3: folds
Uncalled bet ($0.03) returned to Hero
*** SHOWDOWN ***
Hero collected $0.04 from pot
*** SUMMARY ***
Total pot $0.04 | Rake $0 | Jackpot $0 | Bingo $0 | Fortune $0 | Tax $0
Seat 1: 3ecb9f22 (button) folded before Flop (didn't bet)
Seat 2: 5ac336e3 (small blind) folded before Flop
Seat 3: Hero (big blind) collected ($0.04)
Seat 4: 6ab3ea38 folded before Flop (didn't bet)
Seat 5: 8b7080d0 folded before Flop (didn't bet)
Seat 6: 3b85f8e6 folded before Flop (didn't bet)


Poker Hand #RC3334598654: Hold'em No Limit ($0.02/$0.05) - 2025/02/17 21:42:02
Table 'RushAndCash633914' 6-max Seat #1 is the button
Seat 1: ef96c0c8 ($6.68 in chips)
Seat 2: c24b20b9 ($16.95 in chips)
Seat 3: e658d06d ($5 in chips)
Seat 4: 15fafcaa ($5.52 in chips)
Seat 5: aeb50acd ($10.61 in chips)
Seat 6: Hero ($8.47 in chips)
c24b20b9: posts small blind $0.02
e658d06d: posts big blind $0.05
*** HOLE CARDS ***
Dealt to ef96c0c8 
Dealt to c24b20b9 
Dealt to e658d06d 
Dealt to 15fafcaa 
Dealt to aeb50acd 
Dealt to Hero [5h Qc]
15fafcaa: raises $0.05 to $0.1
aeb50acd: folds
Hero: folds
ef96c0c8: folds
c24b20b9: folds
e658d06d: folds
Uncalled bet ($0.05) returned to 15fafcaa
*** SHOWDOWN ***
15fafcaa collected $0.12 from pot
*** SUMMARY ***
Total pot $0.12 | Rake $0 | Jackpot $0 | Bingo $0 | Fortune $0 | Tax $0
Seat 1: ef96c0c8 (button) folded before Flop (didn't bet)
Seat 2: c24b20b9 (small blind) folded before Flop
Seat 3: e658d06d (big blind) folded before Flop
Seat 4: 15fafcaa collected ($0.12)
Seat 5: aeb50acd folded before Flop (didn't bet)
Seat 6: Hero folded before Flop (didn't bet)


Poker Hand #RC3334598605: Hold'em No Limit ($0.02/$0.05) - 2025/02/17 21:41:56
Table 'RushAndCash633865' 6-max Seat #1 is the button
Seat 1: ebb43f9 ($3.7 in chips)
Seat 2: fd236f26 ($5.88 in chips)
Seat 3: c4483bd8 ($5.7 in chips)
Seat 4: e32dc6f0 ($5.17 in chips)
Seat 5: Hero ($8.47 in chips)
Seat 6: 14d966a6 ($8.42 in chips)
fd236f26: posts small blind $0.02
c4483bd8: posts big blind $0.05
*** HOLE CARDS ***
Dealt to ebb43f9 
Dealt to fd236f26 
Dealt to c4483bd8 
Dealt to e32dc6f0 
Dealt to Hero [Jh 7c]
Dealt to 14d966a6 
e32dc6f0: folds
Hero: folds
14d966a6: folds
ebb43f9: folds
fd236f26: raises $0.1 to $0.15
c4483bd8: calls $0.1
*** FLOP *** [6c 8d 4s]
fd236f26: checks
c4483bd8: bets $0.1
fd236f26: folds
Uncalled bet ($0.1) returned to c4483bd8
*** SHOWDOWN ***
c4483bd8 collected $0.29 from pot
*** SUMMARY ***
Total pot $0.3 | Rake $0.01 | Jackpot $0 | Bingo $0 | Fortune $0 | Tax $0
Board [6c 8d 4s]
Seat 1: ebb43f9 (button) folded before Flop (didn't bet)
Seat 2: fd236f26 (small blind) folded on the Flop
Seat 3: c4483bd8 (big blind) won ($0.29)
Seat 4: e32dc6f0 folded before Flop (didn't bet)
Seat 5: Hero folded before Flop (didn't bet)
Seat 6: 14d966a6 folded before Flop (didn't bet)


Poker Hand #RC3334598548: Hold'em No Limit ($0.02/$0.05) - 2025/02/17 21:41:49
Table 'RushAndCash633808' 6-max Seat #1 is the button
Seat 1: Hero ($8.47 in chips)
Seat 2: ad31dea3 ($4.62 in chips)
Seat 3: c35cd20e ($6.05 in chips)
Seat 4: 4c7728b5 ($6.05 in chips)
Seat 5: 42fdd5b8 ($5 in chips)
Seat 6: 5daef2fa ($10.57 in chips)
ad31dea3: posts small blind $0.02
c35cd20e: posts big blind $0.05
*** HOLE CARDS ***
Dealt to Hero [2c Kc]
Dealt to ad31dea3 
Dealt to c35cd20e 
Dealt to 4c7728b5 
Dealt to 42fdd5b8 
Dealt to 5daef2fa 
4c7728b5: folds
42fdd5b8: folds
5daef2fa: folds
Hero: folds
ad31dea3: folds
Uncalled bet ($0.03) returned to c35cd20e
*** SHOWDOWN ***
c35cd20e collected $0.04 from pot
*** SUMMARY ***
Total pot $0.04 | Rake $0 | Jackpot $0 | Bingo $0 | Fortune $0 | Tax $0
Seat 1: Hero (button) folded before Flop (didn't bet)
Seat 2: ad31dea3 (small blind) folded before Flop
Seat 3: c35cd20e (big blind) collected ($0.04)
Seat 4: 4c7728b5 folded before Flop (didn't bet)
Seat 5: 42fdd5b8 folded before Flop (didn't bet)
Seat 6: 5daef2fa folded before Flop (didn't bet)


Poker Hand #RC3334598515: Hold'em No Limit ($0.02/$0.05) - 2025/02/17 21:41:46
Table 'RushAndCash633775' 6-max Seat #1 is the button
Seat 1: 4262311b ($8.54 in chips)
Seat 2: 4c7728b5 ($6.07 in chips)
Seat 3: 1b7f1845 ($6.73 in chips)
Seat 4: Hero ($8.47 in chips)
Seat 5: f3614ba1 ($10.67 in chips)
Seat 6: 994faa22 ($10.31 in chips)
4c7728b5: posts small blind $0.02
1b7f1845: posts big blind $0.05
*** HOLE CARDS ***
Dealt to 4262311b 
Dealt to 4c7728b5 
Dealt to 1b7f1845 
Dealt to Hero [Td 5d]
Dealt to f3614ba1 
Dealt to 994faa22 
Hero: folds
f3614ba1: folds
994faa22: folds
4262311b: raises $0.07 to $0.12
4c7728b5: folds
1b7f1845: folds
Uncalled bet ($0.07) returned to 4262311b
*** SHOWDOWN ***
4262311b collected $0.12 from pot
*** SUMMARY ***
Total pot $0.12 | Rake $0 | Jackpot $0 | Bingo $0 | Fortune $0 | Tax $0
Seat 1: 4262311b (button) collected ($0.12)
Seat 2: 4c7728b5 (small blind) folded before Flop
Seat 3: 1b7f1845 (big blind) folded before Flop
Seat 4: Hero folded before Flop (didn't bet)
Seat 5: f3614ba1 folded before Flop (didn't bet)
Seat 6: 994faa22 folded before Flop (didn't bet)


Poker Hand #RC3334598488: Hold'em No Limit ($0.02/$0.05) - 2025/02/17 21:41:42
Table 'RushAndCash633748' 6-max Seat #1 is the button
Seat 1: b59fc0b9 ($5.12 in chips)
Seat 2: a19fb924 ($7.44 in chips)
Seat 3: Hero ($8.52 in chips)
Seat 4: d57e790f ($7.93 in chips)
Seat 5: 3ecb9f22 ($5 in chips)
Seat 6: fcc3c3cc ($14.32 in chips)
a19fb924: posts small blind $0.02
Hero: posts big blind $0.05
*** HOLE CARDS ***
Dealt to b59fc0b9 
Dealt to a19fb924 
Dealt to Hero [3s 9s]
Dealt to d57e790f 
Dealt to 3ecb9f22 
Dealt to fcc3c3cc 
d57e790f: raises $0.08 to $0.13
3ecb9f22: folds
fcc3c3cc: folds
b59fc0b9: folds
a19fb924: folds
Hero: folds
Uncalled bet ($0.08) returned to d57e790f
*** SHOWDOWN ***
d57e790f collected $0.12 from pot
*** SUMMARY ***
Total pot $0.12 | Rake $0 | Jackpot $0 | Bingo $0 | Fortune $0 | Tax $0
Seat 1: b59fc0b9 (button) folded before Flop (didn't bet)
Seat 2: a19fb924 (small blind) folded before Flop
Seat 3: Hero (big blind) folded before Flop
Seat 4: d57e790f collected ($0.12)
Seat 5: 3ecb9f22 folded before Flop (didn't bet)
Seat 6: fcc3c3cc folded before Flop (didn't bet)


Poker Hand #RC3334598463: Hold'em No Limit ($0.02/$0.05) - 2025/02/17 21:41:39
Table 'RushAndCash633723' 6-max Seat #1 is the button
Seat 1: a81aa4e3 ($5.98 in chips)
Seat 2: d32546a5 ($5.1 in chips)
Seat 3: 677c4b25 ($10.61 in chips)
Seat 4: Hero ($8.52 in chips)
Seat 5: a91946aa ($2.26 in chips)
Seat 6: 9e226e3b ($5.23 in chips)
d32546a5: posts small blind $0.02
677c4b25: posts big blind $0.05
*** HOLE CARDS ***
Dealt to a81aa4e3 
Dealt to d32546a5 
Dealt to 677c4b25 
Dealt to Hero [8d 2c]
Dealt to a91946aa 
Dealt to 9e226e3b 
Hero: folds
a91946aa: folds
9e226e3b: folds
a81aa4e3: folds
d32546a5: raises $0.1 to $0.15
677c4b25: calls $0.1
*** FLOP *** [Qc Jc Ks]
d32546a5: checks
677c4b25: checks
*** TURN *** [Qc Jc Ks] [Ts]
d32546a5: bets $0.25
677c4b25: calls $0.25
*** RIVER *** [Qc Jc Ks Ts] [Ad]
d32546a5: checks
677c4b25: checks
d32546a5: shows [Qs 2s] (Aces-High Straight)
677c4b25: shows [6s As] (Aces-High Straight)
*** SHOWDOWN ***
d32546a5 collected $0.38 from pot
677c4b25 collected $0.38 from pot
*** SUMMARY ***
Total pot $0.8 | Rake $0.04 | Jackpot $0 | Bingo $0 | Fortune $0 | Tax $0
Board [Qc Jc Ks Ts Ad]
Seat 1: a81aa4e3 (button) folded before Flop (didn't bet)
Seat 2: d32546a5 (small blind) showed [Qs 2s] and won ($0.38) with Aces-High Straight
Seat 3: 677c4b25 (big blind) showed [6s As] and won ($0.38) with Aces-High Straight
Seat 4: Hero folded before Flop (didn't bet)
Seat 5: a91946aa folded before Flop (didn't bet)
Seat 6: 9e226e3b folded before Flop (didn't bet)


Poker Hand #RC3334598329: Hold'em No Limit ($0.02/$0.05) - 2025/02/17 21:41:24
Table 'RushAndCash633589' 6-max Seat #1 is the button
Seat 1: 52f54c69 ($5.24 in chips)
Seat 2: 69373e56 ($7.58 in chips)
Seat 3: 2e24bede ($5.92 in chips)
Seat 4: Hero ($8.45 in chips)
Seat 5: a4461af6 ($5.36 in chips)
Seat 6: 1941fa92 ($3.11 in chips)
69373e56: posts small blind $0.02
2e24bede: posts big blind $0.05
*** HOLE CARDS ***
Dealt to 52f54c69 
Dealt to 69373e56 
Dealt to 2e24bede 
Dealt to Hero [Jd Ad]
Dealt to a4461af6 
Dealt to 1941fa92 
Hero: raises $0.05 to $0.1
a4461af6: folds
1941fa92: folds
52f54c69: folds
69373e56: folds
2e24bede: folds
Uncalled bet ($0.05) returned to Hero
*** SHOWDOWN ***
Hero collected $0.12 from pot
*** SUMMARY ***
Total pot $0.12 | Rake $0 | Jackpot $0 | Bingo $0 | Fortune $0 | Tax $0
Seat 1: 52f54c69 (button) folded before Flop (didn't bet)
Seat 2: 69373e56 (small blind) folded before Flop
Seat 3: 2e24bede (big blind) folded before Flop
Seat 4: Hero collected ($0.12)
Seat 5: a4461af6 folded before Flop (didn't bet)
Seat 6: 1941fa92 folded before Flop (didn't bet)


Poker Hand #RC3334598295: Hold'em No Limit ($0.02/$0.05) - 2025/02/17 21:41:19
Table 'RushAndCash633555' 6-max Seat #1 is the button
Seat 1: fad81e68 ($8.31 in chips)
Seat 2: 15e6cce1 ($5 in chips)
Seat 3: 3a46e390 ($6.39 in chips)
Seat 4: Hero ($8.45 in chips)
Seat 5: 10cdb6a1 ($5.05 in chips)
Seat 6: fd236f26 ($5.79 in chips)
15e6cce1: posts small blind $0.02
3a46e390: posts big blind $0.05
*** HOLE CARDS ***
Dealt to fad81e68 
Dealt to 15e6cce1 
Dealt to 3a46e390 
Dealt to Hero [Kc Js]
Dealt to 10cdb6a1 
Dealt to fd236f26 
Hero: folds
10cdb6a1: folds
fd236f26: raises $0.05 to $0.1
fad81e68: folds
15e6cce1: folds
3a46e390: folds
Uncalled bet ($0.05) returned to fd236f26
*** SHOWDOWN ***
fd236f26 collected $0.12 from pot
*** SUMMARY ***
Total pot $0.12 | Rake $0 | Jackpot $0 | Bingo $0 | Fortune $0 | Tax $0
Seat 1: fad81e68 (button) folded before Flop (didn't bet)
Seat 2: 15e6cce1 (small blind) folded before Flop
Seat 3: 3a46e390 (big blind) folded before Flop
Seat 4: Hero folded before Flop (didn't bet)
Seat 5: 10cdb6a1 folded before Flop (didn't bet)
Seat 6: fd236f26 collected ($0.12)


Poker Hand #RC3334598263: Hold'em No Limit ($0.02/$0.05) - 2025/02/17 21:41:16
Table 'RushAndCash633523' 6-max Seat #1 is the button
Seat 1: 35fb946f ($8.83 in chips)
Seat 2: cd875a3c ($6.59 in chips)
Seat 3: a39b5beb ($5.05 in chips)
Seat 4: Hero ($8.45 in chips)
Seat 5: c00cefa1 ($5.3 in chips)
Seat 6: f0600331 ($8.23 in chips)
cd875a3c: posts small blind $0.02
a39b5beb: posts big blind $0.05
*** HOLE CARDS ***
Dealt to 35fb946f 
Dealt to cd875a3c 
Dealt to a39b5beb 
Dealt to Hero [3s 4s]
Dealt to c00cefa1 
Dealt to f0600331 
Hero: folds
c00cefa1: folds
f0600331: folds
35fb946f: folds
cd875a3c: folds
Uncalled bet ($0.03) returned to a39b5beb
*** SHOWDOWN ***
a39b5beb collected $0.04 from pot
*** SUMMARY ***
Total pot $0.04 | Rake $0 | Jackpot $0 | Bingo $0 | Fortune $0 | Tax $0
Seat 1: 35fb946f (button) folded before Flop (didn't bet)
Seat 2: cd875a3c (small blind) folded before Flop
Seat 3: a39b5beb (big blind) collected ($0.04)
Seat 4: Hero folded before Flop (didn't bet)
Seat 5: c00cefa1 folded before Flop (didn't bet)
Seat 6: f0600331 folded before Flop (didn't bet)


Poker Hand #RC3334598230: Hold'em No Limit ($0.02/$0.05) - 2025/02/17 21:41:12
Table 'RushAndCash633490' 6-max Seat #1 is the button
Seat 1: 702c0f17 ($4.55 in chips)
Seat 2: Hero ($8.47 in chips)
Seat 3: b59fc0b9 ($5.21 in chips)
Seat 4: 9c00bca7 ($5.21 in chips)
Seat 5: 4c265d8a ($5.48 in chips)
Seat 6: a19fb924 ($7.42 in chips)
Hero: posts small blind $0.02
b59fc0b9: posts big blind $0.05
*** HOLE CARDS ***
Dealt to 702c0f17 
Dealt to Hero [Ts 9d]
Dealt to b59fc0b9 
Dealt to 9c00bca7 
Dealt to 4c265d8a 
Dealt to a19fb924 
9c00bca7: folds
4c265d8a: raises $0.06 to $0.11
a19fb924: folds
702c0f17: folds
Hero: folds
b59fc0b9: folds
Uncalled bet ($0.06) returned to 4c265d8a
*** SHOWDOWN ***
4c265d8a collected $0.12 from pot
*** SUMMARY ***
Total pot $0.12 | Rake $0 | Jackpot $0 | Bingo $0 | Fortune $0 | Tax $0
Seat 1: 702c0f17 (button) folded before Flop (didn't bet)
Seat 2: Hero (small blind) folded before Flop
Seat 3: b59fc0b9 (big blind) folded before Flop
Seat 4: 9c00bca7 folded before Flop (didn't bet)
Seat 5: 4c265d8a collected ($0.12)
Seat 6: a19fb924 folded before Flop (didn't bet)


Poker Hand #RC3334597963: Hold'em No Limit ($0.02/$0.05) - 2025/02/17 21:40:43
Table 'RushAndCash633223' 6-max Seat #1 is the button
Seat 1: 2fe6d4e9 ($5 in chips)
Seat 2: f0600331 ($8.32 in chips)
Seat 3: Hero ($8.57 in chips)
Seat 4: b59fc0b9 ($5.1 in chips)
Seat 5: 33caafa3 ($5.02 in chips)
Seat 6: 62156df3 ($7.71 in chips)
f0600331: posts small blind $0.02
Hero: posts big blind $0.05
*** HOLE CARDS ***
Dealt to 2fe6d4e9 
Dealt to f0600331 
Dealt to Hero [3d 3h]
Dealt to b59fc0b9 
Dealt to 33caafa3 
Dealt to 62156df3 
b59fc0b9: raises $0.05 to $0.1
33caafa3: folds
62156df3: folds
2fe6d4e9: folds
f0600331: folds
Hero: calls $0.05
*** FLOP *** [7s Th 4d]
Hero: checks
b59fc0b9: bets $0.07
Hero: folds
Uncalled bet ($0.07) returned to b59fc0b9
*** SHOWDOWN ***
b59fc0b9 collected $0.21 from pot
*** SUMMARY ***
Total pot $0.22 | Rake $0.01 | Jackpot $0 | Bingo $0 | Fortune $0 | Tax $0
Board [7s Th 4d]
Seat 1: 2fe6d4e9 (button) folded before Flop (didn't bet)
Seat 2: f0600331 (small blind) folded before Flop
Seat 3: Hero (big blind) folded on the Flop
Seat 4: b59fc0b9 won ($0.21)
Seat 5: 33caafa3 folded before Flop (didn't bet)
Seat 6: 62156df3 folded before Flop (didn't bet)


Poker Hand #RC3334597544: Hold'em No Limit ($0.02/$0.05) - 2025/02/17 21:39:55
Table 'RushAndCash632804' 6-max Seat #1 is the button
Seat 1: 493e7626 ($10.05 in chips)
Seat 2: 87395f7a ($5.07 in chips)
Seat 3: 2642904 ($5.28 in chips)
Seat 4: b59fc0b9 ($5.29 in chips)
Seat 5: Hero ($8.33 in chips)
Seat 6: c723772e ($10.95 in chips)
87395f7a: posts small blind $0.02
2642904: posts big blind $0.05
*** HOLE CARDS ***
Dealt to 493e7626 
Dealt to 87395f7a 
Dealt to 2642904 
Dealt to b59fc0b9 
Dealt to Hero [9h 8h]
Dealt to c723772e 
b59fc0b9: raises $0.05 to $0.1
Hero: calls $0.1
c723772e: folds
493e7626: folds
87395f7a: folds
2642904: folds
*** FLOP *** [2s Kh 8c]
b59fc0b9: bets $0.09
Hero: calls $0.09
*** TURN *** [2s Kh 8c] [5d]
b59fc0b9: checks
Hero: checks
*** RIVER *** [2s Kh 8c 5d] [8s]
b59fc0b9: checks
Hero: bets $0.34
b59fc0b9: folds
Uncalled bet ($0.34) returned to Hero
*** SHOWDOWN ***
Hero collected $0.43 from pot
*** SUMMARY ***
Total pot $0.45 | Rake $0.02 | Jackpot $0 | Bingo $0 | Fortune $0 | Tax $0
Board [2s Kh 8c 5d 8s]
Seat 1: 493e7626 (button) folded before Flop (didn't bet)
Seat 2: 87395f7a (small blind) folded before Flop
Seat 3: 2642904 (big blind) folded before Flop
Seat 4: b59fc0b9 folded on the River
Seat 5: Hero won ($0.43)
Seat 6: c723772e folded before Flop (didn't bet)


Poker Hand #RC3334597516: Hold'em No Limit ($0.02/$0.05) - 2025/02/17 21:39:52
Table 'RushAndCash632776' 6-max Seat #1 is the button
Seat 1: 9c00bca7 ($5.39 in chips)
Seat 2: Hero ($8.35 in chips)
Seat 3: 411d6d13 ($5 in chips)
Seat 4: 3e6e7b99 ($5 in chips)
Seat 5: fa499268 ($8.52 in chips)
Seat 6: 4ec50768 ($5.2 in chips)
Hero: posts small blind $0.02
411d6d13: posts big blind $0.05
*** HOLE CARDS ***
Dealt to 9c00bca7 
Dealt to Hero [Qs 5h]
Dealt to 411d6d13 
Dealt to 3e6e7b99 
Dealt to fa499268 
Dealt to 4ec50768 
3e6e7b99: raises $0.06 to $0.11
fa499268: folds
4ec50768: folds
9c00bca7: calls $0.11
Hero: folds
411d6d13: folds
*** FLOP *** [7c 5s 5c]
3e6e7b99: checks
9c00bca7: checks
*** TURN *** [7c 5s 5c] [Tc]
3e6e7b99: checks
9c00bca7: checks
*** RIVER *** [7c 5s 5c Tc] [4h]
3e6e7b99: checks
9c00bca7: checks
3e6e7b99: shows [3d 3s] (Pair of Fives and Pair of Treys)
9c00bca7: shows [Jh Qd] (Pair of Fives)
*** SHOWDOWN ***
3e6e7b99 collected $0.28 from pot
*** SUMMARY ***
Total pot $0.29 | Rake $0.01 | Jackpot $0 | Bingo $0 | Fortune $0 | Tax $0
Board [7c 5s 5c Tc 4h]
Seat 1: 9c00bca7 (button) showed [Jh Qd] and lost with Pair of Fives
Seat 2: Hero (small blind) folded before Flop
Seat 3: 411d6d13 (big blind) folded before Flop
Seat 4: 3e6e7b99 showed [3d 3s] and won ($0.28) with Pair of Fives and Pair of Treys
Seat 5: fa499268 folded before Flop (didn't bet)
Seat 6: 4ec50768 folded before Flop (didn't bet)


Poker Hand #RC3334597486: Hold'em No Limit ($0.02/$0.05) - 2025/02/17 21:39:49
Table 'RushAndCash632746' 6-max Seat #1 is the button
Seat 1: 4c265d8a ($5 in chips)
Seat 2: 3ffd6491 ($9.84 in chips)
Seat 3: 4812f5c8 ($5 in chips)
Seat 4: Hero ($8.35 in chips)
Seat 5: 73a8db79 ($2.83 in chips)
Seat 6: ad31dea3 ($4.42 in chips)
3ffd6491: posts small blind $0.02
4812f5c8: posts big blind $0.05
*** HOLE CARDS ***
Dealt to 4c265d8a 
Dealt to 3ffd6491 
Dealt to 4812f5c8 
Dealt to Hero [Qh Jc]
Dealt to 73a8db79 
Dealt to ad31dea3 
Hero: folds
73a8db79: folds
ad31dea3: raises $0.05 to $0.1
4c265d8a: folds
3ffd6491: folds
4812f5c8: folds
Uncalled bet ($0.05) returned to ad31dea3
*** SHOWDOWN ***
ad31dea3 collected $0.12 from pot
*** SUMMARY ***
Total pot $0.12 | Rake $0 | Jackpot $0 | Bingo $0 | Fortune $0 | Tax $0
Seat 1: 4c265d8a (button) folded before Flop (didn't bet)
Seat 2: 3ffd6491 (small blind) folded before Flop
Seat 3: 4812f5c8 (big blind) folded before Flop
Seat 4: Hero folded before Flop (didn't bet)
Seat 5: 73a8db79 folded before Flop (didn't bet)
Seat 6: ad31dea3 collected ($0.12)


Poker Hand #RC3334597387: Hold'em No Limit ($0.02/$0.05) - 2025/02/17 21:39:36
Table 'RushAndCash632647' 6-max Seat #1 is the button
Seat 1: 9acb7e4c ($7.54 in chips)
Seat 2: Hero ($8.3 in chips)
Seat 3: 5ea9f27c ($3.75 in chips)
Seat 4: 8c6d38f2 ($5.07 in chips)
Seat 5: e5dc0403 ($5 in chips)
Seat 6: 167e28c4 ($9.26 in chips)
Hero: posts small blind $0.02
5ea9f27c: posts big blind $0.05
*** HOLE CARDS ***
Dealt to 9acb7e4c 
Dealt to Hero [Kh Js]
Dealt to 5ea9f27c 
Dealt to 8c6d38f2 
Dealt to e5dc0403 
Dealt to 167e28c4 
8c6d38f2: folds
e5dc0403: folds
167e28c4: folds
9acb7e4c: folds
Hero: calls $0.03
5ea9f27c: checks
*** FLOP *** [5h 8c 2c]
Hero: bets $0.05
5ea9f27c: folds
Uncalled bet ($0.05) returned to Hero
*** SHOWDOWN ***
Hero collected $0.1 from pot
*** SUMMARY ***
Total pot $0.1 | Rake $0 | Jackpot $0 | Bingo $0 | Fortune $0 | Tax $0
Board [5h 8c 2c]
Seat 1: 9acb7e4c (button) folded before Flop (didn't bet)
Seat 2: Hero (small blind) won ($0.1)
Seat 3: 5ea9f27c (big blind) folded on the Flop
Seat 4: 8c6d38f2 folded before Flop (didn't bet)
Seat 5: e5dc0403 folded before Flop (didn't bet)
Seat 6: 167e28c4 folded before Flop (didn't bet)


Poker Hand #RC3334597361: Hold'em No Limit ($0.02/$0.05) - 2025/02/17 21:39:33
Table 'RushAndCash632621' 6-max Seat #1 is the button
Seat 1: Hero ($8.3 in chips)
Seat 2: 4fa289e4 ($5.6 in chips)
Seat 3: 56b9b8a5 ($5.14 in chips)
Seat 4: 5ea9f27c ($3.75 in chips)
Seat 5: 87d5083b ($21.33 in chips)
Seat 6: fd5b33a8 ($7.56 in chips)
4fa289e4: posts small blind $0.02
56b9b8a5: posts big blind $0.05
*** HOLE CARDS ***
Dealt to Hero [8c 6d]
Dealt to 4fa289e4 
Dealt to 56b9b8a5 
Dealt to 5ea9f27c 
Dealt to 87d5083b 
Dealt to fd5b33a8 
5ea9f27c: folds
87d5083b: raises $0.05 to $0.1
fd5b33a8: calls $0.1
Hero: folds
4fa289e4: folds
56b9b8a5: folds
*** FLOP *** [Qh 4s Qd]
87d5083b: checks
fd5b33a8: checks
*** TURN *** [Qh 4s Qd] [2d]
87d5083b: bets $0.2
fd5b33a8: folds
Uncalled bet ($0.2) returned to 87d5083b
*** SHOWDOWN ***
87d5083b collected $0.26 from pot
*** SUMMARY ***
Total pot $0.27 | Rake $0.01 | Jackpot $0 | Bingo $0 | Fortune $0 | Tax $0
Board [Qh 4s Qd 2d]
Seat 1: Hero (button) folded before Flop (didn't bet)
Seat 2: 4fa289e4 (small blind) folded before Flop
Seat 3: 56b9b8a5 (big blind) folded before Flop
Seat 4: 5ea9f27c folded before Flop (didn't bet)
Seat 5: 87d5083b won ($0.26)
Seat 6: fd5b33a8 folded on the Turn


Poker Hand #RC3334597329: Hold'em No Limit ($0.02/$0.05) - 2025/02/17 21:39:29
Table 'RushAndCash632589' 6-max Seat #1 is the button
Seat 1: 65ca9276 ($9.88 in chips)
Seat 2: 46fb98 ($5.2 in chips)
Seat 3: a86de18f ($3.44 in chips)
Seat 4: 84d9e7d1 ($1.93 in chips)
Seat 5: f3ded747 ($5.28 in chips)
Seat 6: Hero ($8.3 in chips)
46fb98: posts small blind $0.02
a86de18f: posts big blind $0.05
*** HOLE CARDS ***
Dealt to 65ca9276 
Dealt to 46fb98 
Dealt to a86de18f 
Dealt to 84d9e7d1 
Dealt to f3ded747 
Dealt to Hero [8c 5h]
84d9e7d1: folds
f3ded747: folds
Hero: folds
65ca9276: folds
46fb98: raises $0.08 to $0.13
a86de18f: calls $0.08
*** FLOP *** [5d Tc Js]
46fb98: bets $0.12
a86de18f: calls $0.12
*** TURN *** [5d Tc Js] [2s]
46fb98: bets $0.28
a86de18f: calls $0.28
*** RIVER *** [5d Tc Js 2s] [Kc]
46fb98: checks
a86de18f: bets $0.8
46fb98: calls $0.8
a86de18f: shows [Ad 4c] (Ace-High)
46fb98: shows [Jd 2d] (Pair of Jacks and Pair of Twos)
*** SHOWDOWN ***
46fb98 collected $2.46 from pot
*** SUMMARY ***
Total pot $2.66 | Rake $0.13 | Jackpot $0.07 | Bingo $0 | Fortune $0 | Tax $0
Board [5d Tc Js 2s Kc]
Seat 1: 65ca9276 (button) folded before Flop (didn't bet)
Seat 2: 46fb98 (small blind) showed [Jd 2d] and won ($2.46) with Pair of Jacks and Pair of Twos
Seat 3: a86de18f (big blind) showed [Ad 4c] and lost with Ace-High
Seat 4: 84d9e7d1 folded before Flop (didn't bet)
Seat 5: f3ded747 folded before Flop (didn't bet)
Seat 6: Hero folded before Flop (didn't bet)


Poker Hand #RC3334597305: Hold'em No Limit ($0.02/$0.05) - 2025/02/17 21:39:26
Table 'RushAndCash632565' 6-max Seat #1 is the button
Seat 1: 5b79005a ($5.74 in chips)
Seat 2: Hero ($8.32 in chips)
Seat 3: 6c7828d3 ($5.37 in chips)
Seat 4: 656af102 ($7.14 in chips)
Seat 5: 87d5083b ($21.33 in chips)
Seat 6: 2fe6d4e9 ($5 in chips)
Hero: posts small blind $0.02
6c7828d3: posts big blind $0.05
*** HOLE CARDS ***
Dealt to 5b79005a 
Dealt to Hero [Js 7c]
Dealt to 6c7828d3 
Dealt to 656af102 
Dealt to 87d5083b 
Dealt to 2fe6d4e9 
656af102: folds
87d5083b: folds
2fe6d4e9: raises $0.07 to $0.12
5b79005a: folds
Hero: folds
6c7828d3: calls $0.07
*** FLOP *** [5s 2d 4s]
6c7828d3: checks
2fe6d4e9: checks
*** TURN *** [5s 2d 4s] [Td]
6c7828d3: bets $0.26
2fe6d4e9: folds
Uncalled bet ($0.26) returned to 6c7828d3
*** SHOWDOWN ***
6c7828d3 collected $0.25 from pot
*** SUMMARY ***
Total pot $0.26 | Rake $0.01 | Jackpot $0 | Bingo $0 | Fortune $0 | Tax $0
Board [5s 2d 4s Td]
Seat 1: 5b79005a (button) folded before Flop (didn't bet)
Seat 2: Hero (small blind) folded before Flop
Seat 3: 6c7828d3 (big blind) won ($0.25)
Seat 4: 656af102 folded before Flop (didn't bet)
Seat 5: 87d5083b folded before Flop (didn't bet)
Seat 6: 2fe6d4e9 folded on the Turn


Poker Hand #RC3334597261: Hold'em No Limit ($0.02/$0.05) - 2025/02/17 21:39:20
Table 'RushAndCash632521' 6-max Seat #1 is the button
Seat 1: ad31dea3 ($4.42 in chips)
Seat 2: ef96c0c8 ($6.92 in chips)
Seat 3: Hero ($8.37 in chips)
Seat 4: a95b1a3c ($5 in chips)
Seat 5: 9acb7e4c ($7.56 in chips)
Seat 6: 6ad786fd ($5.09 in chips)
ef96c0c8: posts small blind $0.02
Hero: posts big blind $0.05
*** HOLE CARDS ***
Dealt to ad31dea3 
Dealt to ef96c0c8 
Dealt to Hero [Tc 5s]
Dealt to a95b1a3c 
Dealt to 9acb7e4c 
Dealt to 6ad786fd 
a95b1a3c: raises $0.05 to $0.1
9acb7e4c: folds
6ad786fd: calls $0.1
ad31dea3: folds
ef96c0c8: folds
Hero: folds
*** FLOP *** [Qc Ah Jc]
a95b1a3c: bets $0.1
6ad786fd: raises $0.3 to $0.4
a95b1a3c: calls $0.3
*** TURN *** [Qc Ah Jc] [2h]
a95b1a3c: checks
6ad786fd: bets $1
a95b1a3c: calls $1
*** RIVER *** [Qc Ah Jc 2h] [9s]
a95b1a3c: checks
6ad786fd: bets $3.59 and is all-in
a95b1a3c: folds
Uncalled bet ($3.59) returned to 6ad786fd
*** SHOWDOWN ***
6ad786fd collected $2.85 from pot
*** SUMMARY ***
Total pot $3.07 | Rake $0.15 | Jackpot $0.07 | Bingo $0 | Fortune $0 | Tax $0
Board [Qc Ah Jc 2h 9s]
Seat 1: ad31dea3 (button) folded before Flop (didn't bet)
Seat 2: ef96c0c8 (small blind) folded before Flop
Seat 3: Hero (big blind) folded before Flop
Seat 4: a95b1a3c folded on the River
Seat 5: 9acb7e4c folded before Flop (didn't bet)
Seat 6: 6ad786fd won ($2.85)


Poker Hand #RC3334597233: Hold'em No Limit ($0.02/$0.05) - 2025/02/17 21:39:16
Table 'RushAndCash632493' 6-max Seat #1 is the button
Seat 1: Hero ($8.37 in chips)
Seat 2: 8ea92302 ($5.12 in chips)
Seat 3: 3e3946b0 ($5.26 in chips)
Seat 4: e0b522d5 ($5.22 in chips)
Seat 5: 5bf5cd50 ($5.17 in chips)
Seat 6: b0c3ff95 ($9.6 in chips)
8ea92302: posts small blind $0.02
3e3946b0: posts big blind $0.05
*** HOLE CARDS ***
Dealt to Hero [2d 2c]
Dealt to 8ea92302 
Dealt to 3e3946b0 
Dealt to e0b522d5 
Dealt to 5bf5cd50 
Dealt to b0c3ff95 
e0b522d5: raises $0.06 to $0.11
5bf5cd50: folds
b0c3ff95: raises $0.29 to $0.4
Hero: folds
8ea92302: folds
3e3946b0: folds
e0b522d5: folds
Uncalled bet ($0.29) returned to b0c3ff95
*** SHOWDOWN ***
b0c3ff95 collected $0.28 from pot
*** SUMMARY ***
Total pot $0.29 | Rake $0.01 | Jackpot $0 | Bingo $0 | Fortune $0 | Tax $0
Seat 1: Hero (button) folded before Flop (didn't bet)
Seat 2: 8ea92302 (small blind) folded before Flop
Seat 3: 3e3946b0 (big blind) folded before Flop
Seat 4: e0b522d5 folded before Flop
Seat 5: 5bf5cd50 folded before Flop (didn't bet)
Seat 6: b0c3ff95 collected ($0.28)


Poker Hand #RC3334597025: Hold'em No Limit ($0.02/$0.05) - 2025/02/17 21:38:54
Table 'RushAndCash632285' 6-max Seat #1 is the button
Seat 1: 5bf5cd50 ($5.27 in chips)
Seat 2: e4aeeb30 ($5 in chips)
Seat 3: Hero ($8.26 in chips)
Seat 4: 75d5d480 ($5.33 in chips)
Seat 5: 52f54c69 ($5.2 in chips)
Seat 6: a9d8ced4 ($5.95 in chips)
e4aeeb30: posts small blind $0.02
Hero: posts big blind $0.05
*** HOLE CARDS ***
Dealt to 5bf5cd50 
Dealt to e4aeeb30 
Dealt to Hero [Ad 9c]
Dealt to 75d5d480 
Dealt to 52f54c69 
Dealt to a9d8ced4 
75d5d480: folds
52f54c69: folds
a9d8ced4: folds
5bf5cd50: raises $0.05 to $0.1
e4aeeb30: folds
Hero: calls $0.05
*** FLOP *** [Tc Ac 2c]
Hero: checks
5bf5cd50: checks
*** TURN *** [Tc Ac 2c] [Jc]
Hero: bets $0.12
5bf5cd50: folds
Uncalled bet ($0.12) returned to Hero
*** SHOWDOWN ***
Hero collected $0.21 from pot
*** SUMMARY ***
Total pot $0.22 | Rake $0.01 | Jackpot $0 | Bingo $0 | Fortune $0 | Tax $0
Board [Tc Ac 2c Jc]
Seat 1: 5bf5cd50 (button) folded on the Turn
Seat 2: e4aeeb30 (small blind) folded before Flop
Seat 3: Hero (big blind) won ($0.21)
Seat 4: 75d5d480 folded before Flop (didn't bet)
Seat 5: 52f54c69 folded before Flop (didn't bet)
Seat 6: a9d8ced4 folded before Flop (didn't bet)


Poker Hand #RC3334596997: Hold'em No Limit ($0.02/$0.05) - 2025/02/17 21:38:51
Table 'RushAndCash632257' 6-max Seat #1 is the button
Seat 1: 3db4c32a ($5.92 in chips)
Seat 2: 486aa946 ($4.92 in chips)
Seat 3: 493727d2 ($11.2 in chips)
Seat 4: 1b6c31ec ($8.61 in chips)
Seat 5: Hero ($8.26 in chips)
Seat 6: 30d19f6e ($5.14 in chips)
486aa946: posts small blind $0.02
493727d2: posts big blind $0.05
*** HOLE CARDS ***
Dealt to 3db4c32a 
Dealt to 486aa946 
Dealt to 493727d2 
Dealt to 1b6c31ec 
Dealt to Hero [8d 5c]
Dealt to 30d19f6e 
1b6c31ec: raises $0.05 to $0.1
Hero: folds
30d19f6e: folds
3db4c32a: raises $0.19 to $0.29
486aa946: folds
493727d2: folds
1b6c31ec: raises $0.49 to $0.78
3db4c32a: calls $0.49
*** FLOP *** [Td Kd Qs]
1b6c31ec: checks
3db4c32a: checks
*** TURN *** [Td Kd Qs] [9h]
1b6c31ec: checks
3db4c32a: bets $0.95
1b6c31ec: raises $6.88 to $7.83 and is all-in
3db4c32a: folds
Uncalled bet ($6.88) returned to 1b6c31ec
*** SHOWDOWN ***
1b6c31ec collected $3.31 from pot
*** SUMMARY ***
Total pot $3.53 | Rake $0.15 | Jackpot $0.07 | Bingo $0 | Fortune $0 | Tax $0
Board [Td Kd Qs 9h]
Seat 1: 3db4c32a (button) folded on the Turn
Seat 2: 486aa946 (small blind) folded before Flop
Seat 3: 493727d2 (big blind) folded before Flop
Seat 4: 1b6c31ec won ($3.31)
Seat 5: Hero folded before Flop (didn't bet)
Seat 6: 30d19f6e folded before Flop (didn't bet)


Poker Hand #RC3334596971: Hold'em No Limit ($0.02/$0.05) - 2025/02/17 21:38:48
Table 'RushAndCash632231' 6-max Seat #1 is the button
Seat 1: 3e301744 ($11.7 in chips)
Seat 2: 802a8ffb ($9.03 in chips)
Seat 3: cbfc1dd3 ($6.27 in chips)
Seat 4: fec3d78d ($4.63 in chips)
Seat 5: Hero ($8.26 in chips)
Seat 6: 63d14fd2 ($3.19 in chips)
802a8ffb: posts small blind $0.02
cbfc1dd3: posts big blind $0.05
*** HOLE CARDS ***
Dealt to 3e301744 
Dealt to 802a8ffb 
Dealt to cbfc1dd3 
Dealt to fec3d78d 
Dealt to Hero [2s 9d]
Dealt to 63d14fd2 
fec3d78d: folds
Hero: folds
63d14fd2: raises $0.05 to $0.1
3e301744: calls $0.1
802a8ffb: folds
cbfc1dd3: raises $0.45 to $0.55
63d14fd2: folds
3e301744: calls $0.45
*** FLOP *** [Tc 5h 6h]
cbfc1dd3: checks
3e301744: checks
*** TURN *** [Tc 5h 6h] [4h]
cbfc1dd3: bets $0.75
3e301744: calls $0.75
*** RIVER *** [Tc 5h 6h 4h] [Ts]
cbfc1dd3: bets $2.45
3e301744: raises $7.95 to $10.4 and is all-in
cbfc1dd3: folds
Uncalled bet ($7.95) returned to 3e301744
*** SHOWDOWN ***
3e301744 collected $7.4 from pot
*** SUMMARY ***
Total pot $7.62 | Rake $0.15 | Jackpot $0.07 | Bingo $0 | Fortune $0 | Tax $0
Board [Tc 5h 6h 4h Ts]
Seat 1: 3e301744 (button) won ($7.4)
Seat 2: 802a8ffb (small blind) folded before Flop
Seat 3: cbfc1dd3 (big blind) folded on the River
Seat 4: fec3d78d folded before Flop (didn't bet)
Seat 5: Hero folded before Flop (didn't bet)
Seat 6: 63d14fd2 folded before Flop


Poker Hand #RC3334596924: Hold'em No Limit ($0.02/$0.05) - 2025/02/17 21:38:42
Table 'RushAndCash632184' 6-max Seat #1 is the button
Seat 1: a363f4b ($3.91 in chips)
Seat 2: 86fb354d ($10.02 in chips)
Seat 3: 5e166e9a ($10.23 in chips)
Seat 4: Hero ($8.26 in chips)
Seat 5: e8992002 ($17.37 in chips)
Seat 6: b4cd57cf ($6.1 in chips)
86fb354d: posts small blind $0.02
5e166e9a: posts big blind $0.05
*** HOLE CARDS ***
Dealt to a363f4b 
Dealt to 86fb354d 
Dealt to 5e166e9a 
Dealt to Hero [6s 7d]
Dealt to e8992002 
Dealt to b4cd57cf 
Hero: folds
e8992002: folds
b4cd57cf: folds
a363f4b: folds
86fb354d: raises $0.1 to $0.15
5e166e9a: calls $0.1
*** FLOP *** [5d 2h 4c]
86fb354d: checks
5e166e9a: bets $0.1
86fb354d: calls $0.1
*** TURN *** [5d 2h 4c] [Qd]
86fb354d: checks
5e166e9a: checks
*** RIVER *** [5d 2h 4c Qd] [3d]
86fb354d: bets $0.17
5e166e9a: calls $0.17
86fb354d: shows [Ah Jd] (Fives-High Straight)
5e166e9a: shows [7c 5c] (Pair of Fives)
*** SHOWDOWN ***
86fb354d collected $0.8 from pot
*** SUMMARY ***
Total pot $0.84 | Rake $0.04 | Jackpot $0 | Bingo $0 | Fortune $0 | Tax $0
Board [5d 2h 4c Qd 3d]
Seat 1: a363f4b (button) folded before Flop (didn't bet)
Seat 2: 86fb354d (small blind) showed [Ah Jd] and won ($0.8) with Fives-High Straight
Seat 3: 5e166e9a (big blind) showed [7c 5c] and lost with Pair of Fives
Seat 4: Hero folded before Flop (didn't bet)
Seat 5: e8992002 folded before Flop (didn't bet)
Seat 6: b4cd57cf folded before Flop (didn't bet)


Poker Hand #RC3334596895: Hold'em No Limit ($0.02/$0.05) - 2025/02/17 21:38:39
Table 'RushAndCash632155' 6-max Seat #1 is the button
Seat 1: 86fb354d ($10.02 in chips)
Seat 2: Hero ($8.28 in chips)
Seat 3: 6c1c4416 ($17.99 in chips)
Seat 4: 15141573 ($5.21 in chips)
Seat 5: d60e3ce5 ($6.13 in chips)
Seat 6: b9ae439d ($5.85 in chips)
Hero: posts small blind $0.02
6c1c4416: posts big blind $0.05
*** HOLE CARDS ***
Dealt to 86fb354d 
Dealt to Hero [6h 7s]
Dealt to 6c1c4416 
Dealt to 15141573 
Dealt to d60e3ce5 
Dealt to b9ae439d 
15141573: raises $0.07 to $0.12
d60e3ce5: folds
b9ae439d: folds
86fb354d: folds
Hero: folds
6c1c4416: calls $0.07
*** FLOP *** [6d 3h 5c]
6c1c4416: bets $0.13
15141573: folds
Uncalled bet ($0.13) returned to 6c1c4416
*** SHOWDOWN ***
6c1c4416 collected $0.25 from pot
*** SUMMARY ***
Total pot $0.26 | Rake $0.01 | Jackpot $0 | Bingo $0 | Fortune $0 | Tax $0
Board [6d 3h 5c]
Seat 1: 86fb354d (button) folded before Flop (didn't bet)
Seat 2: Hero (small blind) folded before Flop
Seat 3: 6c1c4416 (big blind) won ($0.25)
Seat 4: 15141573 folded on the Flop
Seat 5: d60e3ce5 folded before Flop (didn't bet)
Seat 6: b9ae439d folded before Flop (didn't bet)


Poker Hand #RC3334596866: Hold'em No Limit ($0.02/$0.05) - 2025/02/17 21:38:36
Table 'RushAndCash632126' 6-max Seat #1 is the button
Seat 1: 67aeeaf2 ($9.98 in chips)
Seat 2: 5741d28a ($7.51 in chips)
Seat 3: d04ecf ($6.34 in chips)
Seat 4: a8c71cd6 ($5.11 in chips)
Seat 5: 5b79005a ($5.81 in chips)
Seat 6: Hero ($8.28 in chips)
5741d28a: posts small blind $0.02
d04ecf: posts big blind $0.05
*** HOLE CARDS ***
Dealt to 67aeeaf2 
Dealt to 5741d28a 
Dealt to d04ecf 
Dealt to a8c71cd6 
Dealt to 5b79005a 
Dealt to Hero [Qs 2c]
a8c71cd6: folds
5b79005a: folds
Hero: folds
67aeeaf2: folds
5741d28a: raises $0.1 to $0.15
d04ecf: folds
Uncalled bet ($0.1) returned to 5741d28a
*** SHOWDOWN ***
5741d28a collected $0.1 from pot
*** SUMMARY ***
Total pot $0.1 | Rake $0 | Jackpot $0 | Bingo $0 | Fortune $0 | Tax $0
Seat 1: 67aeeaf2 (button) folded before Flop (didn't bet)
Seat 2: 5741d28a (small blind) collected ($0.1)
Seat 3: d04ecf (big blind) folded before Flop
Seat 4: a8c71cd6 folded before Flop (didn't bet)
Seat 5: 5b79005a folded before Flop (didn't bet)
Seat 6: Hero folded before Flop (didn't bet)


Poker Hand #RC3334596837: Hold'em No Limit ($0.02/$0.05) - 2025/02/17 21:38:32
Table 'RushAndCash632097' 6-max Seat #1 is the button
Seat 1: de38466f ($4.44 in chips)
Seat 2: aaa792dc ($8.41 in chips)
Seat 3: Hero ($8.33 in chips)
Seat 4: 860b5247 ($10.88 in chips)
Seat 5: 22643080 ($8.09 in chips)
Seat 6: 67aeeaf2 ($9.98 in chips)
aaa792dc: posts small blind $0.02
Hero: posts big blind $0.05
*** HOLE CARDS ***
Dealt to de38466f 
Dealt to aaa792dc 
Dealt to Hero [Js 7c]
Dealt to 860b5247 
Dealt to 22643080 
Dealt to 67aeeaf2 
860b5247: folds
22643080: raises $0.08 to $0.13
67aeeaf2: folds
de38466f: folds
aaa792dc: folds
Hero: folds
Uncalled bet ($0.08) returned to 22643080
*** SHOWDOWN ***
22643080 collected $0.12 from pot
*** SUMMARY ***
Total pot $0.12 | Rake $0 | Jackpot $0 | Bingo $0 | Fortune $0 | Tax $0
Seat 1: de38466f (button) folded before Flop (didn't bet)
Seat 2: aaa792dc (small blind) folded before Flop
Seat 3: Hero (big blind) folded before Flop
Seat 4: 860b5247 folded before Flop (didn't bet)
Seat 5: 22643080 collected ($0.12)
Seat 6: 67aeeaf2 folded before Flop (didn't bet)


Poker Hand #RC3334596809: Hold'em No Limit ($0.02/$0.05) - 2025/02/17 21:38:29
Table 'RushAndCash632069' 6-max Seat #1 is the button
Seat 1: Hero ($8.33 in chips)
Seat 2: 2e24bede ($5.27 in chips)
Seat 3: 207d9345 ($21.46 in chips)
Seat 4: c3883bcf ($6.2 in chips)
Seat 5: a19fb924 ($8.47 in chips)
Seat 6: 9e226e3b ($5 in chips)
2e24bede: posts small blind $0.02
207d9345: posts big blind $0.05
*** HOLE CARDS ***
Dealt to Hero [4s 8s]
Dealt to 2e24bede 
Dealt to 207d9345 
Dealt to c3883bcf 
Dealt to a19fb924 
Dealt to 9e226e3b 
c3883bcf: raises $0.05 to $0.1
a19fb924: folds
9e226e3b: folds
Hero: folds
2e24bede: folds
207d9345: calls $0.05
*** FLOP *** [Jc Ad Td]
207d9345: checks
c3883bcf: bets $0.08
207d9345: calls $0.08
*** TURN *** [Jc Ad Td] [7d]
207d9345: checks
c3883bcf: bets $0.29
207d9345: calls $0.29
*** RIVER *** [Jc Ad Td 7d] [6d]
207d9345: checks
c3883bcf: bets $2.5
207d9345: folds
Uncalled bet ($2.5) returned to c3883bcf
*** SHOWDOWN ***
c3883bcf collected $0.92 from pot
*** SUMMARY ***
Total pot $0.96 | Rake $0.04 | Jackpot $0 | Bingo $0 | Fortune $0 | Tax $0
Board [Jc Ad Td 7d 6d]
Seat 1: Hero (button) folded before Flop (didn't bet)
Seat 2: 2e24bede (small blind) folded before Flop
Seat 3: 207d9345 (big blind) folded on the River
Seat 4: c3883bcf won ($0.92)
Seat 5: a19fb924 folded before Flop (didn't bet)
Seat 6: 9e226e3b folded before Flop (didn't bet)


Poker Hand #RC3334596778: Hold'em No Limit ($0.02/$0.05) - 2025/02/17 21:38:26
Table 'RushAndCash632038' 6-max Seat #1 is the button
Seat 1: Hero ($8.33 in chips)
Seat 2: cc8de981 ($9.24 in chips)
Seat 3: f1fc05db ($5.65 in chips)
Seat 4: 419eb9fb ($6 in chips)
Seat 5: 493e7626 ($10.03 in chips)
Seat 6: e183d966 ($6.51 in chips)
cc8de981: posts small blind $0.02
f1fc05db: posts big blind $0.05
*** HOLE CARDS ***
Dealt to Hero [3c 4c]
Dealt to cc8de981 
Dealt to f1fc05db 
Dealt to 419eb9fb 
Dealt to 493e7626 
Dealt to e183d966 
419eb9fb: raises $0.1 to $0.15
493e7626: folds
e183d966: folds
Hero: folds
cc8de981: folds
f1fc05db: raises $0.24 to $0.39
419eb9fb: calls $0.24
*** FLOP *** [Kc 3h 9d]
f1fc05db: bets $0.27
419eb9fb: calls $0.27
*** TURN *** [Kc 3h 9d] [Ad]
f1fc05db: checks
419eb9fb: checks
*** RIVER *** [Kc 3h 9d Ad] [4d]
f1fc05db: bets $1.01
419eb9fb: raises $4.33 to $5.34 and is all-in
f1fc05db: calls $3.98 and is all-in
Uncalled bet ($0.35) returned to 419eb9fb
419eb9fb: shows [2c 5c] (Fives-High Straight)
f1fc05db: shows [Th Ks] (Pair of Kings)
*** SHOWDOWN ***
419eb9fb collected $11.1 from pot
*** SUMMARY ***
Total pot $11.32 | Rake $0.15 | Jackpot $0.07 | Bingo $0 | Fortune $0 | Tax $0
Board [Kc 3h 9d Ad 4d]
Seat 1: Hero (button) folded before Flop (didn't bet)
Seat 2: cc8de981 (small blind) folded before Flop
Seat 3: f1fc05db (big blind) showed [Th Ks] and lost with Pair of Kings
Seat 4: 419eb9fb showed [2c 5c] and won ($11.1) with Fives-High Straight
Seat 5: 493e7626 folded before Flop (didn't bet)
Seat 6: e183d966 folded before Flop (didn't bet)


Poker Hand #RC3334596751: Hold'em No Limit ($0.02/$0.05) - 2025/02/17 21:38:22
Table 'RushAndCash632011' 6-max Seat #1 is the button
Seat 1: 6c7828d3 ($5.12 in chips)
Seat 2: Hero ($8.35 in chips)
Seat 3: 9f9e1094 ($6.03 in chips)
Seat 4: 2e24bede ($5.32 in chips)
Seat 5: 81b0c107 ($6.71 in chips)
Seat 6: 65ca9276 ($8.79 in chips)
Hero: posts small blind $0.02
9f9e1094: posts big blind $0.05
*** HOLE CARDS ***
Dealt to 6c7828d3 
Dealt to Hero [5d 6h]
Dealt to 9f9e1094 
Dealt to 2e24bede 
Dealt to 81b0c107 
Dealt to 65ca9276 
2e24bede: folds
81b0c107: folds
65ca9276: folds
6c7828d3: raises $0.06 to $0.11
Hero: folds
9f9e1094: folds
Uncalled bet ($0.06) returned to 6c7828d3
*** SHOWDOWN ***
6c7828d3 collected $0.12 from pot
*** SUMMARY ***
Total pot $0.12 | Rake $0 | Jackpot $0 | Bingo $0 | Fortune $0 | Tax $0
Seat 1: 6c7828d3 (button) collected ($0.12)
Seat 2: Hero (small blind) folded before Flop
Seat 3: 9f9e1094 (big blind) folded before Flop
Seat 4: 2e24bede folded before Flop (didn't bet)
Seat 5: 81b0c107 folded before Flop (didn't bet)
Seat 6: 65ca9276 folded before Flop (didn't bet)


Poker Hand #RC3334596709: Hold'em No Limit ($0.02/$0.05) - 2025/02/17 21:38:17
Table 'RushAndCash631969' 6-max Seat #1 is the button
Seat 1: 56b9b8a5 ($5.02 in chips)
Seat 2: a58470c1 ($4.85 in chips)
Seat 3: 3f6d99d0 ($4.58 in chips)
Seat 4: 6b09dc81 ($4.91 in chips)
Seat 5: bcb971d3 ($5.75 in chips)
Seat 6: Hero ($8.35 in chips)
a58470c1: posts small blind $0.02
3f6d99d0: posts big blind $0.05
*** HOLE CARDS ***
Dealt to 56b9b8a5 
Dealt to a58470c1 
Dealt to 3f6d99d0 
Dealt to 6b09dc81 
Dealt to bcb971d3 
Dealt to Hero [2d 3s]
6b09dc81: raises $0.05 to $0.1
bcb971d3: folds
Hero: folds
56b9b8a5: folds
a58470c1: raises $0.35 to $0.45
3f6d99d0: folds
6b09dc81: folds
Uncalled bet ($0.35) returned to a58470c1
*** SHOWDOWN ***
a58470c1 collected $0.24 from pot
*** SUMMARY ***
Total pot $0.25 | Rake $0.01 | Jackpot $0 | Bingo $0 | Fortune $0 | Tax $0
Seat 1: 56b9b8a5 (button) folded before Flop (didn't bet)
Seat 2: a58470c1 (small blind) collected ($0.24)
Seat 3: 3f6d99d0 (big blind) folded before Flop
Seat 4: 6b09dc81 folded before Flop
Seat 5: bcb971d3 folded before Flop (didn't bet)
Seat 6: Hero folded before Flop (didn't bet)


Poker Hand #RC3334596682: Hold'em No Limit ($0.02/$0.05) - 2025/02/17 21:38:14
Table 'RushAndCash631942' 6-max Seat #1 is the button
Seat 1: Hero ($8.35 in chips)
Seat 2: c62b7a0b ($22.25 in chips)
Seat 3: a9d8ced4 ($6.15 in chips)
Seat 4: 742ccfee ($1.75 in chips)
Seat 5: d04ecf ($6.34 in chips)
Seat 6: 3f6d99d0 ($4.58 in chips)
c62b7a0b: posts small blind $0.02
a9d8ced4: posts big blind $0.05
*** HOLE CARDS ***
Dealt to Hero [Jc 5d]
Dealt to c62b7a0b 
Dealt to a9d8ced4 
Dealt to 742ccfee 
Dealt to d04ecf 
Dealt to 3f6d99d0 
742ccfee: raises $0.05 to $0.1
d04ecf: folds
3f6d99d0: folds
Hero: folds
c62b7a0b: folds
a9d8ced4: calls $0.05
*** FLOP *** [6s As Qd]
a9d8ced4: checks
742ccfee: bets $0.22
a9d8ced4: folds
Uncalled bet ($0.22) returned to 742ccfee
*** SHOWDOWN ***
742ccfee collected $0.21 from pot
*** SUMMARY ***
Total pot $0.22 | Rake $0.01 | Jackpot $0 | Bingo $0 | Fortune $0 | Tax $0
Board [6s As Qd]
Seat 1: Hero (button) folded before Flop (didn't bet)
Seat 2: c62b7a0b (small blind) folded before Flop
Seat 3: a9d8ced4 (big blind) folded on the Flop
Seat 4: 742ccfee won ($0.21)
Seat 5: d04ecf folded before Flop (didn't bet)
Seat 6: 3f6d99d0 folded before Flop (didn't bet)


Poker Hand #RC3334596646: Hold'em No Limit ($0.02/$0.05) - 2025/02/17 21:38:09
Table 'RushAndCash631906' 6-max Seat #1 is the button
Seat 1: 5daef2fa ($6.04 in chips)
Seat 2: 4ec50768 ($5.6 in chips)
Seat 3: e3c32f29 ($5.55 in chips)
Seat 4: Hero ($8.35 in chips)
Seat 5: 545ae247 ($7.06 in chips)
Seat 6: 47d6aff8 ($5.53 in chips)
4ec50768: posts small blind $0.02
e3c32f29: posts big blind $0.05
*** HOLE CARDS ***
Dealt to 5daef2fa 
Dealt to 4ec50768 
Dealt to e3c32f29 
Dealt to Hero [Kd 3s]
Dealt to 545ae247 
Dealt to 47d6aff8 
Hero: folds
545ae247: folds
47d6aff8: folds
5daef2fa: raises $0.07 to $0.12
4ec50768: folds
e3c32f29: raises $0.38 to $0.5
5daef2fa: folds
Uncalled bet ($0.38) returned to e3c32f29
*** SHOWDOWN ***
e3c32f29 collected $0.25 from pot
*** SUMMARY ***
Total pot $0.26 | Rake $0.01 | Jackpot $0 | Bingo $0 | Fortune $0 | Tax $0
Seat 1: 5daef2fa (button) folded before Flop
Seat 2: 4ec50768 (small blind) folded before Flop
Seat 3: e3c32f29 (big blind) collected ($0.25)
Seat 4: Hero folded before Flop (didn't bet)
Seat 5: 545ae247 folded before Flop (didn't bet)
Seat 6: 47d6aff8 folded before Flop (didn't bet)


Poker Hand #RC3334596488: Hold'em No Limit ($0.02/$0.05) - 2025/02/17 21:37:50
Table 'RushAndCash631748' 6-max Seat #1 is the button
Seat 1: 7eb5dbb3 ($12.15 in chips)
Seat 2: 5daef2fa ($5.9 in chips)
Seat 3: c83a952b ($5.7 in chips)
Seat 4: Hero ($8.45 in chips)
Seat 5: 6ac4af54 ($12.68 in chips)
Seat 6: b66c51bb ($5.32 in chips)
5daef2fa: posts small blind $0.02
c83a952b: posts big blind $0.05
*** HOLE CARDS ***
Dealt to 7eb5dbb3 
Dealt to 5daef2fa 
Dealt to c83a952b 
Dealt to Hero [Kd Jh]
Dealt to 6ac4af54 
Dealt to b66c51bb 
Hero: raises $0.05 to $0.1
6ac4af54: folds
b66c51bb: folds
7eb5dbb3: folds
5daef2fa: raises $0.4 to $0.5
c83a952b: folds
Hero: folds
Uncalled bet ($0.4) returned to 5daef2fa
*** SHOWDOWN ***
5daef2fa collected $0.24 from pot
*** SUMMARY ***
Total pot $0.25 | Rake $0.01 | Jackpot $0 | Bingo $0 | Fortune $0 | Tax $0
Seat 1: 7eb5dbb3 (button) folded before Flop (didn't bet)
Seat 2: 5daef2fa (small blind) collected ($0.24)
Seat 3: c83a952b (big blind) folded before Flop
Seat 4: Hero folded before Flop
Seat 5: 6ac4af54 folded before Flop (didn't bet)
Seat 6: b66c51bb folded before Flop (didn't bet)


Poker Hand #RC3334596453: Hold'em No Limit ($0.02/$0.05) - 2025/02/17 21:37:46
Table 'RushAndCash631713' 6-max Seat #1 is the button
Seat 1: 4b8a11ed ($5 in chips)
Seat 2: 826a79b4 ($7.02 in chips)
Seat 3: 55e0d4fe ($7.91 in chips)
Seat 4: 75a97e80 ($5.21 in chips)
Seat 5: Hero ($8.45 in chips)
Seat 6: bacb67c8 ($9.72 in chips)
826a79b4: posts small blind $0.02
55e0d4fe: posts big blind $0.05
*** HOLE CARDS ***
Dealt to 4b8a11ed 
Dealt to 826a79b4 
Dealt to 55e0d4fe 
Dealt to 75a97e80 
Dealt to Hero [2h 3d]
Dealt to bacb67c8 
75a97e80: folds
Hero: folds
bacb67c8: folds
4b8a11ed: folds
826a79b4: folds
Uncalled bet ($0.03) returned to 55e0d4fe
*** SHOWDOWN ***
55e0d4fe collected $0.04 from pot
*** SUMMARY ***
Total pot $0.04 | Rake $0 | Jackpot $0 | Bingo $0 | Fortune $0 | Tax $0
Seat 1: 4b8a11ed (button) folded before Flop (didn't bet)
Seat 2: 826a79b4 (small blind) folded before Flop
Seat 3: 55e0d4fe (big blind) collected ($0.04)
Seat 4: 75a97e80 folded before Flop (didn't bet)
Seat 5: Hero folded before Flop (didn't bet)
Seat 6: bacb67c8 folded before Flop (didn't bet)


Poker Hand #RC3334596423: Hold'em No Limit ($0.02/$0.05) - 2025/02/17 21:37:43
Table 'RushAndCash631683' 6-max Seat #1 is the button
Seat 1: 4c7728b5 ($5.2 in chips)
Seat 2: Hero ($8.47 in chips)
Seat 3: 9604af2 ($6.64 in chips)
Seat 4: dc99401b ($5.07 in chips)
Seat 5: b70bdf37 ($5.22 in chips)
Seat 6: d037279c ($7 in chips)
Hero: posts small blind $0.02
9604af2: posts big blind $0.05
*** HOLE CARDS ***
Dealt to 4c7728b5 
Dealt to Hero [6s Js]
Dealt to 9604af2 
Dealt to dc99401b 
Dealt to b70bdf37 
Dealt to d037279c 
dc99401b: folds
b70bdf37: folds
d037279c: folds
4c7728b5: raises $0.08 to $0.13
Hero: folds
9604af2: raises $0.37 to $0.5
4c7728b5: calls $0.37
*** FLOP *** [Ts 5h Jd]
9604af2: bets $0.51
4c7728b5: calls $0.51
*** TURN *** [Ts 5h Jd] [8s]
9604af2: bets $1.02
4c7728b5: calls $1.02
*** RIVER *** [Ts 5h Jd 8s] [3s]
9604af2: bets $4.61 and is all-in
4c7728b5: folds
Uncalled bet ($4.61) returned to 9604af2
*** SHOWDOWN ***
9604af2 collected $3.86 from pot
*** SUMMARY ***
Total pot $4.08 | Rake $0.15 | Jackpot $0.07 | Bingo $0 | Fortune $0 | Tax $0
Board [Ts 5h Jd 8s 3s]
Seat 1: 4c7728b5 (button) folded on the River
Seat 2: Hero (small blind) folded before Flop
Seat 3: 9604af2 (big blind) won ($3.86)
Seat 4: dc99401b folded before Flop (didn't bet)
Seat 5: b70bdf37 folded before Flop (didn't bet)
Seat 6: d037279c folded before Flop (didn't bet)


Poker Hand #RC3334596239: Hold'em No Limit ($0.02/$0.05) - 2025/02/17 21:37:21
Table 'RushAndCash631499' 6-max Seat #1 is the button
Seat 1: 3d2a56c8 ($10.69 in chips)
Seat 2: d737deb4 ($10.22 in chips)
Seat 3: Hero ($8.59 in chips)
Seat 4: b8c09f2 ($6.51 in chips)
Seat 5: a9bca211 ($5.22 in chips)
Seat 6: 4262311b ($8.47 in chips)
d737deb4: posts small blind $0.02
Hero: posts big blind $0.05
*** HOLE CARDS ***
Dealt to 3d2a56c8 
Dealt to d737deb4 
Dealt to Hero [9c 6c]
Dealt to b8c09f2 
Dealt to a9bca211 
Dealt to 4262311b 
b8c09f2: folds
a9bca211: folds
4262311b: folds
3d2a56c8: raises $0.07 to $0.12
d737deb4: folds
Hero: calls $0.07
*** FLOP *** [As 3d Ah]
Hero: checks
3d2a56c8: bets $0.08
Hero: folds
Uncalled bet ($0.08) returned to 3d2a56c8
*** SHOWDOWN ***
3d2a56c8 collected $0.25 from pot
*** SUMMARY ***
Total pot $0.26 | Rake $0.01 | Jackpot $0 | Bingo $0 | Fortune $0 | Tax $0
Board [As 3d Ah]
Seat 1: 3d2a56c8 (button) won ($0.25)
Seat 2: d737deb4 (small blind) folded before Flop
Seat 3: Hero (big blind) folded on the Flop
Seat 4: b8c09f2 folded before Flop (didn't bet)
Seat 5: a9bca211 folded before Flop (didn't bet)
Seat 6: 4262311b folded before Flop (didn't bet)


Poker Hand #RC3334596205: Hold'em No Limit ($0.02/$0.05) - 2025/02/17 21:37:16
Table 'RushAndCash631465' 6-max Seat #1 is the button
Seat 1: e0b522d5 ($5.19 in chips)
Seat 2: b02447b8 ($5.22 in chips)
Seat 3: 2aa9c26c ($5.52 in chips)
Seat 4: 46fb98 ($5.28 in chips)
Seat 5: Hero ($8.59 in chips)
Seat 6: 577bd292 ($5.86 in chips)
b02447b8: posts small blind $0.02
2aa9c26c: posts big blind $0.05
*** HOLE CARDS ***
Dealt to e0b522d5 
Dealt to b02447b8 
Dealt to 2aa9c26c 
Dealt to 46fb98 
Dealt to Hero [2s 5h]
Dealt to 577bd292 
46fb98: raises $0.05 to $0.1
Hero: folds
577bd292: raises $0.32 to $0.42
e0b522d5: folds
b02447b8: folds
2aa9c26c: folds
46fb98: folds
Uncalled bet ($0.32) returned to 577bd292
*** SHOWDOWN ***
577bd292 collected $0.26 from pot
*** SUMMARY ***
Total pot $0.27 | Rake $0.01 | Jackpot $0 | Bingo $0 | Fortune $0 | Tax $0
Seat 1: e0b522d5 (button) folded before Flop (didn't bet)
Seat 2: b02447b8 (small blind) folded before Flop
Seat 3: 2aa9c26c (big blind) folded before Flop
Seat 4: 46fb98 folded before Flop
Seat 5: Hero folded before Flop (didn't bet)
Seat 6: 577bd292 collected ($0.26)


Poker Hand #RC3334596166: Hold'em No Limit ($0.02/$0.05) - 2025/02/17 21:37:12
Table 'RushAndCash631426' 6-max Seat #1 is the button
Seat 1: 3ae3072b ($5.45 in chips)
Seat 2: cd69b3e5 ($7.99 in chips)
Seat 3: c00cefa1 ($5 in chips)
Seat 4: Hero ($8.59 in chips)
Seat 5: f0a8dabb ($4.99 in chips)
Seat 6: af7760fa ($7.7 in chips)
cd69b3e5: posts small blind $0.02
c00cefa1: posts big blind $0.05
*** HOLE CARDS ***
Dealt to 3ae3072b 
Dealt to cd69b3e5 
Dealt to c00cefa1 
Dealt to Hero [7h 4d]
Dealt to f0a8dabb 
Dealt to af7760fa 
Hero: folds
f0a8dabb: folds
af7760fa: folds
3ae3072b: raises $0.1 to $0.15
cd69b3e5: folds
c00cefa1: calls $0.1
*** FLOP *** [2d Kd Jd]
c00cefa1: checks
3ae3072b: checks
*** TURN *** [2d Kd Jd] [3h]
c00cefa1: bets $0.11
3ae3072b: calls $0.11
*** RIVER *** [2d Kd Jd 3h] [7c]
c00cefa1: bets $0.18
3ae3072b: folds
Uncalled bet ($0.18) returned to c00cefa1
*** SHOWDOWN ***
c00cefa1 collected $0.52 from pot
*** SUMMARY ***
Total pot $0.54 | Rake $0.02 | Jackpot $0 | Bingo $0 | Fortune $0 | Tax $0
Board [2d Kd Jd 3h 7c]
Seat 1: 3ae3072b (button) folded on the River
Seat 2: cd69b3e5 (small blind) folded before Flop
Seat 3: c00cefa1 (big blind) won ($0.52)
Seat 4: Hero folded before Flop (didn't bet)
Seat 5: f0a8dabb folded before Flop (didn't bet)
Seat 6: af7760fa folded before Flop (didn't bet)


Poker Hand #RC3334596141: Hold'em No Limit ($0.02/$0.05) - 2025/02/17 21:37:08
Table 'RushAndCash631401' 6-max Seat #1 is the button
Seat 1: c35cd20e ($5.67 in chips)
Seat 2: 30d19f6e ($5 in chips)
Seat 3: 56b9b8a5 ($5 in chips)
Seat 4: 7d310fdd ($5.69 in chips)
Seat 5: 52f43d28 ($9.1 in chips)
Seat 6: Hero ($8.59 in chips)
30d19f6e: posts small blind $0.02
56b9b8a5: posts big blind $0.05
*** HOLE CARDS ***
Dealt to c35cd20e 
Dealt to 30d19f6e 
Dealt to 56b9b8a5 
Dealt to 7d310fdd 
Dealt to 52f43d28 
Dealt to Hero [4s 8s]
7d310fdd: raises $0.06 to $0.11
52f43d28: folds
Hero: folds
c35cd20e: folds
30d19f6e: folds
56b9b8a5: folds
Uncalled bet ($0.06) returned to 7d310fdd
*** SHOWDOWN ***
7d310fdd collected $0.12 from pot
*** SUMMARY ***
Total pot $0.12 | Rake $0 | Jackpot $0 | Bingo $0 | Fortune $0 | Tax $0
Seat 1: c35cd20e (button) folded before Flop (didn't bet)
Seat 2: 30d19f6e (small blind) folded before Flop
Seat 3: 56b9b8a5 (big blind) folded before Flop
Seat 4: 7d310fdd collected ($0.12)
Seat 5: 52f43d28 folded before Flop (didn't bet)
Seat 6: Hero folded before Flop (didn't bet)


Poker Hand #RC3334596102: Hold'em No Limit ($0.02/$0.05) - 2025/02/17 21:37:03
Table 'RushAndCash631362' 6-max Seat #1 is the button
Seat 1: e17748e2 ($5 in chips)
Seat 2: 19259657 ($5.77 in chips)
Seat 3: a0f1665c ($5.56 in chips)
Seat 4: Hero ($8.59 in chips)
Seat 5: 116bb053 ($2.86 in chips)
Seat 6: 5c8c19b7 ($12.39 in chips)
19259657: posts small blind $0.02
a0f1665c: posts big blind $0.05
*** HOLE CARDS ***
Dealt to e17748e2 
Dealt to 19259657 
Dealt to a0f1665c 
Dealt to Hero [8s 6c]
Dealt to 116bb053 
Dealt to 5c8c19b7 
Hero: folds
116bb053: folds
5c8c19b7: folds
e17748e2: raises $0.06 to $0.11
19259657: folds
a0f1665c: folds
Uncalled bet ($0.06) returned to e17748e2
*** SHOWDOWN ***
e17748e2 collected $0.12 from pot
*** SUMMARY ***
Total pot $0.12 | Rake $0 | Jackpot $0 | Bingo $0 | Fortune $0 | Tax $0
Seat 1: e17748e2 (button) collected ($0.12)
Seat 2: 19259657 (small blind) folded before Flop
Seat 3: a0f1665c (big blind) folded before Flop
Seat 4: Hero folded before Flop (didn't bet)
Seat 5: 116bb053 folded before Flop (didn't bet)
Seat 6: 5c8c19b7 folded before Flop (didn't bet)


Poker Hand #RC3334596075: Hold'em No Limit ($0.02/$0.05) - 2025/02/17 21:37:00
Table 'RushAndCash631335' 6-max Seat #1 is the button
Seat 1: dfc02c40 ($6.63 in chips)
Seat 2: Hero ($8.61 in chips)
Seat 3: 2e24bede ($5.28 in chips)
Seat 4: f9d64f1a ($5.6 in chips)
Seat 5: 86fb354d ($5 in chips)
Seat 6: 5e4e4a51 ($5.67 in chips)
Hero: posts small blind $0.02
2e24bede: posts big blind $0.05
*** HOLE CARDS ***
Dealt to dfc02c40 
Dealt to Hero [Qs 4s]
Dealt to 2e24bede 
Dealt to f9d64f1a 
Dealt to 86fb354d 
Dealt to 5e4e4a51 
f9d64f1a: folds
86fb354d: folds
5e4e4a51: calls $0.05
dfc02c40: raises $0.13 to $0.18
Hero: folds
2e24bede: folds
5e4e4a51: calls $0.13
*** FLOP *** [3h 3d Jh]
5e4e4a51: checks
dfc02c40: bets $0.15
5e4e4a51: calls $0.15
*** TURN *** [3h 3d Jh] [9s]
5e4e4a51: checks
dfc02c40: bets $0.35
5e4e4a51: calls $0.35
*** RIVER *** [3h 3d Jh 9s] [4c]
5e4e4a51: checks
dfc02c40: checks
5e4e4a51: shows [Th Qh] (Pair of Treys)
dfc02c40: shows [7h 7s] (Pair of Sevens and Pair of Treys)
*** SHOWDOWN ***
dfc02c40 collected $1.36 from pot
*** SUMMARY ***
Total pot $1.43 | Rake $0.07 | Jackpot $0 | Bingo $0 | Fortune $0 | Tax $0
Board [3h 3d Jh 9s 4c]
Seat 1: dfc02c40 (button) showed [7h 7s] and won ($1.36) with Pair of Sevens and Pair of Treys
Seat 2: Hero (small blind) folded before Flop
Seat 3: 2e24bede (big blind) folded before Flop
Seat 4: f9d64f1a folded before Flop (didn't bet)
Seat 5: 86fb354d folded before Flop (didn't bet)
Seat 6: 5e4e4a51 showed [Th Qh] and lost with Pair of Treys


Poker Hand #RC3334595956: Hold'em No Limit ($0.02/$0.05) - 2025/02/17 21:36:46
Table 'RushAndCash631216' 6-max Seat #1 is the button
Seat 1: 7f13dd41 ($4.92 in chips)
Seat 2: 769f9172 ($12.05 in chips)
Seat 3: 59c43665 ($5.07 in chips)
Seat 4: 77d1364f ($3.17 in chips)
Seat 5: Hero ($8.54 in chips)
Seat 6: 21be8833 ($5 in chips)
769f9172: posts small blind $0.02
59c43665: posts big blind $0.05
*** HOLE CARDS ***
Dealt to 7f13dd41 
Dealt to 769f9172 
Dealt to 59c43665 
Dealt to 77d1364f 
Dealt to Hero [Ah Ks]
Dealt to 21be8833 
77d1364f: folds
Hero: raises $0.05 to $0.1
21be8833: folds
7f13dd41: folds
769f9172: folds
59c43665: folds
Uncalled bet ($0.05) returned to Hero
*** SHOWDOWN ***
Hero collected $0.12 from pot
*** SUMMARY ***
Total pot $0.12 | Rake $0 | Jackpot $0 | Bingo $0 | Fortune $0 | Tax $0
Seat 1: 7f13dd41 (button) folded before Flop (didn't bet)
Seat 2: 769f9172 (small blind) folded before Flop
Seat 3: 59c43665 (big blind) folded before Flop
Seat 4: 77d1364f folded before Flop (didn't bet)
Seat 5: Hero collected ($0.12)
Seat 6: 21be8833 folded before Flop (didn't bet)


Poker Hand #RC3334595929: Hold'em No Limit ($0.02/$0.05) - 2025/02/17 21:36:43
Table 'RushAndCash631189' 6-max Seat #1 is the button
Seat 1: Hero ($8.54 in chips)
Seat 2: e183d966 ($6.25 in chips)
Seat 3: c606a534 ($11.54 in chips)
Seat 4: 6008538 ($5.68 in chips)
Seat 5: 4577a98c ($5.07 in chips)
Seat 6: 814edd7 ($4.77 in chips)
e183d966: posts small blind $0.02
c606a534: posts big blind $0.05
*** HOLE CARDS ***
Dealt to Hero [2c 8d]
Dealt to e183d966 
Dealt to c606a534 
Dealt to 6008538 
Dealt to 4577a98c 
Dealt to 814edd7 
6008538: folds
4577a98c: raises $0.06 to $0.11
814edd7: folds
Hero: folds
e183d966: calls $0.09
c606a534: folds
*** FLOP *** [Jd 3s 6d]
e183d966: checks
4577a98c: checks
*** TURN *** [Jd 3s 6d] [Js]
e183d966: bets $0.1
4577a98c: calls $0.1
*** RIVER *** [Jd 3s 6d Js] [Qh]
e183d966: bets $0.36
4577a98c: folds
Uncalled bet ($0.36) returned to e183d966
*** SHOWDOWN ***
e183d966 collected $0.45 from pot
*** SUMMARY ***
Total pot $0.47 | Rake $0.02 | Jackpot $0 | Bingo $0 | Fortune $0 | Tax $0
Board [Jd 3s 6d Js Qh]
Seat 1: Hero (button) folded before Flop (didn't bet)
Seat 2: e183d966 (small blind) won ($0.45)
Seat 3: c606a534 (big blind) folded before Flop
Seat 4: 6008538 folded before Flop (didn't bet)
Seat 5: 4577a98c folded on the River
Seat 6: 814edd7 folded before Flop (didn't bet)


Poker Hand #RC3334595895: Hold'em No Limit ($0.02/$0.05) - 2025/02/17 21:36:39
Table 'RushAndCash631155' 6-max Seat #1 is the button
Seat 1: a63aa4b7 ($15.25 in chips)
Seat 2: e4aeeb30 ($5.09 in chips)
Seat 3: Hero ($8.59 in chips)
Seat 4: e5dc0403 ($5 in chips)
Seat 5: dcd4e05 ($1.9 in chips)
Seat 6: a81aa4e3 ($6.12 in chips)
e4aeeb30: posts small blind $0.02
Hero: posts big blind $0.05
*** HOLE CARDS ***
Dealt to a63aa4b7 
Dealt to e4aeeb30 
Dealt to Hero [8s 4s]
Dealt to e5dc0403 
Dealt to dcd4e05 
Dealt to a81aa4e3 
e5dc0403: folds
dcd4e05: folds
a81aa4e3: folds
a63aa4b7: folds
e4aeeb30: raises $0.1 to $0.15
Hero: folds
Uncalled bet ($0.1) returned to e4aeeb30
*** SHOWDOWN ***
e4aeeb30 collected $0.1 from pot
*** SUMMARY ***
Total pot $0.1 | Rake $0 | Jackpot $0 | Bingo $0 | Fortune $0 | Tax $0
Seat 1: a63aa4b7 (button) folded before Flop (didn't bet)
Seat 2: e4aeeb30 (small blind) collected ($0.1)
Seat 3: Hero (big blind) folded before Flop
Seat 4: e5dc0403 folded before Flop (didn't bet)
Seat 5: dcd4e05 folded before Flop (didn't bet)
Seat 6: a81aa4e3 folded before Flop (didn't bet)


Poker Hand #RC3334595869: Hold'em No Limit ($0.02/$0.05) - 2025/02/17 21:36:36
Table 'RushAndCash631129' 6-max Seat #1 is the button
Seat 1: 49b4f33a ($12.93 in chips)
Seat 2: 223a5c5d ($5.13 in chips)
Seat 3: d916afa1 ($20.64 in chips)
Seat 4: Hero ($8.59 in chips)
Seat 5: c16b612d ($5.52 in chips)
Seat 6: e4aeeb30 ($5.09 in chips)
223a5c5d: posts small blind $0.02
d916afa1: posts big blind $0.05
*** HOLE CARDS ***
Dealt to 49b4f33a 
Dealt to 223a5c5d 
Dealt to d916afa1 
Dealt to Hero [7c Qs]
Dealt to c16b612d 
Dealt to e4aeeb30 
Hero: folds
c16b612d: raises $0.08 to $0.13
e4aeeb30: folds
49b4f33a: folds
223a5c5d: folds
d916afa1: calls $0.08
*** FLOP *** [3s Qh 5s]
d916afa1: bets $0.14
c16b612d: calls $0.14
*** TURN *** [3s Qh 5s] [7h]
d916afa1: bets $0.28
c16b612d: calls $0.28
*** RIVER *** [3s Qh 5s 7h] [8c]
d916afa1: checks
c16b612d: checks
d916afa1: shows [4s 7s] (Pair of Sevens)
c16b612d: shows [Tc Th] (Pair of Tens)
*** SHOWDOWN ***
c16b612d collected $1.07 from pot
*** SUMMARY ***
Total pot $1.12 | Rake $0.05 | Jackpot $0 | Bingo $0 | Fortune $0 | Tax $0
Board [3s Qh 5s 7h 8c]
Seat 1: 49b4f33a (button) folded before Flop (didn't bet)
Seat 2: 223a5c5d (small blind) folded before Flop
Seat 3: d916afa1 (big blind) showed [4s 7s] and lost with Pair of Sevens
Seat 4: Hero folded before Flop (didn't bet)
Seat 5: c16b612d showed [Tc Th] and won ($1.07) with Pair of Tens
Seat 6: e4aeeb30 folded before Flop (didn't bet)


Poker Hand #RC3334595829: Hold'em No Limit ($0.02/$0.05) - 2025/02/17 21:36:32
Table 'RushAndCash631089' 6-max Seat #1 is the button
Seat 1: Hero ($8.59 in chips)
Seat 2: 50b3f230 ($6.65 in chips)
Seat 3: 2676a891 ($5.11 in chips)
Seat 4: 7eb5dbb3 ($11.24 in chips)
Seat 5: ee489ab4 ($1.94 in chips)
Seat 6: 30b5f3ab ($5 in chips)
50b3f230: posts small blind $0.02
2676a891: posts big blind $0.05
*** HOLE CARDS ***
Dealt to Hero [3d Td]
Dealt to 50b3f230 
Dealt to 2676a891 
Dealt to 7eb5dbb3 
Dealt to ee489ab4 
Dealt to 30b5f3ab 
7eb5dbb3: raises $0.08 to $0.13
ee489ab4: calls $0.13
30b5f3ab: folds
Hero: folds
50b3f230: folds
2676a891: folds
*** FLOP *** [9c 5c 8d]
7eb5dbb3: checks
ee489ab4: checks
*** TURN *** [9c 5c 8d] [Ad]
7eb5dbb3: bets $0.25
ee489ab4: calls $0.25
*** RIVER *** [9c 5c 8d Ad] [As]
7eb5dbb3: bets $0.63
ee489ab4: calls $0.63
7eb5dbb3: shows [Qd Ah] (Three Aces)
ee489ab4: shows [4c Ac] (Three Aces)
*** SHOWDOWN ***
7eb5dbb3 collected $1.92 from pot
*** SUMMARY ***
Total pot $2.09 | Rake $0.1 | Jackpot $0.07 | Bingo $0 | Fortune $0 | Tax $0
Board [9c 5c 8d Ad As]
Seat 1: Hero (button) folded before Flop (didn't bet)
Seat 2: 50b3f230 (small blind) folded before Flop
Seat 3: 2676a891 (big blind) folded before Flop
Seat 4: 7eb5dbb3 showed [Qd Ah] and won ($1.92) with Three Aces
Seat 5: ee489ab4 showed [4c Ac] and lost with Three Aces
Seat 6: 30b5f3ab folded before Flop (didn't bet)


Poker Hand #RC3334595635: Hold'em No Limit ($0.02/$0.05) - 2025/02/17 21:36:09
Table 'RushAndCash630895' 6-max Seat #1 is the button
Seat 1: 3e3946b0 ($6.28 in chips)
Seat 2: c0cd67df ($5 in chips)
Seat 3: Hero ($8.69 in chips)
Seat 4: 2676a891 ($5 in chips)
Seat 5: fa30bfa7 ($5.13 in chips)
Seat 6: f18b40b7 ($7.86 in chips)
c0cd67df: posts small blind $0.02
Hero: posts big blind $0.05
*** HOLE CARDS ***
Dealt to 3e3946b0 
Dealt to c0cd67df 
Dealt to Hero [Kc 9c]
Dealt to 2676a891 
Dealt to fa30bfa7 
Dealt to f18b40b7 
2676a891: raises $0.05 to $0.1
fa30bfa7: folds
f18b40b7: folds
3e3946b0: folds
c0cd67df: folds
Hero: calls $0.05
*** FLOP *** [Qh 6h 3h]
Hero: checks
2676a891: bets $0.17
Hero: folds
Uncalled bet ($0.17) returned to 2676a891
*** SHOWDOWN ***
2676a891 collected $0.21 from pot
*** SUMMARY ***
Total pot $0.22 | Rake $0.01 | Jackpot $0 | Bingo $0 | Fortune $0 | Tax $0
Board [Qh 6h 3h]
Seat 1: 3e3946b0 (button) folded before Flop (didn't bet)
Seat 2: c0cd67df (small blind) folded before Flop
Seat 3: Hero (big blind) folded on the Flop
Seat 4: 2676a891 won ($0.21)
Seat 5: fa30bfa7 folded before Flop (didn't bet)
Seat 6: f18b40b7 folded before Flop (didn't bet)


Poker Hand #RC3334595580: Hold'em No Limit ($0.02/$0.05) - 2025/02/17 21:36:03
Table 'RushAndCash630840' 6-max Seat #1 is the button
Seat 1: e7c4d687 ($3.52 in chips)
Seat 2: 44a9f3f0 ($6.62 in chips)
Seat 3: bcb971d3 ($5.47 in chips)
Seat 4: 5daef2fa ($6.09 in chips)
Seat 5: Hero ($8.69 in chips)
Seat 6: a4227633 ($6.39 in chips)
44a9f3f0: posts small blind $0.02
bcb971d3: posts big blind $0.05
*** HOLE CARDS ***
Dealt to e7c4d687 
Dealt to 44a9f3f0 
Dealt to bcb971d3 
Dealt to 5daef2fa 
Dealt to Hero [2h Th]
Dealt to a4227633 
5daef2fa: raises $0.07 to $0.12
Hero: folds
a4227633: folds
e7c4d687: folds
44a9f3f0: folds
bcb971d3: calls $0.07
*** FLOP *** [9d Qs 6h]
bcb971d3: checks
5daef2fa: bets $0.09
bcb971d3: calls $0.09
*** TURN *** [9d Qs 6h] [Jh]
bcb971d3: checks
5daef2fa: checks
*** RIVER *** [9d Qs 6h Jh] [4c]
bcb971d3: checks
5daef2fa: checks
bcb971d3: shows [8d 8s] (Pair of Eights)
5daef2fa: shows [5c 6c] (Pair of Sixes)
*** SHOWDOWN ***
bcb971d3 collected $0.42 from pot
*** SUMMARY ***
Total pot $0.44 | Rake $0.02 | Jackpot $0 | Bingo $0 | Fortune $0 | Tax $0
Board [9d Qs 6h Jh 4c]
Seat 1: e7c4d687 (button) folded before Flop (didn't bet)
Seat 2: 44a9f3f0 (small blind) folded before Flop
Seat 3: bcb971d3 (big blind) showed [8d 8s] and won ($0.42) with Pair of Eights
Seat 4: 5daef2fa showed [5c 6c] and lost with Pair of Sixes
Seat 5: Hero folded before Flop (didn't bet)
Seat 6: a4227633 folded before Flop (didn't bet)


Poker Hand #RC3334595551: Hold'em No Limit ($0.02/$0.05) - 2025/02/17 21:36:00
Table 'RushAndCash630811' 6-max Seat #1 is the button
Seat 1: fb6c913 ($9.6 in chips)
Seat 2: 7b9ea1f3 ($5.84 in chips)
Seat 3: 6e22a6c1 ($7.47 in chips)
Seat 4: 866d801a ($5 in chips)
Seat 5: Hero ($8.69 in chips)
Seat 6: 853dbdb5 ($4.5 in chips)
7b9ea1f3: posts small blind $0.02
6e22a6c1: posts big blind $0.05
*** HOLE CARDS ***
Dealt to fb6c913 
Dealt to 7b9ea1f3 
Dealt to 6e22a6c1 
Dealt to 866d801a 
Dealt to Hero [5s 2s]
Dealt to 853dbdb5 
866d801a: folds
Hero: folds
853dbdb5: folds
fb6c913: folds
7b9ea1f3: folds
Uncalled bet ($0.03) returned to 6e22a6c1
*** SHOWDOWN ***
6e22a6c1 collected $0.04 from pot
*** SUMMARY ***
Total pot $0.04 | Rake $0 | Jackpot $0 | Bingo $0 | Fortune $0 | Tax $0
Seat 1: fb6c913 (button) folded before Flop (didn't bet)
Seat 2: 7b9ea1f3 (small blind) folded before Flop
Seat 3: 6e22a6c1 (big blind) collected ($0.04)
Seat 4: 866d801a folded before Flop (didn't bet)
Seat 5: Hero folded before Flop (didn't bet)
Seat 6: 853dbdb5 folded before Flop (didn't bet)


Poker Hand #RC3334595522: Hold'em No Limit ($0.02/$0.05) - 2025/02/17 21:35:56
Table 'RushAndCash630782' 6-max Seat #1 is the button
Seat 1: Hero ($8.69 in chips)
Seat 2: 18767060 ($9.02 in chips)
Seat 3: fa499268 ($8.2 in chips)
Seat 4: e3cc36cb ($10.12 in chips)
Seat 5: 42c7d5a0 ($5 in chips)
Seat 6: 442376ec ($6.32 in chips)
18767060: posts small blind $0.02
fa499268: posts big blind $0.05
*** HOLE CARDS ***
Dealt to Hero [4h Jc]
Dealt to 18767060 
Dealt to fa499268 
Dealt to e3cc36cb 
Dealt to 42c7d5a0 
Dealt to 442376ec 
e3cc36cb: folds
42c7d5a0: folds
442376ec: raises $0.08 to $0.13
Hero: folds
18767060: folds
fa499268: folds
Uncalled bet ($0.08) returned to 442376ec
*** SHOWDOWN ***
442376ec collected $0.12 from pot
*** SUMMARY ***
Total pot $0.12 | Rake $0 | Jackpot $0 | Bingo $0 | Fortune $0 | Tax $0
Seat 1: Hero (button) folded before Flop (didn't bet)
Seat 2: 18767060 (small blind) folded before Flop
Seat 3: fa499268 (big blind) folded before Flop
Seat 4: e3cc36cb folded before Flop (didn't bet)
Seat 5: 42c7d5a0 folded before Flop (didn't bet)
Seat 6: 442376ec collected ($0.12)


Poker Hand #RC3334595490: Hold'em No Limit ($0.02/$0.05) - 2025/02/17 21:35:52
Table 'RushAndCash630750' 6-max Seat #1 is the button
Seat 1: 38005dc9 ($4.03 in chips)
Seat 2: Hero ($8.71 in chips)
Seat 3: 23f8366a ($6.76 in chips)
Seat 4: 67b2dab9 ($8.67 in chips)
Seat 5: f56d4922 ($5.78 in chips)
Seat 6: e97b3270 ($22.48 in chips)
Hero: posts small blind $0.02
23f8366a: posts big blind $0.05
*** HOLE CARDS ***
Dealt to 38005dc9 
Dealt to Hero [6s 4s]
Dealt to 23f8366a 
Dealt to 67b2dab9 
Dealt to f56d4922 
Dealt to e97b3270 
67b2dab9: folds
f56d4922: raises $0.05 to $0.1
e97b3270: folds
38005dc9: folds
Hero: folds
23f8366a: folds
Uncalled bet ($0.05) returned to f56d4922
*** SHOWDOWN ***
f56d4922 collected $0.12 from pot
*** SUMMARY ***
Total pot $0.12 | Rake $0 | Jackpot $0 | Bingo $0 | Fortune $0 | Tax $0
Seat 1: 38005dc9 (button) folded before Flop (didn't bet)
Seat 2: Hero (small blind) folded before Flop
Seat 3: 23f8366a (big blind) folded before Flop
Seat 4: 67b2dab9 folded before Flop (didn't bet)
Seat 5: f56d4922 collected ($0.12)
Seat 6: e97b3270 folded before Flop (didn't bet)


Poker Hand #RC3334595465: Hold'em No Limit ($0.02/$0.05) - 2025/02/17 21:35:49
Table 'RushAndCash630725' 6-max Seat #1 is the button
Seat 1: 5e4e4a51 ($5.53 in chips)
Seat 2: fcfd355a ($5 in chips)
Seat 3: Hero ($8.76 in chips)
Seat 4: f56d4922 ($5.78 in chips)
Seat 5: eb078c31 ($5 in chips)
Seat 6: 5b79005a ($5.49 in chips)
fcfd355a: posts small blind $0.02
Hero: posts big blind $0.05
*** HOLE CARDS ***
Dealt to 5e4e4a51 
Dealt to fcfd355a 
Dealt to Hero [9c 7h]
Dealt to f56d4922 
Dealt to eb078c31 
Dealt to 5b79005a 
f56d4922: folds
eb078c31: folds
5b79005a: folds
5e4e4a51: folds
fcfd355a: raises $0.1 to $0.15
Hero: folds
Uncalled bet ($0.1) returned to fcfd355a
*** SHOWDOWN ***
fcfd355a collected $0.1 from pot
*** SUMMARY ***
Total pot $0.1 | Rake $0 | Jackpot $0 | Bingo $0 | Fortune $0 | Tax $0
Seat 1: 5e4e4a51 (button) folded before Flop (didn't bet)
Seat 2: fcfd355a (small blind) collected ($0.1)
Seat 3: Hero (big blind) folded before Flop
Seat 4: f56d4922 folded before Flop (didn't bet)
Seat 5: eb078c31 folded before Flop (didn't bet)
Seat 6: 5b79005a folded before Flop (didn't bet)


Poker Hand #RC3334595441: Hold'em No Limit ($0.02/$0.05) - 2025/02/17 21:35:46
Table 'RushAndCash630701' 6-max Seat #1 is the button
Seat 1: 726ab14e ($6.59 in chips)
Seat 2: e3cc36cb ($10.14 in chips)
Seat 3: 69373e56 ($5.79 in chips)
Seat 4: 757f29d9 ($8.49 in chips)
Seat 5: Hero ($8.76 in chips)
Seat 6: fb8cc108 ($5 in chips)
e3cc36cb: posts small blind $0.02
69373e56: posts big blind $0.05
*** HOLE CARDS ***
Dealt to 726ab14e 
Dealt to e3cc36cb 
Dealt to 69373e56 
Dealt to 757f29d9 
Dealt to Hero [Qc Td]
Dealt to fb8cc108 
757f29d9: folds
Hero: folds
fb8cc108: folds
726ab14e: folds
e3cc36cb: folds
Uncalled bet ($0.03) returned to 69373e56
*** SHOWDOWN ***
69373e56 collected $0.04 from pot
*** SUMMARY ***
Total pot $0.04 | Rake $0 | Jackpot $0 | Bingo $0 | Fortune $0 | Tax $0
Seat 1: 726ab14e (button) folded before Flop (didn't bet)
Seat 2: e3cc36cb (small blind) folded before Flop
Seat 3: 69373e56 (big blind) collected ($0.04)
Seat 4: 757f29d9 folded before Flop (didn't bet)
Seat 5: Hero folded before Flop (didn't bet)
Seat 6: fb8cc108 folded before Flop (didn't bet)


Poker Hand #RC3334595144: Hold'em No Limit ($0.02/$0.05) - 2025/02/17 21:35:09
Table 'RushAndCash630404' 6-max Seat #1 is the button
Seat 1: Hero ($8.6 in chips)
Seat 2: b01e47a0 ($6.16 in chips)
Seat 3: d606d9 ($9.66 in chips)
Seat 4: dc99401b ($5 in chips)
Seat 5: 3ed1e77f ($5.56 in chips)
Seat 6: edbb0bb6 ($5 in chips)
b01e47a0: posts small blind $0.02
d606d9: posts big blind $0.05
*** HOLE CARDS ***
Dealt to Hero [Ad Ks]
Dealt to b01e47a0 
Dealt to d606d9 
Dealt to dc99401b 
Dealt to 3ed1e77f 
Dealt to edbb0bb6 
dc99401b: folds
3ed1e77f: folds
edbb0bb6: raises $0.05 to $0.1
Hero: raises $0.22 to $0.32
b01e47a0: folds
d606d9: folds
edbb0bb6: folds
Uncalled bet ($0.22) returned to Hero
*** SHOWDOWN ***
Hero collected $0.26 from pot
*** SUMMARY ***
Total pot $0.27 | Rake $0.01 | Jackpot $0 | Bingo $0 | Fortune $0 | Tax $0
Seat 1: Hero (button) collected ($0.26)
Seat 2: b01e47a0 (small blind) folded before Flop
Seat 3: d606d9 (big blind) folded before Flop
Seat 4: dc99401b folded before Flop (didn't bet)
Seat 5: 3ed1e77f folded before Flop (didn't bet)
Seat 6: edbb0bb6 folded before Flop


Poker Hand #RC3334595116: Hold'em No Limit ($0.02/$0.05) - 2025/02/17 21:35:06
Table 'RushAndCash630376' 6-max Seat #1 is the button
Seat 1: ff01bdba ($10.28 in chips)
Seat 2: 5c8c19b7 ($13.11 in chips)
Seat 3: Hero ($8.65 in chips)
Seat 4: 43c437e9 ($18.24 in chips)
Seat 5: d278c831 ($7.85 in chips)
Seat 6: ceaf3b1d ($6.08 in chips)
5c8c19b7: posts small blind $0.02
Hero: posts big blind $0.05
*** HOLE CARDS ***
Dealt to ff01bdba 
Dealt to 5c8c19b7 
Dealt to Hero [Js 3h]
Dealt to 43c437e9 
Dealt to d278c831 
Dealt to ceaf3b1d 
43c437e9: folds
d278c831: folds
ceaf3b1d: folds
ff01bdba: raises $0.1 to $0.15
5c8c19b7: folds
Hero: folds
Uncalled bet ($0.1) returned to ff01bdba
*** SHOWDOWN ***
ff01bdba collected $0.12 from pot
*** SUMMARY ***
Total pot $0.12 | Rake $0 | Jackpot $0 | Bingo $0 | Fortune $0 | Tax $0
Seat 1: ff01bdba (button) collected ($0.12)
Seat 2: 5c8c19b7 (small blind) folded before Flop
Seat 3: Hero (big blind) folded before Flop
Seat 4: 43c437e9 folded before Flop (didn't bet)
Seat 5: d278c831 folded before Flop (didn't bet)
Seat 6: ceaf3b1d folded before Flop (didn't bet)


Poker Hand #RC3334595087: Hold'em No Limit ($0.02/$0.05) - 2025/02/17 21:35:02
Table 'RushAndCash630347' 6-max Seat #1 is the button
Seat 1: 3ae3072b ($5.36 in chips)
Seat 2: Hero ($8.67 in chips)
Seat 3: f21cbd70 ($5.14 in chips)
Seat 4: 4238ab48 ($7.23 in chips)
Seat 5: 67aeeaf2 ($8.17 in chips)
Seat 6: edf2f3c ($5.65 in chips)
Hero: posts small blind $0.02
f21cbd70: posts big blind $0.05
*** HOLE CARDS ***
Dealt to 3ae3072b 
Dealt to Hero [3d Ah]
Dealt to f21cbd70 
Dealt to 4238ab48 
Dealt to 67aeeaf2 
Dealt to edf2f3c 
4238ab48: raises $0.08 to $0.13
67aeeaf2: folds
edf2f3c: raises $0.25 to $0.38
3ae3072b: folds
Hero: folds
f21cbd70: calls $0.33
4238ab48: raises $1.14 to $1.52
edf2f3c: calls $1.14
f21cbd70: folds
*** FLOP *** [Qh 3h Ad]
4238ab48: bets $1.14
edf2f3c: folds
Uncalled bet ($1.14) returned to 4238ab48
*** SHOWDOWN ***
4238ab48 collected $3.22 from pot
*** SUMMARY ***
Total pot $3.44 | Rake $0.15 | Jackpot $0.07 | Bingo $0 | Fortune $0 | Tax $0
Board [Qh 3h Ad]
Seat 1: 3ae3072b (button) folded before Flop (didn't bet)
Seat 2: Hero (small blind) folded before Flop
Seat 3: f21cbd70 (big blind) folded before Flop
Seat 4: 4238ab48 won ($3.22)
Seat 5: 67aeeaf2 folded before Flop (didn't bet)
Seat 6: edf2f3c folded on the Flop


Poker Hand #RC3334595057: Hold'em No Limit ($0.02/$0.05) - 2025/02/17 21:34:58
Table 'RushAndCash630317' 6-max Seat #1 is the button
Seat 1: a0f1665c ($5.57 in chips)
Seat 2: f0a8dabb ($5.2 in chips)
Seat 3: 29497ac7 ($2 in chips)
Seat 4: Hero ($8.67 in chips)
Seat 5: 95096c6a ($10 in chips)
Seat 6: 417901d6 ($5.44 in chips)
f0a8dabb: posts small blind $0.02
29497ac7: posts big blind $0.05
*** HOLE CARDS ***
Dealt to a0f1665c 
Dealt to f0a8dabb 
Dealt to 29497ac7 
Dealt to Hero [Ah 4s]
Dealt to 95096c6a 
Dealt to 417901d6 
Hero: folds
95096c6a: raises $0.05 to $0.1
417901d6: folds
a0f1665c: calls $0.1
f0a8dabb: folds
29497ac7: folds
*** FLOP *** [2s 7d 2c]
95096c6a: bets $0.18
a0f1665c: folds
Uncalled bet ($0.18) returned to 95096c6a
*** SHOWDOWN ***
95096c6a collected $0.26 from pot
*** SUMMARY ***
Total pot $0.27 | Rake $0.01 | Jackpot $0 | Bingo $0 | Fortune $0 | Tax $0
Board [2s 7d 2c]
Seat 1: a0f1665c (button) folded on the Flop
Seat 2: f0a8dabb (small blind) folded before Flop
Seat 3: 29497ac7 (big blind) folded before Flop
Seat 4: Hero folded before Flop (didn't bet)
Seat 5: 95096c6a won ($0.26)
Seat 6: 417901d6 folded before Flop (didn't bet)


Poker Hand #RC3334595026: Hold'em No Limit ($0.02/$0.05) - 2025/02/17 21:34:55
Table 'RushAndCash630286' 6-max Seat #1 is the button
Seat 1: 24aff26b ($8.96 in chips)
Seat 2: 76135c78 ($13.29 in chips)
Seat 3: ed18a71b ($6.42 in chips)
Seat 4: Hero ($8.67 in chips)
Seat 5: 4305bf97 ($5.08 in chips)
Seat 6: 18767060 ($9.12 in chips)
76135c78: posts small blind $0.02
ed18a71b: posts big blind $0.05
*** HOLE CARDS ***
Dealt to 24aff26b 
Dealt to 76135c78 
Dealt to ed18a71b 
Dealt to Hero [9h Qd]
Dealt to 4305bf97 
Dealt to 18767060 
Hero: folds
4305bf97: folds
18767060: raises $0.05 to $0.1
24aff26b: folds
76135c78: raises $0.39 to $0.49
ed18a71b: raises $1.08 to $1.57
18767060: folds
76135c78: folds
Uncalled bet ($1.08) returned to ed18a71b
*** SHOWDOWN ***
ed18a71b collected $1.03 from pot
*** SUMMARY ***
Total pot $1.08 | Rake $0.05 | Jackpot $0 | Bingo $0 | Fortune $0 | Tax $0
Seat 1: 24aff26b (button) folded before Flop (didn't bet)
Seat 2: 76135c78 (small blind) folded before Flop
Seat 3: ed18a71b (big blind) collected ($1.03)
Seat 4: Hero folded before Flop (didn't bet)
Seat 5: 4305bf97 folded before Flop (didn't bet)
Seat 6: 18767060 folded before Flop


Poker Hand #RC3334594960: Hold'em No Limit ($0.02/$0.05) - 2025/02/17 21:34:48
Table 'RushAndCash630220' 6-max Seat #1 is the button
Seat 1: Hero ($8.67 in chips)
Seat 2: e5fa3450 ($6.08 in chips)
Seat 3: 3c76a91d ($8.98 in chips)
Seat 4: a9d8ced4 ($5.72 in chips)
Seat 5: 9b1a3dd2 ($14.97 in chips)
Seat 6: fb90f143 ($9.94 in chips)
e5fa3450: posts small blind $0.02
3c76a91d: posts big blind $0.05
*** HOLE CARDS ***
Dealt to Hero [6c Qd]
Dealt to e5fa3450 
Dealt to 3c76a91d 
Dealt to a9d8ced4 
Dealt to 9b1a3dd2 
Dealt to fb90f143 
a9d8ced4: folds
9b1a3dd2: folds
fb90f143: folds
Hero: folds
e5fa3450: folds
Uncalled bet ($0.03) returned to 3c76a91d
*** SHOWDOWN ***
3c76a91d collected $0.04 from pot
*** SUMMARY ***
Total pot $0.04 | Rake $0 | Jackpot $0 | Bingo $0 | Fortune $0 | Tax $0
Seat 1: Hero (button) folded before Flop (didn't bet)
Seat 2: e5fa3450 (small blind) folded before Flop
Seat 3: 3c76a91d (big blind) collected ($0.04)
Seat 4: a9d8ced4 folded before Flop (didn't bet)
Seat 5: 9b1a3dd2 folded before Flop (didn't bet)
Seat 6: fb90f143 folded before Flop (didn't bet)


Poker Hand #RC3334594932: Hold'em No Limit ($0.02/$0.05) - 2025/02/17 21:34:44
Table 'RushAndCash630192' 6-max Seat #1 is the button
Seat 1: 79d81faa ($7.75 in chips)
Seat 2: 8e93231a ($6.12 in chips)
Seat 3: edcc4eda ($5.14 in chips)
Seat 4: 3c76a91d ($8.98 in chips)
Seat 5: Hero ($8.67 in chips)
Seat 6: 86b969db ($5.24 in chips)
8e93231a: posts small blind $0.02
edcc4eda: posts big blind $0.05
*** HOLE CARDS ***
Dealt to 79d81faa 
Dealt to 8e93231a 
Dealt to edcc4eda 
Dealt to 3c76a91d 
Dealt to Hero [2d Qc]
Dealt to 86b969db 
3c76a91d: folds
Hero: folds
86b969db: raises $0.08 to $0.13
79d81faa: folds
8e93231a: folds
edcc4eda: folds
Uncalled bet ($0.08) returned to 86b969db
*** SHOWDOWN ***
86b969db collected $0.12 from pot
*** SUMMARY ***
Total pot $0.12 | Rake $0 | Jackpot $0 | Bingo $0 | Fortune $0 | Tax $0
Seat 1: 79d81faa (button) folded before Flop (didn't bet)
Seat 2: 8e93231a (small blind) folded before Flop
Seat 3: edcc4eda (big blind) folded before Flop
Seat 4: 3c76a91d folded before Flop (didn't bet)
Seat 5: Hero folded before Flop (didn't bet)
Seat 6: 86b969db collected ($0.12)


Poker Hand #RC3334594891: Hold'em No Limit ($0.02/$0.05) - 2025/02/17 21:34:40
Table 'RushAndCash630151' 6-max Seat #1 is the button
Seat 1: 866d801a ($5 in chips)
Seat 2: Hero ($8.69 in chips)
Seat 3: 2d23be58 ($5.55 in chips)
Seat 4: 5197516b ($6.29 in chips)
Seat 5: b59fc0b9 ($5.02 in chips)
Seat 6: 3bfcd529 ($5 in chips)
Hero: posts small blind $0.02
2d23be58: posts big blind $0.05
*** HOLE CARDS ***
Dealt to 866d801a 
Dealt to Hero [3s 8d]
Dealt to 2d23be58 
Dealt to 5197516b 
Dealt to b59fc0b9 
Dealt to 3bfcd529 
5197516b: folds
b59fc0b9: folds
3bfcd529: folds
866d801a: folds
Hero: folds
Uncalled bet ($0.03) returned to 2d23be58
*** SHOWDOWN ***
2d23be58 collected $0.04 from pot
*** SUMMARY ***
Total pot $0.04 | Rake $0 | Jackpot $0 | Bingo $0 | Fortune $0 | Tax $0
Seat 1: 866d801a (button) folded before Flop (didn't bet)
Seat 2: Hero (small blind) folded before Flop
Seat 3: 2d23be58 (big blind) collected ($0.04)
Seat 4: 5197516b folded before Flop (didn't bet)
Seat 5: b59fc0b9 folded before Flop (didn't bet)
Seat 6: 3bfcd529 folded before Flop (didn't bet)


Poker Hand #RC3334594866: Hold'em No Limit ($0.02/$0.05) - 2025/02/17 21:34:37
Table 'RushAndCash630126' 6-max Seat #1 is the button
Seat 1: 442376ec ($6.19 in chips)
Seat 2: 9604af2 ($6.3 in chips)
Seat 3: a8fd1cce ($4.79 in chips)
Seat 4: Hero ($8.69 in chips)
Seat 5: 7fc44808 ($10.85 in chips)
Seat 6: f51515ac ($5 in chips)
9604af2: posts small blind $0.02
a8fd1cce: posts big blind $0.05
*** HOLE CARDS ***
Dealt to 442376ec 
Dealt to 9604af2 
Dealt to a8fd1cce 
Dealt to Hero [Ts Qh]
Dealt to 7fc44808 
Dealt to f51515ac 
Hero: folds
7fc44808: folds
f51515ac: raises $0.05 to $0.1
442376ec: raises $0.21 to $0.31
9604af2: folds
a8fd1cce: folds
f51515ac: folds
Uncalled bet ($0.21) returned to 442376ec
*** SHOWDOWN ***
442376ec collected $0.26 from pot
*** SUMMARY ***
Total pot $0.27 | Rake $0.01 | Jackpot $0 | Bingo $0 | Fortune $0 | Tax $0
Seat 1: 442376ec (button) collected ($0.26)
Seat 2: 9604af2 (small blind) folded before Flop
Seat 3: a8fd1cce (big blind) folded before Flop
Seat 4: Hero folded before Flop (didn't bet)
Seat 5: 7fc44808 folded before Flop (didn't bet)
Seat 6: f51515ac folded before Flop


Poker Hand #RC3334564611: Hold'em No Limit ($0.02/$0.05) - 2025/02/17 21:34:05
Table 'RushAndCash629871' 6-max Seat #1 is the button
Seat 1: c7197736 ($8.09 in chips)
Seat 2: c607d475 ($10.23 in chips)
Seat 3: Hero ($9.05 in chips)
Seat 4: 51719807 ($4.94 in chips)
Seat 5: b66c51bb ($5.99 in chips)
Seat 6: fea7bb48 ($7.45 in chips)
c607d475: posts small blind $0.02
Hero: posts big blind $0.05
*** HOLE CARDS ***
Dealt to c7197736 
Dealt to c607d475 
Dealt to Hero [Ah Js]
Dealt to 51719807 
Dealt to b66c51bb 
Dealt to fea7bb48 
51719807: folds
b66c51bb: folds
fea7bb48: folds
c7197736: folds
c607d475: calls $0.03
Hero: raises $0.13 to $0.18
c607d475: calls $0.13
*** FLOP *** [As 5h 4d]
c607d475: checks
Hero: bets $0.18
c607d475: calls $0.18
*** TURN *** [As 5h 4d] [8h]
c607d475: checks
Hero: checks
*** RIVER *** [As 5h 4d 8h] [3h]
c607d475: bets $0.72
Hero: folds
Uncalled bet ($0.72) returned to c607d475
*** SHOWDOWN ***
c607d475 collected $0.69 from pot
*** SUMMARY ***
Total pot $0.72 | Rake $0.03 | Jackpot $0 | Bingo $0 | Fortune $0 | Tax $0
Board [As 5h 4d 8h 3h]
Seat 1: c7197736 (button) folded before Flop (didn't bet)
Seat 2: c607d475 (small blind) won ($0.69)
Seat 3: Hero (big blind) folded on the River
Seat 4: 51719807 folded before Flop (didn't bet)
Seat 5: b66c51bb folded before Flop (didn't bet)
Seat 6: fea7bb48 folded before Flop (didn't bet)


Poker Hand #RC3334564587: Hold'em No Limit ($0.02/$0.05) - 2025/02/17 21:34:02
Table 'RushAndCash629847' 6-max Seat #1 is the button
Seat 1: 198a1e4 ($8.08 in chips)
Seat 2: Hero ($9.07 in chips)
Seat 3: e4385e67 ($5.15 in chips)
Seat 4: 5daef2fa ($5.9 in chips)
Seat 5: 207d9345 ($21.56 in chips)
Seat 6: 3f6d99d0 ($4.98 in chips)
Hero: posts small blind $0.02
e4385e67: posts big blind $0.05
*** HOLE CARDS ***
Dealt to 198a1e4 
Dealt to Hero [6h 4c]
Dealt to e4385e67 
Dealt to 5daef2fa 
Dealt to 207d9345 
Dealt to 3f6d99d0 
5daef2fa: folds
207d9345: folds
3f6d99d0: folds
198a1e4: folds
Hero: folds
Uncalled bet ($0.03) returned to e4385e67
*** SHOWDOWN ***
e4385e67 collected $0.04 from pot
*** SUMMARY ***
Total pot $0.04 | Rake $0 | Jackpot $0 | Bingo $0 | Fortune $0 | Tax $0
Seat 1: 198a1e4 (button) folded before Flop (didn't bet)
Seat 2: Hero (small blind) folded before Flop
Seat 3: e4385e67 (big blind) collected ($0.04)
Seat 4: 5daef2fa folded before Flop (didn't bet)
Seat 5: 207d9345 folded before Flop (didn't bet)
Seat 6: 3f6d99d0 folded before Flop (didn't bet)


Poker Hand #RC3334564559: Hold'em No Limit ($0.02/$0.05) - 2025/02/17 21:33:58
Table 'RushAndCash629819' 6-max Seat #1 is the button
Seat 1: c2efb543 ($5.22 in chips)
Seat 2: Hero ($9.09 in chips)
Seat 3: 981b7542 ($5 in chips)
Seat 4: a4461af6 ($5 in chips)
Seat 5: 2b8b2921 ($12.24 in chips)
Seat 6: c6e11d19 ($5.57 in chips)
Hero: posts small blind $0.02
981b7542: posts big blind $0.05
*** HOLE CARDS ***
Dealt to c2efb543 
Dealt to Hero [4s 6c]
Dealt to 981b7542 
Dealt to a4461af6 
Dealt to 2b8b2921 
Dealt to c6e11d19 
a4461af6: folds
2b8b2921: folds
c6e11d19: raises $0.05 to $0.1
c2efb543: raises $0.2 to $0.3
Hero: folds
981b7542: folds
c6e11d19: folds
Uncalled bet ($0.2) returned to c2efb543
*** SHOWDOWN ***
c2efb543 collected $0.26 from pot
*** SUMMARY ***
Total pot $0.27 | Rake $0.01 | Jackpot $0 | Bingo $0 | Fortune $0 | Tax $0
Seat 1: c2efb543 (button) collected ($0.26)
Seat 2: Hero (small blind) folded before Flop
Seat 3: 981b7542 (big blind) folded before Flop
Seat 4: a4461af6 folded before Flop (didn't bet)
Seat 5: 2b8b2921 folded before Flop (didn't bet)
Seat 6: c6e11d19 folded before Flop


Poker Hand #RC3334564528: Hold'em No Limit ($0.02/$0.05) - 2025/02/17 21:33:55
Table 'RushAndCash629788' 6-max Seat #1 is the button
Seat 1: 3a46e390 ($5.15 in chips)
Seat 2: c27051e0 ($5.34 in chips)
Seat 3: b4cd57cf ($5.94 in chips)
Seat 4: Hero ($9.09 in chips)
Seat 5: fb90f143 ($9.75 in chips)
Seat 6: dda0a24a ($5 in chips)
c27051e0: posts small blind $0.02
b4cd57cf: posts big blind $0.05
*** HOLE CARDS ***
Dealt to 3a46e390 
Dealt to c27051e0 
Dealt to b4cd57cf 
Dealt to Hero [Th 4h]
Dealt to fb90f143 
Dealt to dda0a24a 
Hero: folds
fb90f143: raises $0.06 to $0.11
dda0a24a: folds
3a46e390: folds
c27051e0: folds
b4cd57cf: calls $0.06
*** FLOP *** [9c 4d 6h]
b4cd57cf: checks
fb90f143: bets $0.08
b4cd57cf: calls $0.08
*** TURN *** [9c 4d 6h] [Kc]
b4cd57cf: checks
fb90f143: bets $0.3
b4cd57cf: folds
Uncalled bet ($0.3) returned to fb90f143
*** SHOWDOWN ***
fb90f143 collected $0.38 from pot
*** SUMMARY ***
Total pot $0.4 | Rake $0.02 | Jackpot $0 | Bingo $0 | Fortune $0 | Tax $0
Board [9c 4d 6h Kc]
Seat 1: 3a46e390 (button) folded before Flop (didn't bet)
Seat 2: c27051e0 (small blind) folded before Flop
Seat 3: b4cd57cf (big blind) folded on the Turn
Seat 4: Hero folded before Flop (didn't bet)
Seat 5: fb90f143 won ($0.38)
Seat 6: dda0a24a folded before Flop (didn't bet)


Poker Hand #RC3334564501: Hold'em No Limit ($0.02/$0.05) - 2025/02/17 21:33:51
Table 'RushAndCash629761' 6-max Seat #1 is the button
Seat 1: 4c9f897a ($6.16 in chips)
Seat 2: bebd931c ($4.4 in chips)
Seat 3: a730170a ($5.05 in chips)
Seat 4: 4e53b23f ($5.21 in chips)
Seat 5: Hero ($9.09 in chips)
Seat 6: b8c09f2 ($6.64 in chips)
bebd931c: posts small blind $0.02
a730170a: posts big blind $0.05
*** HOLE CARDS ***
Dealt to 4c9f897a 
Dealt to bebd931c 
Dealt to a730170a 
Dealt to 4e53b23f 
Dealt to Hero [Ah 2c]
Dealt to b8c09f2 
4e53b23f: raises $0.05 to $0.1
Hero: folds
b8c09f2: folds
4c9f897a: folds
bebd931c: folds
a730170a: folds
Uncalled bet ($0.05) returned to 4e53b23f
*** SHOWDOWN ***
4e53b23f collected $0.12 from pot
*** SUMMARY ***
Total pot $0.12 | Rake $0 | Jackpot $0 | Bingo $0 | Fortune $0 | Tax $0
Seat 1: 4c9f897a (button) folded before Flop (didn't bet)
Seat 2: bebd931c (small blind) folded before Flop
Seat 3: a730170a (big blind) folded before Flop
Seat 4: 4e53b23f collected ($0.12)
Seat 5: Hero folded before Flop (didn't bet)
Seat 6: b8c09f2 folded before Flop (didn't bet)


Poker Hand #RC3334564476: Hold'em No Limit ($0.02/$0.05) - 2025/02/17 21:33:48
Table 'RushAndCash629736' 6-max Seat #1 is the button
Seat 1: 83d04f0d ($6.19 in chips)
Seat 2: 20045c1 ($5 in chips)
Seat 3: b66c51bb ($6.06 in chips)
Seat 4: Hero ($9.09 in chips)
Seat 5: de38466f ($4.03 in chips)
Seat 6: a81aa4e3 ($5.35 in chips)
20045c1: posts small blind $0.02
b66c51bb: posts big blind $0.05
*** HOLE CARDS ***
Dealt to 83d04f0d 
Dealt to 20045c1 
Dealt to b66c51bb 
Dealt to Hero [Jc 3c]
Dealt to de38466f 
Dealt to a81aa4e3 
Hero: folds
de38466f: raises $0.05 to $0.1
a81aa4e3: folds
83d04f0d: folds
20045c1: folds
b66c51bb: folds
Uncalled bet ($0.05) returned to de38466f
*** SHOWDOWN ***
de38466f collected $0.12 from pot
*** SUMMARY ***
Total pot $0.12 | Rake $0 | Jackpot $0 | Bingo $0 | Fortune $0 | Tax $0
Seat 1: 83d04f0d (button) folded before Flop (didn't bet)
Seat 2: 20045c1 (small blind) folded before Flop
Seat 3: b66c51bb (big blind) folded before Flop
Seat 4: Hero folded before Flop (didn't bet)
Seat 5: de38466f collected ($0.12)
Seat 6: a81aa4e3 folded before Flop (didn't bet)


Poker Hand #RC3334564411: Hold'em No Limit ($0.02/$0.05) - 2025/02/17 21:33:41
Table 'RushAndCash629671' 6-max Seat #1 is the button
Seat 1: 235dd2d1 ($11.22 in chips)
Seat 2: Hero ($9.11 in chips)
Seat 3: af90d8d7 ($7.83 in chips)
Seat 4: 5fd404ad ($15.7 in chips)
Seat 5: b8123d32 ($5.12 in chips)
Seat 6: ac6c5037 ($8.14 in chips)
Hero: posts small blind $0.02
af90d8d7: posts big blind $0.05
*** HOLE CARDS ***
Dealt to 235dd2d1 
Dealt to Hero [Td Kc]
Dealt to af90d8d7 
Dealt to 5fd404ad 
Dealt to b8123d32 
Dealt to ac6c5037 
5fd404ad: raises $0.1 to $0.15
b8123d32: folds
ac6c5037: folds
235dd2d1: folds
Hero: folds
af90d8d7: folds
Uncalled bet ($0.1) returned to 5fd404ad
*** SHOWDOWN ***
5fd404ad collected $0.12 from pot
*** SUMMARY ***
Total pot $0.12 | Rake $0 | Jackpot $0 | Bingo $0 | Fortune $0 | Tax $0
Seat 1: 235dd2d1 (button) folded before Flop (didn't bet)
Seat 2: Hero (small blind) folded before Flop
Seat 3: af90d8d7 (big blind) folded before Flop
Seat 4: 5fd404ad collected ($0.12)
Seat 5: b8123d32 folded before Flop (didn't bet)
Seat 6: ac6c5037 folded before Flop (didn't bet)


Poker Hand #RC3334564385: Hold'em No Limit ($0.02/$0.05) - 2025/02/17 21:33:38
Table 'RushAndCash629645' 6-max Seat #1 is the button
Seat 1: 6de2662f ($6.15 in chips)
Seat 2: 167e28c4 ($10.96 in chips)
Seat 3: 426b60ef ($4.31 in chips)
Seat 4: 4e3c3196 ($31.08 in chips)
Seat 5: 6608ec00 ($5 in chips)
Seat 6: Hero ($9.11 in chips)
167e28c4: posts small blind $0.02
426b60ef: posts big blind $0.05
*** HOLE CARDS ***
Dealt to 6de2662f 
Dealt to 167e28c4 
Dealt to 426b60ef 
Dealt to 4e3c3196 
Dealt to 6608ec00 
Dealt to Hero [6s Qd]
4e3c3196: folds
6608ec00: folds
Hero: folds
6de2662f: folds
167e28c4: folds
Uncalled bet ($0.03) returned to 426b60ef
*** SHOWDOWN ***
426b60ef collected $0.04 from pot
*** SUMMARY ***
Total pot $0.04 | Rake $0 | Jackpot $0 | Bingo $0 | Fortune $0 | Tax $0
Seat 1: 6de2662f (button) folded before Flop (didn't bet)
Seat 2: 167e28c4 (small blind) folded before Flop
Seat 3: 426b60ef (big blind) collected ($0.04)
Seat 4: 4e3c3196 folded before Flop (didn't bet)
Seat 5: 6608ec00 folded before Flop (didn't bet)
Seat 6: Hero folded before Flop (didn't bet)


Poker Hand #RC3334564345: Hold'em No Limit ($0.02/$0.05) - 2025/02/17 21:33:33
Table 'RushAndCash629605' 6-max Seat #1 is the button
Seat 1: 2e8ab509 ($6.57 in chips)
Seat 2: 4c265d8a ($5 in chips)
Seat 3: db6b60a1 ($6.95 in chips)
Seat 4: a4bd9290 ($6.19 in chips)
Seat 5: Hero ($9.11 in chips)
Seat 6: 4e5ae3cb ($5.79 in chips)
4c265d8a: posts small blind $0.02
db6b60a1: posts big blind $0.05
*** HOLE CARDS ***
Dealt to 2e8ab509 
Dealt to 4c265d8a 
Dealt to db6b60a1 
Dealt to a4bd9290 
Dealt to Hero [2h 8h]
Dealt to 4e5ae3cb 
a4bd9290: folds
Hero: folds
4e5ae3cb: raises $0.07 to $0.12
2e8ab509: folds
4c265d8a: folds
db6b60a1: calls $0.07
*** FLOP *** [4h 4c 9d]
db6b60a1: checks
4e5ae3cb: bets $0.15
db6b60a1: folds
Uncalled bet ($0.15) returned to 4e5ae3cb
*** SHOWDOWN ***
4e5ae3cb collected $0.25 from pot
*** SUMMARY ***
Total pot $0.26 | Rake $0.01 | Jackpot $0 | Bingo $0 | Fortune $0 | Tax $0
Board [4h 4c 9d]
Seat 1: 2e8ab509 (button) folded before Flop (didn't bet)
Seat 2: 4c265d8a (small blind) folded before Flop
Seat 3: db6b60a1 (big blind) folded on the Flop
Seat 4: a4bd9290 folded before Flop (didn't bet)
Seat 5: Hero folded before Flop (didn't bet)
Seat 6: 4e5ae3cb won ($0.25)


Poker Hand #RC3334564316: Hold'em No Limit ($0.02/$0.05) - 2025/02/17 21:33:30
Table 'RushAndCash629576' 6-max Seat #1 is the button
Seat 1: eb1bbc7a ($6.21 in chips)
Seat 2: 9b09147b ($6.76 in chips)
Seat 3: 4b71998b ($11.59 in chips)
Seat 4: Hero ($9.11 in chips)
Seat 5: 961414b1 ($9.46 in chips)
Seat 6: af90d8d7 ($7.85 in chips)
9b09147b: posts small blind $0.02
4b71998b: posts big blind $0.05
*** HOLE CARDS ***
Dealt to eb1bbc7a 
Dealt to 9b09147b 
Dealt to 4b71998b 
Dealt to Hero [Qd 8d]
Dealt to 961414b1 
Dealt to af90d8d7 
Hero: folds
961414b1: folds
af90d8d7: folds
eb1bbc7a: folds
9b09147b: raises $0.1 to $0.15
4b71998b: folds
Uncalled bet ($0.1) returned to 9b09147b
*** SHOWDOWN ***
9b09147b collected $0.1 from pot
*** SUMMARY ***
Total pot $0.1 | Rake $0 | Jackpot $0 | Bingo $0 | Fortune $0 | Tax $0
Seat 1: eb1bbc7a (button) folded before Flop (didn't bet)
Seat 2: 9b09147b (small blind) collected ($0.1)
Seat 3: 4b71998b (big blind) folded before Flop
Seat 4: Hero folded before Flop (didn't bet)
Seat 5: 961414b1 folded before Flop (didn't bet)
Seat 6: af90d8d7 folded before Flop (didn't bet)


Poker Hand #RC3334564282: Hold'em No Limit ($0.02/$0.05) - 2025/02/17 21:33:26
Table 'RushAndCash629542' 6-max Seat #1 is the button
Seat 1: 826a79b4 ($6.3 in chips)
Seat 2: f85679bb ($5.11 in chips)
Seat 3: 35016d48 ($5 in chips)
Seat 4: dedffe42 ($3.44 in chips)
Seat 5: Hero ($9.11 in chips)
Seat 6: c3ca6759 ($5.38 in chips)
f85679bb: posts small blind $0.02
35016d48: posts big blind $0.05
*** HOLE CARDS ***
Dealt to 826a79b4 
Dealt to f85679bb 
Dealt to 35016d48 
Dealt to dedffe42 
Dealt to Hero [2d 7s]
Dealt to c3ca6759 
dedffe42: folds
Hero: folds
c3ca6759: folds
826a79b4: raises $0.06 to $0.11
f85679bb: folds
35016d48: folds
Uncalled bet ($0.06) returned to 826a79b4
*** SHOWDOWN ***
826a79b4 collected $0.12 from pot
*** SUMMARY ***
Total pot $0.12 | Rake $0 | Jackpot $0 | Bingo $0 | Fortune $0 | Tax $0
Seat 1: 826a79b4 (button) collected ($0.12)
Seat 2: f85679bb (small blind) folded before Flop
Seat 3: 35016d48 (big blind) folded before Flop
Seat 4: dedffe42 folded before Flop (didn't bet)
Seat 5: Hero folded before Flop (didn't bet)
Seat 6: c3ca6759 folded before Flop (didn't bet)


Poker Hand #RC3334564249: Hold'em No Limit ($0.02/$0.05) - 2025/02/17 21:33:23
Table 'RushAndCash629509' 6-max Seat #1 is the button
Seat 1: 961414b1 ($9.46 in chips)
Seat 2: 679a8f7 ($7.06 in chips)
Seat 3: Hero ($9.16 in chips)
Seat 4: edf2f3c ($5.89 in chips)
Seat 5: 47d6aff8 ($5.04 in chips)
Seat 6: 826a79b4 ($6.3 in chips)
679a8f7: posts small blind $0.02
Hero: posts big blind $0.05
*** HOLE CARDS ***
Dealt to 961414b1 
Dealt to 679a8f7 
Dealt to Hero [6d 7c]
Dealt to edf2f3c 
Dealt to 47d6aff8 
Dealt to 826a79b4 
edf2f3c: folds
47d6aff8: folds
826a79b4: folds
961414b1: folds
679a8f7: raises $0.1 to $0.15
Hero: folds
Uncalled bet ($0.1) returned to 679a8f7
*** SHOWDOWN ***
679a8f7 collected $0.1 from pot
*** SUMMARY ***
Total pot $0.1 | Rake $0 | Jackpot $0 | Bingo $0 | Fortune $0 | Tax $0
Seat 1: 961414b1 (button) folded before Flop (didn't bet)
Seat 2: 679a8f7 (small blind) collected ($0.1)
Seat 3: Hero (big blind) folded before Flop
Seat 4: edf2f3c folded before Flop (didn't bet)
Seat 5: 47d6aff8 folded before Flop (didn't bet)
Seat 6: 826a79b4 folded before Flop (didn't bet)


Poker Hand #RC3334564174: Hold'em No Limit ($0.02/$0.05) - 2025/02/17 21:33:14
Table 'RushAndCash629434' 6-max Seat #1 is the button
Seat 1: 367e3140 ($5.02 in chips)
Seat 2: 80c22e34 ($5.43 in chips)
Seat 3: Hero ($9.14 in chips)
Seat 4: 679a8f7 ($7.06 in chips)
Seat 5: ddbc9201 ($5 in chips)
Seat 6: bb96e95c ($5.18 in chips)
80c22e34: posts small blind $0.02
Hero: posts big blind $0.05
*** HOLE CARDS ***
Dealt to 367e3140 
Dealt to 80c22e34 
Dealt to Hero [7h Jh]
Dealt to 679a8f7 
Dealt to ddbc9201 
Dealt to bb96e95c 
679a8f7: folds
ddbc9201: folds
bb96e95c: folds
367e3140: folds
80c22e34: folds
Uncalled bet ($0.03) returned to Hero
*** SHOWDOWN ***
Hero collected $0.04 from pot
*** SUMMARY ***
Total pot $0.04 | Rake $0 | Jackpot $0 | Bingo $0 | Fortune $0 | Tax $0
Seat 1: 367e3140 (button) folded before Flop (didn't bet)
Seat 2: 80c22e34 (small blind) folded before Flop
Seat 3: Hero (big blind) collected ($0.04)
Seat 4: 679a8f7 folded before Flop (didn't bet)
Seat 5: ddbc9201 folded before Flop (didn't bet)
Seat 6: bb96e95c folded before Flop (didn't bet)


Poker Hand #RC3334564145: Hold'em No Limit ($0.02/$0.05) - 2025/02/17 21:33:11
Table 'RushAndCash629405' 6-max Seat #1 is the button
Seat 1: Hero ($9.14 in chips)
Seat 2: f56d4922 ($5.56 in chips)
Seat 3: d691d846 ($3.83 in chips)
Seat 4: 3b701823 ($5 in chips)
Seat 5: bd394772 ($7.23 in chips)
Seat 6: 34388f19 ($3.89 in chips)
f56d4922: posts small blind $0.02
d691d846: posts big blind $0.05
*** HOLE CARDS ***
Dealt to Hero [3d Qs]
Dealt to f56d4922 
Dealt to d691d846 
Dealt to 3b701823 
Dealt to bd394772 
Dealt to 34388f19 
3b701823: folds
bd394772: folds
34388f19: calls $0.05
Hero: folds
f56d4922: folds
d691d846: checks
*** FLOP *** [7d Ah 4c]
d691d846: checks
34388f19: bets $0.06
d691d846: folds
Uncalled bet ($0.06) returned to 34388f19
*** SHOWDOWN ***
34388f19 collected $0.12 from pot
*** SUMMARY ***
Total pot $0.12 | Rake $0 | Jackpot $0 | Bingo $0 | Fortune $0 | Tax $0
Board [7d Ah 4c]
Seat 1: Hero (button) folded before Flop (didn't bet)
Seat 2: f56d4922 (small blind) folded before Flop
Seat 3: d691d846 (big blind) folded on the Flop
Seat 4: 3b701823 folded before Flop (didn't bet)
Seat 5: bd394772 folded before Flop (didn't bet)
Seat 6: 34388f19 won ($0.12)


Poker Hand #RC3334564092: Hold'em No Limit ($0.02/$0.05) - 2025/02/17 21:33:04
Table 'RushAndCash629352' 6-max Seat #1 is the button
Seat 1: Hero ($9.14 in chips)
Seat 2: 79d81faa ($7.98 in chips)
Seat 3: ad31dea3 ($5.44 in chips)
Seat 4: 27baaa05 ($7.13 in chips)
Seat 5: a291e856 ($6.01 in chips)
Seat 6: afd28441 ($5.24 in chips)
79d81faa: posts small blind $0.02
ad31dea3: posts big blind $0.05
*** HOLE CARDS ***
Dealt to Hero [6s 3d]
Dealt to 79d81faa 
Dealt to ad31dea3 
Dealt to 27baaa05 
Dealt to a291e856 
Dealt to afd28441 
27baaa05: folds
a291e856: folds
afd28441: folds
Hero: folds
79d81faa: raises $0.06 to $0.11
ad31dea3: raises $0.23 to $0.34
79d81faa: folds
Uncalled bet ($0.23) returned to ad31dea3
*** SHOWDOWN ***
ad31dea3 collected $0.21 from pot
*** SUMMARY ***
Total pot $0.22 | Rake $0.01 | Jackpot $0 | Bingo $0 | Fortune $0 | Tax $0
Seat 1: Hero (button) folded before Flop (didn't bet)
Seat 2: 79d81faa (small blind) folded before Flop
Seat 3: ad31dea3 (big blind) collected ($0.21)
Seat 4: 27baaa05 folded before Flop (didn't bet)
Seat 5: a291e856 folded before Flop (didn't bet)
Seat 6: afd28441 folded before Flop (didn't bet)


Poker Hand #RC3334564067: Hold'em No Limit ($0.02/$0.05) - 2025/02/17 21:33:01
Table 'RushAndCash629327' 6-max Seat #1 is the button
Seat 1: c0a90b1a ($5.35 in chips)
Seat 2: f9d64f1a ($5.58 in chips)
Seat 3: 8c3789e ($6.37 in chips)
Seat 4: 8e07c53 ($6.12 in chips)
Seat 5: 42fca4f9 ($10.15 in chips)
Seat 6: Hero ($9.14 in chips)
f9d64f1a: posts small blind $0.02
8c3789e: posts big blind $0.05
*** HOLE CARDS ***
Dealt to c0a90b1a 
Dealt to f9d64f1a 
Dealt to 8c3789e 
Dealt to 8e07c53 
Dealt to 42fca4f9 
Dealt to Hero [5h 3h]
8e07c53: folds
42fca4f9: folds
Hero: folds
c0a90b1a: folds
f9d64f1a: raises $0.09 to $0.14
8c3789e: folds
Uncalled bet ($0.09) returned to f9d64f1a
*** SHOWDOWN ***
f9d64f1a collected $0.1 from pot
*** SUMMARY ***
Total pot $0.1 | Rake $0 | Jackpot $0 | Bingo $0 | Fortune $0 | Tax $0
Seat 1: c0a90b1a (button) folded before Flop (didn't bet)
Seat 2: f9d64f1a (small blind) collected ($0.1)
Seat 3: 8c3789e (big blind) folded before Flop
Seat 4: 8e07c53 folded before Flop (didn't bet)
Seat 5: 42fca4f9 folded before Flop (didn't bet)
Seat 6: Hero folded before Flop (didn't bet)


Poker Hand #RC3334564036: Hold'em No Limit ($0.02/$0.05) - 2025/02/17 21:32:57
Table 'RushAndCash629296' 6-max Seat #1 is the button
Seat 1: 46fb98 ($5 in chips)
Seat 2: Hero ($9.16 in chips)
Seat 3: 1606744a ($6.23 in chips)
Seat 4: 5e166e9a ($9.41 in chips)
Seat 5: 75a97e80 ($5.35 in chips)
Seat 6: 79d81faa ($7.98 in chips)
Hero: posts small blind $0.02
1606744a: posts big blind $0.05
*** HOLE CARDS ***
Dealt to 46fb98 
Dealt to Hero [4h 6h]
Dealt to 1606744a 
Dealt to 5e166e9a 
Dealt to 75a97e80 
Dealt to 79d81faa 
5e166e9a: raises $0.06 to $0.11
75a97e80: folds
79d81faa: folds
46fb98: folds
Hero: folds
1606744a: calls $0.06
*** FLOP *** [8s 9c 7c]
1606744a: checks
5e166e9a: checks
*** TURN *** [8s 9c 7c] [2d]
1606744a: checks
5e166e9a: checks
*** RIVER *** [8s 9c 7c 2d] [6s]
1606744a: checks
5e166e9a: checks
1606744a: shows [Kc Ac] (Ace-High)
5e166e9a: shows [Qd Ks] (King-High)
*** SHOWDOWN ***
1606744a collected $0.23 from pot
*** SUMMARY ***
Total pot $0.24 | Rake $0.01 | Jackpot $0 | Bingo $0 | Fortune $0 | Tax $0
Board [8s 9c 7c 2d 6s]
Seat 1: 46fb98 (button) folded before Flop (didn't bet)
Seat 2: Hero (small blind) folded before Flop
Seat 3: 1606744a (big blind) showed [Kc Ac] and won ($0.23) with Ace-High
Seat 4: 5e166e9a showed [Qd Ks] and lost with King-High
Seat 5: 75a97e80 folded before Flop (didn't bet)
Seat 6: 79d81faa folded before Flop (didn't bet)


Poker Hand #RC3334564006: Hold'em No Limit ($0.02/$0.05) - 2025/02/17 21:32:54
Table 'RushAndCash629266' 6-max Seat #1 is the button
Seat 1: 69c3afd2 ($4.4 in chips)
Seat 2: Hero ($9.18 in chips)
Seat 3: f71501ed ($5.3 in chips)
Seat 4: 5337265e ($12.22 in chips)
Seat 5: c16b612d ($5.8 in chips)
Seat 6: 493727d2 ($10.69 in chips)
Hero: posts small blind $0.02
f71501ed: posts big blind $0.05
*** HOLE CARDS ***
Dealt to 69c3afd2 
Dealt to Hero [7s 8c]
Dealt to f71501ed 
Dealt to 5337265e 
Dealt to c16b612d 
Dealt to 493727d2 
5337265e: folds
c16b612d: folds
493727d2: folds
69c3afd2: folds
Hero: folds
Uncalled bet ($0.03) returned to f71501ed
*** SHOWDOWN ***
f71501ed collected $0.04 from pot
*** SUMMARY ***
Total pot $0.04 | Rake $0 | Jackpot $0 | Bingo $0 | Fortune $0 | Tax $0
Seat 1: 69c3afd2 (button) folded before Flop (didn't bet)
Seat 2: Hero (small blind) folded before Flop
Seat 3: f71501ed (big blind) collected ($0.04)
Seat 4: 5337265e folded before Flop (didn't bet)
Seat 5: c16b612d folded before Flop (didn't bet)
Seat 6: 493727d2 folded before Flop (didn't bet)


Poker Hand #RC3334563964: Hold'em No Limit ($0.02/$0.05) - 2025/02/17 21:32:49
Table 'RushAndCash629224' 6-max Seat #1 is the button
Seat 1: 9864109b ($5.71 in chips)
Seat 2: 4e5ae3cb ($6.17 in chips)
Seat 3: 5e166e9a ($9.46 in chips)
Seat 4: Hero ($9.18 in chips)
Seat 5: d3671a33 ($3.46 in chips)
Seat 6: 9da6ba55 ($5.37 in chips)
4e5ae3cb: posts small blind $0.02
5e166e9a: posts big blind $0.05
*** HOLE CARDS ***
Dealt to 9864109b 
Dealt to 4e5ae3cb 
Dealt to 5e166e9a 
Dealt to Hero [6h 5d]
Dealt to d3671a33 
Dealt to 9da6ba55 
Hero: folds
d3671a33: raises $0.1 to $0.15
9da6ba55: folds
9864109b: folds
4e5ae3cb: calls $0.13
5e166e9a: folds
*** FLOP *** [Kc 2d 5c]
4e5ae3cb: checks
d3671a33: bets $0.18
4e5ae3cb: calls $0.18
*** TURN *** [Kc 2d 5c] [Ah]
4e5ae3cb: checks
d3671a33: bets $0.36
4e5ae3cb: folds
Uncalled bet ($0.36) returned to d3671a33
*** SHOWDOWN ***
d3671a33 collected $0.68 from pot
*** SUMMARY ***
Total pot $0.71 | Rake $0.03 | Jackpot $0 | Bingo $0 | Fortune $0 | Tax $0
Board [Kc 2d 5c Ah]
Seat 1: 9864109b (button) folded before Flop (didn't bet)
Seat 2: 4e5ae3cb (small blind) folded on the Turn
Seat 3: 5e166e9a (big blind) folded before Flop
Seat 4: Hero folded before Flop (didn't bet)
Seat 5: d3671a33 won ($0.68)
Seat 6: 9da6ba55 folded before Flop (didn't bet)


Poker Hand #RC3334563909: Hold'em No Limit ($0.02/$0.05) - 2025/02/17 21:32:43
Table 'RushAndCash629169' 6-max Seat #1 is the button
Seat 1: Hero ($9.18 in chips)
Seat 2: fb8cc108 ($5.09 in chips)
Seat 3: cd69b3e5 ($4.43 in chips)
Seat 4: e7a0ba42 ($22.11 in chips)
Seat 5: 12cda2e0 ($22.09 in chips)
Seat 6: 2f650001 ($4.91 in chips)
fb8cc108: posts small blind $0.02
cd69b3e5: posts big blind $0.05
*** HOLE CARDS ***
Dealt to Hero [9c Jc]
Dealt to fb8cc108 
Dealt to cd69b3e5 
Dealt to e7a0ba42 
Dealt to 12cda2e0 
Dealt to 2f650001 
e7a0ba42: folds
12cda2e0: raises $0.08 to $0.13
2f650001: folds
Hero: folds
fb8cc108: folds
cd69b3e5: calls $0.08
*** FLOP *** [6d 9s Kd]
cd69b3e5: checks
12cda2e0: bets $0.21
cd69b3e5: folds
Uncalled bet ($0.21) returned to 12cda2e0
*** SHOWDOWN ***
12cda2e0 collected $0.27 from pot
*** SUMMARY ***
Total pot $0.28 | Rake $0.01 | Jackpot $0 | Bingo $0 | Fortune $0 | Tax $0
Board [6d 9s Kd]
Seat 1: Hero (button) folded before Flop (didn't bet)
Seat 2: fb8cc108 (small blind) folded before Flop
Seat 3: cd69b3e5 (big blind) folded on the Flop
Seat 4: e7a0ba42 folded before Flop (didn't bet)
Seat 5: 12cda2e0 won ($0.27)
Seat 6: 2f650001 folded before Flop (didn't bet)


Poker Hand #RC3334563879: Hold'em No Limit ($0.02/$0.05) - 2025/02/17 21:32:39
Table 'RushAndCash629139' 6-max Seat #1 is the button
Seat 1: 2f650001 ($4.91 in chips)
Seat 2: b54d616e ($5.5 in chips)
Seat 3: 702c0f17 ($4.96 in chips)
Seat 4: 80c22e34 ($5.36 in chips)
Seat 5: Hero ($9.18 in chips)
Seat 6: ab43c8b8 ($9.49 in chips)
b54d616e: posts small blind $0.02
702c0f17: posts big blind $0.05
*** HOLE CARDS ***
Dealt to 2f650001 
Dealt to b54d616e 
Dealt to 702c0f17 
Dealt to 80c22e34 
Dealt to Hero [8s 6d]
Dealt to ab43c8b8 
80c22e34: folds
Hero: folds
ab43c8b8: raises $0.05 to $0.1
2f650001: folds
b54d616e: folds
702c0f17: folds
Uncalled bet ($0.05) returned to ab43c8b8
*** SHOWDOWN ***
ab43c8b8 collected $0.12 from pot
*** SUMMARY ***
Total pot $0.12 | Rake $0 | Jackpot $0 | Bingo $0 | Fortune $0 | Tax $0
Seat 1: 2f650001 (button) folded before Flop (didn't bet)
Seat 2: b54d616e (small blind) folded before Flop
Seat 3: 702c0f17 (big blind) folded before Flop
Seat 4: 80c22e34 folded before Flop (didn't bet)
Seat 5: Hero folded before Flop (didn't bet)
Seat 6: ab43c8b8 collected ($0.12)


Poker Hand #RC3334563854: Hold'em No Limit ($0.02/$0.05) - 2025/02/17 21:32:36
Table 'RushAndCash629114' 6-max Seat #1 is the button
Seat 1: 5abb6a6d ($3.4 in chips)
Seat 2: ab43c8b8 ($9.51 in chips)
Seat 3: Hero ($9.23 in chips)
Seat 4: 702c0f17 ($4.96 in chips)
Seat 5: c9f8ff1c ($5.26 in chips)
Seat 6: f03e6fec ($5.53 in chips)
ab43c8b8: posts small blind $0.02
Hero: posts big blind $0.05
*** HOLE CARDS ***
Dealt to 5abb6a6d 
Dealt to ab43c8b8 
Dealt to Hero [5h 9d]
Dealt to 702c0f17 
Dealt to c9f8ff1c 
Dealt to f03e6fec 
702c0f17: folds
c9f8ff1c: raises $0.08 to $0.13
f03e6fec: folds
5abb6a6d: folds
ab43c8b8: folds
Hero: folds
Uncalled bet ($0.08) returned to c9f8ff1c
*** SHOWDOWN ***
c9f8ff1c collected $0.12 from pot
*** SUMMARY ***
Total pot $0.12 | Rake $0 | Jackpot $0 | Bingo $0 | Fortune $0 | Tax $0
Seat 1: 5abb6a6d (button) folded before Flop (didn't bet)
Seat 2: ab43c8b8 (small blind) folded before Flop
Seat 3: Hero (big blind) folded before Flop
Seat 4: 702c0f17 folded before Flop (didn't bet)
Seat 5: c9f8ff1c collected ($0.12)
Seat 6: f03e6fec folded before Flop (didn't bet)


Poker Hand #RC3334563818: Hold'em No Limit ($0.02/$0.05) - 2025/02/17 21:32:32
Table 'RushAndCash629078' 6-max Seat #1 is the button
Seat 1: b0c3ff95 ($10.46 in chips)
Seat 2: 49b4f33a ($15.84 in chips)
Seat 3: 56b9b8a5 ($5.18 in chips)
Seat 4: 573eb753 ($7.27 in chips)
Seat 5: Hero ($9.23 in chips)
Seat 6: 23c23672 ($6.78 in chips)
49b4f33a: posts small blind $0.02
56b9b8a5: posts big blind $0.05
*** HOLE CARDS ***
Dealt to b0c3ff95 
Dealt to 49b4f33a 
Dealt to 56b9b8a5 
Dealt to 573eb753 
Dealt to Hero [5d 7c]
Dealt to 23c23672 
573eb753: folds
Hero: folds
23c23672: raises $0.06 to $0.11
b0c3ff95: folds
49b4f33a: folds
56b9b8a5: folds
Uncalled bet ($0.06) returned to 23c23672
*** SHOWDOWN ***
23c23672 collected $0.12 from pot
*** SUMMARY ***
Total pot $0.12 | Rake $0 | Jackpot $0 | Bingo $0 | Fortune $0 | Tax $0
Seat 1: b0c3ff95 (button) folded before Flop (didn't bet)
Seat 2: 49b4f33a (small blind) folded before Flop
Seat 3: 56b9b8a5 (big blind) folded before Flop
Seat 4: 573eb753 folded before Flop (didn't bet)
Seat 5: Hero folded before Flop (didn't bet)
Seat 6: 23c23672 collected ($0.12)


Poker Hand #RC3334563765: Hold'em No Limit ($0.02/$0.05) - 2025/02/17 21:32:25
Table 'RushAndCash629025' 6-max Seat #1 is the button
Seat 1: 83d04f0d ($5.05 in chips)
Seat 2: aa2d17c0 ($9.62 in chips)
Seat 3: 3b701823 ($5 in chips)
Seat 4: d0a192cb ($4.68 in chips)
Seat 5: Hero ($9.23 in chips)
Seat 6: 2a10169c ($5 in chips)
aa2d17c0: posts small blind $0.02
3b701823: posts big blind $0.05
*** HOLE CARDS ***
Dealt to 83d04f0d 
Dealt to aa2d17c0 
Dealt to 3b701823 
Dealt to d0a192cb 
Dealt to Hero [2s 7s]
Dealt to 2a10169c 
d0a192cb: folds
Hero: folds
2a10169c: folds
83d04f0d: raises $0.05 to $0.1
aa2d17c0: calls $0.08
3b701823: calls $0.05
*** FLOP *** [Jh 8h Ah]
aa2d17c0: checks
3b701823: checks
83d04f0d: bets $0.15
aa2d17c0: calls $0.15
3b701823: folds
*** TURN *** [Jh 8h Ah] [3h]
aa2d17c0: checks
83d04f0d: bets $0.3
aa2d17c0: raises $0.6 to $0.9
83d04f0d: calls $0.6
*** RIVER *** [Jh 8h Ah 3h] [Qs]
aa2d17c0: checks
83d04f0d: bets $1.2
aa2d17c0: folds
Uncalled bet ($1.2) returned to 83d04f0d
*** SHOWDOWN ***
83d04f0d collected $2.22 from pot
*** SUMMARY ***
Total pot $2.4 | Rake $0.11 | Jackpot $0.07 | Bingo $0 | Fortune $0 | Tax $0
Board [Jh 8h Ah 3h Qs]
Seat 1: 83d04f0d (button) won ($2.22)
Seat 2: aa2d17c0 (small blind) folded on the River
Seat 3: 3b701823 (big blind) folded on the Flop
Seat 4: d0a192cb folded before Flop (didn't bet)
Seat 5: Hero folded before Flop (didn't bet)
Seat 6: 2a10169c folded before Flop (didn't bet)


Poker Hand #RC3334563547: Hold'em No Limit ($0.02/$0.05) - 2025/02/17 21:31:59
Table 'RushAndCash628807' 6-max Seat #1 is the button
Seat 1: 679a8f7 ($7.34 in chips)
Seat 2: 553d6ccb ($5 in chips)
Seat 3: Hero ($9.04 in chips)
Seat 4: 71ee6520 ($5.98 in chips)
Seat 5: d0a192cb ($4.86 in chips)
Seat 6: 3b98b9ec ($18.68 in chips)
553d6ccb: posts small blind $0.02
Hero: posts big blind $0.05
*** HOLE CARDS ***
Dealt to 679a8f7 
Dealt to 553d6ccb 
Dealt to Hero [4d 4c]
Dealt to 71ee6520 
Dealt to d0a192cb 
Dealt to 3b98b9ec 
71ee6520: folds
d0a192cb: raises $0.05 to $0.1
3b98b9ec: folds
679a8f7: folds
553d6ccb: folds
Hero: calls $0.05
*** FLOP *** [2h 3c 5d]
Hero: checks
d0a192cb: bets $0.08
Hero: calls $0.08
*** TURN *** [2h 3c 5d] [6s]
Hero: checks
d0a192cb: checks
*** RIVER *** [2h 3c 5d 6s] [6c]
Hero: bets $0.2
d0a192cb: folds
Uncalled bet ($0.2) returned to Hero
*** SHOWDOWN ***
Hero collected $0.37 from pot
*** SUMMARY ***
Total pot $0.38 | Rake $0.01 | Jackpot $0 | Bingo $0 | Fortune $0 | Tax $0
Board [2h 3c 5d 6s 6c]
Seat 1: 679a8f7 (button) folded before Flop (didn't bet)
Seat 2: 553d6ccb (small blind) folded before Flop
Seat 3: Hero (big blind) won ($0.37)
Seat 4: 71ee6520 folded before Flop (didn't bet)
Seat 5: d0a192cb folded on the River
Seat 6: 3b98b9ec folded before Flop (didn't bet)


Poker Hand #RC3334563518: Hold'em No Limit ($0.02/$0.05) - 2025/02/17 21:31:56
Table 'RushAndCash628778' 6-max Seat #1 is the button
Seat 1: 2a10169c ($5.03 in chips)
Seat 2: 52f54c69 ($5.73 in chips)
Seat 3: 4ebd5be6 ($5.43 in chips)
Seat 4: Hero ($9.04 in chips)
Seat 5: 8d7c8253 ($5.62 in chips)
Seat 6: ee3fdfd8 ($5.09 in chips)
52f54c69: posts small blind $0.02
4ebd5be6: posts big blind $0.05
*** HOLE CARDS ***
Dealt to 2a10169c 
Dealt to 52f54c69 
Dealt to 4ebd5be6 
Dealt to Hero [Qs 2c]
Dealt to 8d7c8253 
Dealt to ee3fdfd8 
Hero: folds
8d7c8253: folds
ee3fdfd8: raises $0.05 to $0.1
2a10169c: folds
52f54c69: folds
4ebd5be6: folds
Uncalled bet ($0.05) returned to ee3fdfd8
*** SHOWDOWN ***
ee3fdfd8 collected $0.12 from pot
*** SUMMARY ***
Total pot $0.12 | Rake $0 | Jackpot $0 | Bingo $0 | Fortune $0 | Tax $0
Seat 1: 2a10169c (button) folded before Flop (didn't bet)
Seat 2: 52f54c69 (small blind) folded before Flop
Seat 3: 4ebd5be6 (big blind) folded before Flop
Seat 4: Hero folded before Flop (didn't bet)
Seat 5: 8d7c8253 folded before Flop (didn't bet)
Seat 6: ee3fdfd8 collected ($0.12)


Poker Hand #RC3334563440: Hold'em No Limit ($0.02/$0.05) - 2025/02/17 21:31:47
Table 'RushAndCash628700' 6-max Seat #1 is the button
Seat 1: 5466aa49 ($5.64 in chips)
Seat 2: 9604af2 ($6.53 in chips)
Seat 3: fd5b33a8 ($5.59 in chips)
Seat 4: dbb7a28 ($10.49 in chips)
Seat 5: Hero ($9.04 in chips)
Seat 6: 1606744a ($5.81 in chips)
9604af2: posts small blind $0.02
fd5b33a8: posts big blind $0.05
*** HOLE CARDS ***
Dealt to 5466aa49 
Dealt to 9604af2 
Dealt to fd5b33a8 
Dealt to dbb7a28 
Dealt to Hero [Ts 8c]
Dealt to 1606744a 
dbb7a28: folds
Hero: folds
1606744a: calls $0.05
5466aa49: folds
9604af2: folds
fd5b33a8: checks
*** FLOP *** [Td 3s 7s]
fd5b33a8: checks
1606744a: checks
*** TURN *** [Td 3s 7s] [2h]
fd5b33a8: checks
1606744a: checks
*** RIVER *** [Td 3s 7s 2h] [8d]
fd5b33a8: checks
1606744a: checks
fd5b33a8: shows [Tc 9h] (Pair of Tens)
1606744a: shows [9c Qc] (Queen-High)
*** SHOWDOWN ***
fd5b33a8 collected $0.12 from pot
*** SUMMARY ***
Total pot $0.12 | Rake $0 | Jackpot $0 | Bingo $0 | Fortune $0 | Tax $0
Board [Td 3s 7s 2h 8d]
Seat 1: 5466aa49 (button) folded before Flop (didn't bet)
Seat 2: 9604af2 (small blind) folded before Flop
Seat 3: fd5b33a8 (big blind) showed [Tc 9h] and won ($0.12) with Pair of Tens
Seat 4: dbb7a28 folded before Flop (didn't bet)
Seat 5: Hero folded before Flop (didn't bet)
Seat 6: 1606744a showed [9c Qc] and lost with Queen-High


Poker Hand #RC3334563413: Hold'em No Limit ($0.02/$0.05) - 2025/02/17 21:31:44
Table 'RushAndCash628673' 6-max Seat #1 is the button
Seat 1: 598d859f ($15.42 in chips)
Seat 2: fea7bb48 ($7.59 in chips)
Seat 3: ac56502f ($1.77 in chips)
Seat 4: 189fa0ee ($5.93 in chips)
Seat 5: Hero ($9.04 in chips)
Seat 6: cf6b193c ($13.95 in chips)
fea7bb48: posts small blind $0.02
ac56502f: posts big blind $0.05
*** HOLE CARDS ***
Dealt to 598d859f 
Dealt to fea7bb48 
Dealt to ac56502f 
Dealt to 189fa0ee 
Dealt to Hero [3h Ks]
Dealt to cf6b193c 
189fa0ee: folds
Hero: folds
cf6b193c: folds
598d859f: raises $0.08 to $0.13
fea7bb48: raises $0.24 to $0.37
ac56502f: folds
598d859f: calls $0.24
*** FLOP *** [8h 4d 4s]
fea7bb48: bets $0.4
598d859f: folds
Uncalled bet ($0.4) returned to fea7bb48
*** SHOWDOWN ***
fea7bb48 collected $0.75 from pot
*** SUMMARY ***
Total pot $0.79 | Rake $0.04 | Jackpot $0 | Bingo $0 | Fortune $0 | Tax $0
Board [8h 4d 4s]
Seat 1: 598d859f (button) folded on the Flop
Seat 2: fea7bb48 (small blind) won ($0.75)
Seat 3: ac56502f (big blind) folded before Flop
Seat 4: 189fa0ee folded before Flop (didn't bet)
Seat 5: Hero folded before Flop (didn't bet)
Seat 6: cf6b193c folded before Flop (didn't bet)


Poker Hand #RC3334563090: Hold'em No Limit ($0.02/$0.05) - 2025/02/17 21:31:06
Table 'RushAndCash628350' 6-max Seat #1 is the button
Seat 1: Hero ($9.15 in chips)
Seat 2: 8c6d38f2 ($5.34 in chips)
Seat 3: 6b09dc81 ($4.78 in chips)
Seat 4: 6be17d4e ($5.5 in chips)
Seat 5: 12cda2e0 ($22.4 in chips)
Seat 6: 5daef2fa ($5.92 in chips)
8c6d38f2: posts small blind $0.02
6b09dc81: posts big blind $0.05
*** HOLE CARDS ***
Dealt to Hero [Qs 6s]
Dealt to 8c6d38f2 
Dealt to 6b09dc81 
Dealt to 6be17d4e 
Dealt to 12cda2e0 
Dealt to 5daef2fa 
6be17d4e: folds
12cda2e0: folds
5daef2fa: folds
Hero: raises $0.05 to $0.1
8c6d38f2: folds
6b09dc81: calls $0.05
*** FLOP *** [As Ks 3h]
6b09dc81: checks
Hero: bets $0.08
6b09dc81: calls $0.08
*** TURN *** [As Ks 3h] [Td]
6b09dc81: checks
Hero: checks
*** RIVER *** [As Ks 3h Td] [4h]
6b09dc81: checks
Hero: checks
6b09dc81: shows [Ad 6d] (Pair of Aces)
Hero: shows [Qs 6s] (Ace-High)
*** SHOWDOWN ***
6b09dc81 collected $0.37 from pot
*** SUMMARY ***
Total pot $0.38 | Rake $0.01 | Jackpot $0 | Bingo $0 | Fortune $0 | Tax $0
Board [As Ks 3h Td 4h]
Seat 1: Hero (button) showed [Qs 6s] and lost with Ace-High
Seat 2: 8c6d38f2 (small blind) folded before Flop
Seat 3: 6b09dc81 (big blind) showed [Ad 6d] and won ($0.37) with Pair of Aces
Seat 4: 6be17d4e folded before Flop (didn't bet)
Seat 5: 12cda2e0 folded before Flop (didn't bet)
Seat 6: 5daef2fa folded before Flop (didn't bet)


Poker Hand #RC3334563064: Hold'em No Limit ($0.02/$0.05) - 2025/02/17 21:31:03
Table 'RushAndCash628324' 6-max Seat #1 is the button
Seat 1: ccabd9d2 ($6.27 in chips)
Seat 2: 717e9861 ($5.68 in chips)
Seat 3: eb21bc62 ($3.22 in chips)
Seat 4: Hero ($9.15 in chips)
Seat 5: 21e0e4ee ($5 in chips)
Seat 6: c5f37c20 ($2.62 in chips)
717e9861: posts small blind $0.02
eb21bc62: posts big blind $0.05
*** HOLE CARDS ***
Dealt to ccabd9d2 
Dealt to 717e9861 
Dealt to eb21bc62 
Dealt to Hero [2d 3c]
Dealt to 21e0e4ee 
Dealt to c5f37c20 
Hero: folds
21e0e4ee: raises $0.07 to $0.12
c5f37c20: folds
ccabd9d2: folds
717e9861: folds
eb21bc62: folds
Uncalled bet ($0.07) returned to 21e0e4ee
*** SHOWDOWN ***
21e0e4ee collected $0.12 from pot
*** SUMMARY ***
Total pot $0.12 | Rake $0 | Jackpot $0 | Bingo $0 | Fortune $0 | Tax $0
Seat 1: ccabd9d2 (button) folded before Flop (didn't bet)
Seat 2: 717e9861 (small blind) folded before Flop
Seat 3: eb21bc62 (big blind) folded before Flop
Seat 4: Hero folded before Flop (didn't bet)
Seat 5: 21e0e4ee collected ($0.12)
Seat 6: c5f37c20 folded before Flop (didn't bet)


Poker Hand #RC3334563036: Hold'em No Limit ($0.02/$0.05) - 2025/02/17 21:31:00
Table 'RushAndCash628296' 6-max Seat #1 is the button
Seat 1: f4ed7f83 ($5.09 in chips)
Seat 2: 5381eb4c ($7.53 in chips)
Seat 3: Hero ($9.2 in chips)
Seat 4: d163f8fc ($5.78 in chips)
Seat 5: af90d8d7 ($7.99 in chips)
Seat 6: 7cf365ea ($5.77 in chips)
5381eb4c: posts small blind $0.02
Hero: posts big blind $0.05
*** HOLE CARDS ***
Dealt to f4ed7f83 
Dealt to 5381eb4c 
Dealt to Hero [7c 4h]
Dealt to d163f8fc 
Dealt to af90d8d7 
Dealt to 7cf365ea 
d163f8fc: folds
af90d8d7: folds
7cf365ea: folds
f4ed7f83: folds
5381eb4c: folds
Uncalled bet ($0.03) returned to Hero
*** SHOWDOWN ***
Hero collected $0.04 from pot
*** SUMMARY ***
Total pot $0.04 | Rake $0 | Jackpot $0 | Bingo $0 | Fortune $0 | Tax $0
Seat 1: f4ed7f83 (button) folded before Flop (didn't bet)
Seat 2: 5381eb4c (small blind) folded before Flop
Seat 3: Hero (big blind) collected ($0.04)
Seat 4: d163f8fc folded before Flop (didn't bet)
Seat 5: af90d8d7 folded before Flop (didn't bet)
Seat 6: 7cf365ea folded before Flop (didn't bet)


Poker Hand #RC3334563006: Hold'em No Limit ($0.02/$0.05) - 2025/02/17 21:30:56
Table 'RushAndCash628266' 6-max Seat #1 is the button
Seat 1: b2966865 ($12.08 in chips)
Seat 2: b01e47a0 ($6.32 in chips)
Seat 3: 650e9dc7 ($11.15 in chips)
Seat 4: Hero ($9.2 in chips)
Seat 5: 6b09dc81 ($4.78 in chips)
Seat 6: 3d537b07 ($5.25 in chips)
b01e47a0: posts small blind $0.02
650e9dc7: posts big blind $0.05
*** HOLE CARDS ***
Dealt to b2966865 
Dealt to b01e47a0 
Dealt to 650e9dc7 
Dealt to Hero [Js 6d]
Dealt to 6b09dc81 
Dealt to 3d537b07 
Hero: folds
6b09dc81: folds
3d537b07: folds
b2966865: raises $0.05 to $0.1
b01e47a0: folds
650e9dc7: folds
Uncalled bet ($0.05) returned to b2966865
*** SHOWDOWN ***
b2966865 collected $0.12 from pot
*** SUMMARY ***
Total pot $0.12 | Rake $0 | Jackpot $0 | Bingo $0 | Fortune $0 | Tax $0
Seat 1: b2966865 (button) collected ($0.12)
Seat 2: b01e47a0 (small blind) folded before Flop
Seat 3: 650e9dc7 (big blind) folded before Flop
Seat 4: Hero folded before Flop (didn't bet)
Seat 5: 6b09dc81 folded before Flop (didn't bet)
Seat 6: 3d537b07 folded before Flop (didn't bet)


Poker Hand #RC3334562976: Hold'em No Limit ($0.02/$0.05) - 2025/02/17 21:30:53
Table 'RushAndCash628236' 6-max Seat #1 is the button
Seat 1: ad31dea3 ($5.16 in chips)
Seat 2: 93a6c244 ($15.29 in chips)
Seat 3: 71ee6520 ($5.82 in chips)
Seat 4: ca7c2b72 ($5.02 in chips)
Seat 5: 7cf365ea ($5.77 in chips)
Seat 6: Hero ($9.2 in chips)
93a6c244: posts small blind $0.02
71ee6520: posts big blind $0.05
*** HOLE CARDS ***
Dealt to ad31dea3 
Dealt to 93a6c244 
Dealt to 71ee6520 
Dealt to ca7c2b72 
Dealt to 7cf365ea 
Dealt to Hero [Ts 7h]
ca7c2b72: folds
7cf365ea: folds
Hero: folds
ad31dea3: folds
93a6c244: raises $0.1 to $0.15
71ee6520: folds
Uncalled bet ($0.1) returned to 93a6c244
*** SHOWDOWN ***
93a6c244 collected $0.1 from pot
*** SUMMARY ***
Total pot $0.1 | Rake $0 | Jackpot $0 | Bingo $0 | Fortune $0 | Tax $0
Seat 1: ad31dea3 (button) folded before Flop (didn't bet)
Seat 2: 93a6c244 (small blind) collected ($0.1)
Seat 3: 71ee6520 (big blind) folded before Flop
Seat 4: ca7c2b72 folded before Flop (didn't bet)
Seat 5: 7cf365ea folded before Flop (didn't bet)
Seat 6: Hero folded before Flop (didn't bet)


Poker Hand #RC3334562948: Hold'em No Limit ($0.02/$0.05) - 2025/02/17 21:30:50
Table 'RushAndCash628208' 6-max Seat #1 is the button
Seat 1: 8196f154 ($5 in chips)
Seat 2: Hero ($9.22 in chips)
Seat 3: baaf0b0d ($13.75 in chips)
Seat 4: 8cf3ad10 ($7.47 in chips)
Seat 5: bebd931c ($4.6 in chips)
Seat 6: 530477b2 ($5.13 in chips)
Hero: posts small blind $0.02
baaf0b0d: posts big blind $0.05
*** HOLE CARDS ***
Dealt to 8196f154 
Dealt to Hero [5h 8d]
Dealt to baaf0b0d 
Dealt to 8cf3ad10 
Dealt to bebd931c 
Dealt to 530477b2 
8cf3ad10: folds
bebd931c: raises $0.06 to $0.11
530477b2: folds
8196f154: folds
Hero: folds
baaf0b0d: folds
Uncalled bet ($0.06) returned to bebd931c
*** SHOWDOWN ***
bebd931c collected $0.12 from pot
*** SUMMARY ***
Total pot $0.12 | Rake $0 | Jackpot $0 | Bingo $0 | Fortune $0 | Tax $0
Seat 1: 8196f154 (button) folded before Flop (didn't bet)
Seat 2: Hero (small blind) folded before Flop
Seat 3: baaf0b0d (big blind) folded before Flop
Seat 4: 8cf3ad10 folded before Flop (didn't bet)
Seat 5: bebd931c collected ($0.12)
Seat 6: 530477b2 folded before Flop (didn't bet)


Poker Hand #RC3334562920: Hold'em No Limit ($0.02/$0.05) - 2025/02/17 21:30:47
Table 'RushAndCash628180' 6-max Seat #1 is the button
Seat 1: 11224f8 ($10.15 in chips)
Seat 2: 89bcbb95 ($8.8 in chips)
Seat 3: Hero ($9.27 in chips)
Seat 4: baaf0b0d ($13.75 in chips)
Seat 5: c00cefa1 ($5 in chips)
Seat 6: b8c09f2 ($6.83 in chips)
89bcbb95: posts small blind $0.02
Hero: posts big blind $0.05
*** HOLE CARDS ***
Dealt to 11224f8 
Dealt to 89bcbb95 
Dealt to Hero [2d 9d]
Dealt to baaf0b0d 
Dealt to c00cefa1 
Dealt to b8c09f2 
baaf0b0d: folds
c00cefa1: folds
b8c09f2: raises $0.1 to $0.15
11224f8: calls $0.15
89bcbb95: folds
Hero: folds
*** FLOP *** [3c 9c 9s]
b8c09f2: checks
11224f8: checks
*** TURN *** [3c 9c 9s] [Kh]
b8c09f2: checks
11224f8: checks
*** RIVER *** [3c 9c 9s Kh] [2h]
b8c09f2: checks
11224f8: bets $0.28
b8c09f2: folds
Uncalled bet ($0.28) returned to 11224f8
*** SHOWDOWN ***
11224f8 collected $0.36 from pot
*** SUMMARY ***
Total pot $0.37 | Rake $0.01 | Jackpot $0 | Bingo $0 | Fortune $0 | Tax $0
Board [3c 9c 9s Kh 2h]
Seat 1: 11224f8 (button) won ($0.36)
Seat 2: 89bcbb95 (small blind) folded before Flop
Seat 3: Hero (big blind) folded before Flop
Seat 4: baaf0b0d folded before Flop (didn't bet)
Seat 5: c00cefa1 folded before Flop (didn't bet)
Seat 6: b8c09f2 folded on the River


Poker Hand #RC3334562892: Hold'em No Limit ($0.02/$0.05) - 2025/02/17 21:30:44
Table 'RushAndCash628152' 6-max Seat #1 is the button
Seat 1: 8858e1f1 ($5.97 in chips)
Seat 2: 95d29c49 ($7.52 in chips)
Seat 3: 516da84c ($3.05 in chips)
Seat 4: 11224f8 ($10.15 in chips)
Seat 5: Hero ($9.27 in chips)
Seat 6: 742ccfee ($2.65 in chips)
95d29c49: posts small blind $0.02
516da84c: posts big blind $0.05
*** HOLE CARDS ***
Dealt to 8858e1f1 
Dealt to 95d29c49 
Dealt to 516da84c 
Dealt to 11224f8 
Dealt to Hero [Kc 9d]
Dealt to 742ccfee 
11224f8: folds
Hero: folds
742ccfee: folds
8858e1f1: raises $0.06 to $0.11
95d29c49: folds
516da84c: folds
Uncalled bet ($0.06) returned to 8858e1f1
*** SHOWDOWN ***
8858e1f1 collected $0.12 from pot
*** SUMMARY ***
Total pot $0.12 | Rake $0 | Jackpot $0 | Bingo $0 | Fortune $0 | Tax $0
Seat 1: 8858e1f1 (button) collected ($0.12)
Seat 2: 95d29c49 (small blind) folded before Flop
Seat 3: 516da84c (big blind) folded before Flop
Seat 4: 11224f8 folded before Flop (didn't bet)
Seat 5: Hero folded before Flop (didn't bet)
Seat 6: 742ccfee folded before Flop (didn't bet)


Poker Hand #RC3334562858: Hold'em No Limit ($0.02/$0.05) - 2025/02/17 21:30:40
Table 'RushAndCash628118' 6-max Seat #1 is the button
Seat 1: 32d40ce0 ($5.7 in chips)
Seat 2: f52f15b4 ($1.3 in chips)
Seat 3: f9ca7f51 ($3.02 in chips)
Seat 4: Hero ($9.27 in chips)
Seat 5: 9a69a3a0 ($9.87 in chips)
Seat 6: 2a10169c ($5.2 in chips)
f52f15b4: posts small blind $0.02
f9ca7f51: posts big blind $0.05
*** HOLE CARDS ***
Dealt to 32d40ce0 
Dealt to f52f15b4 
Dealt to f9ca7f51 
Dealt to Hero [8c 7d]
Dealt to 9a69a3a0 
Dealt to 2a10169c 
Hero: folds
9a69a3a0: folds
2a10169c: folds
32d40ce0: folds
f52f15b4: folds
Uncalled bet ($0.03) returned to f9ca7f51
*** SHOWDOWN ***
f9ca7f51 collected $0.04 from pot
*** SUMMARY ***
Total pot $0.04 | Rake $0 | Jackpot $0 | Bingo $0 | Fortune $0 | Tax $0
Seat 1: 32d40ce0 (button) folded before Flop (didn't bet)
Seat 2: f52f15b4 (small blind) folded before Flop
Seat 3: f9ca7f51 (big blind) collected ($0.04)
Seat 4: Hero folded before Flop (didn't bet)
Seat 5: 9a69a3a0 folded before Flop (didn't bet)
Seat 6: 2a10169c folded before Flop (didn't bet)


Poker Hand #RC3334562827: Hold'em No Limit ($0.02/$0.05) - 2025/02/17 21:30:36
Table 'RushAndCash628087' 6-max Seat #1 is the button
Seat 1: 4b3dba4 ($9.9 in chips)
Seat 2: 994faa22 ($5 in chips)
Seat 3: 63d14fd2 ($3.4 in chips)
Seat 4: d8d5b4d7 ($5 in chips)
Seat 5: Hero ($9.27 in chips)
Seat 6: 9fa2589a ($3.52 in chips)
994faa22: posts small blind $0.02
63d14fd2: posts big blind $0.05
*** HOLE CARDS ***
Dealt to 4b3dba4 
Dealt to 994faa22 
Dealt to 63d14fd2 
Dealt to d8d5b4d7 
Dealt to Hero [Ah 6s]
Dealt to 9fa2589a 
d8d5b4d7: raises $0.08 to $0.13
Hero: folds
9fa2589a: folds
4b3dba4: calls $0.13
994faa22: folds
63d14fd2: folds
*** FLOP *** [Ac 2h 7s]
d8d5b4d7: bets $0.05
4b3dba4: calls $0.05
*** TURN *** [Ac 2h 7s] [7c]
d8d5b4d7: bets $0.25
4b3dba4: calls $0.25
*** RIVER *** [Ac 2h 7s 7c] [9c]
d8d5b4d7: bets $0.75
4b3dba4: folds
Uncalled bet ($0.75) returned to d8d5b4d7
*** SHOWDOWN ***
d8d5b4d7 collected $0.89 from pot
*** SUMMARY ***
Total pot $0.93 | Rake $0.04 | Jackpot $0 | Bingo $0 | Fortune $0 | Tax $0
Board [Ac 2h 7s 7c 9c]
Seat 1: 4b3dba4 (button) folded on the River
Seat 2: 994faa22 (small blind) folded before Flop
Seat 3: 63d14fd2 (big blind) folded before Flop
Seat 4: d8d5b4d7 won ($0.89)
Seat 5: Hero folded before Flop (didn't bet)
Seat 6: 9fa2589a folded before Flop (didn't bet)


Poker Hand #RC3334562784: Hold'em No Limit ($0.02/$0.05) - 2025/02/17 21:30:31
Table 'RushAndCash628044' 6-max Seat #1 is the button
Seat 1: Hero ($9.2 in chips)
Seat 2: ef7b5599 ($34.24 in chips)
Seat 3: eed867f5 ($9.24 in chips)
Seat 4: 7fe74cc5 ($9.25 in chips)
Seat 5: 81004403 ($5.06 in chips)
Seat 6: fcfd355a ($5.77 in chips)
ef7b5599: posts small blind $0.02
eed867f5: posts big blind $0.05
*** HOLE CARDS ***
Dealt to Hero [2d 6c]
Dealt to ef7b5599 
Dealt to eed867f5 
Dealt to 7fe74cc5 
Dealt to 81004403 
Dealt to fcfd355a 
7fe74cc5: folds
81004403: folds
fcfd355a: folds
Hero: folds
ef7b5599: raises $0.1 to $0.15
eed867f5: raises $0.4 to $0.55
ef7b5599: folds
Uncalled bet ($0.4) returned to eed867f5
*** SHOWDOWN ***
eed867f5 collected $0.29 from pot
*** SUMMARY ***
Total pot $0.3 | Rake $0.01 | Jackpot $0 | Bingo $0 | Fortune $0 | Tax $0
Seat 1: Hero (button) folded before Flop (didn't bet)
Seat 2: ef7b5599 (small blind) folded before Flop
Seat 3: eed867f5 (big blind) collected ($0.29)
Seat 4: 7fe74cc5 folded before Flop (didn't bet)
Seat 5: 81004403 folded before Flop (didn't bet)
Seat 6: fcfd355a folded before Flop (didn't bet)


Poker Hand #RC3334562747: Hold'em No Limit ($0.02/$0.05) - 2025/02/17 21:30:27
Table 'RushAndCash628007' 6-max Seat #1 is the button
Seat 1: 7fe74cc5 ($9.25 in chips)
Seat 2: 71ee6520 ($5.84 in chips)
Seat 3: Hero ($9.25 in chips)
Seat 4: 81004403 ($5.06 in chips)
Seat 5: 981b7542 ($5 in chips)
Seat 6: e2d5acdf ($5.16 in chips)
71ee6520: posts small blind $0.02
Hero: posts big blind $0.05
*** HOLE CARDS ***
Dealt to 7fe74cc5 
Dealt to 71ee6520 
Dealt to Hero [Kd 6h]
Dealt to 81004403 
Dealt to 981b7542 
Dealt to e2d5acdf 
81004403: folds
981b7542: folds
e2d5acdf: folds
7fe74cc5: folds
71ee6520: folds
Uncalled bet ($0.03) returned to Hero
*** SHOWDOWN ***
Hero collected $0.04 from pot
*** SUMMARY ***
Total pot $0.04 | Rake $0 | Jackpot $0 | Bingo $0 | Fortune $0 | Tax $0
Seat 1: 7fe74cc5 (button) folded before Flop (didn't bet)
Seat 2: 71ee6520 (small blind) folded before Flop
Seat 3: Hero (big blind) collected ($0.04)
Seat 4: 81004403 folded before Flop (didn't bet)
Seat 5: 981b7542 folded before Flop (didn't bet)
Seat 6: e2d5acdf folded before Flop (didn't bet)


Poker Hand #RC3334562718: Hold'em No Limit ($0.02/$0.05) - 2025/02/17 21:30:24
Table 'RushAndCash627978' 6-max Seat #1 is the button
Seat 1: a664c86a ($4.93 in chips)
Seat 2: Hero ($9.27 in chips)
Seat 3: 3ae3072b ($4.7 in chips)
Seat 4: cbfc1dd3 ($5.07 in chips)
Seat 5: 717e9861 ($5.66 in chips)
Seat 6: b3362681 ($7.9 in chips)
Hero: posts small blind $0.02
3ae3072b: posts big blind $0.05
*** HOLE CARDS ***
Dealt to a664c86a 
Dealt to Hero [8s 9d]
Dealt to 3ae3072b 
Dealt to cbfc1dd3 
Dealt to 717e9861 
Dealt to b3362681 
cbfc1dd3: folds
717e9861: folds
b3362681: raises $0.05 to $0.1
a664c86a: folds
Hero: folds
3ae3072b: calls $0.05
*** FLOP *** [Jh 4d 4s]
3ae3072b: checks
b3362681: checks
*** TURN *** [Jh 4d 4s] [2h]
3ae3072b: checks
b3362681: checks
*** RIVER *** [Jh 4d 4s 2h] [Ts]
3ae3072b: bets $0.32
b3362681: folds
Uncalled bet ($0.32) returned to 3ae3072b
*** SHOWDOWN ***
3ae3072b collected $0.21 from pot
*** SUMMARY ***
Total pot $0.22 | Rake $0.01 | Jackpot $0 | Bingo $0 | Fortune $0 | Tax $0
Board [Jh 4d 4s 2h Ts]
Seat 1: a664c86a (button) folded before Flop (didn't bet)
Seat 2: Hero (small blind) folded before Flop
Seat 3: 3ae3072b (big blind) won ($0.21)
Seat 4: cbfc1dd3 folded before Flop (didn't bet)
Seat 5: 717e9861 folded before Flop (didn't bet)
Seat 6: b3362681 folded on the River


Poker Hand #RC3334562682: Hold'em No Limit ($0.02/$0.05) - 2025/02/17 21:30:19
Table 'RushAndCash627942' 6-max Seat #1 is the button
Seat 1: Hero ($9.27 in chips)
Seat 2: 3e301744 ($7.08 in chips)
Seat 3: d163f8fc ($5.45 in chips)
Seat 4: ef1c45d4 ($5.14 in chips)
Seat 5: 3ae3072b ($4.7 in chips)
Seat 6: f4ed7f83 ($5.16 in chips)
3e301744: posts small blind $0.02
d163f8fc: posts big blind $0.05
*** HOLE CARDS ***
Dealt to Hero [Jc 8s]
Dealt to 3e301744 
Dealt to d163f8fc 
Dealt to ef1c45d4 
Dealt to 3ae3072b 
Dealt to f4ed7f83 
ef1c45d4: folds
3ae3072b: folds
f4ed7f83: folds
Hero: folds
3e301744: folds
Uncalled bet ($0.03) returned to d163f8fc
*** SHOWDOWN ***
d163f8fc collected $0.04 from pot
*** SUMMARY ***
Total pot $0.04 | Rake $0 | Jackpot $0 | Bingo $0 | Fortune $0 | Tax $0
Seat 1: Hero (button) folded before Flop (didn't bet)
Seat 2: 3e301744 (small blind) folded before Flop
Seat 3: d163f8fc (big blind) collected ($0.04)
Seat 4: ef1c45d4 folded before Flop (didn't bet)
Seat 5: 3ae3072b folded before Flop (didn't bet)
Seat 6: f4ed7f83 folded before Flop (didn't bet)


Poker Hand #RC3334562636: Hold'em No Limit ($0.02/$0.05) - 2025/02/17 21:30:13
Table 'RushAndCash627896' 6-max Seat #1 is the button
Seat 1: f4ed7f83 ($5.16 in chips)
Seat 2: 3db4c32a ($6.09 in chips)
Seat 3: dd5b2a2c ($5.14 in chips)
Seat 4: b59fc0b9 ($5 in chips)
Seat 5: 433fbf8f ($5.8 in chips)
Seat 6: Hero ($9.27 in chips)
3db4c32a: posts small blind $0.02
dd5b2a2c: posts big blind $0.05
*** HOLE CARDS ***
Dealt to f4ed7f83 
Dealt to 3db4c32a 
Dealt to dd5b2a2c 
Dealt to b59fc0b9 
Dealt to 433fbf8f 
Dealt to Hero [3c 8s]
b59fc0b9: folds
433fbf8f: folds
Hero: folds
f4ed7f83: folds
3db4c32a: folds
Uncalled bet ($0.03) returned to dd5b2a2c
*** SHOWDOWN ***
dd5b2a2c collected $0.04 from pot
*** SUMMARY ***
Total pot $0.04 | Rake $0 | Jackpot $0 | Bingo $0 | Fortune $0 | Tax $0
Seat 1: f4ed7f83 (button) folded before Flop (didn't bet)
Seat 2: 3db4c32a (small blind) folded before Flop
Seat 3: dd5b2a2c (big blind) collected ($0.04)
Seat 4: b59fc0b9 folded before Flop (didn't bet)
Seat 5: 433fbf8f folded before Flop (didn't bet)
Seat 6: Hero folded before Flop (didn't bet)


Poker Hand #RC3334562508: Hold'em No Limit ($0.02/$0.05) - 2025/02/17 21:29:57
Table 'RushAndCash627768' 6-max Seat #1 is the button
Seat 1: c00cefa1 ($5 in chips)
Seat 2: Hero ($9.22 in chips)
Seat 3: d11ba472 ($8.5 in chips)
Seat 4: 1ea6bb97 ($9.05 in chips)
Seat 5: b4c33f6c ($7.44 in chips)
Seat 6: ac56502f ($0.94 in chips)
Hero: posts small blind $0.02
d11ba472: posts big blind $0.05
*** HOLE CARDS ***
Dealt to c00cefa1 
Dealt to Hero [Qs 9s]
Dealt to d11ba472 
Dealt to 1ea6bb97 
Dealt to b4c33f6c 
Dealt to ac56502f 
1ea6bb97: folds
b4c33f6c: folds
ac56502f: folds
c00cefa1: folds
Hero: calls $0.03
d11ba472: checks
*** FLOP *** [Th As 7c]
Hero: bets $0.05
d11ba472: folds
Uncalled bet ($0.05) returned to Hero
*** SHOWDOWN ***
Hero collected $0.1 from pot
*** SUMMARY ***
Total pot $0.1 | Rake $0 | Jackpot $0 | Bingo $0 | Fortune $0 | Tax $0
Board [Th As 7c]
Seat 1: c00cefa1 (button) folded before Flop (didn't bet)
Seat 2: Hero (small blind) won ($0.1)
Seat 3: d11ba472 (big blind) folded on the Flop
Seat 4: 1ea6bb97 folded before Flop (didn't bet)
Seat 5: b4c33f6c folded before Flop (didn't bet)
Seat 6: ac56502f folded before Flop (didn't bet)


Poker Hand #RC3334562478: Hold'em No Limit ($0.02/$0.05) - 2025/02/17 21:29:54
Table 'RushAndCash627738' 6-max Seat #1 is the button
Seat 1: Hero ($9.22 in chips)
Seat 2: b213f49b ($2.27 in chips)
Seat 3: f52f15b4 ($1.37 in chips)
Seat 4: 367e3140 ($5.52 in chips)
Seat 5: 6008538 ($4.87 in chips)
Seat 6: c3883bcf ($5.52 in chips)
b213f49b: posts small blind $0.02
f52f15b4: posts big blind $0.05
*** HOLE CARDS ***
Dealt to Hero [4c 6c]
Dealt to b213f49b 
Dealt to f52f15b4 
Dealt to 367e3140 
Dealt to 6008538 
Dealt to c3883bcf 
367e3140: folds
6008538: folds
c3883bcf: folds
Hero: folds
b213f49b: raises $0.1 to $0.15
f52f15b4: folds
Uncalled bet ($0.1) returned to b213f49b
*** SHOWDOWN ***
b213f49b collected $0.1 from pot
*** SUMMARY ***
Total pot $0.1 | Rake $0 | Jackpot $0 | Bingo $0 | Fortune $0 | Tax $0
Seat 1: Hero (button) folded before Flop (didn't bet)
Seat 2: b213f49b (small blind) collected ($0.1)
Seat 3: f52f15b4 (big blind) folded before Flop
Seat 4: 367e3140 folded before Flop (didn't bet)
Seat 5: 6008538 folded before Flop (didn't bet)
Seat 6: c3883bcf folded before Flop (didn't bet)


Poker Hand #RC3334562434: Hold'em No Limit ($0.02/$0.05) - 2025/02/17 21:29:48
Table 'RushAndCash627694' 6-max Seat #1 is the button
Seat 1: Hero ($9.22 in chips)
Seat 2: f6efd55a ($9.7 in chips)
Seat 3: 99d91f75 ($6.92 in chips)
Seat 4: 4afebef ($6 in chips)
Seat 5: 66981141 ($12.48 in chips)
Seat 6: a73946fe ($7.33 in chips)
f6efd55a: posts small blind $0.02
99d91f75: posts big blind $0.05
*** HOLE CARDS ***
Dealt to Hero [Th 6d]
Dealt to f6efd55a 
Dealt to 99d91f75 
Dealt to 4afebef 
Dealt to 66981141 
Dealt to a73946fe 
4afebef: folds
66981141: folds
a73946fe: folds
Hero: folds
f6efd55a: folds
Uncalled bet ($0.03) returned to 99d91f75
*** SHOWDOWN ***
99d91f75 collected $0.04 from pot
*** SUMMARY ***
Total pot $0.04 | Rake $0 | Jackpot $0 | Bingo $0 | Fortune $0 | Tax $0
Seat 1: Hero (button) folded before Flop (didn't bet)
Seat 2: f6efd55a (small blind) folded before Flop
Seat 3: 99d91f75 (big blind) collected ($0.04)
Seat 4: 4afebef folded before Flop (didn't bet)
Seat 5: 66981141 folded before Flop (didn't bet)
Seat 6: a73946fe folded before Flop (didn't bet)


Poker Hand #RC3334562391: Hold'em No Limit ($0.02/$0.05) - 2025/02/17 21:29:44
Table 'RushAndCash627651' 6-max Seat #1 is the button
Seat 1: a8c71cd6 ($6.45 in chips)
Seat 2: 1ea6bb97 ($9.07 in chips)
Seat 3: Hero ($9.27 in chips)
Seat 4: 42fca4f9 ($10.41 in chips)
Seat 5: 8196f154 ($5.05 in chips)
Seat 6: 9ccadbb5 ($10.43 in chips)
1ea6bb97: posts small blind $0.02
Hero: posts big blind $0.05
*** HOLE CARDS ***
Dealt to a8c71cd6 
Dealt to 1ea6bb97 
Dealt to Hero [9s 2h]
Dealt to 42fca4f9 
Dealt to 8196f154 
Dealt to 9ccadbb5 
42fca4f9: folds
8196f154: raises $0.09 to $0.14
9ccadbb5: folds
a8c71cd6: folds
1ea6bb97: folds
Hero: folds
Uncalled bet ($0.09) returned to 8196f154
*** SHOWDOWN ***
8196f154 collected $0.12 from pot
*** SUMMARY ***
Total pot $0.12 | Rake $0 | Jackpot $0 | Bingo $0 | Fortune $0 | Tax $0
Seat 1: a8c71cd6 (button) folded before Flop (didn't bet)
Seat 2: 1ea6bb97 (small blind) folded before Flop
Seat 3: Hero (big blind) folded before Flop
Seat 4: 42fca4f9 folded before Flop (didn't bet)
Seat 5: 8196f154 collected ($0.12)
Seat 6: 9ccadbb5 folded before Flop (didn't bet)


Poker Hand #RC3334562363: Hold'em No Limit ($0.02/$0.05) - 2025/02/17 21:29:41
Table 'RushAndCash627623' 6-max Seat #1 is the button
Seat 1: f9d64f1a ($5.49 in chips)
Seat 2: 21e0e4ee ($5 in chips)
Seat 3: ad31dea3 ($4.9 in chips)
Seat 4: 65900825 ($4.31 in chips)
Seat 5: Hero ($9.27 in chips)
Seat 6: ead6cfaf ($5.54 in chips)
21e0e4ee: posts small blind $0.02
ad31dea3: posts big blind $0.05
*** HOLE CARDS ***
Dealt to f9d64f1a 
Dealt to 21e0e4ee 
Dealt to ad31dea3 
Dealt to 65900825 
Dealt to Hero [2d 6s]
Dealt to ead6cfaf 
65900825: raises $0.1 to $0.15
Hero: folds
ead6cfaf: folds
f9d64f1a: folds
21e0e4ee: folds
ad31dea3: folds
Uncalled bet ($0.1) returned to 65900825
*** SHOWDOWN ***
65900825 collected $0.12 from pot
*** SUMMARY ***
Total pot $0.12 | Rake $0 | Jackpot $0 | Bingo $0 | Fortune $0 | Tax $0
Seat 1: f9d64f1a (button) folded before Flop (didn't bet)
Seat 2: 21e0e4ee (small blind) folded before Flop
Seat 3: ad31dea3 (big blind) folded before Flop
Seat 4: 65900825 collected ($0.12)
Seat 5: Hero folded before Flop (didn't bet)
Seat 6: ead6cfaf folded before Flop (didn't bet)


Poker Hand #RC3334562308: Hold'em No Limit ($0.02/$0.05) - 2025/02/17 21:29:35
Table 'RushAndCash627568' 6-max Seat #1 is the button
Seat 1: 426b60ef ($3.61 in chips)
Seat 2: ddbc9201 ($5 in chips)
Seat 3: 20d906bf ($4.82 in chips)
Seat 4: c6e11d19 ($5.51 in chips)
Seat 5: Hero ($9.27 in chips)
Seat 6: 4c9f897a ($5.78 in chips)
ddbc9201: posts small blind $0.02
20d906bf: posts big blind $0.05
*** HOLE CARDS ***
Dealt to 426b60ef 
Dealt to ddbc9201 
Dealt to 20d906bf 
Dealt to c6e11d19 
Dealt to Hero [6s 9d]
Dealt to 4c9f897a 
c6e11d19: raises $0.05 to $0.1
Hero: folds
4c9f897a: raises $0.21 to $0.31
426b60ef: folds
ddbc9201: folds
20d906bf: folds
c6e11d19: calls $0.21
*** FLOP *** [Ad Qd Kd]
c6e11d19: checks
4c9f897a: checks
*** TURN *** [Ad Qd Kd] [Jh]
c6e11d19: checks
4c9f897a: checks
*** RIVER *** [Ad Qd Kd Jh] [3h]
c6e11d19: checks
4c9f897a: checks
c6e11d19: shows [8c 8d] (Pair of Eights)
4c9f897a: shows [As 4h] (Pair of Aces)
*** SHOWDOWN ***
4c9f897a collected $0.66 from pot
*** SUMMARY ***
Total pot $0.69 | Rake $0.03 | Jackpot $0 | Bingo $0 | Fortune $0 | Tax $0
Board [Ad Qd Kd Jh 3h]
Seat 1: 426b60ef (button) folded before Flop (didn't bet)
Seat 2: ddbc9201 (small blind) folded before Flop
Seat 3: 20d906bf (big blind) folded before Flop
Seat 4: c6e11d19 showed [8c 8d] and lost with Pair of Eights
Seat 5: Hero folded before Flop (didn't bet)
Seat 6: 4c9f897a showed [As 4h] and won ($0.66) with Pair of Aces


Poker Hand #RC3334562083: Hold'em No Limit ($0.02/$0.05) - 2025/02/17 21:29:08
Table 'RushAndCash627343' 6-max Seat #1 is the button
Seat 1: d897e841 ($5 in chips)
Seat 2: f1fc05db ($4.85 in chips)
Seat 3: f23a8d23 ($5.07 in chips)
Seat 4: 4262311b ($5.31 in chips)
Seat 5: c04eb337 ($6.51 in chips)
Seat 6: Hero ($9.37 in chips)
f1fc05db: posts small blind $0.02
f23a8d23: posts big blind $0.05
*** HOLE CARDS ***
Dealt to d897e841 
Dealt to f1fc05db 
Dealt to f23a8d23 
Dealt to 4262311b 
Dealt to c04eb337 
Dealt to Hero [Ac 4c]
4262311b: folds
c04eb337: folds
Hero: raises $0.05 to $0.1
d897e841: folds
f1fc05db: raises $0.19 to $0.29
f23a8d23: folds
Hero: folds
Uncalled bet ($0.19) returned to f1fc05db
*** SHOWDOWN ***
f1fc05db collected $0.24 from pot
*** SUMMARY ***
Total pot $0.25 | Rake $0.01 | Jackpot $0 | Bingo $0 | Fortune $0 | Tax $0
Seat 1: d897e841 (button) folded before Flop (didn't bet)
Seat 2: f1fc05db (small blind) collected ($0.24)
Seat 3: f23a8d23 (big blind) folded before Flop
Seat 4: 4262311b folded before Flop (didn't bet)
Seat 5: c04eb337 folded before Flop (didn't bet)
Seat 6: Hero folded before Flop


Poker Hand #RC3334562051: Hold'em No Limit ($0.02/$0.05) - 2025/02/17 21:29:04
Table 'RushAndCash627311' 6-max Seat #1 is the button
Seat 1: 34028f01 ($6.94 in chips)
Seat 2: 5947e28d ($5 in chips)
Seat 3: 31bef4 ($5.58 in chips)
Seat 4: cc91d9ca ($6.69 in chips)
Seat 5: Hero ($9.37 in chips)
Seat 6: 167e28c4 ($10.63 in chips)
5947e28d: posts small blind $0.02
31bef4: posts big blind $0.05
*** HOLE CARDS ***
Dealt to 34028f01 
Dealt to 5947e28d 
Dealt to 31bef4 
Dealt to cc91d9ca 
Dealt to Hero [5c 9c]
Dealt to 167e28c4 
cc91d9ca: folds
Hero: folds
167e28c4: folds
34028f01: raises $0.06 to $0.11
5947e28d: folds
31bef4: calls $0.06
*** FLOP *** [6d Ac 4s]
31bef4: checks
34028f01: checks
*** TURN *** [6d Ac 4s] [6h]
31bef4: bets $0.12
34028f01: folds
Uncalled bet ($0.12) returned to 31bef4
*** SHOWDOWN ***
31bef4 collected $0.23 from pot
*** SUMMARY ***
Total pot $0.24 | Rake $0.01 | Jackpot $0 | Bingo $0 | Fortune $0 | Tax $0
Board [6d Ac 4s 6h]
Seat 1: 34028f01 (button) folded on the Turn
Seat 2: 5947e28d (small blind) folded before Flop
Seat 3: 31bef4 (big blind) won ($0.23)
Seat 4: cc91d9ca folded before Flop (didn't bet)
Seat 5: Hero folded before Flop (didn't bet)
Seat 6: 167e28c4 folded before Flop (didn't bet)


Poker Hand #RC3334562026: Hold'em No Limit ($0.02/$0.05) - 2025/02/17 21:29:01
Table 'RushAndCash627286' 6-max Seat #1 is the button
Seat 1: c83a952b ($5 in chips)
Seat 2: 933f6ef1 ($4.95 in chips)
Seat 3: a28ca95c ($28.91 in chips)
Seat 4: 961414b1 ($8.4 in chips)
Seat 5: Hero ($9.37 in chips)
Seat 6: c3883bcf ($5.68 in chips)
933f6ef1: posts small blind $0.02
a28ca95c: posts big blind $0.05
*** HOLE CARDS ***
Dealt to c83a952b 
Dealt to 933f6ef1 
Dealt to a28ca95c 
Dealt to 961414b1 
Dealt to Hero [2h Js]
Dealt to c3883bcf 
961414b1: folds
Hero: folds
c3883bcf: folds
c83a952b: raises $0.05 to $0.1
933f6ef1: folds
a28ca95c: folds
Uncalled bet ($0.05) returned to c83a952b
*** SHOWDOWN ***
c83a952b collected $0.12 from pot
*** SUMMARY ***
Total pot $0.12 | Rake $0 | Jackpot $0 | Bingo $0 | Fortune $0 | Tax $0
Seat 1: c83a952b (button) collected ($0.12)
Seat 2: 933f6ef1 (small blind) folded before Flop
Seat 3: a28ca95c (big blind) folded before Flop
Seat 4: 961414b1 folded before Flop (didn't bet)
Seat 5: Hero folded before Flop (didn't bet)
Seat 6: c3883bcf folded before Flop (didn't bet)


Poker Hand #RC3334561996: Hold'em No Limit ($0.02/$0.05) - 2025/02/17 21:28:57
Table 'RushAndCash627256' 6-max Seat #1 is the button
Seat 1: eb63e0f4 ($0.98 in chips)
Seat 2: edcc4eda ($5.02 in chips)
Seat 3: 5947e28d ($5 in chips)
Seat 4: 1c0eec17 ($5.12 in chips)
Seat 5: Hero ($9.37 in chips)
Seat 6: c7197736 ($8.21 in chips)
edcc4eda: posts small blind $0.02
5947e28d: posts big blind $0.05
*** HOLE CARDS ***
Dealt to eb63e0f4 
Dealt to edcc4eda 
Dealt to 5947e28d 
Dealt to 1c0eec17 
Dealt to Hero [9s 3s]
Dealt to c7197736 
1c0eec17: raises $0.05 to $0.1
Hero: folds
c7197736: folds
eb63e0f4: calls $0.1
edcc4eda: folds
5947e28d: folds
*** FLOP *** [Tc Ks 3d]
1c0eec17: checks
eb63e0f4: bets $0.09
1c0eec17: folds
Uncalled bet ($0.09) returned to eb63e0f4
*** SHOWDOWN ***
eb63e0f4 collected $0.26 from pot
*** SUMMARY ***
Total pot $0.27 | Rake $0.01 | Jackpot $0 | Bingo $0 | Fortune $0 | Tax $0
Board [Tc Ks 3d]
Seat 1: eb63e0f4 (button) won ($0.26)
Seat 2: edcc4eda (small blind) folded before Flop
Seat 3: 5947e28d (big blind) folded before Flop
Seat 4: 1c0eec17 folded on the Flop
Seat 5: Hero folded before Flop (didn't bet)
Seat 6: c7197736 folded before Flop (didn't bet)


Poker Hand #RC3334561858: Hold'em No Limit ($0.02/$0.05) - 2025/02/17 21:28:40
Table 'RushAndCash627118' 6-max Seat #1 is the button
Seat 1: fb6c913 ($9.13 in chips)
Seat 2: 22643080 ($6.89 in chips)
Seat 3: ff65d17f ($2.22 in chips)
Seat 4: Hero ($9.3 in chips)
Seat 5: 71ee6520 ($5 in chips)
Seat 6: 95096c6a ($8.9 in chips)
22643080: posts small blind $0.02
ff65d17f: posts big blind $0.05
*** HOLE CARDS ***
Dealt to fb6c913 
Dealt to 22643080 
Dealt to ff65d17f 
Dealt to Hero [Ks Qh]
Dealt to 71ee6520 
Dealt to 95096c6a 
Hero: raises $0.05 to $0.1
71ee6520: folds
95096c6a: folds
fb6c913: folds
22643080: folds
ff65d17f: folds
Uncalled bet ($0.05) returned to Hero
*** SHOWDOWN ***
Hero collected $0.12 from pot
*** SUMMARY ***
Total pot $0.12 | Rake $0 | Jackpot $0 | Bingo $0 | Fortune $0 | Tax $0
Seat 1: fb6c913 (button) folded before Flop (didn't bet)
Seat 2: 22643080 (small blind) folded before Flop
Seat 3: ff65d17f (big blind) folded before Flop
Seat 4: Hero collected ($0.12)
Seat 5: 71ee6520 folded before Flop (didn't bet)
Seat 6: 95096c6a folded before Flop (didn't bet)


Poker Hand #RC3334561830: Hold'em No Limit ($0.02/$0.05) - 2025/02/17 21:28:36
Table 'RushAndCash627090' 6-max Seat #1 is the button
Seat 1: 6ebc3323 ($8.81 in chips)
Seat 2: Hero ($9.32 in chips)
Seat 3: 3113f559 ($3.7 in chips)
Seat 4: 367e3140 ($5.45 in chips)
Seat 5: 1db4daae ($5.07 in chips)
Seat 6: 7615146e ($6.14 in chips)
Hero: posts small blind $0.02
3113f559: posts big blind $0.05
*** HOLE CARDS ***
Dealt to 6ebc3323 
Dealt to Hero [8c Qd]
Dealt to 3113f559 
Dealt to 367e3140 
Dealt to 1db4daae 
Dealt to 7615146e 
367e3140: raises $0.08 to $0.13
1db4daae: folds
7615146e: folds
6ebc3323: folds
Hero: folds
3113f559: folds
Uncalled bet ($0.08) returned to 367e3140
*** SHOWDOWN ***
367e3140 collected $0.12 from pot
*** SUMMARY ***
Total pot $0.12 | Rake $0 | Jackpot $0 | Bingo $0 | Fortune $0 | Tax $0
Seat 1: 6ebc3323 (button) folded before Flop (didn't bet)
Seat 2: Hero (small blind) folded before Flop
Seat 3: 3113f559 (big blind) folded before Flop
Seat 4: 367e3140 collected ($0.12)
Seat 5: 1db4daae folded before Flop (didn't bet)
Seat 6: 7615146e folded before Flop (didn't bet)


Poker Hand #RC3334561408: Hold'em No Limit ($0.02/$0.05) - 2025/02/17 21:27:46
Table 'RushAndCash626668' 6-max Seat #1 is the button
Seat 1: Hero ($7.85 in chips)
Seat 2: 426b60ef ($5.33 in chips)
Seat 3: 11224f8 ($9.76 in chips)
Seat 4: 7da7ba8a ($6.68 in chips)
Seat 5: baaf0b0d ($13.42 in chips)
Seat 6: 77d1364f ($4.23 in chips)
426b60ef: posts small blind $0.02
11224f8: posts big blind $0.05
*** HOLE CARDS ***
Dealt to Hero [Th Td]
Dealt to 426b60ef 
Dealt to 11224f8 
Dealt to 7da7ba8a 
Dealt to baaf0b0d 
Dealt to 77d1364f 
7da7ba8a: folds
baaf0b0d: folds
77d1364f: folds
Hero: raises $0.05 to $0.1
426b60ef: raises $0.19 to $0.29
11224f8: folds
Hero: calls $0.19
*** FLOP *** [3s Ts Js]
426b60ef: checks
Hero: checks
*** TURN *** [3s Ts Js] [5h]
426b60ef: bets $0.32
Hero: calls $0.32
*** RIVER *** [3s Ts Js 5h] [6c]
426b60ef: checks
Hero: bets $0.96
426b60ef: calls $0.96
Hero: shows [Th Td] (Three Tens)
426b60ef: shows [Kc Jh] (Pair of Jacks)
*** SHOWDOWN ***
Hero collected $2.97 from pot
*** SUMMARY ***
Total pot $3.19 | Rake $0.15 | Jackpot $0.07 | Bingo $0 | Fortune $0 | Tax $0
Board [3s Ts Js 5h 6c]
Seat 1: Hero (button) showed [Th Td] and won ($2.97) with Three Tens
Seat 2: 426b60ef (small blind) showed [Kc Jh] and lost with Pair of Jacks
Seat 3: 11224f8 (big blind) folded before Flop
Seat 4: 7da7ba8a folded before Flop (didn't bet)
Seat 5: baaf0b0d folded before Flop (didn't bet)
Seat 6: 77d1364f folded before Flop (didn't bet)


Poker Hand #RC3334561370: Hold'em No Limit ($0.02/$0.05) - 2025/02/17 21:27:42
Table 'RushAndCash626630' 6-max Seat #1 is the button
Seat 1: f0600331 ($9.36 in chips)
Seat 2: Hero ($7.87 in chips)
Seat 3: f0a8dabb ($4.13 in chips)
Seat 4: e390e48e ($8.81 in chips)
Seat 5: 75077557 ($1.3 in chips)
Seat 6: f6efd55a ($9.96 in chips)
Hero: posts small blind $0.02
f0a8dabb: posts big blind $0.05
*** HOLE CARDS ***
Dealt to f0600331 
Dealt to Hero [Ah 5s]
Dealt to f0a8dabb 
Dealt to e390e48e 
Dealt to 75077557 
Dealt to f6efd55a 
e390e48e: folds
75077557: folds
f6efd55a: raises $0.08 to $0.13
f0600331: folds
Hero: folds
f0a8dabb: calls $0.08
*** FLOP *** [3h 9s 3d]
f0a8dabb: checks
f6efd55a: bets $0.14
f0a8dabb: folds
Uncalled bet ($0.14) returned to f6efd55a
*** SHOWDOWN ***
f6efd55a collected $0.27 from pot
*** SUMMARY ***
Total pot $0.28 | Rake $0.01 | Jackpot $0 | Bingo $0 | Fortune $0 | Tax $0
Board [3h 9s 3d]
Seat 1: f0600331 (button) folded before Flop (didn't bet)
Seat 2: Hero (small blind) folded before Flop
Seat 3: f0a8dabb (big blind) folded on the Flop
Seat 4: e390e48e folded before Flop (didn't bet)
Seat 5: 75077557 folded before Flop (didn't bet)
Seat 6: f6efd55a won ($0.27)


Poker Hand #RC3334561341: Hold'em No Limit ($0.02/$0.05) - 2025/02/17 21:27:38
Table 'RushAndCash626601' 6-max Seat #1 is the button
Seat 1: c00cefa1 ($5 in chips)
Seat 2: b282789b ($11.84 in chips)
Seat 3: f6efd55a ($10.01 in chips)
Seat 4: b59988af ($7.35 in chips)
Seat 5: Hero ($7.87 in chips)
Seat 6: 75077557 ($1.3 in chips)
b282789b: posts small blind $0.02
f6efd55a: posts big blind $0.05
*** HOLE CARDS ***
Dealt to c00cefa1 
Dealt to b282789b 
Dealt to f6efd55a 
Dealt to b59988af 
Dealt to Hero [6c 9d]
Dealt to 75077557 
b59988af: raises $0.08 to $0.13
Hero: folds
75077557: folds
c00cefa1: folds
b282789b: folds
f6efd55a: folds
Uncalled bet ($0.08) returned to b59988af
*** SHOWDOWN ***
b59988af collected $0.12 from pot
*** SUMMARY ***
Total pot $0.12 | Rake $0 | Jackpot $0 | Bingo $0 | Fortune $0 | Tax $0
Seat 1: c00cefa1 (button) folded before Flop (didn't bet)
Seat 2: b282789b (small blind) folded before Flop
Seat 3: f6efd55a (big blind) folded before Flop
Seat 4: b59988af collected ($0.12)
Seat 5: Hero folded before Flop (didn't bet)
Seat 6: 75077557 folded before Flop (didn't bet)


Poker Hand #RC3334561313: Hold'em No Limit ($0.02/$0.05) - 2025/02/17 21:27:35
Table 'RushAndCash626573' 6-max Seat #1 is the button
Seat 1: 22a3f0e8 ($5.71 in chips)
Seat 2: a28ca95c ($29.57 in chips)
Seat 3: Hero ($7.92 in chips)
Seat 4: d04ecf ($3.73 in chips)
Seat 5: 12ef643d ($4.93 in chips)
Seat 6: 8f3a3c0a ($13.88 in chips)
a28ca95c: posts small blind $0.02
Hero: posts big blind $0.05
*** HOLE CARDS ***
Dealt to 22a3f0e8 
Dealt to a28ca95c 
Dealt to Hero [3s Ad]
Dealt to d04ecf 
Dealt to 12ef643d 
Dealt to 8f3a3c0a 
d04ecf: folds
12ef643d: folds
8f3a3c0a: folds
22a3f0e8: folds
a28ca95c: folds
Uncalled bet ($0.03) returned to Hero
*** SHOWDOWN ***
Hero collected $0.04 from pot
*** SUMMARY ***
Total pot $0.04 | Rake $0 | Jackpot $0 | Bingo $0 | Fortune $0 | Tax $0
Seat 1: 22a3f0e8 (button) folded before Flop (didn't bet)
Seat 2: a28ca95c (small blind) folded before Flop
Seat 3: Hero (big blind) collected ($0.04)
Seat 4: d04ecf folded before Flop (didn't bet)
Seat 5: 12ef643d folded before Flop (didn't bet)
Seat 6: 8f3a3c0a folded before Flop (didn't bet)


Poker Hand #RC3334561283: Hold'em No Limit ($0.02/$0.05) - 2025/02/17 21:27:31
Table 'RushAndCash626543' 6-max Seat #1 is the button
Seat 1: 75077557 ($1.3 in chips)
Seat 2: Hero ($7.94 in chips)
Seat 3: ed18a71b ($5.09 in chips)
Seat 4: 58623097 ($5.07 in chips)
Seat 5: 22a3f0e8 ($5.71 in chips)
Seat 6: 100d4f9e ($5 in chips)
Hero: posts small blind $0.02
ed18a71b: posts big blind $0.05
*** HOLE CARDS ***
Dealt to 75077557 
Dealt to Hero [5d 4h]
Dealt to ed18a71b 
Dealt to 58623097 
Dealt to 22a3f0e8 
Dealt to 100d4f9e 
58623097: folds
22a3f0e8: folds
100d4f9e: folds
75077557: folds
Hero: folds
Uncalled bet ($0.03) returned to ed18a71b
*** SHOWDOWN ***
ed18a71b collected $0.04 from pot
*** SUMMARY ***
Total pot $0.04 | Rake $0 | Jackpot $0 | Bingo $0 | Fortune $0 | Tax $0
Seat 1: 75077557 (button) folded before Flop (didn't bet)
Seat 2: Hero (small blind) folded before Flop
Seat 3: ed18a71b (big blind) collected ($0.04)
Seat 4: 58623097 folded before Flop (didn't bet)
Seat 5: 22a3f0e8 folded before Flop (didn't bet)
Seat 6: 100d4f9e folded before Flop (didn't bet)


Poker Hand #RC3334560989: Hold'em No Limit ($0.02/$0.05) - 2025/02/17 21:26:57
Table 'RushAndCash626249' 6-max Seat #1 is the button
Seat 1: 367e3140 ($4.7 in chips)
Seat 2: 8c8bf19e ($5 in chips)
Seat 3: 68f55461 ($5 in chips)
Seat 4: d691d846 ($3.86 in chips)
Seat 5: Hero ($8.15 in chips)
Seat 6: 3b85f8e6 ($13.12 in chips)
8c8bf19e: posts small blind $0.02
68f55461: posts big blind $0.05
*** HOLE CARDS ***
Dealt to 367e3140 
Dealt to 8c8bf19e 
Dealt to 68f55461 
Dealt to d691d846 
Dealt to Hero [Ac Jh]
Dealt to 3b85f8e6 
d691d846: folds
Hero: raises $0.05 to $0.1
3b85f8e6: folds
367e3140: folds
8c8bf19e: folds
68f55461: calls $0.05
*** FLOP *** [Kc 2h Qh]
68f55461: bets $0.11
Hero: calls $0.11
*** TURN *** [Kc 2h Qh] [4d]
68f55461: bets $0.22
Hero: folds
Uncalled bet ($0.22) returned to 68f55461
*** SHOWDOWN ***
68f55461 collected $0.42 from pot
*** SUMMARY ***
Total pot $0.44 | Rake $0.02 | Jackpot $0 | Bingo $0 | Fortune $0 | Tax $0
Board [Kc 2h Qh 4d]
Seat 1: 367e3140 (button) folded before Flop (didn't bet)
Seat 2: 8c8bf19e (small blind) folded before Flop
Seat 3: 68f55461 (big blind) won ($0.42)
Seat 4: d691d846 folded before Flop (didn't bet)
Seat 5: Hero folded on the Turn
Seat 6: 3b85f8e6 folded before Flop (didn't bet)


Poker Hand #RC3334560921: Hold'em No Limit ($0.02/$0.05) - 2025/02/17 21:26:49
Table 'RushAndCash626181' 6-max Seat #1 is the button
Seat 1: c7d7e6aa ($27.22 in chips)
Seat 2: e16b78a9 ($8.7 in chips)
Seat 3: e20e5cfc ($5.46 in chips)
Seat 4: Hero ($8.15 in chips)
Seat 5: eed867f5 ($9.85 in chips)
Seat 6: f7c51ea2 ($6.03 in chips)
e16b78a9: posts small blind $0.02
e20e5cfc: posts big blind $0.05
*** HOLE CARDS ***
Dealt to c7d7e6aa 
Dealt to e16b78a9 
Dealt to e20e5cfc 
Dealt to Hero [6c 3s]
Dealt to eed867f5 
Dealt to f7c51ea2 
Hero: folds
eed867f5: folds
f7c51ea2: folds
c7d7e6aa: raises $0.07 to $0.12
e16b78a9: folds
e20e5cfc: folds
Uncalled bet ($0.07) returned to c7d7e6aa
*** SHOWDOWN ***
c7d7e6aa collected $0.12 from pot
*** SUMMARY ***
Total pot $0.12 | Rake $0 | Jackpot $0 | Bingo $0 | Fortune $0 | Tax $0
Seat 1: c7d7e6aa (button) collected ($0.12)
Seat 2: e16b78a9 (small blind) folded before Flop
Seat 3: e20e5cfc (big blind) folded before Flop
Seat 4: Hero folded before Flop (didn't bet)
Seat 5: eed867f5 folded before Flop (didn't bet)
Seat 6: f7c51ea2 folded before Flop (didn't bet)


Poker Hand #RC3334560859: Hold'em No Limit ($0.02/$0.05) - 2025/02/17 21:26:41
Table 'RushAndCash626119' 6-max Seat #1 is the button
Seat 1: 4ec50768 ($5 in chips)
Seat 2: 8f9fd8b1 ($12.79 in chips)
Seat 3: Hero ($8.2 in chips)
Seat 4: 6e22a6c1 ($6.54 in chips)
Seat 5: eb21bc62 ($3.71 in chips)
Seat 6: e297f049 ($5 in chips)
8f9fd8b1: posts small blind $0.02
Hero: posts big blind $0.05
*** HOLE CARDS ***
Dealt to 4ec50768 
Dealt to 8f9fd8b1 
Dealt to Hero [As 6d]
Dealt to 6e22a6c1 
Dealt to eb21bc62 
Dealt to e297f049 
6e22a6c1: raises $0.05 to $0.1
eb21bc62: folds
e297f049: calls $0.1
4ec50768: folds
8f9fd8b1: folds
Hero: folds
*** FLOP *** [4c 7d 4s]
6e22a6c1: checks
e297f049: checks
*** TURN *** [4c 7d 4s] [3s]
6e22a6c1: bets $0.05
e297f049: calls $0.05
*** RIVER *** [4c 7d 4s 3s] [Ts]
6e22a6c1: checks
e297f049: checks
6e22a6c1: shows [Jd Ac] (Pair of Fours)
e297f049: shows [Qs Kh] (Pair of Fours)
*** SHOWDOWN ***
6e22a6c1 collected $0.36 from pot
*** SUMMARY ***
Total pot $0.37 | Rake $0.01 | Jackpot $0 | Bingo $0 | Fortune $0 | Tax $0
Board [4c 7d 4s 3s Ts]
Seat 1: 4ec50768 (button) folded before Flop (didn't bet)
Seat 2: 8f9fd8b1 (small blind) folded before Flop
Seat 3: Hero (big blind) folded before Flop
Seat 4: 6e22a6c1 showed [Jd Ac] and won ($0.36) with Pair of Fours
Seat 5: eb21bc62 folded before Flop (didn't bet)
Seat 6: e297f049 showed [Qs Kh] and lost with Pair of Fours


Poker Hand #RC3334560834: Hold'em No Limit ($0.02/$0.05) - 2025/02/17 21:26:38
Table 'RushAndCash626094' 6-max Seat #1 is the button
Seat 1: a9eb9f38 ($5.97 in chips)
Seat 2: bebd931c ($4.95 in chips)
Seat 3: d5150c28 ($13.49 in chips)
Seat 4: Hero ($8.2 in chips)
Seat 5: 1fa8537 ($8.13 in chips)
Seat 6: 7fc44808 ($11.27 in chips)
bebd931c: posts small blind $0.02
d5150c28: posts big blind $0.05
*** HOLE CARDS ***
Dealt to a9eb9f38 
Dealt to bebd931c 
Dealt to d5150c28 
Dealt to Hero [2h 2c]
Dealt to 1fa8537 
Dealt to 7fc44808 
Hero: folds
1fa8537: folds
7fc44808: folds
a9eb9f38: raises $0.05 to $0.1
bebd931c: calls $0.08
d5150c28: folds
*** FLOP *** [Ad 9s 6h]
bebd931c: checks
a9eb9f38: checks
*** TURN *** [Ad 9s 6h] [9d]
bebd931c: checks
a9eb9f38: bets $0.34
bebd931c: folds
Uncalled bet ($0.34) returned to a9eb9f38
*** SHOWDOWN ***
a9eb9f38 collected $0.24 from pot
*** SUMMARY ***
Total pot $0.25 | Rake $0.01 | Jackpot $0 | Bingo $0 | Fortune $0 | Tax $0
Board [Ad 9s 6h 9d]
Seat 1: a9eb9f38 (button) won ($0.24)
Seat 2: bebd931c (small blind) folded on the Turn
Seat 3: d5150c28 (big blind) folded before Flop
Seat 4: Hero folded before Flop (didn't bet)
Seat 5: 1fa8537 folded before Flop (didn't bet)
Seat 6: 7fc44808 folded before Flop (didn't bet)


Poker Hand #RC3334560756: Hold'em No Limit ($0.02/$0.05) - 2025/02/17 21:26:29
Table 'RushAndCash626016' 6-max Seat #1 is the button
Seat 1: 9b7148f5 ($9.89 in chips)
Seat 2: 20c536f4 ($3.4 in chips)
Seat 3: 7cf365ea ($4.93 in chips)
Seat 4: e2d5acdf ($5.01 in chips)
Seat 5: 5cfa2d9a ($4.7 in chips)
Seat 6: Hero ($8.13 in chips)
20c536f4: posts small blind $0.02
7cf365ea: posts big blind $0.05
*** HOLE CARDS ***
Dealt to 9b7148f5 
Dealt to 20c536f4 
Dealt to 7cf365ea 
Dealt to e2d5acdf 
Dealt to 5cfa2d9a 
Dealt to Hero [Jc Qh]
e2d5acdf: folds
5cfa2d9a: folds
Hero: raises $0.05 to $0.1
9b7148f5: folds
20c536f4: folds
7cf365ea: folds
Uncalled bet ($0.05) returned to Hero
*** SHOWDOWN ***
Hero collected $0.12 from pot
*** SUMMARY ***
Total pot $0.12 | Rake $0 | Jackpot $0 | Bingo $0 | Fortune $0 | Tax $0
Seat 1: 9b7148f5 (button) folded before Flop (didn't bet)
Seat 2: 20c536f4 (small blind) folded before Flop
Seat 3: 7cf365ea (big blind) folded before Flop
Seat 4: e2d5acdf folded before Flop (didn't bet)
Seat 5: 5cfa2d9a folded before Flop (didn't bet)
Seat 6: Hero collected ($0.12)


Poker Hand #RC3334560696: Hold'em No Limit ($0.02/$0.05) - 2025/02/17 21:26:22
Table 'RushAndCash625956' 6-max Seat #1 is the button
Seat 1: Hero ($8.13 in chips)
Seat 2: 9babc997 ($5.05 in chips)
Seat 3: 67b2dab9 ($5.14 in chips)
Seat 4: 381c6d82 ($10.35 in chips)
Seat 5: 9b09147b ($5.61 in chips)
Seat 6: b59988af ($7.63 in chips)
9babc997: posts small blind $0.02
67b2dab9: posts big blind $0.05
*** HOLE CARDS ***
Dealt to Hero [6c Th]
Dealt to 9babc997 
Dealt to 67b2dab9 
Dealt to 381c6d82 
Dealt to 9b09147b 
Dealt to b59988af 
381c6d82: raises $0.05 to $0.1
9b09147b: folds
b59988af: folds
Hero: folds
9babc997: folds
67b2dab9: folds
Uncalled bet ($0.05) returned to 381c6d82
*** SHOWDOWN ***
381c6d82 collected $0.12 from pot
*** SUMMARY ***
Total pot $0.12 | Rake $0 | Jackpot $0 | Bingo $0 | Fortune $0 | Tax $0
Seat 1: Hero (button) folded before Flop (didn't bet)
Seat 2: 9babc997 (small blind) folded before Flop
Seat 3: 67b2dab9 (big blind) folded before Flop
Seat 4: 381c6d82 collected ($0.12)
Seat 5: 9b09147b folded before Flop (didn't bet)
Seat 6: b59988af folded before Flop (didn't bet)


Poker Hand #RC3334560668: Hold'em No Limit ($0.02/$0.05) - 2025/02/17 21:26:18
Table 'RushAndCash625928' 6-max Seat #1 is the button
Seat 1: 577bd292 ($5.31 in chips)
Seat 2: f23a8d23 ($5 in chips)
Seat 3: Hero ($8.18 in chips)
Seat 4: 3c76a91d ($11.62 in chips)
Seat 5: 2ffae4a2 ($12.97 in chips)
Seat 6: 5abb6a6d ($7.28 in chips)
f23a8d23: posts small blind $0.02
Hero: posts big blind $0.05
*** HOLE CARDS ***
Dealt to 577bd292 
Dealt to f23a8d23 
Dealt to Hero [6d 2c]
Dealt to 3c76a91d 
Dealt to 2ffae4a2 
Dealt to 5abb6a6d 
3c76a91d: folds
2ffae4a2: raises $0.05 to $0.1
5abb6a6d: folds
577bd292: folds
f23a8d23: folds
Hero: folds
Uncalled bet ($0.05) returned to 2ffae4a2
*** SHOWDOWN ***
2ffae4a2 collected $0.12 from pot
*** SUMMARY ***
Total pot $0.12 | Rake $0 | Jackpot $0 | Bingo $0 | Fortune $0 | Tax $0
Seat 1: 577bd292 (button) folded before Flop (didn't bet)
Seat 2: f23a8d23 (small blind) folded before Flop
Seat 3: Hero (big blind) folded before Flop
Seat 4: 3c76a91d folded before Flop (didn't bet)
Seat 5: 2ffae4a2 collected ($0.12)
Seat 6: 5abb6a6d folded before Flop (didn't bet)


Poker Hand #RC3334560633: Hold'em No Limit ($0.02/$0.05) - 2025/02/17 21:26:14
Table 'RushAndCash625893' 6-max Seat #1 is the button
Seat 1: 5abb6a6d ($7.28 in chips)
Seat 2: 769f9172 ($12.87 in chips)
Seat 3: 3ffd6491 ($9.32 in chips)
Seat 4: Hero ($8.18 in chips)
Seat 5: d75cab93 ($12.67 in chips)
Seat 6: d5150c28 ($13.46 in chips)
769f9172: posts small blind $0.02
3ffd6491: posts big blind $0.05
*** HOLE CARDS ***
Dealt to 5abb6a6d 
Dealt to 769f9172 
Dealt to 3ffd6491 
Dealt to Hero [Ah 2c]
Dealt to d75cab93 
Dealt to d5150c28 
Hero: folds
d75cab93: folds
d5150c28: folds
5abb6a6d: folds
769f9172: folds
Uncalled bet ($0.03) returned to 3ffd6491
*** SHOWDOWN ***
3ffd6491 collected $0.04 from pot
*** SUMMARY ***
Total pot $0.04 | Rake $0 | Jackpot $0 | Bingo $0 | Fortune $0 | Tax $0
Seat 1: 5abb6a6d (button) folded before Flop (didn't bet)
Seat 2: 769f9172 (small blind) folded before Flop
Seat 3: 3ffd6491 (big blind) collected ($0.04)
Seat 4: Hero folded before Flop (didn't bet)
Seat 5: d75cab93 folded before Flop (didn't bet)
Seat 6: d5150c28 folded before Flop (didn't bet)


Poker Hand #RC3334560604: Hold'em No Limit ($0.02/$0.05) - 2025/02/17 21:26:11
Table 'RushAndCash625864' 6-max Seat #1 is the button
Seat 1: 9590c0df ($5 in chips)
Seat 2: Hero ($8.2 in chips)
Seat 3: 55e0d4fe ($6.35 in chips)
Seat 4: da930a8e ($5.21 in chips)
Seat 5: 69a18b01 ($6.51 in chips)
Seat 6: 75077557 ($1.4 in chips)
Hero: posts small blind $0.02
55e0d4fe: posts big blind $0.05
*** HOLE CARDS ***
Dealt to 9590c0df 
Dealt to Hero [4h Kh]
Dealt to 55e0d4fe 
Dealt to da930a8e 
Dealt to 69a18b01 
Dealt to 75077557 
da930a8e: folds
69a18b01: folds
75077557: raises $0.1 to $0.15
9590c0df: folds
Hero: folds
55e0d4fe: calls $0.1
*** FLOP *** [5c 5h 3c]
55e0d4fe: checks
75077557: bets $0.16
55e0d4fe: calls $0.16
*** TURN *** [5c 5h 3c] [8d]
55e0d4fe: checks
75077557: bets $0.48
55e0d4fe: folds
Uncalled bet ($0.48) returned to 75077557
*** SHOWDOWN ***
75077557 collected $0.61 from pot
*** SUMMARY ***
Total pot $0.64 | Rake $0.03 | Jackpot $0 | Bingo $0 | Fortune $0 | Tax $0
Board [5c 5h 3c 8d]
Seat 1: 9590c0df (button) folded before Flop (didn't bet)
Seat 2: Hero (small blind) folded before Flop
Seat 3: 55e0d4fe (big blind) folded on the Turn
Seat 4: da930a8e folded before Flop (didn't bet)
Seat 5: 69a18b01 folded before Flop (didn't bet)
Seat 6: 75077557 won ($0.61)


Poker Hand #RC3334560277: Hold'em No Limit ($0.02/$0.05) - 2025/02/17 21:25:31
Table 'RushAndCash625537' 6-max Seat #1 is the button
Seat 1: 5ab23b99 ($1.78 in chips)
Seat 2: cda83b9b ($6.04 in chips)
Seat 3: e95d0223 ($5.33 in chips)
Seat 4: c0a90b1a ($5 in chips)
Seat 5: c3c40ffa ($5.02 in chips)
Seat 6: Hero ($7.85 in chips)
cda83b9b: posts small blind $0.02
e95d0223: posts big blind $0.05
*** HOLE CARDS ***
Dealt to 5ab23b99 
Dealt to cda83b9b 
Dealt to e95d0223 
Dealt to c0a90b1a 
Dealt to c3c40ffa 
Dealt to Hero [8s 8c]
c0a90b1a: folds
c3c40ffa: raises $0.08 to $0.13
Hero: calls $0.13
5ab23b99: folds
cda83b9b: folds
e95d0223: folds
*** FLOP *** [Jc 2c 8h]
c3c40ffa: checks
Hero: bets $0.18
c3c40ffa: calls $0.18
*** TURN *** [Jc 2c 8h] [Qh]
c3c40ffa: checks
Hero: bets $0.52
c3c40ffa: folds
Uncalled bet ($0.52) returned to Hero
*** SHOWDOWN ***
Hero collected $0.66 from pot
*** SUMMARY ***
Total pot $0.69 | Rake $0.03 | Jackpot $0 | Bingo $0 | Fortune $0 | Tax $0
Board [Jc 2c 8h Qh]
Seat 1: 5ab23b99 (button) folded before Flop (didn't bet)
Seat 2: cda83b9b (small blind) folded before Flop
Seat 3: e95d0223 (big blind) folded before Flop
Seat 4: c0a90b1a folded before Flop (didn't bet)
Seat 5: c3c40ffa folded on the Turn
Seat 6: Hero won ($0.66)


Poker Hand #RC3334559851: Hold'em No Limit ($0.02/$0.05) - 2025/02/17 21:24:40
Table 'RushAndCash625111' 6-max Seat #1 is the button
Seat 1: b59fc0b9 ($5.09 in chips)
Seat 2: 235dd2d1 ($7.07 in chips)
Seat 3: cda83b9b ($6.52 in chips)
Seat 4: 9f09d482 ($11.01 in chips)
Seat 5: Hero ($7.39 in chips)
Seat 6: b74983a1 ($5.05 in chips)
235dd2d1: posts small blind $0.02
cda83b9b: posts big blind $0.05
*** HOLE CARDS ***
Dealt to b59fc0b9 
Dealt to 235dd2d1 
Dealt to cda83b9b 
Dealt to 9f09d482 
Dealt to Hero [9h 8h]
Dealt to b74983a1 
9f09d482: folds
Hero: raises $0.05 to $0.1
b74983a1: folds
b59fc0b9: folds
235dd2d1: folds
cda83b9b: calls $0.05
*** FLOP *** [As 9s 5c]
cda83b9b: checks
Hero: bets $0.08
cda83b9b: calls $0.08
*** TURN *** [As 9s 5c] [9c]
cda83b9b: checks
Hero: checks
*** RIVER *** [As 9s 5c 9c] [Qc]
cda83b9b: bets $0.3
Hero: raises $0.74 to $1.04
cda83b9b: folds
Uncalled bet ($0.74) returned to Hero
*** SHOWDOWN ***
Hero collected $0.94 from pot
*** SUMMARY ***
Total pot $0.98 | Rake $0.04 | Jackpot $0 | Bingo $0 | Fortune $0 | Tax $0
Board [As 9s 5c 9c Qc]
Seat 1: b59fc0b9 (button) folded before Flop (didn't bet)
Seat 2: 235dd2d1 (small blind) folded before Flop
Seat 3: cda83b9b (big blind) folded on the River
Seat 4: 9f09d482 folded before Flop (didn't bet)
Seat 5: Hero won ($0.94)
Seat 6: b74983a1 folded before Flop (didn't bet)


Poker Hand #RC3334559826: Hold'em No Limit ($0.02/$0.05) - 2025/02/17 21:24:36
Table 'RushAndCash625086' 6-max Seat #1 is the button
Seat 1: 8cf3ad10 ($7.03 in chips)
Seat 2: b8c09f2 ($6.69 in chips)
Seat 3: 75077557 ($6.57 in chips)
Seat 4: 3a46e390 ($5.19 in chips)
Seat 5: Hero ($7.39 in chips)
Seat 6: 65ca9276 ($10.07 in chips)
b8c09f2: posts small blind $0.02
75077557: posts big blind $0.05
*** HOLE CARDS ***
Dealt to 8cf3ad10 
Dealt to b8c09f2 
Dealt to 75077557 
Dealt to 3a46e390 
Dealt to Hero [Jc 5s]
Dealt to 65ca9276 
3a46e390: folds
Hero: folds
65ca9276: raises $0.08 to $0.13
8cf3ad10: calls $0.13
b8c09f2: folds
75077557: calls $0.08
*** FLOP *** [Kh Qs 6s]
75077557: checks
65ca9276: bets $0.14
8cf3ad10: folds
75077557: calls $0.14
*** TURN *** [Kh Qs 6s] [2d]
75077557: checks
65ca9276: checks
*** RIVER *** [Kh Qs 6s 2d] [4c]
75077557: checks
65ca9276: checks
75077557: shows [Td Qc] (Pair of Queens)
65ca9276: shows [Qh Js] (Pair of Queens)
*** SHOWDOWN ***
65ca9276 collected $0.66 from pot
*** SUMMARY ***
Total pot $0.69 | Rake $0.03 | Jackpot $0 | Bingo $0 | Fortune $0 | Tax $0
Board [Kh Qs 6s 2d 4c]
Seat 1: 8cf3ad10 (button) folded on the Flop
Seat 2: b8c09f2 (small blind) folded before Flop
Seat 3: 75077557 (big blind) showed [Td Qc] and lost with Pair of Queens
Seat 4: 3a46e390 folded before Flop (didn't bet)
Seat 5: Hero folded before Flop (didn't bet)
Seat 6: 65ca9276 showed [Qh Js] and won ($0.66) with Pair of Queens


Poker Hand #RC3334559795: Hold'em No Limit ($0.02/$0.05) - 2025/02/17 21:24:33
Table 'RushAndCash625055' 6-max Seat #1 is the button
Seat 1: Hero ($7.39 in chips)
Seat 2: b59fc0b9 ($5.11 in chips)
Seat 3: 84667b37 ($4.71 in chips)
Seat 4: 3a46e390 ($5.19 in chips)
Seat 5: a93f76f9 ($5 in chips)
Seat 6: 11224f8 ($5 in chips)
b59fc0b9: posts small blind $0.02
84667b37: posts big blind $0.05
*** HOLE CARDS ***
Dealt to Hero [5d 8h]
Dealt to b59fc0b9 
Dealt to 84667b37 
Dealt to 3a46e390 
Dealt to a93f76f9 
Dealt to 11224f8 
3a46e390: folds
a93f76f9: raises $0.05 to $0.1
11224f8: raises $0.22 to $0.32
Hero: folds
b59fc0b9: folds
84667b37: folds
a93f76f9: raises $0.54 to $0.86
11224f8: folds
Uncalled bet ($0.54) returned to a93f76f9
*** SHOWDOWN ***
a93f76f9 collected $0.68 from pot
*** SUMMARY ***
Total pot $0.71 | Rake $0.03 | Jackpot $0 | Bingo $0 | Fortune $0 | Tax $0
Seat 1: Hero (button) folded before Flop (didn't bet)
Seat 2: b59fc0b9 (small blind) folded before Flop
Seat 3: 84667b37 (big blind) folded before Flop
Seat 4: 3a46e390 folded before Flop (didn't bet)
Seat 5: a93f76f9 collected ($0.68)
Seat 6: 11224f8 folded before Flop


Poker Hand #RC3334559750: Hold'em No Limit ($0.02/$0.05) - 2025/02/17 21:24:27
Table 'RushAndCash625010' 6-max Seat #1 is the button
Seat 1: 6ab3ea38 ($5 in chips)
Seat 2: Hero ($7.41 in chips)
Seat 3: 657ee1fc ($5.11 in chips)
Seat 4: aa2d17c0 ($5.8 in chips)
Seat 5: 12cda2e0 ($22.18 in chips)
Seat 6: edf64ec2 ($5.48 in chips)
Hero: posts small blind $0.02
657ee1fc: posts big blind $0.05
*** HOLE CARDS ***
Dealt to 6ab3ea38 
Dealt to Hero [As 6d]
Dealt to 657ee1fc 
Dealt to aa2d17c0 
Dealt to 12cda2e0 
Dealt to edf64ec2 
aa2d17c0: folds
12cda2e0: raises $0.08 to $0.13
edf64ec2: calls $0.13
6ab3ea38: folds
Hero: folds
657ee1fc: folds
*** FLOP *** [Jh 9c Ad]
12cda2e0: checks
edf64ec2: checks
*** TURN *** [Jh 9c Ad] [9s]
12cda2e0: bets $0.14
edf64ec2: folds
Uncalled bet ($0.14) returned to 12cda2e0
*** SHOWDOWN ***
12cda2e0 collected $0.32 from pot
*** SUMMARY ***
Total pot $0.33 | Rake $0.01 | Jackpot $0 | Bingo $0 | Fortune $0 | Tax $0
Board [Jh 9c Ad 9s]
Seat 1: 6ab3ea38 (button) folded before Flop (didn't bet)
Seat 2: Hero (small blind) folded before Flop
Seat 3: 657ee1fc (big blind) folded before Flop
Seat 4: aa2d17c0 folded before Flop (didn't bet)
Seat 5: 12cda2e0 won ($0.32)
Seat 6: edf64ec2 folded on the Turn


Poker Hand #RC3334559679: Hold'em No Limit ($0.02/$0.05) - 2025/02/17 21:24:18
Table 'RushAndCash624939' 6-max Seat #1 is the button
Seat 1: 2eb4439f ($10.52 in chips)
Seat 2: c7197736 ($8.79 in chips)
Seat 3: 3c76a91d ($10.62 in chips)
Seat 4: Hero ($7.41 in chips)
Seat 5: 45d33c76 ($10.1 in chips)
Seat 6: 3939bf98 ($6.53 in chips)
c7197736: posts small blind $0.02
3c76a91d: posts big blind $0.05
*** HOLE CARDS ***
Dealt to 2eb4439f 
Dealt to c7197736 
Dealt to 3c76a91d 
Dealt to Hero [5h 3h]
Dealt to 45d33c76 
Dealt to 3939bf98 
Hero: folds
45d33c76: folds
3939bf98: folds
2eb4439f: raises $0.07 to $0.12
c7197736: folds
3c76a91d: folds
Uncalled bet ($0.07) returned to 2eb4439f
*** SHOWDOWN ***
2eb4439f collected $0.12 from pot
*** SUMMARY ***
Total pot $0.12 | Rake $0 | Jackpot $0 | Bingo $0 | Fortune $0 | Tax $0
Seat 1: 2eb4439f (button) collected ($0.12)
Seat 2: c7197736 (small blind) folded before Flop
Seat 3: 3c76a91d (big blind) folded before Flop
Seat 4: Hero folded before Flop (didn't bet)
Seat 5: 45d33c76 folded before Flop (didn't bet)
Seat 6: 3939bf98 folded before Flop (didn't bet)


Poker Hand #RC3334559644: Hold'em No Limit ($0.02/$0.05) - 2025/02/17 21:24:14
Table 'RushAndCash624904' 6-max Seat #1 is the button
Seat 1: 5abb6a6d ($6.79 in chips)
Seat 2: c24b20b9 ($17.31 in chips)
Seat 3: Hero ($7.46 in chips)
Seat 4: 8d31c727 ($12.52 in chips)
Seat 5: ac56502f ($5 in chips)
Seat 6: c35cd20e ($5.07 in chips)
c24b20b9: posts small blind $0.02
Hero: posts big blind $0.05
*** HOLE CARDS ***
Dealt to 5abb6a6d 
Dealt to c24b20b9 
Dealt to Hero [9d Kh]
Dealt to 8d31c727 
Dealt to ac56502f 
Dealt to c35cd20e 
8d31c727: folds
ac56502f: folds
c35cd20e: folds
5abb6a6d: raises $0.06 to $0.11
c24b20b9: folds
Hero: folds
Uncalled bet ($0.06) returned to 5abb6a6d
*** SHOWDOWN ***
5abb6a6d collected $0.12 from pot
*** SUMMARY ***
Total pot $0.12 | Rake $0 | Jackpot $0 | Bingo $0 | Fortune $0 | Tax $0
Seat 1: 5abb6a6d (button) collected ($0.12)
Seat 2: c24b20b9 (small blind) folded before Flop
Seat 3: Hero (big blind) folded before Flop
Seat 4: 8d31c727 folded before Flop (didn't bet)
Seat 5: ac56502f folded before Flop (didn't bet)
Seat 6: c35cd20e folded before Flop (didn't bet)


Poker Hand #RC3334559612: Hold'em No Limit ($0.02/$0.05) - 2025/02/17 21:24:10
Table 'RushAndCash624872' 6-max Seat #1 is the button
Seat 1: ac6c5037 ($4.66 in chips)
Seat 2: 426b60ef ($5.56 in chips)
Seat 3: 81004403 ($4.88 in chips)
Seat 4: Hero ($7.46 in chips)
Seat 5: afceb40a ($3.11 in chips)
Seat 6: 62fdcc3c ($5.49 in chips)
426b60ef: posts small blind $0.02
81004403: posts big blind $0.05
*** HOLE CARDS ***
Dealt to ac6c5037 
Dealt to 426b60ef 
Dealt to 81004403 
Dealt to Hero [6d 9c]
Dealt to afceb40a 
Dealt to 62fdcc3c 
Hero: folds
afceb40a: folds
62fdcc3c: folds
ac6c5037: raises $0.05 to $0.1
426b60ef: raises $0.25 to $0.35
81004403: folds
ac6c5037: folds
Uncalled bet ($0.25) returned to 426b60ef
*** SHOWDOWN ***
426b60ef collected $0.24 from pot
*** SUMMARY ***
Total pot $0.25 | Rake $0.01 | Jackpot $0 | Bingo $0 | Fortune $0 | Tax $0
Seat 1: ac6c5037 (button) folded before Flop
Seat 2: 426b60ef (small blind) collected ($0.24)
Seat 3: 81004403 (big blind) folded before Flop
Seat 4: Hero folded before Flop (didn't bet)
Seat 5: afceb40a folded before Flop (didn't bet)
Seat 6: 62fdcc3c folded before Flop (didn't bet)


Poker Hand #RC3334559585: Hold'em No Limit ($0.02/$0.05) - 2025/02/17 21:24:06
Table 'RushAndCash624845' 6-max Seat #1 is the button
Seat 1: c7197736 ($8.79 in chips)
Seat 2: 1ea6bb97 ($7.4 in chips)
Seat 3: 1c0eec17 ($4.87 in chips)
Seat 4: 71e00d83 ($13.7 in chips)
Seat 5: Hero ($7.46 in chips)
Seat 6: 43c437e9 ($19.06 in chips)
1ea6bb97: posts small blind $0.02
1c0eec17: posts big blind $0.05
*** HOLE CARDS ***
Dealt to c7197736 
Dealt to 1ea6bb97 
Dealt to 1c0eec17 
Dealt to 71e00d83 
Dealt to Hero [5h 8h]
Dealt to 43c437e9 
71e00d83: folds
Hero: folds
43c437e9: folds
c7197736: folds
1ea6bb97: folds
Uncalled bet ($0.03) returned to 1c0eec17
*** SHOWDOWN ***
1c0eec17 collected $0.04 from pot
*** SUMMARY ***
Total pot $0.04 | Rake $0 | Jackpot $0 | Bingo $0 | Fortune $0 | Tax $0
Seat 1: c7197736 (button) folded before Flop (didn't bet)
Seat 2: 1ea6bb97 (small blind) folded before Flop
Seat 3: 1c0eec17 (big blind) collected ($0.04)
Seat 4: 71e00d83 folded before Flop (didn't bet)
Seat 5: Hero folded before Flop (didn't bet)
Seat 6: 43c437e9 folded before Flop (didn't bet)


Poker Hand #RC3334559545: Hold'em No Limit ($0.02/$0.05) - 2025/02/17 21:24:01
Table 'RushAndCash624805' 6-max Seat #1 is the button
Seat 1: Hero ($7.46 in chips)
Seat 2: c59158f3 ($5.16 in chips)
Seat 3: fa7bb2c5 ($5 in chips)
Seat 4: 37865b6f ($5.29 in chips)
Seat 5: 1b6c31ec ($7.48 in chips)
Seat 6: ea7a7ae0 ($7.44 in chips)
c59158f3: posts small blind $0.02
fa7bb2c5: posts big blind $0.05
*** HOLE CARDS ***
Dealt to Hero [Jh 2c]
Dealt to c59158f3 
Dealt to fa7bb2c5 
Dealt to 37865b6f 
Dealt to 1b6c31ec 
Dealt to ea7a7ae0 
37865b6f: folds
1b6c31ec: folds
ea7a7ae0: folds
Hero: folds
c59158f3: folds
Uncalled bet ($0.03) returned to fa7bb2c5
*** SHOWDOWN ***
fa7bb2c5 collected $0.04 from pot
*** SUMMARY ***
Total pot $0.04 | Rake $0 | Jackpot $0 | Bingo $0 | Fortune $0 | Tax $0
Seat 1: Hero (button) folded before Flop (didn't bet)
Seat 2: c59158f3 (small blind) folded before Flop
Seat 3: fa7bb2c5 (big blind) collected ($0.04)
Seat 4: 37865b6f folded before Flop (didn't bet)
Seat 5: 1b6c31ec folded before Flop (didn't bet)
Seat 6: ea7a7ae0 folded before Flop (didn't bet)


Poker Hand #RC3334559518: Hold'em No Limit ($0.02/$0.05) - 2025/02/17 21:23:57
Table 'RushAndCash624778' 6-max Seat #1 is the button
Seat 1: 93a6c244 ($14.01 in chips)
Seat 2: 719071b8 ($5.07 in chips)
Seat 3: b8a41e4 ($5.7 in chips)
Seat 4: 37865b6f ($5.29 in chips)
Seat 5: Hero ($7.46 in chips)
Seat 6: 54a16a21 ($5.17 in chips)
719071b8: posts small blind $0.02
b8a41e4: posts big blind $0.05
*** HOLE CARDS ***
Dealt to 93a6c244 
Dealt to 719071b8 
Dealt to b8a41e4 
Dealt to 37865b6f 
Dealt to Hero [Ts 2h]
Dealt to 54a16a21 
37865b6f: folds
Hero: folds
54a16a21: folds
93a6c244: folds
719071b8: raises $0.1 to $0.15
b8a41e4: calls $0.1
*** FLOP *** [Kc 3s 9s]
719071b8: checks
b8a41e4: checks
*** TURN *** [Kc 3s 9s] [Ac]
719071b8: bets $0.23
b8a41e4: folds
Uncalled bet ($0.23) returned to 719071b8
*** SHOWDOWN ***
719071b8 collected $0.29 from pot
*** SUMMARY ***
Total pot $0.3 | Rake $0.01 | Jackpot $0 | Bingo $0 | Fortune $0 | Tax $0
Board [Kc 3s 9s Ac]
Seat 1: 93a6c244 (button) folded before Flop (didn't bet)
Seat 2: 719071b8 (small blind) won ($0.29)
Seat 3: b8a41e4 (big blind) folded on the Turn
Seat 4: 37865b6f folded before Flop (didn't bet)
Seat 5: Hero folded before Flop (didn't bet)
Seat 6: 54a16a21 folded before Flop (didn't bet)


Poker Hand #RC3334559495: Hold'em No Limit ($0.02/$0.05) - 2025/02/17 21:23:54
Table 'RushAndCash624755' 6-max Seat #1 is the button
Seat 1: 6d5fa70b ($5.05 in chips)
Seat 2: 7c65d0bd ($5.06 in chips)
Seat 3: e87181cd ($5.3 in chips)
Seat 4: Hero ($7.46 in chips)
Seat 5: c9f8ff1c ($5.16 in chips)
Seat 6: 719071b8 ($5.07 in chips)
7c65d0bd: posts small blind $0.02
e87181cd: posts big blind $0.05
*** HOLE CARDS ***
Dealt to 6d5fa70b 
Dealt to 7c65d0bd 
Dealt to e87181cd 
Dealt to Hero [4s 9s]
Dealt to c9f8ff1c 
Dealt to 719071b8 
Hero: folds
c9f8ff1c: folds
719071b8: folds
6d5fa70b: raises $0.08 to $0.13
7c65d0bd: folds
e87181cd: raises $0.32 to $0.45
6d5fa70b: folds
Uncalled bet ($0.32) returned to e87181cd
*** SHOWDOWN ***
e87181cd collected $0.27 from pot
*** SUMMARY ***
Total pot $0.28 | Rake $0.01 | Jackpot $0 | Bingo $0 | Fortune $0 | Tax $0
Seat 1: 6d5fa70b (button) folded before Flop
Seat 2: 7c65d0bd (small blind) folded before Flop
Seat 3: e87181cd (big blind) collected ($0.27)
Seat 4: Hero folded before Flop (didn't bet)
Seat 5: c9f8ff1c folded before Flop (didn't bet)
Seat 6: 719071b8 folded before Flop (didn't bet)


Poker Hand #RC3334559472: Hold'em No Limit ($0.02/$0.05) - 2025/02/17 21:23:51
Table 'RushAndCash624732' 6-max Seat #1 is the button
Seat 1: Hero ($7.39 in chips)
Seat 2: 8d7c8253 ($5.55 in chips)
Seat 3: 6650c8cb ($12.21 in chips)
Seat 4: 2ffae4a2 ($13.31 in chips)
Seat 5: 5ddfff80 ($4.81 in chips)
Seat 6: ad40d3d9 ($5 in chips)
8d7c8253: posts small blind $0.02
6650c8cb: posts big blind $0.05
*** HOLE CARDS ***
Dealt to Hero [Tc 2h]
Dealt to 8d7c8253 
Dealt to 6650c8cb 
Dealt to 2ffae4a2 
Dealt to 5ddfff80 
Dealt to ad40d3d9 
2ffae4a2: folds
5ddfff80: folds
ad40d3d9: folds
Hero: folds
8d7c8253: folds
Uncalled bet ($0.03) returned to 6650c8cb
*** SHOWDOWN ***
6650c8cb collected $0.04 from pot
*** SUMMARY ***
Total pot $0.04 | Rake $0 | Jackpot $0 | Bingo $0 | Fortune $0 | Tax $0
Seat 1: Hero (button) folded before Flop (didn't bet)
Seat 2: 8d7c8253 (small blind) folded before Flop
Seat 3: 6650c8cb (big blind) collected ($0.04)
Seat 4: 2ffae4a2 folded before Flop (didn't bet)
Seat 5: 5ddfff80 folded before Flop (didn't bet)
Seat 6: ad40d3d9 folded before Flop (didn't bet)


Poker Hand #RC3334559446: Hold'em No Limit ($0.02/$0.05) - 2025/02/17 21:23:48
Table 'RushAndCash624706' 6-max Seat #1 is the button
Seat 1: 143ede8b ($11.26 in chips)
Seat 2: b45be298 ($3.51 in chips)
Seat 3: Hero ($7.44 in chips)
Seat 4: 6008538 ($3.44 in chips)
Seat 5: f8081566 ($4.69 in chips)
Seat 6: 3c76a91d ($10.72 in chips)
b45be298: posts small blind $0.02
Hero: posts big blind $0.05
*** HOLE CARDS ***
Dealt to 143ede8b 
Dealt to b45be298 
Dealt to Hero [Jh 9d]
Dealt to 6008538 
Dealt to f8081566 
Dealt to 3c76a91d 
6008538: folds
f8081566: folds
3c76a91d: folds
143ede8b: folds
b45be298: folds
Uncalled bet ($0.03) returned to Hero
*** SHOWDOWN ***
Hero collected $0.04 from pot
*** SUMMARY ***
Total pot $0.04 | Rake $0 | Jackpot $0 | Bingo $0 | Fortune $0 | Tax $0
Seat 1: 143ede8b (button) folded before Flop (didn't bet)
Seat 2: b45be298 (small blind) folded before Flop
Seat 3: Hero (big blind) collected ($0.04)
Seat 4: 6008538 folded before Flop (didn't bet)
Seat 5: f8081566 folded before Flop (didn't bet)
Seat 6: 3c76a91d folded before Flop (didn't bet)


Poker Hand #RC3334559419: Hold'em No Limit ($0.02/$0.05) - 2025/02/17 21:23:45
Table 'RushAndCash624679' 6-max Seat #1 is the button
Seat 1: f0600331 ($5.52 in chips)
Seat 2: 7aca7e93 ($5.09 in chips)
Seat 3: 65900825 ($4.99 in chips)
Seat 4: 42fca4f9 ($10.06 in chips)
Seat 5: 4c9f897a ($5 in chips)
Seat 6: Hero ($7.44 in chips)
7aca7e93: posts small blind $0.02
65900825: posts big blind $0.05
*** HOLE CARDS ***
Dealt to f0600331 
Dealt to 7aca7e93 
Dealt to 65900825 
Dealt to 42fca4f9 
Dealt to 4c9f897a 
Dealt to Hero [Qc 4c]
42fca4f9: folds
4c9f897a: folds
Hero: folds
f0600331: raises $0.08 to $0.13
7aca7e93: folds
65900825: folds
Uncalled bet ($0.08) returned to f0600331
*** SHOWDOWN ***
f0600331 collected $0.12 from pot
*** SUMMARY ***
Total pot $0.12 | Rake $0 | Jackpot $0 | Bingo $0 | Fortune $0 | Tax $0
Seat 1: f0600331 (button) collected ($0.12)
Seat 2: 7aca7e93 (small blind) folded before Flop
Seat 3: 65900825 (big blind) folded before Flop
Seat 4: 42fca4f9 folded before Flop (didn't bet)
Seat 5: 4c9f897a folded before Flop (didn't bet)
Seat 6: Hero folded before Flop (didn't bet)


Poker Hand #RC3334559394: Hold'em No Limit ($0.02/$0.05) - 2025/02/17 21:23:42
Table 'RushAndCash624654' 6-max Seat #1 is the button
Seat 1: bb96e95c ($5 in chips)
Seat 2: 8c3789e ($6.42 in chips)
Seat 3: a28dd81d ($5 in chips)
Seat 4: Hero ($7.44 in chips)
Seat 5: a375b232 ($5.5 in chips)
Seat 6: d49c6b7d ($5 in chips)
8c3789e: posts small blind $0.02
a28dd81d: posts big blind $0.05
*** HOLE CARDS ***
Dealt to bb96e95c 
Dealt to 8c3789e 
Dealt to a28dd81d 
Dealt to Hero [7s Ad]
Dealt to a375b232 
Dealt to d49c6b7d 
Hero: folds
a375b232: folds
d49c6b7d: raises $0.08 to $0.13
bb96e95c: folds
8c3789e: folds
a28dd81d: folds
Uncalled bet ($0.08) returned to d49c6b7d
*** SHOWDOWN ***
d49c6b7d collected $0.12 from pot
*** SUMMARY ***
Total pot $0.12 | Rake $0 | Jackpot $0 | Bingo $0 | Fortune $0 | Tax $0
Seat 1: bb96e95c (button) folded before Flop (didn't bet)
Seat 2: 8c3789e (small blind) folded before Flop
Seat 3: a28dd81d (big blind) folded before Flop
Seat 4: Hero folded before Flop (didn't bet)
Seat 5: a375b232 folded before Flop (didn't bet)
Seat 6: d49c6b7d collected ($0.12)


Poker Hand #RC3334559370: Hold'em No Limit ($0.02/$0.05) - 2025/02/17 21:23:39
Table 'RushAndCash624630' 6-max Seat #1 is the button
Seat 1: da930a8e ($4.66 in chips)
Seat 2: 5e2a2694 ($5.26 in chips)
Seat 3: 573eb753 ($6.21 in chips)
Seat 4: d737deb4 ($5 in chips)
Seat 5: e32dc6f0 ($5 in chips)
Seat 6: Hero ($7.44 in chips)
5e2a2694: posts small blind $0.02
573eb753: posts big blind $0.05
*** HOLE CARDS ***
Dealt to da930a8e 
Dealt to 5e2a2694 
Dealt to 573eb753 
Dealt to d737deb4 
Dealt to e32dc6f0 
Dealt to Hero [5s 2d]
d737deb4: folds
e32dc6f0: folds
Hero: folds
da930a8e: raises $0.08 to $0.13
5e2a2694: folds
573eb753: raises $0.4 to $0.53
da930a8e: folds
Uncalled bet ($0.4) returned to 573eb753
*** SHOWDOWN ***
573eb753 collected $0.27 from pot
*** SUMMARY ***
Total pot $0.28 | Rake $0.01 | Jackpot $0 | Bingo $0 | Fortune $0 | Tax $0
Seat 1: da930a8e (button) folded before Flop
Seat 2: 5e2a2694 (small blind) folded before Flop
Seat 3: 573eb753 (big blind) collected ($0.27)
Seat 4: d737deb4 folded before Flop (didn't bet)
Seat 5: e32dc6f0 folded before Flop (didn't bet)
Seat 6: Hero folded before Flop (didn't bet)


Poker Hand #RC3334559326: Hold'em No Limit ($0.02/$0.05) - 2025/02/17 21:23:33
Table 'RushAndCash624586' 6-max Seat #1 is the button
Seat 1: beffcf8a ($5.47 in chips)
Seat 2: Hero ($7.46 in chips)
Seat 3: e0a9129e ($2.02 in chips)
Seat 4: c3bb6a23 ($5 in chips)
Seat 5: dbb7a28 ($10.18 in chips)
Seat 6: f0a8dabb ($4.76 in chips)
Hero: posts small blind $0.02
e0a9129e: posts big blind $0.05
*** HOLE CARDS ***
Dealt to beffcf8a 
Dealt to Hero [Kh 5h]
Dealt to e0a9129e 
Dealt to c3bb6a23 
Dealt to dbb7a28 
Dealt to f0a8dabb 
c3bb6a23: folds
dbb7a28: folds
f0a8dabb: folds
beffcf8a: raises $0.05 to $0.1
Hero: folds
e0a9129e: folds
Uncalled bet ($0.05) returned to beffcf8a
*** SHOWDOWN ***
beffcf8a collected $0.12 from pot
*** SUMMARY ***
Total pot $0.12 | Rake $0 | Jackpot $0 | Bingo $0 | Fortune $0 | Tax $0
Seat 1: beffcf8a (button) collected ($0.12)
Seat 2: Hero (small blind) folded before Flop
Seat 3: e0a9129e (big blind) folded before Flop
Seat 4: c3bb6a23 folded before Flop (didn't bet)
Seat 5: dbb7a28 folded before Flop (didn't bet)
Seat 6: f0a8dabb folded before Flop (didn't bet)


Poker Hand #RC3334559304: Hold'em No Limit ($0.02/$0.05) - 2025/02/17 21:23:30
Table 'RushAndCash624564' 6-max Seat #1 is the button
Seat 1: Hero ($7.46 in chips)
Seat 2: e6ee1d7f ($5 in chips)
Seat 3: b54d616e ($5 in chips)
Seat 4: 8f1315bb ($6.88 in chips)
Seat 5: 493727d2 ($9.66 in chips)
Seat 6: 2ffae4a2 ($13.38 in chips)
e6ee1d7f: posts small blind $0.02
b54d616e: posts big blind $0.05
*** HOLE CARDS ***
Dealt to Hero [Ad 5c]
Dealt to e6ee1d7f 
Dealt to b54d616e 
Dealt to 8f1315bb 
Dealt to 493727d2 
Dealt to 2ffae4a2 
8f1315bb: folds
493727d2: raises $0.06 to $0.11
2ffae4a2: folds
Hero: folds
e6ee1d7f: folds
b54d616e: folds
Uncalled bet ($0.06) returned to 493727d2
*** SHOWDOWN ***
493727d2 collected $0.12 from pot
*** SUMMARY ***
Total pot $0.12 | Rake $0 | Jackpot $0 | Bingo $0 | Fortune $0 | Tax $0
Seat 1: Hero (button) folded before Flop (didn't bet)
Seat 2: e6ee1d7f (small blind) folded before Flop
Seat 3: b54d616e (big blind) folded before Flop
Seat 4: 8f1315bb folded before Flop (didn't bet)
Seat 5: 493727d2 collected ($0.12)
Seat 6: 2ffae4a2 folded before Flop (didn't bet)


Poker Hand #RC3334559276: Hold'em No Limit ($0.02/$0.05) - 2025/02/17 21:23:27
Table 'RushAndCash624536' 6-max Seat #1 is the button
Seat 1: c04eb337 ($5.07 in chips)
Seat 2: a63aa4b7 ($17.18 in chips)
Seat 3: d03e7668 ($5.77 in chips)
Seat 4: Hero ($7.46 in chips)
Seat 5: c5f37c20 ($2.91 in chips)
Seat 6: 14d966a6 ($5 in chips)
a63aa4b7: posts small blind $0.02
d03e7668: posts big blind $0.05
*** HOLE CARDS ***
Dealt to c04eb337 
Dealt to a63aa4b7 
Dealt to d03e7668 
Dealt to Hero [Qc Jh]
Dealt to c5f37c20 
Dealt to 14d966a6 
Hero: folds
c5f37c20: folds
14d966a6: raises $0.05 to $0.1
c04eb337: folds
a63aa4b7: folds
d03e7668: folds
Uncalled bet ($0.05) returned to 14d966a6
*** SHOWDOWN ***
14d966a6 collected $0.12 from pot
*** SUMMARY ***
Total pot $0.12 | Rake $0 | Jackpot $0 | Bingo $0 | Fortune $0 | Tax $0
Seat 1: c04eb337 (button) folded before Flop (didn't bet)
Seat 2: a63aa4b7 (small blind) folded before Flop
Seat 3: d03e7668 (big blind) folded before Flop
Seat 4: Hero folded before Flop (didn't bet)
Seat 5: c5f37c20 folded before Flop (didn't bet)
Seat 6: 14d966a6 collected ($0.12)


Poker Hand #RC3334559087: Hold'em No Limit ($0.02/$0.05) - 2025/02/17 21:23:03
Table 'RushAndCash624347' 6-max Seat #1 is the button
Seat 1: 116bb053 ($4.44 in chips)
Seat 2: 67aeeaf2 ($4.95 in chips)
Seat 3: Hero ($7.59 in chips)
Seat 4: 7aca7e93 ($5 in chips)
Seat 5: 9013f95e ($10.45 in chips)
Seat 6: 40bb6be1 ($5.1 in chips)
67aeeaf2: posts small blind $0.02
Hero: posts big blind $0.05
*** HOLE CARDS ***
Dealt to 116bb053 
Dealt to 67aeeaf2 
Dealt to Hero [4s 4d]
Dealt to 7aca7e93 
Dealt to 9013f95e 
Dealt to 40bb6be1 
7aca7e93: raises $0.08 to $0.13
9013f95e: folds
40bb6be1: folds
116bb053: folds
67aeeaf2: folds
Hero: calls $0.08
*** FLOP *** [6h 2h Js]
Hero: checks
7aca7e93: bets $0.07
Hero: folds
Uncalled bet ($0.07) returned to 7aca7e93
*** SHOWDOWN ***
7aca7e93 collected $0.27 from pot
*** SUMMARY ***
Total pot $0.28 | Rake $0.01 | Jackpot $0 | Bingo $0 | Fortune $0 | Tax $0
Board [6h 2h Js]
Seat 1: 116bb053 (button) folded before Flop (didn't bet)
Seat 2: 67aeeaf2 (small blind) folded before Flop
Seat 3: Hero (big blind) folded on the Flop
Seat 4: 7aca7e93 won ($0.27)
Seat 5: 9013f95e folded before Flop (didn't bet)
Seat 6: 40bb6be1 folded before Flop (didn't bet)


Poker Hand #RC3334559062: Hold'em No Limit ($0.02/$0.05) - 2025/02/17 21:22:59
Table 'RushAndCash624322' 6-max Seat #1 is the button
Seat 1: 53a8c2fd ($10.55 in chips)
Seat 2: d03e7668 ($5.79 in chips)
Seat 3: Hero ($7.64 in chips)
Seat 4: 32d40ce0 ($6.7 in chips)
Seat 5: 1e474bac ($5 in chips)
Seat 6: a4227633 ($5.42 in chips)
d03e7668: posts small blind $0.02
Hero: posts big blind $0.05
*** HOLE CARDS ***
Dealt to 53a8c2fd 
Dealt to d03e7668 
Dealt to Hero [Ah 2h]
Dealt to 32d40ce0 
Dealt to 1e474bac 
Dealt to a4227633 
32d40ce0: folds
1e474bac: folds
a4227633: folds
53a8c2fd: raises $0.07 to $0.12
d03e7668: folds
Hero: folds
Uncalled bet ($0.07) returned to 53a8c2fd
*** SHOWDOWN ***
53a8c2fd collected $0.12 from pot
*** SUMMARY ***
Total pot $0.12 | Rake $0 | Jackpot $0 | Bingo $0 | Fortune $0 | Tax $0
Seat 1: 53a8c2fd (button) collected ($0.12)
Seat 2: d03e7668 (small blind) folded before Flop
Seat 3: Hero (big blind) folded before Flop
Seat 4: 32d40ce0 folded before Flop (didn't bet)
Seat 5: 1e474bac folded before Flop (didn't bet)
Seat 6: a4227633 folded before Flop (didn't bet)


Poker Hand #RC3334559037: Hold'em No Limit ($0.02/$0.05) - 2025/02/17 21:22:56
Table 'RushAndCash624297' 6-max Seat #1 is the button
Seat 1: 802a8ffb ($5.81 in chips)
Seat 2: Hero ($7.66 in chips)
Seat 3: 6c641898 ($5 in chips)
Seat 4: ccabd9d2 ($4.62 in chips)
Seat 5: 375be35a ($5 in chips)
Seat 6: 40816bf9 ($5.04 in chips)
Hero: posts small blind $0.02
6c641898: posts big blind $0.05
*** HOLE CARDS ***
Dealt to 802a8ffb 
Dealt to Hero [2h 4c]
Dealt to 6c641898 
Dealt to ccabd9d2 
Dealt to 375be35a 
Dealt to 40816bf9 
ccabd9d2: folds
375be35a: folds
40816bf9: folds
802a8ffb: folds
Hero: folds
Uncalled bet ($0.03) returned to 6c641898
*** SHOWDOWN ***
6c641898 collected $0.04 from pot
*** SUMMARY ***
Total pot $0.04 | Rake $0 | Jackpot $0 | Bingo $0 | Fortune $0 | Tax $0
Seat 1: 802a8ffb (button) folded before Flop (didn't bet)
Seat 2: Hero (small blind) folded before Flop
Seat 3: 6c641898 (big blind) collected ($0.04)
Seat 4: ccabd9d2 folded before Flop (didn't bet)
Seat 5: 375be35a folded before Flop (didn't bet)
Seat 6: 40816bf9 folded before Flop (didn't bet)


Poker Hand #RC3334559012: Hold'em No Limit ($0.02/$0.05) - 2025/02/17 21:22:53
Table 'RushAndCash624272' 6-max Seat #1 is the button
Seat 1: Hero ($7.66 in chips)
Seat 2: e76863c8 ($5.99 in chips)
Seat 3: 180915b9 ($5.58 in chips)
Seat 4: 3ff27d73 ($6.38 in chips)
Seat 5: e6ee1d7f ($5 in chips)
Seat 6: 442376ec ($5.53 in chips)
e76863c8: posts small blind $0.02
180915b9: posts big blind $0.05
*** HOLE CARDS ***
Dealt to Hero [6h Kd]
Dealt to e76863c8 
Dealt to 180915b9 
Dealt to 3ff27d73 
Dealt to e6ee1d7f 
Dealt to 442376ec 
3ff27d73: folds
e6ee1d7f: folds
442376ec: folds
Hero: folds
e76863c8: folds
Uncalled bet ($0.03) returned to 180915b9
*** SHOWDOWN ***
180915b9 collected $0.04 from pot
*** SUMMARY ***
Total pot $0.04 | Rake $0 | Jackpot $0 | Bingo $0 | Fortune $0 | Tax $0
Seat 1: Hero (button) folded before Flop (didn't bet)
Seat 2: e76863c8 (small blind) folded before Flop
Seat 3: 180915b9 (big blind) collected ($0.04)
Seat 4: 3ff27d73 folded before Flop (didn't bet)
Seat 5: e6ee1d7f folded before Flop (didn't bet)
Seat 6: 442376ec folded before Flop (didn't bet)


Poker Hand #RC3334558985: Hold'em No Limit ($0.02/$0.05) - 2025/02/17 21:22:50
Table 'RushAndCash624245' 6-max Seat #1 is the button
Seat 1: 40816bf9 ($5.04 in chips)
Seat 2: b3d19eac ($5.64 in chips)
Seat 3: b4bc5ab5 ($5.28 in chips)
Seat 4: 180915b9 ($5.58 in chips)
Seat 5: Hero ($7.66 in chips)
Seat 6: 76135c78 ($11.95 in chips)
b3d19eac: posts small blind $0.02
b4bc5ab5: posts big blind $0.05
*** HOLE CARDS ***
Dealt to 40816bf9 
Dealt to b3d19eac 
Dealt to b4bc5ab5 
Dealt to 180915b9 
Dealt to Hero [8c 2c]
Dealt to 76135c78 
180915b9: folds
Hero: folds
76135c78: folds
40816bf9: folds
b3d19eac: raises $0.1 to $0.15
b4bc5ab5: raises $0.3 to $0.45
b3d19eac: folds
Uncalled bet ($0.3) returned to b4bc5ab5
*** SHOWDOWN ***
b4bc5ab5 collected $0.29 from pot
*** SUMMARY ***
Total pot $0.3 | Rake $0.01 | Jackpot $0 | Bingo $0 | Fortune $0 | Tax $0
Seat 1: 40816bf9 (button) folded before Flop (didn't bet)
Seat 2: b3d19eac (small blind) folded before Flop
Seat 3: b4bc5ab5 (big blind) collected ($0.29)
Seat 4: 180915b9 folded before Flop (didn't bet)
Seat 5: Hero folded before Flop (didn't bet)
Seat 6: 76135c78 folded before Flop (didn't bet)


Poker Hand #RC3334558940: Hold'em No Limit ($0.02/$0.05) - 2025/02/17 21:22:44
Table 'RushAndCash624200' 6-max Seat #1 is the button
Seat 1: 442376ec ($5.46 in chips)
Seat 2: 65ca9276 ($9.28 in chips)
Seat 3: Hero ($7.71 in chips)
Seat 4: da930a8e ($4.83 in chips)
Seat 5: 7df4712d ($13.54 in chips)
Seat 6: 6008538 ($3.15 in chips)
65ca9276: posts small blind $0.02
Hero: posts big blind $0.05
*** HOLE CARDS ***
Dealt to 442376ec 
Dealt to 65ca9276 
Dealt to Hero [7s 5d]
Dealt to da930a8e 
Dealt to 7df4712d 
Dealt to 6008538 
da930a8e: folds
7df4712d: folds
6008538: folds
442376ec: raises $0.08 to $0.13
65ca9276: folds
Hero: folds
Uncalled bet ($0.08) returned to 442376ec
*** SHOWDOWN ***
442376ec collected $0.12 from pot
*** SUMMARY ***
Total pot $0.12 | Rake $0 | Jackpot $0 | Bingo $0 | Fortune $0 | Tax $0
Seat 1: 442376ec (button) collected ($0.12)
Seat 2: 65ca9276 (small blind) folded before Flop
Seat 3: Hero (big blind) folded before Flop
Seat 4: da930a8e folded before Flop (didn't bet)
Seat 5: 7df4712d folded before Flop (didn't bet)
Seat 6: 6008538 folded before Flop (didn't bet)


Poker Hand #RC3334558900: Hold'em No Limit ($0.02/$0.05) - 2025/02/17 21:22:38
Table 'RushAndCash624160' 6-max Seat #1 is the button
Seat 1: be2b264b ($5.12 in chips)
Seat 2: Hero ($7.73 in chips)
Seat 3: ac6c5037 ($4.97 in chips)
Seat 4: b4c33f6c ($6.16 in chips)
Seat 5: a28ca95c ($32.2 in chips)
Seat 6: 8507bdad ($10.07 in chips)
Hero: posts small blind $0.02
ac6c5037: posts big blind $0.05
*** HOLE CARDS ***
Dealt to be2b264b 
Dealt to Hero [7d 8s]
Dealt to ac6c5037 
Dealt to b4c33f6c 
Dealt to a28ca95c 
Dealt to 8507bdad 
b4c33f6c: folds
a28ca95c: folds
8507bdad: folds
be2b264b: raises $0.07 to $0.12
Hero: folds
ac6c5037: folds
Uncalled bet ($0.07) returned to be2b264b
*** SHOWDOWN ***
be2b264b collected $0.12 from pot
*** SUMMARY ***
Total pot $0.12 | Rake $0 | Jackpot $0 | Bingo $0 | Fortune $0 | Tax $0
Seat 1: be2b264b (button) collected ($0.12)
Seat 2: Hero (small blind) folded before Flop
Seat 3: ac6c5037 (big blind) folded before Flop
Seat 4: b4c33f6c folded before Flop (didn't bet)
Seat 5: a28ca95c folded before Flop (didn't bet)
Seat 6: 8507bdad folded before Flop (didn't bet)


Poker Hand #RC3334558878: Hold'em No Limit ($0.02/$0.05) - 2025/02/17 21:22:35
Table 'RushAndCash624138' 6-max Seat #1 is the button
Seat 1: 229ec9a7 ($7.23 in chips)
Seat 2: ead6cfaf ($5.02 in chips)
Seat 3: e56c8107 ($5 in chips)
Seat 4: 50254767 ($5.37 in chips)
Seat 5: Hero ($7.73 in chips)
Seat 6: 2b8b2921 ($8.95 in chips)
ead6cfaf: posts small blind $0.02
e56c8107: posts big blind $0.05
*** HOLE CARDS ***
Dealt to 229ec9a7 
Dealt to ead6cfaf 
Dealt to e56c8107 
Dealt to 50254767 
Dealt to Hero [7h Js]
Dealt to 2b8b2921 
50254767: raises $0.08 to $0.13
Hero: folds
2b8b2921: folds
229ec9a7: folds
ead6cfaf: folds
e56c8107: folds
Uncalled bet ($0.08) returned to 50254767
*** SHOWDOWN ***
50254767 collected $0.12 from pot
*** SUMMARY ***
Total pot $0.12 | Rake $0 | Jackpot $0 | Bingo $0 | Fortune $0 | Tax $0
Seat 1: 229ec9a7 (button) folded before Flop (didn't bet)
Seat 2: ead6cfaf (small blind) folded before Flop
Seat 3: e56c8107 (big blind) folded before Flop
Seat 4: 50254767 collected ($0.12)
Seat 5: Hero folded before Flop (didn't bet)
Seat 6: 2b8b2921 folded before Flop (didn't bet)


Poker Hand #RC3334558856: Hold'em No Limit ($0.02/$0.05) - 2025/02/17 21:22:32
Table 'RushAndCash624116' 6-max Seat #1 is the button
Seat 1: 34a123ac ($7.71 in chips)
Seat 2: b9ae439d ($4.38 in chips)
Seat 3: 9013f95e ($10.57 in chips)
Seat 4: Hero ($7.73 in chips)
Seat 5: 167e28c4 ($9.89 in chips)
Seat 6: 4ebd5be6 ($6.65 in chips)
b9ae439d: posts small blind $0.02
9013f95e: posts big blind $0.05
*** HOLE CARDS ***
Dealt to 34a123ac 
Dealt to b9ae439d 
Dealt to 9013f95e 
Dealt to Hero [4d 8c]
Dealt to 167e28c4 
Dealt to 4ebd5be6 
Hero: folds
167e28c4: folds
4ebd5be6: raises $0.06 to $0.11
34a123ac: folds
b9ae439d: folds
9013f95e: folds
Uncalled bet ($0.06) returned to 4ebd5be6
*** SHOWDOWN ***
4ebd5be6 collected $0.12 from pot
*** SUMMARY ***
Total pot $0.12 | Rake $0 | Jackpot $0 | Bingo $0 | Fortune $0 | Tax $0
Seat 1: 34a123ac (button) folded before Flop (didn't bet)
Seat 2: b9ae439d (small blind) folded before Flop
Seat 3: 9013f95e (big blind) folded before Flop
Seat 4: Hero folded before Flop (didn't bet)
Seat 5: 167e28c4 folded before Flop (didn't bet)
Seat 6: 4ebd5be6 collected ($0.12)


Poker Hand #RC3334558832: Hold'em No Limit ($0.02/$0.05) - 2025/02/17 21:22:29
Table 'RushAndCash624092' 6-max Seat #1 is the button
Seat 1: 50254767 ($5.37 in chips)
Seat 2: 84667b37 ($4.58 in chips)
Seat 3: 442376ec ($5.53 in chips)
Seat 4: d0d9ce45 ($2.5 in chips)
Seat 5: 4238ab48 ($7.71 in chips)
Seat 6: Hero ($7.73 in chips)
84667b37: posts small blind $0.02
442376ec: posts big blind $0.05
*** HOLE CARDS ***
Dealt to 50254767 
Dealt to 84667b37 
Dealt to 442376ec 
Dealt to d0d9ce45 
Dealt to 4238ab48 
Dealt to Hero [Th 4c]
d0d9ce45: folds
4238ab48: raises $0.08 to $0.13
Hero: folds
50254767: folds
84667b37: folds
442376ec: folds
Uncalled bet ($0.08) returned to 4238ab48
*** SHOWDOWN ***
4238ab48 collected $0.12 from pot
*** SUMMARY ***
Total pot $0.12 | Rake $0 | Jackpot $0 | Bingo $0 | Fortune $0 | Tax $0
Seat 1: 50254767 (button) folded before Flop (didn't bet)
Seat 2: 84667b37 (small blind) folded before Flop
Seat 3: 442376ec (big blind) folded before Flop
Seat 4: d0d9ce45 folded before Flop (didn't bet)
Seat 5: 4238ab48 collected ($0.12)
Seat 6: Hero folded before Flop (didn't bet)


Poker Hand #RC3334558806: Hold'em No Limit ($0.02/$0.05) - 2025/02/17 21:22:26
Table 'RushAndCash624066' 6-max Seat #1 is the button
Seat 1: e3c32f29 ($6.62 in chips)
Seat 2: d0d9ce45 ($2.52 in chips)
Seat 3: 2b8b2921 ($9 in chips)
Seat 4: 100d4f9e ($5.02 in chips)
Seat 5: 5f1cdd27 ($6.35 in chips)
Seat 6: Hero ($7.73 in chips)
d0d9ce45: posts small blind $0.02
2b8b2921: posts big blind $0.05
*** HOLE CARDS ***
Dealt to e3c32f29 
Dealt to d0d9ce45 
Dealt to 2b8b2921 
Dealt to 100d4f9e 
Dealt to 5f1cdd27 
Dealt to Hero [8s 6d]
100d4f9e: folds
5f1cdd27: raises $0.05 to $0.1
Hero: folds
e3c32f29: raises $0.25 to $0.35
d0d9ce45: folds
2b8b2921: folds
5f1cdd27: calls $0.25
*** FLOP *** [9s 3h 5d]
5f1cdd27: checks
e3c32f29: bets $0.39
5f1cdd27: calls $0.39
*** TURN *** [9s 3h 5d] [Ac]
5f1cdd27: bets $0.05
e3c32f29: calls $0.05
*** RIVER *** [9s 3h 5d Ac] [7s]
5f1cdd27: bets $0.05
e3c32f29: calls $0.05
5f1cdd27: shows [9h Ah] (Pair of Aces and Pair of Nines)
e3c32f29: shows [Td Th] (Pair of Tens)
*** SHOWDOWN ***
5f1cdd27 collected $1.6 from pot
*** SUMMARY ***
Total pot $1.75 | Rake $0.08 | Jackpot $0.07 | Bingo $0 | Fortune $0 | Tax $0
Board [9s 3h 5d Ac 7s]
Seat 1: e3c32f29 (button) showed [Td Th] and lost with Pair of Tens
Seat 2: d0d9ce45 (small blind) folded before Flop
Seat 3: 2b8b2921 (big blind) folded before Flop
Seat 4: 100d4f9e folded before Flop (didn't bet)
Seat 5: 5f1cdd27 showed [9h Ah] and won ($1.6) with Pair of Aces and Pair of Nines
Seat 6: Hero folded before Flop (didn't bet)


Poker Hand #RC3334558781: Hold'em No Limit ($0.02/$0.05) - 2025/02/17 21:22:23
Table 'RushAndCash624041' 6-max Seat #1 is the button
Seat 1: Hero ($7.73 in chips)
Seat 2: e56c8107 ($5 in chips)
Seat 3: b7bd1225 ($8.11 in chips)
Seat 4: a05dd313 ($4.23 in chips)
Seat 5: 866d801a ($5 in chips)
Seat 6: 8f1315bb ($6.88 in chips)
e56c8107: posts small blind $0.02
b7bd1225: posts big blind $0.05
*** HOLE CARDS ***
Dealt to Hero [5s Ac]
Dealt to e56c8107 
Dealt to b7bd1225 
Dealt to a05dd313 
Dealt to 866d801a 
Dealt to 8f1315bb 
a05dd313: folds
866d801a: raises $0.06 to $0.11
8f1315bb: folds
Hero: folds
e56c8107: folds
b7bd1225: folds
Uncalled bet ($0.06) returned to 866d801a
*** SHOWDOWN ***
866d801a collected $0.12 from pot
*** SUMMARY ***
Total pot $0.12 | Rake $0 | Jackpot $0 | Bingo $0 | Fortune $0 | Tax $0
Seat 1: Hero (button) folded before Flop (didn't bet)
Seat 2: e56c8107 (small blind) folded before Flop
Seat 3: b7bd1225 (big blind) folded before Flop
Seat 4: a05dd313 folded before Flop (didn't bet)
Seat 5: 866d801a collected ($0.12)
Seat 6: 8f1315bb folded before Flop (didn't bet)


Poker Hand #RC3334558755: Hold'em No Limit ($0.02/$0.05) - 2025/02/17 21:22:19
Table 'RushAndCash624015' 6-max Seat #1 is the button
Seat 1: 11224f8 ($5.31 in chips)
Seat 2: Hero ($7.75 in chips)
Seat 3: dbb7a28 ($10.33 in chips)
Seat 4: 50254767 ($5.44 in chips)
Seat 5: 5b79005a ($6.08 in chips)
Seat 6: 5a5583b4 ($6.28 in chips)
Hero: posts small blind $0.02
dbb7a28: posts big blind $0.05
*** HOLE CARDS ***
Dealt to 11224f8 
Dealt to Hero [Qc 9h]
Dealt to dbb7a28 
Dealt to 50254767 
Dealt to 5b79005a 
Dealt to 5a5583b4 
50254767: folds
5b79005a: raises $0.05 to $0.1
5a5583b4: folds
11224f8: calls $0.1
Hero: folds
dbb7a28: folds
*** FLOP *** [7c 6h Tc]
5b79005a: bets $0.09
11224f8: folds
Uncalled bet ($0.09) returned to 5b79005a
*** SHOWDOWN ***
5b79005a collected $0.26 from pot
*** SUMMARY ***
Total pot $0.27 | Rake $0.01 | Jackpot $0 | Bingo $0 | Fortune $0 | Tax $0
Board [7c 6h Tc]
Seat 1: 11224f8 (button) folded on the Flop
Seat 2: Hero (small blind) folded before Flop
Seat 3: dbb7a28 (big blind) folded before Flop
Seat 4: 50254767 folded before Flop (didn't bet)
Seat 5: 5b79005a won ($0.26)
Seat 6: 5a5583b4 folded before Flop (didn't bet)


Poker Hand #RC3334558372: Hold'em No Limit ($0.02/$0.05) - 2025/02/17 21:21:33
Table 'RushAndCash623632' 6-max Seat #1 is the button
Seat 1: cda83b9b ($6.88 in chips)
Seat 2: 11224f8 ($5.12 in chips)
Seat 3: 5422bec9 ($5 in chips)
Seat 4: 40816bf9 ($5.18 in chips)
Seat 5: Hero ($7.9 in chips)
Seat 6: 207d9345 ($21.99 in chips)
11224f8: posts small blind $0.02
5422bec9: posts big blind $0.05
*** HOLE CARDS ***
Dealt to cda83b9b 
Dealt to 11224f8 
Dealt to 5422bec9 
Dealt to 40816bf9 
Dealt to Hero [8d 8c]
Dealt to 207d9345 
40816bf9: folds
Hero: raises $0.05 to $0.1
207d9345: folds
cda83b9b: folds
11224f8: calls $0.08
5422bec9: folds
*** FLOP *** [Jh Ks 6s]
11224f8: checks
Hero: checks
*** TURN *** [Jh Ks 6s] [Js]
11224f8: checks
Hero: checks
*** RIVER *** [Jh Ks 6s Js] [Ah]
11224f8: bets $0.05
Hero: calls $0.05
11224f8: shows [Ac 7c] (Pair of Aces and Pair of Jacks)
Hero: shows [8d 8c] (Pair of Jacks and Pair of Eights)
*** SHOWDOWN ***
11224f8 collected $0.34 from pot
*** SUMMARY ***
Total pot $0.35 | Rake $0.01 | Jackpot $0 | Bingo $0 | Fortune $0 | Tax $0
Board [Jh Ks 6s Js Ah]
Seat 1: cda83b9b (button) folded before Flop (didn't bet)
Seat 2: 11224f8 (small blind) showed [Ac 7c] and won ($0.34) with Pair of Aces and Pair of Jacks
Seat 3: 5422bec9 (big blind) folded before Flop
Seat 4: 40816bf9 folded before Flop (didn't bet)
Seat 5: Hero showed [8d 8c] and lost with Pair of Jacks and Pair of Eights
Seat 6: 207d9345 folded before Flop (didn't bet)


Poker Hand #RC3334558329: Hold'em No Limit ($0.02/$0.05) - 2025/02/17 21:21:29
Table 'RushAndCash623589' 6-max Seat #1 is the button
Seat 1: de38466f ($1.29 in chips)
Seat 2: 8e07c53 ($5.85 in chips)
Seat 3: e3c32f29 ($6.75 in chips)
Seat 4: 945593bf ($17.31 in chips)
Seat 5: a28ca95c ($32.4 in chips)
Seat 6: Hero ($7.9 in chips)
8e07c53: posts small blind $0.02
e3c32f29: posts big blind $0.05
*** HOLE CARDS ***
Dealt to de38466f 
Dealt to 8e07c53 
Dealt to e3c32f29 
Dealt to 945593bf 
Dealt to a28ca95c 
Dealt to Hero [8s 9c]
945593bf: folds
a28ca95c: folds
Hero: folds
de38466f: folds
8e07c53: raises $0.06 to $0.11
e3c32f29: calls $0.06
*** FLOP *** [8d 9d 6h]
8e07c53: bets $0.08
e3c32f29: folds
Uncalled bet ($0.08) returned to 8e07c53
*** SHOWDOWN ***
8e07c53 collected $0.21 from pot
*** SUMMARY ***
Total pot $0.22 | Rake $0.01 | Jackpot $0 | Bingo $0 | Fortune $0 | Tax $0
Board [8d 9d 6h]
Seat 1: de38466f (button) folded before Flop (didn't bet)
Seat 2: 8e07c53 (small blind) won ($0.21)
Seat 3: e3c32f29 (big blind) folded on the Flop
Seat 4: 945593bf folded before Flop (didn't bet)
Seat 5: a28ca95c folded before Flop (didn't bet)
Seat 6: Hero folded before Flop (didn't bet)


Poker Hand #RC3334558305: Hold'em No Limit ($0.02/$0.05) - 2025/02/17 21:21:25
Table 'RushAndCash623565' 6-max Seat #1 is the button
Seat 1: bacb67c8 ($7.69 in chips)
Seat 2: 99d91f75 ($7.03 in chips)
Seat 3: 692e3a83 ($9 in chips)
Seat 4: 11224f8 ($5.17 in chips)
Seat 5: b213f49b ($2.46 in chips)
Seat 6: Hero ($7.9 in chips)
99d91f75: posts small blind $0.02
692e3a83: posts big blind $0.05
*** HOLE CARDS ***
Dealt to bacb67c8 
Dealt to 99d91f75 
Dealt to 692e3a83 
Dealt to 11224f8 
Dealt to b213f49b 
Dealt to Hero [6s Ts]
11224f8: folds
b213f49b: raises $0.1 to $0.15
Hero: folds
bacb67c8: folds
99d91f75: folds
692e3a83: folds
Uncalled bet ($0.1) returned to b213f49b
*** SHOWDOWN ***
b213f49b collected $0.12 from pot
*** SUMMARY ***
Total pot $0.12 | Rake $0 | Jackpot $0 | Bingo $0 | Fortune $0 | Tax $0
Seat 1: bacb67c8 (button) folded before Flop (didn't bet)
Seat 2: 99d91f75 (small blind) folded before Flop
Seat 3: 692e3a83 (big blind) folded before Flop
Seat 4: 11224f8 folded before Flop (didn't bet)
Seat 5: b213f49b collected ($0.12)
Seat 6: Hero folded before Flop (didn't bet)


Poker Hand #RC3334558229: Hold'em No Limit ($0.02/$0.05) - 2025/02/17 21:21:15
Table 'RushAndCash623489' 6-max Seat #1 is the button
Seat 1: Hero ($7.9 in chips)
Seat 2: a28ca95c ($32.42 in chips)
Seat 3: c0a90b1a ($5 in chips)
Seat 4: 9f09d482 ($10.76 in chips)
Seat 5: e76863c8 ($5.84 in chips)
Seat 6: 50254767 ($5.44 in chips)
a28ca95c: posts small blind $0.02
c0a90b1a: posts big blind $0.05
*** HOLE CARDS ***
Dealt to Hero [Ts Ad]
Dealt to a28ca95c 
Dealt to c0a90b1a 
Dealt to 9f09d482 
Dealt to e76863c8 
Dealt to 50254767 
9f09d482: raises $0.06 to $0.11
e76863c8: folds
50254767: folds
Hero: folds
a28ca95c: folds
c0a90b1a: calls $0.06
*** FLOP *** [Jc 7d 6s]
c0a90b1a: checks
9f09d482: bets $0.22
c0a90b1a: calls $0.22
*** TURN *** [Jc 7d 6s] [8d]
c0a90b1a: checks
9f09d482: checks
*** RIVER *** [Jc 7d 6s 8d] [Ah]
c0a90b1a: checks
9f09d482: bets $0.62
c0a90b1a: folds
Uncalled bet ($0.62) returned to 9f09d482
*** SHOWDOWN ***
9f09d482 collected $0.65 from pot
*** SUMMARY ***
Total pot $0.68 | Rake $0.03 | Jackpot $0 | Bingo $0 | Fortune $0 | Tax $0
Board [Jc 7d 6s 8d Ah]
Seat 1: Hero (button) folded before Flop (didn't bet)
Seat 2: a28ca95c (small blind) folded before Flop
Seat 3: c0a90b1a (big blind) folded on the River
Seat 4: 9f09d482 won ($0.65)
Seat 5: e76863c8 folded before Flop (didn't bet)
Seat 6: 50254767 folded before Flop (didn't bet)


Poker Hand #RC3334558192: Hold'em No Limit ($0.02/$0.05) - 2025/02/17 21:21:11
Table 'RushAndCash623452' 6-max Seat #1 is the button
Seat 1: 116bb053 ($4.58 in chips)
Seat 2: 961414b1 ($5.35 in chips)
Seat 3: 7c65d0bd ($5.17 in chips)
Seat 4: 9f9e1094 ($5.3 in chips)
Seat 5: Hero ($7.83 in chips)
Seat 6: 3db4c32a ($5.22 in chips)
961414b1: posts small blind $0.02
7c65d0bd: posts big blind $0.05
*** HOLE CARDS ***
Dealt to 116bb053 
Dealt to 961414b1 
Dealt to 7c65d0bd 
Dealt to 9f9e1094 
Dealt to Hero [3c Kh]
Dealt to 3db4c32a 
9f9e1094: folds
Hero: folds
3db4c32a: folds
116bb053: folds
961414b1: raises $0.1 to $0.15
7c65d0bd: folds
Uncalled bet ($0.1) returned to 961414b1
*** SHOWDOWN ***
961414b1 collected $0.1 from pot
*** SUMMARY ***
Total pot $0.1 | Rake $0 | Jackpot $0 | Bingo $0 | Fortune $0 | Tax $0
Seat 1: 116bb053 (button) folded before Flop (didn't bet)
Seat 2: 961414b1 (small blind) collected ($0.1)
Seat 3: 7c65d0bd (big blind) folded before Flop
Seat 4: 9f9e1094 folded before Flop (didn't bet)
Seat 5: Hero folded before Flop (didn't bet)
Seat 6: 3db4c32a folded before Flop (didn't bet)


Poker Hand #RC3334558171: Hold'em No Limit ($0.02/$0.05) - 2025/02/17 21:21:07
Table 'RushAndCash623431' 6-max Seat #1 is the button
Seat 1: 573eb753 ($5.19 in chips)
Seat 2: Hero ($7.85 in chips)
Seat 3: 77d1364f ($5.13 in chips)
Seat 4: b62e02b ($5.22 in chips)
Seat 5: 2c90d915 ($5.82 in chips)
Seat 6: e32dc6f0 ($5.3 in chips)
Hero: posts small blind $0.02
77d1364f: posts big blind $0.05
*** HOLE CARDS ***
Dealt to 573eb753 
Dealt to Hero [Kh 9s]
Dealt to 77d1364f 
Dealt to b62e02b 
Dealt to 2c90d915 
Dealt to e32dc6f0 
b62e02b: folds
2c90d915: folds
e32dc6f0: raises $0.06 to $0.11
573eb753: folds
Hero: folds
77d1364f: folds
Uncalled bet ($0.06) returned to e32dc6f0
*** SHOWDOWN ***
e32dc6f0 collected $0.12 from pot
*** SUMMARY ***
Total pot $0.12 | Rake $0 | Jackpot $0 | Bingo $0 | Fortune $0 | Tax $0
Seat 1: 573eb753 (button) folded before Flop (didn't bet)
Seat 2: Hero (small blind) folded before Flop
Seat 3: 77d1364f (big blind) folded before Flop
Seat 4: b62e02b folded before Flop (didn't bet)
Seat 5: 2c90d915 folded before Flop (didn't bet)
Seat 6: e32dc6f0 collected ($0.12)


Poker Hand #RC3334558146: Hold'em No Limit ($0.02/$0.05) - 2025/02/17 21:21:04
Table 'RushAndCash623406' 6-max Seat #1 is the button
Seat 1: d5f2b405 ($1.22 in chips)
Seat 2: f6efd55a ($9.64 in chips)
Seat 3: Hero ($7.9 in chips)
Seat 4: 961414b1 ($5.35 in chips)
Seat 5: 42065dde ($5.07 in chips)
Seat 6: 375be35a ($5 in chips)
f6efd55a: posts small blind $0.02
Hero: posts big blind $0.05
*** HOLE CARDS ***
Dealt to d5f2b405 
Dealt to f6efd55a 
Dealt to Hero [Jd 3h]
Dealt to 961414b1 
Dealt to 42065dde 
Dealt to 375be35a 
961414b1: folds
42065dde: folds
375be35a: raises $0.05 to $0.1
d5f2b405: folds
f6efd55a: raises $0.45 to $0.55
Hero: folds
375be35a: folds
Uncalled bet ($0.45) returned to f6efd55a
*** SHOWDOWN ***
f6efd55a collected $0.24 from pot
*** SUMMARY ***
Total pot $0.25 | Rake $0.01 | Jackpot $0 | Bingo $0 | Fortune $0 | Tax $0
Seat 1: d5f2b405 (button) folded before Flop (didn't bet)
Seat 2: f6efd55a (small blind) collected ($0.24)
Seat 3: Hero (big blind) folded before Flop
Seat 4: 961414b1 folded before Flop (didn't bet)
Seat 5: 42065dde folded before Flop (didn't bet)
Seat 6: 375be35a folded before Flop


Poker Hand #RC3334558120: Hold'em No Limit ($0.02/$0.05) - 2025/02/17 21:21:01
Table 'RushAndCash623380' 6-max Seat #1 is the button
Seat 1: cd53b3fd ($5 in chips)
Seat 2: d278c831 ($6.77 in chips)
Seat 3: Hero ($7.95 in chips)
Seat 4: 42fca4f9 ($8.86 in chips)
Seat 5: 4b3dba4 ($6.63 in chips)
Seat 6: d11ba472 ($7.68 in chips)
d278c831: posts small blind $0.02
Hero: posts big blind $0.05
*** HOLE CARDS ***
Dealt to cd53b3fd 
Dealt to d278c831 
Dealt to Hero [4c 9d]
Dealt to 42fca4f9 
Dealt to 4b3dba4 
Dealt to d11ba472 
42fca4f9: folds
4b3dba4: folds
d11ba472: folds
cd53b3fd: folds
d278c831: folds
Uncalled bet ($0.03) returned to Hero
*** SHOWDOWN ***
Hero collected $0.04 from pot
*** SUMMARY ***
Total pot $0.04 | Rake $0 | Jackpot $0 | Bingo $0 | Fortune $0 | Tax $0
Seat 1: cd53b3fd (button) folded before Flop (didn't bet)
Seat 2: d278c831 (small blind) folded before Flop
Seat 3: Hero (big blind) collected ($0.04)
Seat 4: 42fca4f9 folded before Flop (didn't bet)
Seat 5: 4b3dba4 folded before Flop (didn't bet)
Seat 6: d11ba472 folded before Flop (didn't bet)


Poker Hand #RC3334558095: Hold'em No Limit ($0.02/$0.05) - 2025/02/17 21:20:58
Table 'RushAndCash623355' 6-max Seat #1 is the button
Seat 1: 56cefdc9 ($8.24 in chips)
Seat 2: 530477b2 ($5 in chips)
Seat 3: 4238ab48 ($8.24 in chips)
Seat 4: 49b4f33a ($13.73 in chips)
Seat 5: Hero ($7.95 in chips)
Seat 6: 3324467a ($5 in chips)
530477b2: posts small blind $0.02
4238ab48: posts big blind $0.05
*** HOLE CARDS ***
Dealt to 56cefdc9 
Dealt to 530477b2 
Dealt to 4238ab48 
Dealt to 49b4f33a 
Dealt to Hero [As 6d]
Dealt to 3324467a 
49b4f33a: raises $0.06 to $0.11
Hero: folds
3324467a: folds
56cefdc9: folds
530477b2: folds
4238ab48: calls $0.06
*** FLOP *** [7s Jc Th]
4238ab48: checks
49b4f33a: checks
*** TURN *** [7s Jc Th] [Kd]
4238ab48: bets $0.08
49b4f33a: raises $0.2 to $0.28
4238ab48: calls $0.2
*** RIVER *** [7s Jc Th Kd] [Ks]
4238ab48: checks
49b4f33a: bets $1.1
4238ab48: folds
Uncalled bet ($1.1) returned to 49b4f33a
*** SHOWDOWN ***
49b4f33a collected $0.76 from pot
*** SUMMARY ***
Total pot $0.8 | Rake $0.04 | Jackpot $0 | Bingo $0 | Fortune $0 | Tax $0
Board [7s Jc Th Kd Ks]
Seat 1: 56cefdc9 (button) folded before Flop (didn't bet)
Seat 2: 530477b2 (small blind) folded before Flop
Seat 3: 4238ab48 (big blind) folded on the River
Seat 4: 49b4f33a won ($0.76)
Seat 5: Hero folded before Flop (didn't bet)
Seat 6: 3324467a folded before Flop (didn't bet)


Poker Hand #RC3334558054: Hold'em No Limit ($0.02/$0.05) - 2025/02/17 21:20:52
Table 'RushAndCash623314' 6-max Seat #1 is the button
Seat 1: Hero ($7.95 in chips)
Seat 2: 43c437e9 ($14.52 in chips)
Seat 3: bfe94c7c ($5 in chips)
Seat 4: 84667b37 ($4.88 in chips)
Seat 5: a25931dc ($4.75 in chips)
Seat 6: ef96c0c8 ($5.01 in chips)
43c437e9: posts small blind $0.02
bfe94c7c: posts big blind $0.05
*** HOLE CARDS ***
Dealt to Hero [8c Tc]
Dealt to 43c437e9 
Dealt to bfe94c7c 
Dealt to 84667b37 
Dealt to a25931dc 
Dealt to ef96c0c8 
84667b37: raises $0.05 to $0.1
a25931dc: folds
ef96c0c8: folds
Hero: folds
43c437e9: folds
bfe94c7c: calls $0.05
*** FLOP *** [Js 8h 4d]
bfe94c7c: bets $0.05
84667b37: calls $0.05
*** TURN *** [Js 8h 4d] [9c]
bfe94c7c: checks
84667b37: checks
*** RIVER *** [Js 8h 4d 9c] [3s]
bfe94c7c: checks
84667b37: checks
bfe94c7c: shows [3c 4h] (Pair of Fours and Pair of Treys)
84667b37: shows [Ah 2h] (Ace-High)
*** SHOWDOWN ***
bfe94c7c collected $0.3 from pot
*** SUMMARY ***
Total pot $0.32 | Rake $0.02 | Jackpot $0 | Bingo $0 | Fortune $0 | Tax $0
Board [Js 8h 4d 9c 3s]
Seat 1: Hero (button) folded before Flop (didn't bet)
Seat 2: 43c437e9 (small blind) folded before Flop
Seat 3: bfe94c7c (big blind) showed [3c 4h] and won ($0.3) with Pair of Fours and Pair of Treys
Seat 4: 84667b37 showed [Ah 2h] and lost with Ace-High
Seat 5: a25931dc folded before Flop (didn't bet)
Seat 6: ef96c0c8 folded before Flop (didn't bet)


Poker Hand #RC3334558005: Hold'em No Limit ($0.02/$0.05) - 2025/02/17 21:20:46
Table 'RushAndCash623265' 6-max Seat #1 is the button
Seat 1: 711af4a4 ($10.53 in chips)
Seat 2: Hero ($7.97 in chips)
Seat 3: 769f9172 ($6.55 in chips)
Seat 4: c51d95f9 ($5.64 in chips)
Seat 5: d0d9ce45 ($2.59 in chips)
Seat 6: 1e76a4d8 ($6.15 in chips)
Hero: posts small blind $0.02
769f9172: posts big blind $0.05
*** HOLE CARDS ***
Dealt to 711af4a4 
Dealt to Hero [Ac 6s]
Dealt to 769f9172 
Dealt to c51d95f9 
Dealt to d0d9ce45 
Dealt to 1e76a4d8 
c51d95f9: folds
d0d9ce45: folds
1e76a4d8: folds
711af4a4: folds
Hero: folds
Uncalled bet ($0.03) returned to 769f9172
*** SHOWDOWN ***
769f9172 collected $0.04 from pot
*** SUMMARY ***
Total pot $0.04 | Rake $0 | Jackpot $0 | Bingo $0 | Fortune $0 | Tax $0
Seat 1: 711af4a4 (button) folded before Flop (didn't bet)
Seat 2: Hero (small blind) folded before Flop
Seat 3: 769f9172 (big blind) collected ($0.04)
Seat 4: c51d95f9 folded before Flop (didn't bet)
Seat 5: d0d9ce45 folded before Flop (didn't bet)
Seat 6: 1e76a4d8 folded before Flop (didn't bet)


Poker Hand #RC3334557970: Hold'em No Limit ($0.02/$0.05) - 2025/02/17 21:20:41
Table 'RushAndCash623230' 6-max Seat #1 is the button
Seat 1: b59fc0b9 ($5.07 in chips)
Seat 2: b282789b ($11.74 in chips)
Seat 3: 6d5fa70b ($5.13 in chips)
Seat 4: 23a65ab7 ($5.87 in chips)
Seat 5: Hero ($7.97 in chips)
Seat 6: dcd4e05 ($2.15 in chips)
b282789b: posts small blind $0.02
6d5fa70b: posts big blind $0.05
*** HOLE CARDS ***
Dealt to b59fc0b9 
Dealt to b282789b 
Dealt to 6d5fa70b 
Dealt to 23a65ab7 
Dealt to Hero [4d Jc]
Dealt to dcd4e05 
23a65ab7: folds
Hero: folds
dcd4e05: folds
b59fc0b9: folds
b282789b: raises $0.1 to $0.15
6d5fa70b: folds
Uncalled bet ($0.1) returned to b282789b
*** SHOWDOWN ***
b282789b collected $0.1 from pot
*** SUMMARY ***
Total pot $0.1 | Rake $0 | Jackpot $0 | Bingo $0 | Fortune $0 | Tax $0
Seat 1: b59fc0b9 (button) folded before Flop (didn't bet)
Seat 2: b282789b (small blind) collected ($0.1)
Seat 3: 6d5fa70b (big blind) folded before Flop
Seat 4: 23a65ab7 folded before Flop (didn't bet)
Seat 5: Hero folded before Flop (didn't bet)
Seat 6: dcd4e05 folded before Flop (didn't bet)


Poker Hand #RC3334557599: Hold'em No Limit ($0.02/$0.05) - 2025/02/17 21:19:55
Table 'RushAndCash622859' 6-max Seat #1 is the button
Seat 1: 24aff26b ($11.19 in chips)
Seat 2: 3939bf98 ($5.04 in chips)
Seat 3: e4aeeb30 ($5.07 in chips)
Seat 4: 86b969db ($5 in chips)
Seat 5: Hero ($7.97 in chips)
Seat 6: d201e5fe ($9.38 in chips)
3939bf98: posts small blind $0.02
e4aeeb30: posts big blind $0.05
*** HOLE CARDS ***
Dealt to 24aff26b 
Dealt to 3939bf98 
Dealt to e4aeeb30 
Dealt to 86b969db 
Dealt to Hero [3c Tc]
Dealt to d201e5fe 
86b969db: folds
Hero: folds
d201e5fe: folds
24aff26b: folds
3939bf98: raises $0.1 to $0.15
e4aeeb30: calls $0.1
*** FLOP *** [7c 2h 7d]
3939bf98: bets $0.1
e4aeeb30: folds
Uncalled bet ($0.1) returned to 3939bf98
*** SHOWDOWN ***
3939bf98 collected $0.29 from pot
*** SUMMARY ***
Total pot $0.3 | Rake $0.01 | Jackpot $0 | Bingo $0 | Fortune $0 | Tax $0
Board [7c 2h 7d]
Seat 1: 24aff26b (button) folded before Flop (didn't bet)
Seat 2: 3939bf98 (small blind) won ($0.29)
Seat 3: e4aeeb30 (big blind) folded on the Flop
Seat 4: 86b969db folded before Flop (didn't bet)
Seat 5: Hero folded before Flop (didn't bet)
Seat 6: d201e5fe folded before Flop (didn't bet)


Poker Hand #RC3334557543: Hold'em No Limit ($0.02/$0.05) - 2025/02/17 21:19:48
Table 'RushAndCash622803' 6-max Seat #1 is the button
Seat 1: 14d03752 ($7.67 in chips)
Seat 2: Hero ($7.99 in chips)
Seat 3: b3aefb75 ($10.28 in chips)
Seat 4: ed18a71b ($5 in chips)
Seat 5: cf6b193c ($8.82 in chips)
Seat 6: a05482e7 ($5.19 in chips)
Hero: posts small blind $0.02
b3aefb75: posts big blind $0.05
*** HOLE CARDS ***
Dealt to 14d03752 
Dealt to Hero [Ts 8h]
Dealt to b3aefb75 
Dealt to ed18a71b 
Dealt to cf6b193c 
Dealt to a05482e7 
ed18a71b: folds
cf6b193c: folds
a05482e7: folds
14d03752: folds
Hero: folds
Uncalled bet ($0.03) returned to b3aefb75
*** SHOWDOWN ***
b3aefb75 collected $0.04 from pot
*** SUMMARY ***
Total pot $0.04 | Rake $0 | Jackpot $0 | Bingo $0 | Fortune $0 | Tax $0
Seat 1: 14d03752 (button) folded before Flop (didn't bet)
Seat 2: Hero (small blind) folded before Flop
Seat 3: b3aefb75 (big blind) collected ($0.04)
Seat 4: ed18a71b folded before Flop (didn't bet)
Seat 5: cf6b193c folded before Flop (didn't bet)
Seat 6: a05482e7 folded before Flop (didn't bet)


Poker Hand #RC3334557520: Hold'em No Limit ($0.02/$0.05) - 2025/02/17 21:19:45
Table 'RushAndCash622780' 6-max Seat #1 is the button
Seat 1: bfe94c7c ($5.08 in chips)
Seat 2: 3565018d ($5.31 in chips)
Seat 3: 4e5ae3cb ($5.84 in chips)
Seat 4: f5c1fc6d ($6.7 in chips)
Seat 5: Hero ($7.99 in chips)
Seat 6: ed18a71b ($5 in chips)
3565018d: posts small blind $0.02
4e5ae3cb: posts big blind $0.05
*** HOLE CARDS ***
Dealt to bfe94c7c 
Dealt to 3565018d 
Dealt to 4e5ae3cb 
Dealt to f5c1fc6d 
Dealt to Hero [3c 6h]
Dealt to ed18a71b 
f5c1fc6d: raises $0.1 to $0.15
Hero: folds
ed18a71b: folds
bfe94c7c: folds
3565018d: calls $0.13
4e5ae3cb: folds
*** FLOP *** [Th 4s 5s]
3565018d: checks
f5c1fc6d: bets $0.18
3565018d: calls $0.18
*** TURN *** [Th 4s 5s] [Ac]
3565018d: checks
f5c1fc6d: bets $0.36
3565018d: folds
Uncalled bet ($0.36) returned to f5c1fc6d
*** SHOWDOWN ***
f5c1fc6d collected $0.68 from pot
*** SUMMARY ***
Total pot $0.71 | Rake $0.03 | Jackpot $0 | Bingo $0 | Fortune $0 | Tax $0
Board [Th 4s 5s Ac]
Seat 1: bfe94c7c (button) folded before Flop (didn't bet)
Seat 2: 3565018d (small blind) folded on the Turn
Seat 3: 4e5ae3cb (big blind) folded before Flop
Seat 4: f5c1fc6d won ($0.68)
Seat 5: Hero folded before Flop (didn't bet)
Seat 6: ed18a71b folded before Flop (didn't bet)


Poker Hand #RC3334557418: Hold'em No Limit ($0.02/$0.05) - 2025/02/17 21:19:32
Table 'RushAndCash622678' 6-max Seat #1 is the button
Seat 1: 8f9fd8b1 ($14.1 in chips)
Seat 2: 8862e1e9 ($5.14 in chips)
Seat 3: 9788125b ($5.55 in chips)
Seat 4: Hero ($7.92 in chips)
Seat 5: bda6a3d1 ($5 in chips)
Seat 6: 229ec9a7 ($7.5 in chips)
8862e1e9: posts small blind $0.02
9788125b: posts big blind $0.05
*** HOLE CARDS ***
Dealt to 8f9fd8b1 
Dealt to 8862e1e9 
Dealt to 9788125b 
Dealt to Hero [Kd Js]
Dealt to bda6a3d1 
Dealt to 229ec9a7 
Hero: raises $0.05 to $0.1
bda6a3d1: folds
229ec9a7: folds
8f9fd8b1: folds
8862e1e9: folds
9788125b: folds
Uncalled bet ($0.05) returned to Hero
*** SHOWDOWN ***
Hero collected $0.12 from pot
*** SUMMARY ***
Total pot $0.12 | Rake $0 | Jackpot $0 | Bingo $0 | Fortune $0 | Tax $0
Seat 1: 8f9fd8b1 (button) folded before Flop (didn't bet)
Seat 2: 8862e1e9 (small blind) folded before Flop
Seat 3: 9788125b (big blind) folded before Flop
Seat 4: Hero collected ($0.12)
Seat 5: bda6a3d1 folded before Flop (didn't bet)
Seat 6: 229ec9a7 folded before Flop (didn't bet)


Poker Hand #RC3334557364: Hold'em No Limit ($0.02/$0.05) - 2025/02/17 21:19:25
Table 'RushAndCash622624' 6-max Seat #1 is the button
Seat 1: Hero ($7.92 in chips)
Seat 2: cf7f09c2 ($16.85 in chips)
Seat 3: e6aa09ff ($5 in chips)
Seat 4: 81004403 ($4.86 in chips)
Seat 5: 568ae949 ($4 in chips)
Seat 6: 395482a9 ($6.28 in chips)
cf7f09c2: posts small blind $0.02
e6aa09ff: posts big blind $0.05
*** HOLE CARDS ***
Dealt to Hero [Th Kh]
Dealt to cf7f09c2 
Dealt to e6aa09ff 
Dealt to 81004403 
Dealt to 568ae949 
Dealt to 395482a9 
81004403: raises $0.05 to $0.1
568ae949: folds
395482a9: folds
Hero: folds
cf7f09c2: folds
e6aa09ff: folds
Uncalled bet ($0.05) returned to 81004403
*** SHOWDOWN ***
81004403 collected $0.12 from pot
*** SUMMARY ***
Total pot $0.12 | Rake $0 | Jackpot $0 | Bingo $0 | Fortune $0 | Tax $0
Seat 1: Hero (button) folded before Flop (didn't bet)
Seat 2: cf7f09c2 (small blind) folded before Flop
Seat 3: e6aa09ff (big blind) folded before Flop
Seat 4: 81004403 collected ($0.12)
Seat 5: 568ae949 folded before Flop (didn't bet)
Seat 6: 395482a9 folded before Flop (didn't bet)


Poker Hand #RC3334557323: Hold'em No Limit ($0.02/$0.05) - 2025/02/17 21:19:20
Table 'RushAndCash622583' 6-max Seat #1 is the button
Seat 1: 656af102 ($6.44 in chips)
Seat 2: 191b60c1 ($7.51 in chips)
Seat 3: Hero ($7.97 in chips)
Seat 4: 1606744a ($5 in chips)
Seat 5: 42c7d5a0 ($5 in chips)
Seat 6: 2db50b0f ($5.12 in chips)
191b60c1: posts small blind $0.02
Hero: posts big blind $0.05
*** HOLE CARDS ***
Dealt to 656af102 
Dealt to 191b60c1 
Dealt to Hero [4h 2h]
Dealt to 1606744a 
Dealt to 42c7d5a0 
Dealt to 2db50b0f 
1606744a: folds
42c7d5a0: folds
2db50b0f: raises $0.05 to $0.1
656af102: folds
191b60c1: folds
Hero: folds
Uncalled bet ($0.05) returned to 2db50b0f
*** SHOWDOWN ***
2db50b0f collected $0.12 from pot
*** SUMMARY ***
Total pot $0.12 | Rake $0 | Jackpot $0 | Bingo $0 | Fortune $0 | Tax $0
Seat 1: 656af102 (button) folded before Flop (didn't bet)
Seat 2: 191b60c1 (small blind) folded before Flop
Seat 3: Hero (big blind) folded before Flop
Seat 4: 1606744a folded before Flop (didn't bet)
Seat 5: 42c7d5a0 folded before Flop (didn't bet)
Seat 6: 2db50b0f collected ($0.12)


Poker Hand #RC3334557299: Hold'em No Limit ($0.02/$0.05) - 2025/02/17 21:19:16
Table 'RushAndCash622559' 6-max Seat #1 is the button
Seat 1: 167e28c4 ($7.26 in chips)
Seat 2: 64b39229 ($5.09 in chips)
Seat 3: Hero ($8.02 in chips)
Seat 4: f6efd55a ($9.53 in chips)
Seat 5: f1be594d ($5 in chips)
Seat 6: ac6501c3 ($5.05 in chips)
64b39229: posts small blind $0.02
Hero: posts big blind $0.05
*** HOLE CARDS ***
Dealt to 167e28c4 
Dealt to 64b39229 
Dealt to Hero [5s 4d]
Dealt to f6efd55a 
Dealt to f1be594d 
Dealt to ac6501c3 
f6efd55a: folds
f1be594d: folds
ac6501c3: raises $0.1 to $0.15
167e28c4: raises $0.3 to $0.45
64b39229: folds
Hero: folds
ac6501c3: calls $0.3
*** FLOP *** [Ah Jd Jh]
ac6501c3: checks
167e28c4: bets $0.49
ac6501c3: calls $0.49
*** TURN *** [Ah Jd Jh] [As]
ac6501c3: checks
167e28c4: checks
*** RIVER *** [Ah Jd Jh As] [Qs]
ac6501c3: bets $0.65
167e28c4: raises $0.65 to $1.3
ac6501c3: folds
Uncalled bet ($0.65) returned to 167e28c4
*** SHOWDOWN ***
167e28c4 collected $3.03 from pot
*** SUMMARY ***
Total pot $3.25 | Rake $0.15 | Jackpot $0.07 | Bingo $0 | Fortune $0 | Tax $0
Board [Ah Jd Jh As Qs]
Seat 1: 167e28c4 (button) won ($3.03)
Seat 2: 64b39229 (small blind) folded before Flop
Seat 3: Hero (big blind) folded before Flop
Seat 4: f6efd55a folded before Flop (didn't bet)
Seat 5: f1be594d folded before Flop (didn't bet)
Seat 6: ac6501c3 folded on the River


Poker Hand #RC3334557276: Hold'em No Limit ($0.02/$0.05) - 2025/02/17 21:19:13
Table 'RushAndCash622536' 6-max Seat #1 is the button
Seat 1: ef7e6107 ($5.17 in chips)
Seat 2: 99df5763 ($7.6 in chips)
Seat 3: 6863e136 ($4.91 in chips)
Seat 4: 66be2112 ($5.12 in chips)
Seat 5: Hero ($8.02 in chips)
Seat 6: a19fb924 ($6.78 in chips)
99df5763: posts small blind $0.02
6863e136: posts big blind $0.05
*** HOLE CARDS ***
Dealt to ef7e6107 
Dealt to 99df5763 
Dealt to 6863e136 
Dealt to 66be2112 
Dealt to Hero [Kh 5c]
Dealt to a19fb924 
66be2112: raises $0.08 to $0.13
Hero: folds
a19fb924: folds
ef7e6107: folds
99df5763: folds
6863e136: calls $0.08
*** FLOP *** [Ad 7h 2c]
6863e136: checks
66be2112: bets $0.1
6863e136: calls $0.1
*** TURN *** [Ad 7h 2c] [9h]
6863e136: checks
66be2112: checks
*** RIVER *** [Ad 7h 2c 9h] [Th]
6863e136: bets $0.26
66be2112: folds
Uncalled bet ($0.26) returned to 6863e136
*** SHOWDOWN ***
6863e136 collected $0.46 from pot
*** SUMMARY ***
Total pot $0.48 | Rake $0.02 | Jackpot $0 | Bingo $0 | Fortune $0 | Tax $0
Board [Ad 7h 2c 9h Th]
Seat 1: ef7e6107 (button) folded before Flop (didn't bet)
Seat 2: 99df5763 (small blind) folded before Flop
Seat 3: 6863e136 (big blind) won ($0.46)
Seat 4: 66be2112 folded on the River
Seat 5: Hero folded before Flop (didn't bet)
Seat 6: a19fb924 folded before Flop (didn't bet)


Poker Hand #RC3334557201: Hold'em No Limit ($0.02/$0.05) - 2025/02/17 21:19:04
Table 'RushAndCash622461' 6-max Seat #1 is the button
Seat 1: 4f7979c7 ($4.99 in chips)
Seat 2: 95096c6a ($5.65 in chips)
Seat 3: 53a8c2fd ($11.12 in chips)
Seat 4: Hero ($7.95 in chips)
Seat 5: e3cc36cb ($5 in chips)
Seat 6: a8c71cd6 ($5 in chips)
95096c6a: posts small blind $0.02
53a8c2fd: posts big blind $0.05
*** HOLE CARDS ***
Dealt to 4f7979c7 
Dealt to 95096c6a 
Dealt to 53a8c2fd 
Dealt to Hero [Th Ts]
Dealt to e3cc36cb 
Dealt to a8c71cd6 
Hero: raises $0.05 to $0.1
e3cc36cb: folds
a8c71cd6: folds
4f7979c7: folds
95096c6a: folds
53a8c2fd: folds
Uncalled bet ($0.05) returned to Hero
*** SHOWDOWN ***
Hero collected $0.12 from pot
*** SUMMARY ***
Total pot $0.12 | Rake $0 | Jackpot $0 | Bingo $0 | Fortune $0 | Tax $0
Seat 1: 4f7979c7 (button) folded before Flop (didn't bet)
Seat 2: 95096c6a (small blind) folded before Flop
Seat 3: 53a8c2fd (big blind) folded before Flop
Seat 4: Hero collected ($0.12)
Seat 5: e3cc36cb folded before Flop (didn't bet)
Seat 6: a8c71cd6 folded before Flop (didn't bet)


Poker Hand #RC3334556861: Hold'em No Limit ($0.02/$0.05) - 2025/02/17 21:18:20
Table 'RushAndCash622121' 6-max Seat #1 is the button
Seat 1: Hero ($7.84 in chips)
Seat 2: e58268de ($7.82 in chips)
Seat 3: 95096c6a ($5.68 in chips)
Seat 4: 20c536f4 ($4.35 in chips)
Seat 5: ca601b39 ($9.47 in chips)
Seat 6: 7a40fb8f ($5.55 in chips)
e58268de: posts small blind $0.02
95096c6a: posts big blind $0.05
*** HOLE CARDS ***
Dealt to Hero [Js Qh]
Dealt to e58268de 
Dealt to 95096c6a 
Dealt to 20c536f4 
Dealt to ca601b39 
Dealt to 7a40fb8f 
20c536f4: folds
ca601b39: folds
7a40fb8f: folds
Hero: raises $0.05 to $0.1
e58268de: folds
95096c6a: calls $0.05
*** FLOP *** [5d 4h 3d]
95096c6a: checks
Hero: checks
*** TURN *** [5d 4h 3d] [Qs]
95096c6a: checks
Hero: bets $0.12
95096c6a: folds
Uncalled bet ($0.12) returned to Hero
*** SHOWDOWN ***
Hero collected $0.21 from pot
*** SUMMARY ***
Total pot $0.22 | Rake $0.01 | Jackpot $0 | Bingo $0 | Fortune $0 | Tax $0
Board [5d 4h 3d Qs]
Seat 1: Hero (button) won ($0.21)
Seat 2: e58268de (small blind) folded before Flop
Seat 3: 95096c6a (big blind) folded on the Turn
Seat 4: 20c536f4 folded before Flop (didn't bet)
Seat 5: ca601b39 folded before Flop (didn't bet)
Seat 6: 7a40fb8f folded before Flop (didn't bet)


Poker Hand #RC3334556834: Hold'em No Limit ($0.02/$0.05) - 2025/02/17 21:18:16
Table 'RushAndCash622094' 6-max Seat #1 is the button
Seat 1: c5f37c20 ($3.06 in chips)
Seat 2: 3b2a8270 ($11.58 in chips)
Seat 3: 21bff972 ($6.73 in chips)
Seat 4: c1784884 ($7.89 in chips)
Seat 5: Hero ($7.84 in chips)
Seat 6: 442376ec ($5 in chips)
3b2a8270: posts small blind $0.02
21bff972: posts big blind $0.05
*** HOLE CARDS ***
Dealt to c5f37c20 
Dealt to 3b2a8270 
Dealt to 21bff972 
Dealt to c1784884 
Dealt to Hero [2h Js]
Dealt to 442376ec 
c1784884: folds
Hero: folds
442376ec: raises $0.06 to $0.11
c5f37c20: calls $0.11
3b2a8270: folds
21bff972: folds
*** FLOP *** [4h 7d 3s]
442376ec: bets $0.15
c5f37c20: folds
Uncalled bet ($0.15) returned to 442376ec
*** SHOWDOWN ***
442376ec collected $0.28 from pot
*** SUMMARY ***
Total pot $0.29 | Rake $0.01 | Jackpot $0 | Bingo $0 | Fortune $0 | Tax $0
Board [4h 7d 3s]
Seat 1: c5f37c20 (button) folded on the Flop
Seat 2: 3b2a8270 (small blind) folded before Flop
Seat 3: 21bff972 (big blind) folded before Flop
Seat 4: c1784884 folded before Flop (didn't bet)
Seat 5: Hero folded before Flop (didn't bet)
Seat 6: 442376ec won ($0.28)


Poker Hand #RC3334556806: Hold'em No Limit ($0.02/$0.05) - 2025/02/17 21:18:12
Table 'RushAndCash622066' 6-max Seat #1 is the button
Seat 1: a730170a ($5 in chips)
Seat 2: c1784884 ($7.91 in chips)
Seat 3: b86c29aa ($9.95 in chips)
Seat 4: 8e93231a ($5.07 in chips)
Seat 5: Hero ($7.84 in chips)
Seat 6: 2ffae4a2 ($14.49 in chips)
c1784884: posts small blind $0.02
b86c29aa: posts big blind $0.05
*** HOLE CARDS ***
Dealt to a730170a 
Dealt to c1784884 
Dealt to b86c29aa 
Dealt to 8e93231a 
Dealt to Hero [2s Kc]
Dealt to 2ffae4a2 
8e93231a: folds
Hero: folds
2ffae4a2: folds
a730170a: folds
c1784884: folds
Uncalled bet ($0.03) returned to b86c29aa
*** SHOWDOWN ***
b86c29aa collected $0.04 from pot
*** SUMMARY ***
Total pot $0.04 | Rake $0 | Jackpot $0 | Bingo $0 | Fortune $0 | Tax $0
Seat 1: a730170a (button) folded before Flop (didn't bet)
Seat 2: c1784884 (small blind) folded before Flop
Seat 3: b86c29aa (big blind) collected ($0.04)
Seat 4: 8e93231a folded before Flop (didn't bet)
Seat 5: Hero folded before Flop (didn't bet)
Seat 6: 2ffae4a2 folded before Flop (didn't bet)


Poker Hand #RC3334556776: Hold'em No Limit ($0.02/$0.05) - 2025/02/17 21:18:09
Table 'RushAndCash622036' 6-max Seat #1 is the button
Seat 1: 5a37a767 ($6.57 in chips)
Seat 2: a9eb9f38 ($5.02 in chips)
Seat 3: b4bc5ab5 ($5 in chips)
Seat 4: Hero ($7.84 in chips)
Seat 5: 42fca4f9 ($9.33 in chips)
Seat 6: 5acd5e40 ($6.02 in chips)
a9eb9f38: posts small blind $0.02
b4bc5ab5: posts big blind $0.05
*** HOLE CARDS ***
Dealt to 5a37a767 
Dealt to a9eb9f38 
Dealt to b4bc5ab5 
Dealt to Hero [Kh 8s]
Dealt to 42fca4f9 
Dealt to 5acd5e40 
Hero: folds
42fca4f9: folds
5acd5e40: folds
5a37a767: raises $0.08 to $0.13
a9eb9f38: folds
b4bc5ab5: folds
Uncalled bet ($0.08) returned to 5a37a767
*** SHOWDOWN ***
5a37a767 collected $0.12 from pot
*** SUMMARY ***
Total pot $0.12 | Rake $0 | Jackpot $0 | Bingo $0 | Fortune $0 | Tax $0
Seat 1: 5a37a767 (button) collected ($0.12)
Seat 2: a9eb9f38 (small blind) folded before Flop
Seat 3: b4bc5ab5 (big blind) folded before Flop
Seat 4: Hero folded before Flop (didn't bet)
Seat 5: 42fca4f9 folded before Flop (didn't bet)
Seat 6: 5acd5e40 folded before Flop (didn't bet)


Poker Hand #RC3334556413: Hold'em No Limit ($0.02/$0.05) - 2025/02/17 21:17:23
Table 'RushAndCash621673' 6-max Seat #1 is the button
Seat 1: 8e07c53 ($5.19 in chips)
Seat 2: 4ea8e2e ($13.15 in chips)
Seat 3: e9c5dfd7 ($9.6 in chips)
Seat 4: 6b09dc81 ($4.81 in chips)
Seat 5: ccabd9d2 ($4.88 in chips)
Seat 6: Hero ($7.94 in chips)
4ea8e2e: posts small blind $0.02
e9c5dfd7: posts big blind $0.05
*** HOLE CARDS ***
Dealt to 8e07c53 
Dealt to 4ea8e2e 
Dealt to e9c5dfd7 
Dealt to 6b09dc81 
Dealt to ccabd9d2 
Dealt to Hero [Ah 9c]
6b09dc81: folds
ccabd9d2: folds
Hero: raises $0.05 to $0.1
8e07c53: calls $0.1
4ea8e2e: folds
e9c5dfd7: calls $0.05
*** FLOP *** [9d Kd Td]
e9c5dfd7: checks
Hero: checks
8e07c53: checks
*** TURN *** [9d Kd Td] [Jc]
e9c5dfd7: checks
Hero: checks
8e07c53: checks
*** RIVER *** [9d Kd Td Jc] [Qd]
e9c5dfd7: bets $0.1
Hero: folds
8e07c53: calls $0.1
e9c5dfd7: shows [7d 6c] (King High Flush)
8e07c53: shows [4s 4d] (King High Flush)
*** SHOWDOWN ***
e9c5dfd7 collected $0.5 from pot
*** SUMMARY ***
Total pot $0.52 | Rake $0.02 | Jackpot $0 | Bingo $0 | Fortune $0 | Tax $0
Board [9d Kd Td Jc Qd]
Seat 1: 8e07c53 (button) showed [4s 4d] and lost with King High Flush
Seat 2: 4ea8e2e (small blind) folded before Flop
Seat 3: e9c5dfd7 (big blind) showed [7d 6c] and won ($0.5) with King High Flush
Seat 4: 6b09dc81 folded before Flop (didn't bet)
Seat 5: ccabd9d2 folded before Flop (didn't bet)
Seat 6: Hero folded on the River


Poker Hand #RC3334556372: Hold'em No Limit ($0.02/$0.05) - 2025/02/17 21:17:18
Table 'RushAndCash621632' 6-max Seat #1 is the button
Seat 1: 69a18b01 ($6.6 in chips)
Seat 2: Hero ($7.96 in chips)
Seat 3: 7c8d7172 ($6.47 in chips)
Seat 4: c1784884 ($7.99 in chips)
Seat 5: b39a93ce ($7.28 in chips)
Seat 6: c514c40d ($5.12 in chips)
Hero: posts small blind $0.02
7c8d7172: posts big blind $0.05
*** HOLE CARDS ***
Dealt to 69a18b01 
Dealt to Hero [9s 2h]
Dealt to 7c8d7172 
Dealt to c1784884 
Dealt to b39a93ce 
Dealt to c514c40d 
c1784884: folds
b39a93ce: raises $0.05 to $0.1
c514c40d: folds
69a18b01: calls $0.1
Hero: folds
7c8d7172: folds
*** FLOP *** [3d 6h 8h]
b39a93ce: checks
69a18b01: checks
*** TURN *** [3d 6h 8h] [2s]
b39a93ce: bets $0.15
69a18b01: folds
Uncalled bet ($0.15) returned to b39a93ce
*** SHOWDOWN ***
b39a93ce collected $0.26 from pot
*** SUMMARY ***
Total pot $0.27 | Rake $0.01 | Jackpot $0 | Bingo $0 | Fortune $0 | Tax $0
Board [3d 6h 8h 2s]
Seat 1: 69a18b01 (button) folded on the Turn
Seat 2: Hero (small blind) folded before Flop
Seat 3: 7c8d7172 (big blind) folded before Flop
Seat 4: c1784884 folded before Flop (didn't bet)
Seat 5: b39a93ce won ($0.26)
Seat 6: c514c40d folded before Flop (didn't bet)


Poker Hand #RC3334555999: Hold'em No Limit ($0.02/$0.05) - 2025/02/17 21:16:31
Table 'RushAndCash621259' 6-max Seat #1 is the button
Seat 1: 15346d36 ($7.16 in chips)
Seat 2: Hero ($8.71 in chips)
Seat 3: 69a18b01 ($5.99 in chips)
Seat 4: 19bb03b5 ($12.35 in chips)
Seat 5: b9d877b0 ($5.14 in chips)
Seat 6: d58b99ca ($32.35 in chips)
Hero: posts small blind $0.02
69a18b01: posts big blind $0.05
*** HOLE CARDS ***
Dealt to 15346d36 
Dealt to Hero [Qs Ad]
Dealt to 69a18b01 
Dealt to 19bb03b5 
Dealt to b9d877b0 
Dealt to d58b99ca 
19bb03b5: folds
b9d877b0: folds
d58b99ca: folds
15346d36: folds
Hero: raises $0.1 to $0.15
69a18b01: raises $0.3 to $0.45
Hero: calls $0.3
*** FLOP *** [6c As 8s]
Hero: checks
69a18b01: bets $0.3
Hero: calls $0.3
*** TURN *** [6c As 8s] [2h]
Hero: checks
69a18b01: bets $1.4
Hero: folds
Uncalled bet ($1.4) returned to 69a18b01
*** SHOWDOWN ***
69a18b01 collected $1.36 from pot
*** SUMMARY ***
Total pot $1.5 | Rake $0.07 | Jackpot $0.07 | Bingo $0 | Fortune $0 | Tax $0
Board [6c As 8s 2h]
Seat 1: 15346d36 (button) folded before Flop (didn't bet)
Seat 2: Hero (small blind) folded on the Turn
Seat 3: 69a18b01 (big blind) won ($1.36)
Seat 4: 19bb03b5 folded before Flop (didn't bet)
Seat 5: b9d877b0 folded before Flop (didn't bet)
Seat 6: d58b99ca folded before Flop (didn't bet)


Poker Hand #RC3334555818: Hold'em No Limit ($0.02/$0.05) - 2025/02/17 21:16:08
Table 'RushAndCash621078' 6-max Seat #1 is the button
Seat 1: b9d877b0 ($5.27 in chips)
Seat 2: e20e5cfc ($5.52 in chips)
Seat 3: Hero ($8.57 in chips)
Seat 4: c7e9103c ($11.06 in chips)
Seat 5: 1fee54bc ($5.14 in chips)
Seat 6: ac6c5037 ($4.83 in chips)
e20e5cfc: posts small blind $0.02
Hero: posts big blind $0.05
*** HOLE CARDS ***
Dealt to b9d877b0 
Dealt to e20e5cfc 
Dealt to Hero [Ac Qc]
Dealt to c7e9103c 
Dealt to 1fee54bc 
Dealt to ac6c5037 
c7e9103c: folds
1fee54bc: folds
ac6c5037: folds
b9d877b0: raises $0.08 to $0.13
e20e5cfc: folds
Hero: raises $0.35 to $0.48
b9d877b0: folds
Uncalled bet ($0.35) returned to Hero
*** SHOWDOWN ***
Hero collected $0.27 from pot
*** SUMMARY ***
Total pot $0.28 | Rake $0.01 | Jackpot $0 | Bingo $0 | Fortune $0 | Tax $0
Seat 1: b9d877b0 (button) folded before Flop
Seat 2: e20e5cfc (small blind) folded before Flop
Seat 3: Hero (big blind) collected ($0.27)
Seat 4: c7e9103c folded before Flop (didn't bet)
Seat 5: 1fee54bc folded before Flop (didn't bet)
Seat 6: ac6c5037 folded before Flop (didn't bet)


Poker Hand #RC3334555767: Hold'em No Limit ($0.02/$0.05) - 2025/02/17 21:16:02
Table 'RushAndCash621027' 6-max Seat #1 is the button
Seat 1: Hero ($8.57 in chips)
Seat 2: 692417ff ($5 in chips)
Seat 3: 1fee54bc ($5.21 in chips)
Seat 4: 51ee7ca4 ($4.97 in chips)
Seat 5: e352a329 ($5.75 in chips)
Seat 6: ef96c0c8 ($6.08 in chips)
692417ff: posts small blind $0.02
1fee54bc: posts big blind $0.05
*** HOLE CARDS ***
Dealt to Hero [Ah 5d]
Dealt to 692417ff 
Dealt to 1fee54bc 
Dealt to 51ee7ca4 
Dealt to e352a329 
Dealt to ef96c0c8 
51ee7ca4: folds
e352a329: folds
ef96c0c8: folds
Hero: folds
692417ff: raises $0.1 to $0.15
1fee54bc: folds
Uncalled bet ($0.1) returned to 692417ff
*** SHOWDOWN ***
692417ff collected $0.1 from pot
*** SUMMARY ***
Total pot $0.1 | Rake $0 | Jackpot $0 | Bingo $0 | Fortune $0 | Tax $0
Seat 1: Hero (button) folded before Flop (didn't bet)
Seat 2: 692417ff (small blind) collected ($0.1)
Seat 3: 1fee54bc (big blind) folded before Flop
Seat 4: 51ee7ca4 folded before Flop (didn't bet)
Seat 5: e352a329 folded before Flop (didn't bet)
Seat 6: ef96c0c8 folded before Flop (didn't bet)


Poker Hand #RC3334555736: Hold'em No Limit ($0.02/$0.05) - 2025/02/17 21:15:57
Table 'RushAndCash620996' 6-max Seat #1 is the button
Seat 1: 71f2556b ($1.67 in chips)
Seat 2: ceaf3b1d ($5.02 in chips)
Seat 3: Hero ($8.62 in chips)
Seat 4: b144f063 ($9.18 in chips)
Seat 5: fe735289 ($5.58 in chips)
Seat 6: 22643080 ($6.76 in chips)
ceaf3b1d: posts small blind $0.02
Hero: posts big blind $0.05
*** HOLE CARDS ***
Dealt to 71f2556b 
Dealt to ceaf3b1d 
Dealt to Hero [Qs 4h]
Dealt to b144f063 
Dealt to fe735289 
Dealt to 22643080 
b144f063: raises $0.05 to $0.1
fe735289: folds
22643080: calls $0.1
71f2556b: folds
ceaf3b1d: folds
Hero: folds
*** FLOP *** [9d 9h 4s]
b144f063: checks
22643080: bets $0.14
b144f063: folds
Uncalled bet ($0.14) returned to 22643080
*** SHOWDOWN ***
22643080 collected $0.26 from pot
*** SUMMARY ***
Total pot $0.27 | Rake $0.01 | Jackpot $0 | Bingo $0 | Fortune $0 | Tax $0
Board [9d 9h 4s]
Seat 1: 71f2556b (button) folded before Flop (didn't bet)
Seat 2: ceaf3b1d (small blind) folded before Flop
Seat 3: Hero (big blind) folded before Flop
Seat 4: b144f063 folded on the Flop
Seat 5: fe735289 folded before Flop (didn't bet)
Seat 6: 22643080 won ($0.26)


Poker Hand #RC3334555712: Hold'em No Limit ($0.02/$0.05) - 2025/02/17 21:15:54
Table 'RushAndCash620972' 6-max Seat #1 is the button
Seat 1: 258a2071 ($10.22 in chips)
Seat 2: 6614dc4b ($5.91 in chips)
Seat 3: a730170a ($5 in chips)
Seat 4: Hero ($8.62 in chips)
Seat 5: f3614ba1 ($9.97 in chips)
Seat 6: 24aff26b ($6.19 in chips)
6614dc4b: posts small blind $0.02
a730170a: posts big blind $0.05
*** HOLE CARDS ***
Dealt to 258a2071 
Dealt to 6614dc4b 
Dealt to a730170a 
Dealt to Hero [4c 3c]
Dealt to f3614ba1 
Dealt to 24aff26b 
Hero: folds
f3614ba1: folds
24aff26b: folds
258a2071: folds
6614dc4b: raises $0.06 to $0.11
a730170a: folds
Uncalled bet ($0.06) returned to 6614dc4b
*** SHOWDOWN ***
6614dc4b collected $0.1 from pot
*** SUMMARY ***
Total pot $0.1 | Rake $0 | Jackpot $0 | Bingo $0 | Fortune $0 | Tax $0
Seat 1: 258a2071 (button) folded before Flop (didn't bet)
Seat 2: 6614dc4b (small blind) collected ($0.1)
Seat 3: a730170a (big blind) folded before Flop
Seat 4: Hero folded before Flop (didn't bet)
Seat 5: f3614ba1 folded before Flop (didn't bet)
Seat 6: 24aff26b folded before Flop (didn't bet)


Poker Hand #RC3334555686: Hold'em No Limit ($0.02/$0.05) - 2025/02/17 21:15:50
Table 'RushAndCash620946' 6-max Seat #1 is the button
Seat 1: Hero ($8.62 in chips)
Seat 2: 94b22b92 ($7.66 in chips)
Seat 3: 258a2071 ($10.27 in chips)
Seat 4: 692e3a83 ($10.65 in chips)
Seat 5: 4812f5c8 ($5.25 in chips)
Seat 6: e56c8107 ($5.07 in chips)
94b22b92: posts small blind $0.02
258a2071: posts big blind $0.05
*** HOLE CARDS ***
Dealt to Hero [Qd 3d]
Dealt to 94b22b92 
Dealt to 258a2071 
Dealt to 692e3a83 
Dealt to 4812f5c8 
Dealt to e56c8107 
692e3a83: raises $0.07 to $0.12
4812f5c8: folds
e56c8107: folds
Hero: folds
94b22b92: calls $0.1
258a2071: folds
*** FLOP *** [Tc Ts 2h]
94b22b92: checks
692e3a83: bets $0.1
94b22b92: folds
Uncalled bet ($0.1) returned to 692e3a83
*** SHOWDOWN ***
692e3a83 collected $0.28 from pot
*** SUMMARY ***
Total pot $0.29 | Rake $0.01 | Jackpot $0 | Bingo $0 | Fortune $0 | Tax $0
Board [Tc Ts 2h]
Seat 1: Hero (button) folded before Flop (didn't bet)
Seat 2: 94b22b92 (small blind) folded on the Flop
Seat 3: 258a2071 (big blind) folded before Flop
Seat 4: 692e3a83 won ($0.28)
Seat 5: 4812f5c8 folded before Flop (didn't bet)
Seat 6: e56c8107 folded before Flop (didn't bet)


Poker Hand #RC3334555652: Hold'em No Limit ($0.02/$0.05) - 2025/02/17 21:15:46
Table 'RushAndCash620912' 6-max Seat #1 is the button
Seat 1: 1b63280e ($6.15 in chips)
Seat 2: 1ea6bb97 ($5.31 in chips)
Seat 3: 93a9dba6 ($5.23 in chips)
Seat 4: 6e22a6c1 ($5 in chips)
Seat 5: 25f30dbe ($2.91 in chips)
Seat 6: Hero ($8.62 in chips)
1ea6bb97: posts small blind $0.02
93a9dba6: posts big blind $0.05
*** HOLE CARDS ***
Dealt to 1b63280e 
Dealt to 1ea6bb97 
Dealt to 93a9dba6 
Dealt to 6e22a6c1 
Dealt to 25f30dbe 
Dealt to Hero [8s 5h]
6e22a6c1: folds
25f30dbe: folds
Hero: folds
1b63280e: folds
1ea6bb97: raises $0.1 to $0.15
93a9dba6: folds
Uncalled bet ($0.1) returned to 1ea6bb97
*** SHOWDOWN ***
1ea6bb97 collected $0.1 from pot
*** SUMMARY ***
Total pot $0.1 | Rake $0 | Jackpot $0 | Bingo $0 | Fortune $0 | Tax $0
Seat 1: 1b63280e (button) folded before Flop (didn't bet)
Seat 2: 1ea6bb97 (small blind) collected ($0.1)
Seat 3: 93a9dba6 (big blind) folded before Flop
Seat 4: 6e22a6c1 folded before Flop (didn't bet)
Seat 5: 25f30dbe folded before Flop (didn't bet)
Seat 6: Hero folded before Flop (didn't bet)


Poker Hand #RC3334555624: Hold'em No Limit ($0.02/$0.05) - 2025/02/17 21:15:42
Table 'RushAndCash620884' 6-max Seat #1 is the button
Seat 1: 7c65d0bd ($5 in chips)
Seat 2: 94cb065d ($5 in chips)
Seat 3: ca462b6a ($6.17 in chips)
Seat 4: Hero ($8.62 in chips)
Seat 5: 25c12d13 ($4.93 in chips)
Seat 6: 1aca371e ($9.2 in chips)
94cb065d: posts small blind $0.02
ca462b6a: posts big blind $0.05
*** HOLE CARDS ***
Dealt to 7c65d0bd 
Dealt to 94cb065d 
Dealt to ca462b6a 
Dealt to Hero [6s 8s]
Dealt to 25c12d13 
Dealt to 1aca371e 
Hero: folds
25c12d13: folds
1aca371e: folds
7c65d0bd: raises $0.07 to $0.12
94cb065d: folds
ca462b6a: folds
Uncalled bet ($0.07) returned to 7c65d0bd
*** SHOWDOWN ***
7c65d0bd collected $0.12 from pot
*** SUMMARY ***
Total pot $0.12 | Rake $0 | Jackpot $0 | Bingo $0 | Fortune $0 | Tax $0
Seat 1: 7c65d0bd (button) collected ($0.12)
Seat 2: 94cb065d (small blind) folded before Flop
Seat 3: ca462b6a (big blind) folded before Flop
Seat 4: Hero folded before Flop (didn't bet)
Seat 5: 25c12d13 folded before Flop (didn't bet)
Seat 6: 1aca371e folded before Flop (didn't bet)


Poker Hand #RC3334555599: Hold'em No Limit ($0.02/$0.05) - 2025/02/17 21:15:38
Table 'RushAndCash620859' 6-max Seat #1 is the button
Seat 1: d03e7668 ($5.57 in chips)
Seat 2: Hero ($8.64 in chips)
Seat 3: b4c33f6c ($5.85 in chips)
Seat 4: 43c437e9 ($14.83 in chips)
Seat 5: ce1cdeb ($5.55 in chips)
Seat 6: fad81e68 ($7.37 in chips)
Hero: posts small blind $0.02
b4c33f6c: posts big blind $0.05
*** HOLE CARDS ***
Dealt to d03e7668 
Dealt to Hero [Ad 5h]
Dealt to b4c33f6c 
Dealt to 43c437e9 
Dealt to ce1cdeb 
Dealt to fad81e68 
43c437e9: folds
ce1cdeb: folds
fad81e68: folds
d03e7668: folds
Hero: folds
Uncalled bet ($0.03) returned to b4c33f6c
*** SHOWDOWN ***
b4c33f6c collected $0.04 from pot
*** SUMMARY ***
Total pot $0.04 | Rake $0 | Jackpot $0 | Bingo $0 | Fortune $0 | Tax $0
Seat 1: d03e7668 (button) folded before Flop (didn't bet)
Seat 2: Hero (small blind) folded before Flop
Seat 3: b4c33f6c (big blind) collected ($0.04)
Seat 4: 43c437e9 folded before Flop (didn't bet)
Seat 5: ce1cdeb folded before Flop (didn't bet)
Seat 6: fad81e68 folded before Flop (didn't bet)


Poker Hand #RC3334555573: Hold'em No Limit ($0.02/$0.05) - 2025/02/17 21:15:35
Table 'RushAndCash620833' 6-max Seat #1 is the button
Seat 1: 3c76a91d ($11.03 in chips)
Seat 2: 207d9345 ($22.22 in chips)
Seat 3: ec1214a6 ($5.02 in chips)
Seat 4: Hero ($8.64 in chips)
Seat 5: 5b79005a ($4.53 in chips)
Seat 6: a6f27d3d ($5.21 in chips)
207d9345: posts small blind $0.02
ec1214a6: posts big blind $0.05
*** HOLE CARDS ***
Dealt to 3c76a91d 
Dealt to 207d9345 
Dealt to ec1214a6 
Dealt to Hero [7d Kd]
Dealt to 5b79005a 
Dealt to a6f27d3d 
Hero: folds
5b79005a: folds
a6f27d3d: folds
3c76a91d: raises $0.05 to $0.1
207d9345: folds
ec1214a6: folds
Uncalled bet ($0.05) returned to 3c76a91d
*** SHOWDOWN ***
3c76a91d collected $0.12 from pot
*** SUMMARY ***
Total pot $0.12 | Rake $0 | Jackpot $0 | Bingo $0 | Fortune $0 | Tax $0
Seat 1: 3c76a91d (button) collected ($0.12)
Seat 2: 207d9345 (small blind) folded before Flop
Seat 3: ec1214a6 (big blind) folded before Flop
Seat 4: Hero folded before Flop (didn't bet)
Seat 5: 5b79005a folded before Flop (didn't bet)
Seat 6: a6f27d3d folded before Flop (didn't bet)


Poker Hand #RC3334555547: Hold'em No Limit ($0.02/$0.05) - 2025/02/17 21:15:32
Table 'RushAndCash620807' 6-max Seat #1 is the button
Seat 1: 4e3c3196 ($28.28 in chips)
Seat 2: edb41254 ($8.05 in chips)
Seat 3: Hero ($8.69 in chips)
Seat 4: ec1214a6 ($5.02 in chips)
Seat 5: 8f1315bb ($6.04 in chips)
Seat 6: 2ae4e16 ($4.21 in chips)
edb41254: posts small blind $0.02
Hero: posts big blind $0.05
*** HOLE CARDS ***
Dealt to 4e3c3196 
Dealt to edb41254 
Dealt to Hero [Kd 6d]
Dealt to ec1214a6 
Dealt to 8f1315bb 
Dealt to 2ae4e16 
ec1214a6: folds
8f1315bb: folds
2ae4e16: folds
4e3c3196: raises $0.05 to $0.1
edb41254: raises $0.2 to $0.3
Hero: folds
4e3c3196: calls $0.2
*** FLOP *** [Jd 2s Ah]
edb41254: checks
4e3c3196: bets $0.22
edb41254: calls $0.22
*** TURN *** [Jd 2s Ah] [Qd]
edb41254: checks
4e3c3196: bets $0.55
edb41254: folds
Uncalled bet ($0.55) returned to 4e3c3196
*** SHOWDOWN ***
4e3c3196 collected $1.04 from pot
*** SUMMARY ***
Total pot $1.09 | Rake $0.05 | Jackpot $0 | Bingo $0 | Fortune $0 | Tax $0
Board [Jd 2s Ah Qd]
Seat 1: 4e3c3196 (button) won ($1.04)
Seat 2: edb41254 (small blind) folded on the Turn
Seat 3: Hero (big blind) folded before Flop
Seat 4: ec1214a6 folded before Flop (didn't bet)
Seat 5: 8f1315bb folded before Flop (didn't bet)
Seat 6: 2ae4e16 folded before Flop (didn't bet)


Poker Hand #RC3334555521: Hold'em No Limit ($0.02/$0.05) - 2025/02/17 21:15:29
Table 'RushAndCash620781' 6-max Seat #1 is the button
Seat 1: f0463362 ($4.79 in chips)
Seat 2: 34028f01 ($5.34 in chips)
Seat 3: d6f5b483 ($9.6 in chips)
Seat 4: 2ae4e16 ($4.21 in chips)
Seat 5: Hero ($8.69 in chips)
Seat 6: 5cfa2d9a ($4.95 in chips)
34028f01: posts small blind $0.02
d6f5b483: posts big blind $0.05
*** HOLE CARDS ***
Dealt to f0463362 
Dealt to 34028f01 
Dealt to d6f5b483 
Dealt to 2ae4e16 
Dealt to Hero [6d Qd]
Dealt to 5cfa2d9a 
2ae4e16: folds
Hero: folds
5cfa2d9a: folds
f0463362: folds
34028f01: raises $0.08 to $0.13
d6f5b483: calls $0.08
*** FLOP *** [Ad Kd Jh]
34028f01: checks
d6f5b483: bets $0.16
34028f01: folds
Uncalled bet ($0.16) returned to d6f5b483
*** SHOWDOWN ***
d6f5b483 collected $0.25 from pot
*** SUMMARY ***
Total pot $0.26 | Rake $0.01 | Jackpot $0 | Bingo $0 | Fortune $0 | Tax $0
Board [Ad Kd Jh]
Seat 1: f0463362 (button) folded before Flop (didn't bet)
Seat 2: 34028f01 (small blind) folded on the Flop
Seat 3: d6f5b483 (big blind) won ($0.25)
Seat 4: 2ae4e16 folded before Flop (didn't bet)
Seat 5: Hero folded before Flop (didn't bet)
Seat 6: 5cfa2d9a folded before Flop (didn't bet)


Poker Hand #RC3334555498: Hold'em No Limit ($0.02/$0.05) - 2025/02/17 21:15:26
Table 'RushAndCash620758' 6-max Seat #1 is the button
Seat 1: f71501ed ($5.17 in chips)
Seat 2: 7c65d0bd ($5.02 in chips)
Seat 3: b1dc2d97 ($5.79 in chips)
Seat 4: dcd4e05 ($1.99 in chips)
Seat 5: d0d9ce45 ($3.92 in chips)
Seat 6: Hero ($8.69 in chips)
7c65d0bd: posts small blind $0.02
b1dc2d97: posts big blind $0.05
*** HOLE CARDS ***
Dealt to f71501ed 
Dealt to 7c65d0bd 
Dealt to b1dc2d97 
Dealt to dcd4e05 
Dealt to d0d9ce45 
Dealt to Hero [2h 3h]
dcd4e05: raises $0.05 to $0.1
d0d9ce45: folds
Hero: folds
f71501ed: folds
7c65d0bd: folds
b1dc2d97: folds
Uncalled bet ($0.05) returned to dcd4e05
*** SHOWDOWN ***
dcd4e05 collected $0.12 from pot
*** SUMMARY ***
Total pot $0.12 | Rake $0 | Jackpot $0 | Bingo $0 | Fortune $0 | Tax $0
Seat 1: f71501ed (button) folded before Flop (didn't bet)
Seat 2: 7c65d0bd (small blind) folded before Flop
Seat 3: b1dc2d97 (big blind) folded before Flop
Seat 4: dcd4e05 collected ($0.12)
Seat 5: d0d9ce45 folded before Flop (didn't bet)
Seat 6: Hero folded before Flop (didn't bet)


Poker Hand #RC3334555475: Hold'em No Limit ($0.02/$0.05) - 2025/02/17 21:15:23
Table 'RushAndCash620735' 6-max Seat #1 is the button
Seat 1: fd5b33a8 ($4.93 in chips)
Seat 2: 25f30dbe ($2.93 in chips)
Seat 3: 65ca9276 ($8.69 in chips)
Seat 4: b0d0d63c ($8.87 in chips)
Seat 5: Hero ($8.69 in chips)
Seat 6: 93a9dba6 ($5.23 in chips)
25f30dbe: posts small blind $0.02
65ca9276: posts big blind $0.05
*** HOLE CARDS ***
Dealt to fd5b33a8 
Dealt to 25f30dbe 
Dealt to 65ca9276 
Dealt to b0d0d63c 
Dealt to Hero [9d Ac]
Dealt to 93a9dba6 
b0d0d63c: folds
Hero: folds
93a9dba6: folds
fd5b33a8: folds
25f30dbe: folds
Uncalled bet ($0.03) returned to 65ca9276
*** SHOWDOWN ***
65ca9276 collected $0.04 from pot
*** SUMMARY ***
Total pot $0.04 | Rake $0 | Jackpot $0 | Bingo $0 | Fortune $0 | Tax $0
Seat 1: fd5b33a8 (button) folded before Flop (didn't bet)
Seat 2: 25f30dbe (small blind) folded before Flop
Seat 3: 65ca9276 (big blind) collected ($0.04)
Seat 4: b0d0d63c folded before Flop (didn't bet)
Seat 5: Hero folded before Flop (didn't bet)
Seat 6: 93a9dba6 folded before Flop (didn't bet)


Poker Hand #RC3334555410: Hold'em No Limit ($0.02/$0.05) - 2025/02/17 21:15:15
Table 'RushAndCash620670' 6-max Seat #1 is the button
Seat 1: 93dfef8b ($11 in chips)
Seat 2: Hero ($8.71 in chips)
Seat 3: 45d33c76 ($9 in chips)
Seat 4: fa36f7b1 ($4.45 in chips)
Seat 5: 42c7d5a0 ($5.89 in chips)
Seat 6: 3b98b9ec ($18.58 in chips)
Hero: posts small blind $0.02
45d33c76: posts big blind $0.05
*** HOLE CARDS ***
Dealt to 93dfef8b 
Dealt to Hero [Ac Tc]
Dealt to 45d33c76 
Dealt to fa36f7b1 
Dealt to 42c7d5a0 
Dealt to 3b98b9ec 
fa36f7b1: raises $0.05 to $0.1
42c7d5a0: folds
3b98b9ec: raises $0.21 to $0.31
93dfef8b: folds
Hero: folds
45d33c76: folds
fa36f7b1: raises $0.56 to $0.87
3b98b9ec: raises $17.71 to $18.58 and is all-in
fa36f7b1: calls $3.58 and is all-in
Uncalled bet ($14.13) returned to 3b98b9ec
3b98b9ec: shows [Kh Kc]
fa36f7b1: shows [Jd Js]
*** FLOP *** [9c 4d 7c]
*** TURN *** [9c 4d 7c] [3c]
*** RIVER *** [9c 4d 7c 3c] [5c]
*** SHOWDOWN ***
3b98b9ec collected $8.75 from pot
*** SUMMARY ***
Total pot $8.97 | Rake $0.15 | Jackpot $0.07 | Bingo $0 | Fortune $0 | Tax $0
Board [9c 4d 7c 3c 5c]
Seat 1: 93dfef8b (button) folded before Flop (didn't bet)
Seat 2: Hero (small blind) folded before Flop
Seat 3: 45d33c76 (big blind) folded before Flop
Seat 4: fa36f7b1 showed [Jd Js] and lost with Pair of Jacks
Seat 5: 42c7d5a0 folded before Flop (didn't bet)
Seat 6: 3b98b9ec showed [Kh Kc] and won ($8.75) with King High Flush


Poker Hand #RC3334555381: Hold'em No Limit ($0.02/$0.05) - 2025/02/17 21:15:11
Table 'RushAndCash620641' 6-max Seat #1 is the button
Seat 1: f0600331 ($6.19 in chips)
Seat 2: fa30bfa7 ($5 in chips)
Seat 3: 6aa0c391 ($5.21 in chips)
Seat 4: Hero ($8.71 in chips)
Seat 5: 191b60c1 ($8.13 in chips)
Seat 6: ef7e6107 ($5 in chips)
fa30bfa7: posts small blind $0.02
6aa0c391: posts big blind $0.05
*** HOLE CARDS ***
Dealt to f0600331 
Dealt to fa30bfa7 
Dealt to 6aa0c391 
Dealt to Hero [Js 9c]
Dealt to 191b60c1 
Dealt to ef7e6107 
Hero: folds
191b60c1: raises $0.07 to $0.12
ef7e6107: folds
f0600331: folds
fa30bfa7: folds
6aa0c391: folds
Uncalled bet ($0.07) returned to 191b60c1
*** SHOWDOWN ***
191b60c1 collected $0.12 from pot
*** SUMMARY ***
Total pot $0.12 | Rake $0 | Jackpot $0 | Bingo $0 | Fortune $0 | Tax $0
Seat 1: f0600331 (button) folded before Flop (didn't bet)
Seat 2: fa30bfa7 (small blind) folded before Flop
Seat 3: 6aa0c391 (big blind) folded before Flop
Seat 4: Hero folded before Flop (didn't bet)
Seat 5: 191b60c1 collected ($0.12)
Seat 6: ef7e6107 folded before Flop (didn't bet)


Poker Hand #RC3334555354: Hold'em No Limit ($0.02/$0.05) - 2025/02/17 21:15:07
Table 'RushAndCash620614' 6-max Seat #1 is the button
Seat 1: 9165e0e3 ($6.48 in chips)
Seat 2: Hero ($8.73 in chips)
Seat 3: d691d846 ($3.32 in chips)
Seat 4: e390e48e ($9.38 in chips)
Seat 5: 12cda2e0 ($21.95 in chips)
Seat 6: 4b3dba4 ($7.72 in chips)
Hero: posts small blind $0.02
d691d846: posts big blind $0.05
*** HOLE CARDS ***
Dealt to 9165e0e3 
Dealt to Hero [4d 8c]
Dealt to d691d846 
Dealt to e390e48e 
Dealt to 12cda2e0 
Dealt to 4b3dba4 
e390e48e: folds
12cda2e0: folds
4b3dba4: folds
9165e0e3: folds
Hero: folds
Uncalled bet ($0.03) returned to d691d846
*** SHOWDOWN ***
d691d846 collected $0.04 from pot
*** SUMMARY ***
Total pot $0.04 | Rake $0 | Jackpot $0 | Bingo $0 | Fortune $0 | Tax $0
Seat 1: 9165e0e3 (button) folded before Flop (didn't bet)
Seat 2: Hero (small blind) folded before Flop
Seat 3: d691d846 (big blind) collected ($0.04)
Seat 4: e390e48e folded before Flop (didn't bet)
Seat 5: 12cda2e0 folded before Flop (didn't bet)
Seat 6: 4b3dba4 folded before Flop (didn't bet)


Poker Hand #RC3334555312: Hold'em No Limit ($0.02/$0.05) - 2025/02/17 21:15:02
Table 'RushAndCash620572' 6-max Seat #1 is the button
Seat 1: dbf5f543 ($5.28 in chips)
Seat 2: be2277bf ($5.32 in chips)
Seat 3: Hero ($8.78 in chips)
Seat 4: 69407b3a ($5.09 in chips)
Seat 5: a6f27d3d ($5.14 in chips)
Seat 6: ec767863 ($5.57 in chips)
be2277bf: posts small blind $0.02
Hero: posts big blind $0.05
*** HOLE CARDS ***
Dealt to dbf5f543 
Dealt to be2277bf 
Dealt to Hero [7d 2d]
Dealt to 69407b3a 
Dealt to a6f27d3d 
Dealt to ec767863 
69407b3a: folds
a6f27d3d: folds
ec767863: folds
dbf5f543: folds
be2277bf: calls $0.03
Hero: checks
*** FLOP *** [Kd 7s Tc]
be2277bf: bets $0.06
Hero: folds
Uncalled bet ($0.06) returned to be2277bf
*** SHOWDOWN ***
be2277bf collected $0.1 from pot
*** SUMMARY ***
Total pot $0.1 | Rake $0 | Jackpot $0 | Bingo $0 | Fortune $0 | Tax $0
Board [Kd 7s Tc]
Seat 1: dbf5f543 (button) folded before Flop (didn't bet)
Seat 2: be2277bf (small blind) won ($0.1)
Seat 3: Hero (big blind) folded on the Flop
Seat 4: 69407b3a folded before Flop (didn't bet)
Seat 5: a6f27d3d folded before Flop (didn't bet)
Seat 6: ec767863 folded before Flop (didn't bet)


Poker Hand #RC3334555281: Hold'em No Limit ($0.02/$0.05) - 2025/02/17 21:14:57
Table 'RushAndCash620541' 6-max Seat #1 is the button
Seat 1: Hero ($8.78 in chips)
Seat 2: b282789b ($5.39 in chips)
Seat 3: 381c6d82 ($5 in chips)
Seat 4: 198a1e4 ($5.3 in chips)
Seat 5: a2123cbe ($11.56 in chips)
Seat 6: 304e7bcd ($4.67 in chips)
b282789b: posts small blind $0.02
381c6d82: posts big blind $0.05
*** HOLE CARDS ***
Dealt to Hero [Qh 4s]
Dealt to b282789b 
Dealt to 381c6d82 
Dealt to 198a1e4 
Dealt to a2123cbe 
Dealt to 304e7bcd 
198a1e4: folds
a2123cbe: folds
304e7bcd: folds
Hero: folds
b282789b: folds
Uncalled bet ($0.03) returned to 381c6d82
*** SHOWDOWN ***
381c6d82 collected $0.04 from pot
*** SUMMARY ***
Total pot $0.04 | Rake $0 | Jackpot $0 | Bingo $0 | Fortune $0 | Tax $0
Seat 1: Hero (button) folded before Flop (didn't bet)
Seat 2: b282789b (small blind) folded before Flop
Seat 3: 381c6d82 (big blind) collected ($0.04)
Seat 4: 198a1e4 folded before Flop (didn't bet)
Seat 5: a2123cbe folded before Flop (didn't bet)
Seat 6: 304e7bcd folded before Flop (didn't bet)


Poker Hand #RC3334555253: Hold'em No Limit ($0.02/$0.05) - 2025/02/17 21:14:53
Table 'RushAndCash620513' 6-max Seat #1 is the button
Seat 1: 23258e5f ($5.58 in chips)
Seat 2: c096c24 ($9.62 in chips)
Seat 3: 5b79005a ($4.65 in chips)
Seat 4: 945593bf ($15.86 in chips)
Seat 5: 6de2662f ($6.32 in chips)
Seat 6: Hero ($8.78 in chips)
c096c24: posts small blind $0.02
5b79005a: posts big blind $0.05
*** HOLE CARDS ***
Dealt to 23258e5f 
Dealt to c096c24 
Dealt to 5b79005a 
Dealt to 945593bf 
Dealt to 6de2662f 
Dealt to Hero [Th 9c]
945593bf: folds
6de2662f: folds
Hero: folds
23258e5f: folds
c096c24: raises $0.05 to $0.1
5b79005a: folds
Uncalled bet ($0.05) returned to c096c24
*** SHOWDOWN ***
c096c24 collected $0.1 from pot
*** SUMMARY ***
Total pot $0.1 | Rake $0 | Jackpot $0 | Bingo $0 | Fortune $0 | Tax $0
Seat 1: 23258e5f (button) folded before Flop (didn't bet)
Seat 2: c096c24 (small blind) collected ($0.1)
Seat 3: 5b79005a (big blind) folded before Flop
Seat 4: 945593bf folded before Flop (didn't bet)
Seat 5: 6de2662f folded before Flop (didn't bet)
Seat 6: Hero folded before Flop (didn't bet)


Poker Hand #RC3334555189: Hold'em No Limit ($0.02/$0.05) - 2025/02/17 21:14:44
Table 'RushAndCash620449' 6-max Seat #1 is the button
Seat 1: Hero ($8.78 in chips)
Seat 2: 7dd18ea7 ($8.1 in chips)
Seat 3: fb6c913 ($9.09 in chips)
Seat 4: d0d9ce45 ($4.06 in chips)
Seat 5: 89bcbb95 ($5.69 in chips)
Seat 6: a28ca95c ($22.85 in chips)
7dd18ea7: posts small blind $0.02
fb6c913: posts big blind $0.05
*** HOLE CARDS ***
Dealt to Hero [5d 2d]
Dealt to 7dd18ea7 
Dealt to fb6c913 
Dealt to d0d9ce45 
Dealt to 89bcbb95 
Dealt to a28ca95c 
d0d9ce45: folds
89bcbb95: raises $0.08 to $0.13
a28ca95c: folds
Hero: folds
7dd18ea7: folds
fb6c913: folds
Uncalled bet ($0.08) returned to 89bcbb95
*** SHOWDOWN ***
89bcbb95 collected $0.12 from pot
*** SUMMARY ***
Total pot $0.12 | Rake $0 | Jackpot $0 | Bingo $0 | Fortune $0 | Tax $0
Seat 1: Hero (button) folded before Flop (didn't bet)
Seat 2: 7dd18ea7 (small blind) folded before Flop
Seat 3: fb6c913 (big blind) folded before Flop
Seat 4: d0d9ce45 folded before Flop (didn't bet)
Seat 5: 89bcbb95 collected ($0.12)
Seat 6: a28ca95c folded before Flop (didn't bet)


Poker Hand #RC3334555161: Hold'em No Limit ($0.02/$0.05) - 2025/02/17 21:14:40
Table 'RushAndCash620421' 6-max Seat #1 is the button
Seat 1: 1e474bac ($5 in chips)
Seat 2: 8ec32764 ($5 in chips)
Seat 3: e4aeeb30 ($5 in chips)
Seat 4: Hero ($8.78 in chips)
Seat 5: 15fafcaa ($5.07 in chips)
Seat 6: e89071f6 ($7.08 in chips)
8ec32764: posts small blind $0.02
e4aeeb30: posts big blind $0.05
*** HOLE CARDS ***
Dealt to 1e474bac 
Dealt to 8ec32764 
Dealt to e4aeeb30 
Dealt to Hero [Jh 4c]
Dealt to 15fafcaa 
Dealt to e89071f6 
Hero: folds
15fafcaa: folds
e89071f6: folds
1e474bac: raises $0.07 to $0.12
8ec32764: folds
e4aeeb30: calls $0.07
*** FLOP *** [3h 7c Th]
e4aeeb30: checks
1e474bac: bets $0.12
e4aeeb30: folds
Uncalled bet ($0.12) returned to 1e474bac
*** SHOWDOWN ***
1e474bac collected $0.25 from pot
*** SUMMARY ***
Total pot $0.26 | Rake $0.01 | Jackpot $0 | Bingo $0 | Fortune $0 | Tax $0
Board [3h 7c Th]
Seat 1: 1e474bac (button) won ($0.25)
Seat 2: 8ec32764 (small blind) folded before Flop
Seat 3: e4aeeb30 (big blind) folded on the Flop
Seat 4: Hero folded before Flop (didn't bet)
Seat 5: 15fafcaa folded before Flop (didn't bet)
Seat 6: e89071f6 folded before Flop (didn't bet)


Poker Hand #RC3334555128: Hold'em No Limit ($0.02/$0.05) - 2025/02/17 21:14:35
Table 'RushAndCash620388' 6-max Seat #1 is the button
Seat 1: d04ecf ($5 in chips)
Seat 2: 100d4f9e ($5.44 in chips)
Seat 3: 2a10169c ($5.21 in chips)
Seat 4: 4238ab48 ($6.41 in chips)
Seat 5: Hero ($8.78 in chips)
Seat 6: c5f37c20 ($2.91 in chips)
100d4f9e: posts small blind $0.02
2a10169c: posts big blind $0.05
*** HOLE CARDS ***
Dealt to d04ecf 
Dealt to 100d4f9e 
Dealt to 2a10169c 
Dealt to 4238ab48 
Dealt to Hero [Qs Tc]
Dealt to c5f37c20 
4238ab48: folds
Hero: folds
c5f37c20: folds
d04ecf: folds
100d4f9e: raises $0.1 to $0.15
2a10169c: folds
Uncalled bet ($0.1) returned to 100d4f9e
*** SHOWDOWN ***
100d4f9e collected $0.1 from pot
*** SUMMARY ***
Total pot $0.1 | Rake $0 | Jackpot $0 | Bingo $0 | Fortune $0 | Tax $0
Seat 1: d04ecf (button) folded before Flop (didn't bet)
Seat 2: 100d4f9e (small blind) collected ($0.1)
Seat 3: 2a10169c (big blind) folded before Flop
Seat 4: 4238ab48 folded before Flop (didn't bet)
Seat 5: Hero folded before Flop (didn't bet)
Seat 6: c5f37c20 folded before Flop (didn't bet)


Poker Hand #RC3334555098: Hold'em No Limit ($0.02/$0.05) - 2025/02/17 21:14:32
Table 'RushAndCash620358' 6-max Seat #1 is the button
Seat 1: ceed678b ($8.84 in chips)
Seat 2: 9013f95e ($13.16 in chips)
Seat 3: 3d2a56c8 ($5.81 in chips)
Seat 4: b144f063 ($9.54 in chips)
Seat 5: Hero ($8.78 in chips)
Seat 6: 3ffd6491 ($10.5 in chips)
9013f95e: posts small blind $0.02
3d2a56c8: posts big blind $0.05
*** HOLE CARDS ***
Dealt to ceed678b 
Dealt to 9013f95e 
Dealt to 3d2a56c8 
Dealt to b144f063 
Dealt to Hero [Ks 2h]
Dealt to 3ffd6491 
b144f063: raises $0.05 to $0.1
Hero: folds
3ffd6491: raises $0.32 to $0.42
ceed678b: raises $0.78 to $1.2
9013f95e: folds
3d2a56c8: folds
b144f063: folds
3ffd6491: folds
Uncalled bet ($0.78) returned to ceed678b
*** SHOWDOWN ***
ceed678b collected $0.96 from pot
*** SUMMARY ***
Total pot $1.01 | Rake $0.05 | Jackpot $0 | Bingo $0 | Fortune $0 | Tax $0
Seat 1: ceed678b (button) collected ($0.96)
Seat 2: 9013f95e (small blind) folded before Flop
Seat 3: 3d2a56c8 (big blind) folded before Flop
Seat 4: b144f063 folded before Flop
Seat 5: Hero folded before Flop (didn't bet)
Seat 6: 3ffd6491 folded before Flop


Poker Hand #RC3334555057: Hold'em No Limit ($0.02/$0.05) - 2025/02/17 21:14:27
Table 'RushAndCash620317' 6-max Seat #1 is the button
Seat 1: Hero ($8.78 in chips)
Seat 2: 7d495353 ($8.73 in chips)
Seat 3: 944e9aa3 ($5.32 in chips)
Seat 4: 3db4c32a ($6.48 in chips)
Seat 5: a05482e7 ($5.1 in chips)
Seat 6: c29eb839 ($4.93 in chips)
7d495353: posts small blind $0.02
944e9aa3: posts big blind $0.05
*** HOLE CARDS ***
Dealt to Hero [Ts Kc]
Dealt to 7d495353 
Dealt to 944e9aa3 
Dealt to 3db4c32a 
Dealt to a05482e7 
Dealt to c29eb839 
3db4c32a: raises $0.06 to $0.11
a05482e7: folds
c29eb839: folds
Hero: folds
7d495353: raises $0.21 to $0.32
944e9aa3: folds
3db4c32a: folds
Uncalled bet ($0.21) returned to 7d495353
*** SHOWDOWN ***
7d495353 collected $0.26 from pot
*** SUMMARY ***
Total pot $0.27 | Rake $0.01 | Jackpot $0 | Bingo $0 | Fortune $0 | Tax $0
Seat 1: Hero (button) folded before Flop (didn't bet)
Seat 2: 7d495353 (small blind) collected ($0.26)
Seat 3: 944e9aa3 (big blind) folded before Flop
Seat 4: 3db4c32a folded before Flop
Seat 5: a05482e7 folded before Flop (didn't bet)
Seat 6: c29eb839 folded before Flop (didn't bet)


Poker Hand #RC3334554957: Hold'em No Limit ($0.02/$0.05) - 2025/02/17 21:14:14
Table 'RushAndCash620217' 6-max Seat #1 is the button
Seat 1: 71e00d83 ($16 in chips)
Seat 2: 188c8947 ($9.12 in chips)
Seat 3: Hero ($8.83 in chips)
Seat 4: eb1bbc7a ($4.93 in chips)
Seat 5: 8d378f31 ($6.36 in chips)
Seat 6: ef7e6107 ($5 in chips)
188c8947: posts small blind $0.02
Hero: posts big blind $0.05
*** HOLE CARDS ***
Dealt to 71e00d83 
Dealt to 188c8947 
Dealt to Hero [As 6c]
Dealt to eb1bbc7a 
Dealt to 8d378f31 
Dealt to ef7e6107 
eb1bbc7a: folds
8d378f31: folds
ef7e6107: folds
71e00d83: raises $0.05 to $0.1
188c8947: folds
Hero: folds
Uncalled bet ($0.05) returned to 71e00d83
*** SHOWDOWN ***
71e00d83 collected $0.12 from pot
*** SUMMARY ***
Total pot $0.12 | Rake $0 | Jackpot $0 | Bingo $0 | Fortune $0 | Tax $0
Seat 1: 71e00d83 (button) collected ($0.12)
Seat 2: 188c8947 (small blind) folded before Flop
Seat 3: Hero (big blind) folded before Flop
Seat 4: eb1bbc7a folded before Flop (didn't bet)
Seat 5: 8d378f31 folded before Flop (didn't bet)
Seat 6: ef7e6107 folded before Flop (didn't bet)


Poker Hand #RC3334554923: Hold'em No Limit ($0.02/$0.05) - 2025/02/17 21:14:10
Table 'RushAndCash620183' 6-max Seat #1 is the button
Seat 1: d55e014a ($4.93 in chips)
Seat 2: Hero ($8.85 in chips)
Seat 3: 5381eb4c ($9.11 in chips)
Seat 4: 677c4b25 ($9.54 in chips)
Seat 5: 6c641898 ($5.09 in chips)
Seat 6: ee3fdfd8 ($6.52 in chips)
Hero: posts small blind $0.02
5381eb4c: posts big blind $0.05
*** HOLE CARDS ***
Dealt to d55e014a 
Dealt to Hero [Qs 3c]
Dealt to 5381eb4c 
Dealt to 677c4b25 
Dealt to 6c641898 
Dealt to ee3fdfd8 
677c4b25: folds
6c641898: folds
ee3fdfd8: folds
d55e014a: calls $0.05
Hero: folds
5381eb4c: checks
*** FLOP *** [5c 8s 4s]
5381eb4c: checks
d55e014a: bets $0.15
5381eb4c: folds
Uncalled bet ($0.15) returned to d55e014a
*** SHOWDOWN ***
d55e014a collected $0.12 from pot
*** SUMMARY ***
Total pot $0.12 | Rake $0 | Jackpot $0 | Bingo $0 | Fortune $0 | Tax $0
Board [5c 8s 4s]
Seat 1: d55e014a (button) won ($0.12)
Seat 2: Hero (small blind) folded before Flop
Seat 3: 5381eb4c (big blind) folded on the Flop
Seat 4: 677c4b25 folded before Flop (didn't bet)
Seat 5: 6c641898 folded before Flop (didn't bet)
Seat 6: ee3fdfd8 folded before Flop (didn't bet)


Poker Hand #RC3334554900: Hold'em No Limit ($0.02/$0.05) - 2025/02/17 21:14:07
Table 'RushAndCash620160' 6-max Seat #1 is the button
Seat 1: 9b1a3dd2 ($10.49 in chips)
Seat 2: e5e6041b ($6.24 in chips)
Seat 3: 2a10169c ($5.14 in chips)
Seat 4: 38a4c833 ($4.66 in chips)
Seat 5: Hero ($8.85 in chips)
Seat 6: 3ed1e77f ($5.1 in chips)
e5e6041b: posts small blind $0.02
2a10169c: posts big blind $0.05
*** HOLE CARDS ***
Dealt to 9b1a3dd2 
Dealt to e5e6041b 
Dealt to 2a10169c 
Dealt to 38a4c833 
Dealt to Hero [Td 9c]
Dealt to 3ed1e77f 
38a4c833: folds
Hero: folds
3ed1e77f: folds
9b1a3dd2: folds
e5e6041b: folds
Uncalled bet ($0.03) returned to 2a10169c
*** SHOWDOWN ***
2a10169c collected $0.04 from pot
*** SUMMARY ***
Total pot $0.04 | Rake $0 | Jackpot $0 | Bingo $0 | Fortune $0 | Tax $0
Seat 1: 9b1a3dd2 (button) folded before Flop (didn't bet)
Seat 2: e5e6041b (small blind) folded before Flop
Seat 3: 2a10169c (big blind) collected ($0.04)
Seat 4: 38a4c833 folded before Flop (didn't bet)
Seat 5: Hero folded before Flop (didn't bet)
Seat 6: 3ed1e77f folded before Flop (didn't bet)


Poker Hand #RC3334554875: Hold'em No Limit ($0.02/$0.05) - 2025/02/17 21:14:04
Table 'RushAndCash620135' 6-max Seat #1 is the button
Seat 1: 4190d158 ($5.97 in chips)
Seat 2: cc8de981 ($5.43 in chips)
Seat 3: 3b85f8e6 ($8.4 in chips)
Seat 4: bfe01d88 ($5.5 in chips)
Seat 5: Hero ($8.85 in chips)
Seat 6: 7dd18ea7 ($8.08 in chips)
cc8de981: posts small blind $0.02
3b85f8e6: posts big blind $0.05
*** HOLE CARDS ***
Dealt to 4190d158 
Dealt to cc8de981 
Dealt to 3b85f8e6 
Dealt to bfe01d88 
Dealt to Hero [9d 2c]
Dealt to 7dd18ea7 
bfe01d88: folds
Hero: folds
7dd18ea7: raises $0.05 to $0.1
4190d158: folds
cc8de981: folds
3b85f8e6: folds
Uncalled bet ($0.05) returned to 7dd18ea7
*** SHOWDOWN ***
7dd18ea7 collected $0.12 from pot
*** SUMMARY ***
Total pot $0.12 | Rake $0 | Jackpot $0 | Bingo $0 | Fortune $0 | Tax $0
Seat 1: 4190d158 (button) folded before Flop (didn't bet)
Seat 2: cc8de981 (small blind) folded before Flop
Seat 3: 3b85f8e6 (big blind) folded before Flop
Seat 4: bfe01d88 folded before Flop (didn't bet)
Seat 5: Hero folded before Flop (didn't bet)
Seat 6: 7dd18ea7 collected ($0.12)


Poker Hand #RC3334554833: Hold'em No Limit ($0.02/$0.05) - 2025/02/17 21:13:59
Table 'RushAndCash620093' 6-max Seat #1 is the button
Seat 1: 5bf5cd50 ($5 in chips)
Seat 2: f994138c ($8.28 in chips)
Seat 3: 6ebc3323 ($8.61 in chips)
Seat 4: d75cab93 ($7.91 in chips)
Seat 5: Hero ($8.85 in chips)
Seat 6: 2d6a0da2 ($5.58 in chips)
f994138c: posts small blind $0.02
6ebc3323: posts big blind $0.05
*** HOLE CARDS ***
Dealt to 5bf5cd50 
Dealt to f994138c 
Dealt to 6ebc3323 
Dealt to d75cab93 
Dealt to Hero [Js Td]
Dealt to 2d6a0da2 
d75cab93: raises $0.06 to $0.11
Hero: folds
2d6a0da2: folds
5bf5cd50: folds
f994138c: folds
6ebc3323: folds
Uncalled bet ($0.06) returned to d75cab93
*** SHOWDOWN ***
d75cab93 collected $0.12 from pot
*** SUMMARY ***
Total pot $0.12 | Rake $0 | Jackpot $0 | Bingo $0 | Fortune $0 | Tax $0
Seat 1: 5bf5cd50 (button) folded before Flop (didn't bet)
Seat 2: f994138c (small blind) folded before Flop
Seat 3: 6ebc3323 (big blind) folded before Flop
Seat 4: d75cab93 collected ($0.12)
Seat 5: Hero folded before Flop (didn't bet)
Seat 6: 2d6a0da2 folded before Flop (didn't bet)


Poker Hand #RC3334554781: Hold'em No Limit ($0.02/$0.05) - 2025/02/17 21:13:52
Table 'RushAndCash620041' 6-max Seat #1 is the button
Seat 1: bfe94c7c ($5.18 in chips)
Seat 2: c62b7a0b ($22.54 in chips)
Seat 3: 18767060 ($10.27 in chips)
Seat 4: Hero ($8.85 in chips)
Seat 5: b4b50b41 ($5 in chips)
Seat 6: 51e72d50 ($4.59 in chips)
c62b7a0b: posts small blind $0.02
18767060: posts big blind $0.05
*** HOLE CARDS ***
Dealt to bfe94c7c 
Dealt to c62b7a0b 
Dealt to 18767060 
Dealt to Hero [2h Qd]
Dealt to b4b50b41 
Dealt to 51e72d50 
Hero: folds
b4b50b41: raises $0.06 to $0.11
51e72d50: folds
bfe94c7c: calls $0.11
c62b7a0b: folds
18767060: folds
*** FLOP *** [4d 7h As]
b4b50b41: checks
bfe94c7c: bets $0.2
b4b50b41: calls $0.2
*** TURN *** [4d 7h As] [7d]
b4b50b41: checks
bfe94c7c: checks
*** RIVER *** [4d 7h As 7d] [Ts]
b4b50b41: checks
bfe94c7c: checks
b4b50b41: shows [4s 4h] (Fours Full over Sevens)
bfe94c7c: shows [Kh 9h] (Pair of Sevens)
*** SHOWDOWN ***
b4b50b41 collected $0.66 from pot
*** SUMMARY ***
Total pot $0.69 | Rake $0.03 | Jackpot $0 | Bingo $0 | Fortune $0 | Tax $0
Board [4d 7h As 7d Ts]
Seat 1: bfe94c7c (button) showed [Kh 9h] and lost with Pair of Sevens
Seat 2: c62b7a0b (small blind) folded before Flop
Seat 3: 18767060 (big blind) folded before Flop
Seat 4: Hero folded before Flop (didn't bet)
Seat 5: b4b50b41 showed [4s 4h] and won ($0.66) with Fours Full over Sevens
Seat 6: 51e72d50 folded before Flop (didn't bet)


Poker Hand #RC3334484648: Hold'em No Limit ($0.02/$0.05) - 2025/02/17 21:13:35
Table 'RushAndCash619908' 6-max Seat #1 is the button
Seat 1: f7c51ea2 ($5 in chips)
Seat 2: 76135c78 ($11.06 in chips)
Seat 3: Hero ($8.9 in chips)
Seat 4: aa08a1c ($5.2 in chips)
Seat 5: 37865b6f ($5.28 in chips)
Seat 6: cf6d512a ($3.61 in chips)
76135c78: posts small blind $0.02
Hero: posts big blind $0.05
*** HOLE CARDS ***
Dealt to f7c51ea2 
Dealt to 76135c78 
Dealt to Hero [Js Ac]
Dealt to aa08a1c 
Dealt to 37865b6f 
Dealt to cf6d512a 
aa08a1c: raises $0.05 to $0.1
37865b6f: raises $0.2 to $0.3
cf6d512a: folds
f7c51ea2: folds
76135c78: folds
Hero: folds
aa08a1c: raises $0.34 to $0.64
37865b6f: folds
Uncalled bet ($0.34) returned to aa08a1c
*** SHOWDOWN ***
aa08a1c collected $0.64 from pot
*** SUMMARY ***
Total pot $0.67 | Rake $0.03 | Jackpot $0 | Bingo $0 | Fortune $0 | Tax $0
Seat 1: f7c51ea2 (button) folded before Flop (didn't bet)
Seat 2: 76135c78 (small blind) folded before Flop
Seat 3: Hero (big blind) folded before Flop
Seat 4: aa08a1c collected ($0.64)
Seat 5: 37865b6f folded before Flop
Seat 6: cf6d512a folded before Flop (didn't bet)


Poker Hand #RC3334484609: Hold'em No Limit ($0.02/$0.05) - 2025/02/17 21:13:29
Table 'RushAndCash619869' 6-max Seat #1 is the button
Seat 1: 4e3c3196 ($27.57 in chips)
Seat 2: Hero ($8.92 in chips)
Seat 3: 2d6a0da2 ($5.63 in chips)
Seat 4: 8f1315bb ($6.17 in chips)
Seat 5: c1784884 ($6.04 in chips)
Seat 6: 4abcea5e ($6.1 in chips)
Hero: posts small blind $0.02
2d6a0da2: posts big blind $0.05
*** HOLE CARDS ***
Dealt to 4e3c3196 
Dealt to Hero [8d Ah]
Dealt to 2d6a0da2 
Dealt to 8f1315bb 
Dealt to c1784884 
Dealt to 4abcea5e 
8f1315bb: folds
c1784884: raises $0.05 to $0.1
4abcea5e: folds
4e3c3196: folds
Hero: folds
2d6a0da2: folds
Uncalled bet ($0.05) returned to c1784884
*** SHOWDOWN ***
c1784884 collected $0.12 from pot
*** SUMMARY ***
Total pot $0.12 | Rake $0 | Jackpot $0 | Bingo $0 | Fortune $0 | Tax $0
Seat 1: 4e3c3196 (button) folded before Flop (didn't bet)
Seat 2: Hero (small blind) folded before Flop
Seat 3: 2d6a0da2 (big blind) folded before Flop
Seat 4: 8f1315bb folded before Flop (didn't bet)
Seat 5: c1784884 collected ($0.12)
Seat 6: 4abcea5e folded before Flop (didn't bet)


Poker Hand #RC3334484423: Hold'em No Limit ($0.02/$0.05) - 2025/02/17 21:13:06
Table 'RushAndCash619683' 6-max Seat #1 is the button
Seat 1: 3ad90733 ($9.87 in chips)
Seat 2: c1784884 ($5.67 in chips)
Seat 3: 22a3f0e8 ($6.87 in chips)
Seat 4: 151b0c91 ($5.67 in chips)
Seat 5: Hero ($9.27 in chips)
Seat 6: ee3fdfd8 ($6.66 in chips)
c1784884: posts small blind $0.02
22a3f0e8: posts big blind $0.05
*** HOLE CARDS ***
Dealt to 3ad90733 
Dealt to c1784884 
Dealt to 22a3f0e8 
Dealt to 151b0c91 
Dealt to Hero [Ac Qc]
Dealt to ee3fdfd8 
151b0c91: folds
Hero: raises $0.05 to $0.1
ee3fdfd8: folds
3ad90733: folds
c1784884: raises $0.25 to $0.35
22a3f0e8: folds
Hero: calls $0.25
*** FLOP *** [7s 9s Tc]
c1784884: bets $0.38
Hero: folds
Uncalled bet ($0.38) returned to c1784884
*** SHOWDOWN ***
c1784884 collected $0.72 from pot
*** SUMMARY ***
Total pot $0.75 | Rake $0.03 | Jackpot $0 | Bingo $0 | Fortune $0 | Tax $0
Board [7s 9s Tc]
Seat 1: 3ad90733 (button) folded before Flop (didn't bet)
Seat 2: c1784884 (small blind) won ($0.72)
Seat 3: 22a3f0e8 (big blind) folded before Flop
Seat 4: 151b0c91 folded before Flop (didn't bet)
Seat 5: Hero folded on the Flop
Seat 6: ee3fdfd8 folded before Flop (didn't bet)


Poker Hand #RC3334484387: Hold'em No Limit ($0.02/$0.05) - 2025/02/17 21:13:01
Table 'RushAndCash619647' 6-max Seat #1 is the button
Seat 1: Hero ($9.27 in chips)
Seat 2: b0ee20aa ($22.78 in chips)
Seat 3: 7bd8ad6 ($5 in chips)
Seat 4: 92855848 ($4.87 in chips)
Seat 5: d6f5b483 ($9.39 in chips)
Seat 6: a375b232 ($5.12 in chips)
b0ee20aa: posts small blind $0.02
7bd8ad6: posts big blind $0.05
*** HOLE CARDS ***
Dealt to Hero [Ts Kd]
Dealt to b0ee20aa 
Dealt to 7bd8ad6 
Dealt to 92855848 
Dealt to d6f5b483 
Dealt to a375b232 
92855848: folds
d6f5b483: raises $0.08 to $0.13
a375b232: folds
Hero: folds
b0ee20aa: folds
7bd8ad6: folds
Uncalled bet ($0.08) returned to d6f5b483
*** SHOWDOWN ***
d6f5b483 collected $0.12 from pot
*** SUMMARY ***
Total pot $0.12 | Rake $0 | Jackpot $0 | Bingo $0 | Fortune $0 | Tax $0
Seat 1: Hero (button) folded before Flop (didn't bet)
Seat 2: b0ee20aa (small blind) folded before Flop
Seat 3: 7bd8ad6 (big blind) folded before Flop
Seat 4: 92855848 folded before Flop (didn't bet)
Seat 5: d6f5b483 collected ($0.12)
Seat 6: a375b232 folded before Flop (didn't bet)


Poker Hand #RC3334484335: Hold'em No Limit ($0.02/$0.05) - 2025/02/17 21:12:54
Table 'RushAndCash619595' 6-max Seat #1 is the button
Seat 1: Hero ($9.2 in chips)
Seat 2: 12cda2e0 ($22.26 in chips)
Seat 3: 692417ff ($5 in chips)
Seat 4: 44cd9f35 ($5.38 in chips)
Seat 5: bbace944 ($3.67 in chips)
Seat 6: f3614ba1 ($10.14 in chips)
12cda2e0: posts small blind $0.02
692417ff: posts big blind $0.05
*** HOLE CARDS ***
Dealt to Hero [6d 2d]
Dealt to 12cda2e0 
Dealt to 692417ff 
Dealt to 44cd9f35 
Dealt to bbace944 
Dealt to f3614ba1 
44cd9f35: folds
bbace944: folds
f3614ba1: folds
Hero: folds
12cda2e0: folds
Uncalled bet ($0.03) returned to 692417ff
*** SHOWDOWN ***
692417ff collected $0.04 from pot
*** SUMMARY ***
Total pot $0.04 | Rake $0 | Jackpot $0 | Bingo $0 | Fortune $0 | Tax $0
Seat 1: Hero (button) folded before Flop (didn't bet)
Seat 2: 12cda2e0 (small blind) folded before Flop
Seat 3: 692417ff (big blind) collected ($0.04)
Seat 4: 44cd9f35 folded before Flop (didn't bet)
Seat 5: bbace944 folded before Flop (didn't bet)
Seat 6: f3614ba1 folded before Flop (didn't bet)


Poker Hand #RC3334484284: Hold'em No Limit ($0.02/$0.05) - 2025/02/17 21:12:47
Table 'RushAndCash619544' 6-max Seat #1 is the button
Seat 1: a375b232 ($5.05 in chips)
Seat 2: Hero ($9.22 in chips)
Seat 3: c7197736 ($5 in chips)
Seat 4: 6e22a6c1 ($6.3 in chips)
Seat 5: ec3424f5 ($5 in chips)
Seat 6: a05482e7 ($5.07 in chips)
Hero: posts small blind $0.02
c7197736: posts big blind $0.05
*** HOLE CARDS ***
Dealt to a375b232 
Dealt to Hero [4c 6d]
Dealt to c7197736 
Dealt to 6e22a6c1 
Dealt to ec3424f5 
Dealt to a05482e7 
6e22a6c1: folds
ec3424f5: folds
a05482e7: folds
a375b232: raises $0.05 to $0.1
Hero: folds
c7197736: folds
Uncalled bet ($0.05) returned to a375b232
*** SHOWDOWN ***
a375b232 collected $0.12 from pot
*** SUMMARY ***
Total pot $0.12 | Rake $0 | Jackpot $0 | Bingo $0 | Fortune $0 | Tax $0
Seat 1: a375b232 (button) collected ($0.12)
Seat 2: Hero (small blind) folded before Flop
Seat 3: c7197736 (big blind) folded before Flop
Seat 4: 6e22a6c1 folded before Flop (didn't bet)
Seat 5: ec3424f5 folded before Flop (didn't bet)
Seat 6: a05482e7 folded before Flop (didn't bet)


Poker Hand #RC3334484261: Hold'em No Limit ($0.02/$0.05) - 2025/02/17 21:12:44
Table 'RushAndCash619521' 6-max Seat #1 is the button
Seat 1: 9604af2 ($7.64 in chips)
Seat 2: bbace944 ($3.69 in chips)
Seat 3: Hero ($9.27 in chips)
Seat 4: bf84714d ($5.95 in chips)
Seat 5: 6e22a6c1 ($6.3 in chips)
Seat 6: 3ed1e77f ($5.17 in chips)
bbace944: posts small blind $0.02
Hero: posts big blind $0.05
*** HOLE CARDS ***
Dealt to 9604af2 
Dealt to bbace944 
Dealt to Hero [6s 2h]
Dealt to bf84714d 
Dealt to 6e22a6c1 
Dealt to 3ed1e77f 
bf84714d: folds
6e22a6c1: folds
3ed1e77f: folds
9604af2: folds
bbace944: folds
Uncalled bet ($0.03) returned to Hero
*** SHOWDOWN ***
Hero collected $0.04 from pot
*** SUMMARY ***
Total pot $0.04 | Rake $0 | Jackpot $0 | Bingo $0 | Fortune $0 | Tax $0
Seat 1: 9604af2 (button) folded before Flop (didn't bet)
Seat 2: bbace944 (small blind) folded before Flop
Seat 3: Hero (big blind) collected ($0.04)
Seat 4: bf84714d folded before Flop (didn't bet)
Seat 5: 6e22a6c1 folded before Flop (didn't bet)
Seat 6: 3ed1e77f folded before Flop (didn't bet)


Poker Hand #RC3334484240: Hold'em No Limit ($0.02/$0.05) - 2025/02/17 21:12:41
Table 'RushAndCash619500' 6-max Seat #1 is the button
Seat 1: dbb7a28 ($10.85 in chips)
Seat 2: 1fa8537 ($7.37 in chips)
Seat 3: 258a2071 ($10.12 in chips)
Seat 4: 9b1a3dd2 ($10.63 in chips)
Seat 5: 14d966a6 ($7.23 in chips)
Seat 6: Hero ($9.27 in chips)
1fa8537: posts small blind $0.02
258a2071: posts big blind $0.05
*** HOLE CARDS ***
Dealt to dbb7a28 
Dealt to 1fa8537 
Dealt to 258a2071 
Dealt to 9b1a3dd2 
Dealt to 14d966a6 
Dealt to Hero [2d Ah]
9b1a3dd2: folds
14d966a6: folds
Hero: folds
dbb7a28: raises $0.05 to $0.1
1fa8537: folds
258a2071: folds
Uncalled bet ($0.05) returned to dbb7a28
*** SHOWDOWN ***
dbb7a28 collected $0.12 from pot
*** SUMMARY ***
Total pot $0.12 | Rake $0 | Jackpot $0 | Bingo $0 | Fortune $0 | Tax $0
Seat 1: dbb7a28 (button) collected ($0.12)
Seat 2: 1fa8537 (small blind) folded before Flop
Seat 3: 258a2071 (big blind) folded before Flop
Seat 4: 9b1a3dd2 folded before Flop (didn't bet)
Seat 5: 14d966a6 folded before Flop (didn't bet)
Seat 6: Hero folded before Flop (didn't bet)


Poker Hand #RC3334484097: Hold'em No Limit ($0.02/$0.05) - 2025/02/17 21:12:21
Table 'RushAndCash619357' 6-max Seat #1 is the button
Seat 1: 4812f5c8 ($5.39 in chips)
Seat 2: Hero ($9.13 in chips)
Seat 3: c4483bd8 ($5.86 in chips)
Seat 4: dbb7a28 ($10.95 in chips)
Seat 5: 8507bdad ($5.24 in chips)
Seat 6: 8f9fd8b1 ($13.85 in chips)
Hero: posts small blind $0.02
c4483bd8: posts big blind $0.05
*** HOLE CARDS ***
Dealt to 4812f5c8 
Dealt to Hero [6s 7s]
Dealt to c4483bd8 
Dealt to dbb7a28 
Dealt to 8507bdad 
Dealt to 8f9fd8b1 
dbb7a28: raises $0.05 to $0.1
8507bdad: folds
8f9fd8b1: folds
4812f5c8: folds
Hero: calls $0.08
c4483bd8: folds
*** FLOP *** [5s 8c 2s]
Hero: checks
dbb7a28: checks
*** TURN *** [5s 8c 2s] [Qs]
Hero: bets $0.14
dbb7a28: folds
Uncalled bet ($0.14) returned to Hero
*** SHOWDOWN ***
Hero collected $0.24 from pot
*** SUMMARY ***
Total pot $0.25 | Rake $0.01 | Jackpot $0 | Bingo $0 | Fortune $0 | Tax $0
Board [5s 8c 2s Qs]
Seat 1: 4812f5c8 (button) folded before Flop (didn't bet)
Seat 2: Hero (small blind) won ($0.24)
Seat 3: c4483bd8 (big blind) folded before Flop
Seat 4: dbb7a28 folded on the Turn
Seat 5: 8507bdad folded before Flop (didn't bet)
Seat 6: 8f9fd8b1 folded before Flop (didn't bet)


Poker Hand #RC3334484073: Hold'em No Limit ($0.02/$0.05) - 2025/02/17 21:12:18
Table 'RushAndCash619333' 6-max Seat #1 is the button
Seat 1: 8d378f31 ($6.16 in chips)
Seat 2: 4305bf97 ($5.66 in chips)
Seat 3: 229ec9a7 ($6.88 in chips)
Seat 4: e20e5cfc ($5.97 in chips)
Seat 5: Hero ($9.13 in chips)
Seat 6: e89071f6 ($6.84 in chips)
4305bf97: posts small blind $0.02
229ec9a7: posts big blind $0.05
*** HOLE CARDS ***
Dealt to 8d378f31 
Dealt to 4305bf97 
Dealt to 229ec9a7 
Dealt to e20e5cfc 
Dealt to Hero [7h 2d]
Dealt to e89071f6 
e20e5cfc: folds
Hero: folds
e89071f6: folds
8d378f31: raises $0.07 to $0.12
4305bf97: folds
229ec9a7: folds
Uncalled bet ($0.07) returned to 8d378f31
*** SHOWDOWN ***
8d378f31 collected $0.12 from pot
*** SUMMARY ***
Total pot $0.12 | Rake $0 | Jackpot $0 | Bingo $0 | Fortune $0 | Tax $0
Seat 1: 8d378f31 (button) collected ($0.12)
Seat 2: 4305bf97 (small blind) folded before Flop
Seat 3: 229ec9a7 (big blind) folded before Flop
Seat 4: e20e5cfc folded before Flop (didn't bet)
Seat 5: Hero folded before Flop (didn't bet)
Seat 6: e89071f6 folded before Flop (didn't bet)


Poker Hand #RC3334483990: Hold'em No Limit ($0.02/$0.05) - 2025/02/17 21:12:07
Table 'RushAndCash619250' 6-max Seat #1 is the button
Seat 1: 33caafa3 ($5.01 in chips)
Seat 2: f18b40b7 ($6.53 in chips)
Seat 3: Hero ($9.11 in chips)
Seat 4: b8c09f2 ($5.15 in chips)
Seat 5: 9c1c8cec ($4.57 in chips)
Seat 6: fa499268 ($7.63 in chips)
f18b40b7: posts small blind $0.02
Hero: posts big blind $0.05
*** HOLE CARDS ***
Dealt to 33caafa3 
Dealt to f18b40b7 
Dealt to Hero [Kd Ac]
Dealt to b8c09f2 
Dealt to 9c1c8cec 
Dealt to fa499268 
b8c09f2: folds
9c1c8cec: folds
fa499268: folds
33caafa3: folds
f18b40b7: folds
Uncalled bet ($0.03) returned to Hero
*** SHOWDOWN ***
Hero collected $0.04 from pot
*** SUMMARY ***
Total pot $0.04 | Rake $0 | Jackpot $0 | Bingo $0 | Fortune $0 | Tax $0
Seat 1: 33caafa3 (button) folded before Flop (didn't bet)
Seat 2: f18b40b7 (small blind) folded before Flop
Seat 3: Hero (big blind) collected ($0.04)
Seat 4: b8c09f2 folded before Flop (didn't bet)
Seat 5: 9c1c8cec folded before Flop (didn't bet)
Seat 6: fa499268 folded before Flop (didn't bet)


Poker Hand #RC3334483962: Hold'em No Limit ($0.02/$0.05) - 2025/02/17 21:12:04
Table 'RushAndCash619222' 6-max Seat #1 is the button
Seat 1: 21c758a ($5.64 in chips)
Seat 2: 12cda2e0 ($21.98 in chips)
Seat 3: a8c71cd6 ($5.61 in chips)
Seat 4: Hero ($9.11 in chips)
Seat 5: 816260d0 ($10.17 in chips)
Seat 6: f0d238ad ($12.67 in chips)
12cda2e0: posts small blind $0.02
a8c71cd6: posts big blind $0.05
*** HOLE CARDS ***
Dealt to 21c758a 
Dealt to 12cda2e0 
Dealt to a8c71cd6 
Dealt to Hero [6d Th]
Dealt to 816260d0 
Dealt to f0d238ad 
Hero: folds
816260d0: folds
f0d238ad: raises $0.05 to $0.1
21c758a: folds
12cda2e0: folds
a8c71cd6: calls $0.05
*** FLOP *** [8c 9d 5s]
a8c71cd6: checks
f0d238ad: checks
*** TURN *** [8c 9d 5s] [Js]
a8c71cd6: bets $0.33
f0d238ad: calls $0.33
*** RIVER *** [8c 9d 5s Js] [4c]
a8c71cd6: bets $1.72
f0d238ad: folds
Uncalled bet ($1.72) returned to a8c71cd6
*** SHOWDOWN ***
a8c71cd6 collected $0.84 from pot
*** SUMMARY ***
Total pot $0.88 | Rake $0.04 | Jackpot $0 | Bingo $0 | Fortune $0 | Tax $0
Board [8c 9d 5s Js 4c]
Seat 1: 21c758a (button) folded before Flop (didn't bet)
Seat 2: 12cda2e0 (small blind) folded before Flop
Seat 3: a8c71cd6 (big blind) showed [Qh] and won ($0.84)
Seat 4: Hero folded before Flop (didn't bet)
Seat 5: 816260d0 folded before Flop (didn't bet)
Seat 6: f0d238ad folded on the River


Poker Hand #RC3334483936: Hold'em No Limit ($0.02/$0.05) - 2025/02/17 21:12:00
Table 'RushAndCash619196' 6-max Seat #1 is the button
Seat 1: 64b39229 ($5.77 in chips)
Seat 2: c4483bd8 ($5.95 in chips)
Seat 3: ae2aee6e ($5.72 in chips)
Seat 4: Hero ($9.11 in chips)
Seat 5: 899a8bc6 ($4.97 in chips)
Seat 6: ef96c0c8 ($6.02 in chips)
c4483bd8: posts small blind $0.02
ae2aee6e: posts big blind $0.05
*** HOLE CARDS ***
Dealt to 64b39229 
Dealt to c4483bd8 
Dealt to ae2aee6e 
Dealt to Hero [Qs 8d]
Dealt to 899a8bc6 
Dealt to ef96c0c8 
Hero: folds
899a8bc6: folds
ef96c0c8: raises $0.07 to $0.12
64b39229: folds
c4483bd8: folds
ae2aee6e: calls $0.07
*** FLOP *** [6s 5d Th]
ae2aee6e: checks
ef96c0c8: bets $0.09
ae2aee6e: folds
Uncalled bet ($0.09) returned to ef96c0c8
*** SHOWDOWN ***
ef96c0c8 collected $0.25 from pot
*** SUMMARY ***
Total pot $0.26 | Rake $0.01 | Jackpot $0 | Bingo $0 | Fortune $0 | Tax $0
Board [6s 5d Th]
Seat 1: 64b39229 (button) folded before Flop (didn't bet)
Seat 2: c4483bd8 (small blind) folded before Flop
Seat 3: ae2aee6e (big blind) folded on the Flop
Seat 4: Hero folded before Flop (didn't bet)
Seat 5: 899a8bc6 folded before Flop (didn't bet)
Seat 6: ef96c0c8 won ($0.25)


Poker Hand #RC3334483857: Hold'em No Limit ($0.02/$0.05) - 2025/02/17 21:11:51
Table 'RushAndCash619117' 6-max Seat #1 is the button
Seat 1: Hero ($9.11 in chips)
Seat 2: 1438969d ($2.69 in chips)
Seat 3: 4f9889fc ($5.36 in chips)
Seat 4: fbf49d86 ($5.19 in chips)
Seat 5: 51ee7ca4 ($5.01 in chips)
Seat 6: d278c831 ($5.39 in chips)
1438969d: posts small blind $0.02
4f9889fc: posts big blind $0.05
*** HOLE CARDS ***
Dealt to Hero [Kc 6h]
Dealt to 1438969d 
Dealt to 4f9889fc 
Dealt to fbf49d86 
Dealt to 51ee7ca4 
Dealt to d278c831 
fbf49d86: folds
51ee7ca4: folds
d278c831: folds
Hero: folds
1438969d: folds
Uncalled bet ($0.03) returned to 4f9889fc
*** SHOWDOWN ***
4f9889fc collected $0.04 from pot
*** SUMMARY ***
Total pot $0.04 | Rake $0 | Jackpot $0 | Bingo $0 | Fortune $0 | Tax $0
Seat 1: Hero (button) folded before Flop (didn't bet)
Seat 2: 1438969d (small blind) folded before Flop
Seat 3: 4f9889fc (big blind) collected ($0.04)
Seat 4: fbf49d86 folded before Flop (didn't bet)
Seat 5: 51ee7ca4 folded before Flop (didn't bet)
Seat 6: d278c831 folded before Flop (didn't bet)


Poker Hand #RC3334483726: Hold'em No Limit ($0.02/$0.05) - 2025/02/17 21:11:35
Table 'RushAndCash618986' 6-max Seat #1 is the button
Seat 1: 4f7979c7 ($4.59 in chips)
Seat 2: 3ed1e77f ($5.19 in chips)
Seat 3: 64b39229 ($5.68 in chips)
Seat 4: Hero ($9.11 in chips)
Seat 5: 45d33c76 ($8.91 in chips)
Seat 6: e4fd27d ($18.69 in chips)
3ed1e77f: posts small blind $0.02
64b39229: posts big blind $0.05
*** HOLE CARDS ***
Dealt to 4f7979c7 
Dealt to 3ed1e77f 
Dealt to 64b39229 
Dealt to Hero [Jd 3s]
Dealt to 45d33c76 
Dealt to e4fd27d 
Hero: folds
45d33c76: folds
e4fd27d: folds
4f7979c7: folds
3ed1e77f: folds
Uncalled bet ($0.03) returned to 64b39229
*** SHOWDOWN ***
64b39229 collected $0.04 from pot
*** SUMMARY ***
Total pot $0.04 | Rake $0 | Jackpot $0 | Bingo $0 | Fortune $0 | Tax $0
Seat 1: 4f7979c7 (button) folded before Flop (didn't bet)
Seat 2: 3ed1e77f (small blind) folded before Flop
Seat 3: 64b39229 (big blind) collected ($0.04)
Seat 4: Hero folded before Flop (didn't bet)
Seat 5: 45d33c76 folded before Flop (didn't bet)
Seat 6: e4fd27d folded before Flop (didn't bet)


Poker Hand #RC3334483675: Hold'em No Limit ($0.02/$0.05) - 2025/02/17 21:11:28
Table 'RushAndCash618935' 6-max Seat #1 is the button
Seat 1: Hero ($9.11 in chips)
Seat 2: 62156df3 ($5.15 in chips)
Seat 3: 8f1315bb ($6.21 in chips)
Seat 4: e7c4d687 ($2.29 in chips)
Seat 5: 4f7979c7 ($4.61 in chips)
Seat 6: b8a41e4 ($5 in chips)
62156df3: posts small blind $0.02
8f1315bb: posts big blind $0.05
*** HOLE CARDS ***
Dealt to Hero [2s 6d]
Dealt to 62156df3 
Dealt to 8f1315bb 
Dealt to e7c4d687 
Dealt to 4f7979c7 
Dealt to b8a41e4 
e7c4d687: folds
4f7979c7: folds
b8a41e4: raises $0.08 to $0.13
Hero: folds
62156df3: folds
8f1315bb: folds
Uncalled bet ($0.08) returned to b8a41e4
*** SHOWDOWN ***
b8a41e4 collected $0.12 from pot
*** SUMMARY ***
Total pot $0.12 | Rake $0 | Jackpot $0 | Bingo $0 | Fortune $0 | Tax $0
Seat 1: Hero (button) folded before Flop (didn't bet)
Seat 2: 62156df3 (small blind) folded before Flop
Seat 3: 8f1315bb (big blind) folded before Flop
Seat 4: e7c4d687 folded before Flop (didn't bet)
Seat 5: 4f7979c7 folded before Flop (didn't bet)
Seat 6: b8a41e4 collected ($0.12)


Poker Hand #RC3334483065: Hold'em No Limit ($0.02/$0.05) - 2025/02/17 21:10:13
Table 'RushAndCash618325' 6-max Seat #1 is the button
Seat 1: 8023de0f ($5 in chips)
Seat 2: 5f1cdd27 ($5 in chips)
Seat 3: e32dc6f0 ($5 in chips)
Seat 4: 15125d65 ($14.71 in chips)
Seat 5: Hero ($8.92 in chips)
Seat 6: d606d9 ($10.65 in chips)
5f1cdd27: posts small blind $0.02
e32dc6f0: posts big blind $0.05
*** HOLE CARDS ***
Dealt to 8023de0f 
Dealt to 5f1cdd27 
Dealt to e32dc6f0 
Dealt to 15125d65 
Dealt to Hero [Kh Th]
Dealt to d606d9 
15125d65: folds
Hero: raises $0.05 to $0.1
d606d9: folds
8023de0f: folds
5f1cdd27: folds
e32dc6f0: calls $0.05
*** FLOP *** [9h 3h As]
e32dc6f0: checks
Hero: bets $0.08
e32dc6f0: calls $0.08
*** TURN *** [9h 3h As] [5s]
e32dc6f0: checks
Hero: checks
*** RIVER *** [9h 3h As 5s] [4h]
e32dc6f0: checks
Hero: bets $0.3
e32dc6f0: folds
Uncalled bet ($0.3) returned to Hero
*** SHOWDOWN ***
Hero collected $0.37 from pot
*** SUMMARY ***
Total pot $0.38 | Rake $0.01 | Jackpot $0 | Bingo $0 | Fortune $0 | Tax $0
Board [9h 3h As 5s 4h]
Seat 1: 8023de0f (button) folded before Flop (didn't bet)
Seat 2: 5f1cdd27 (small blind) folded before Flop
Seat 3: e32dc6f0 (big blind) folded on the River
Seat 4: 15125d65 folded before Flop (didn't bet)
Seat 5: Hero won ($0.37)
Seat 6: d606d9 folded before Flop (didn't bet)


Poker Hand #RC3334483038: Hold'em No Limit ($0.02/$0.05) - 2025/02/17 21:10:09
Table 'RushAndCash618298' 6-max Seat #1 is the button
Seat 1: Hero ($8.92 in chips)
Seat 2: db83c16e ($3.14 in chips)
Seat 3: 1fa8537 ($6.98 in chips)
Seat 4: a63aa4b7 ($19.21 in chips)
Seat 5: 198a1e4 ($5.6 in chips)
Seat 6: 92855848 ($5.02 in chips)
db83c16e: posts small blind $0.02
1fa8537: posts big blind $0.05
*** HOLE CARDS ***
Dealt to Hero [9s 4c]
Dealt to db83c16e 
Dealt to 1fa8537 
Dealt to a63aa4b7 
Dealt to 198a1e4 
Dealt to 92855848 
a63aa4b7: folds
198a1e4: raises $0.05 to $0.1
92855848: folds
Hero: folds
db83c16e: folds
1fa8537: folds
Uncalled bet ($0.05) returned to 198a1e4
*** SHOWDOWN ***
198a1e4 collected $0.12 from pot
*** SUMMARY ***
Total pot $0.12 | Rake $0 | Jackpot $0 | Bingo $0 | Fortune $0 | Tax $0
Seat 1: Hero (button) folded before Flop (didn't bet)
Seat 2: db83c16e (small blind) folded before Flop
Seat 3: 1fa8537 (big blind) folded before Flop
Seat 4: a63aa4b7 folded before Flop (didn't bet)
Seat 5: 198a1e4 collected ($0.12)
Seat 6: 92855848 folded before Flop (didn't bet)


Poker Hand #RC3334483007: Hold'em No Limit ($0.02/$0.05) - 2025/02/17 21:10:06
Table 'RushAndCash618267' 6-max Seat #1 is the button
Seat 1: fe9dbb50 ($5.43 in chips)
Seat 2: Hero ($8.94 in chips)
Seat 3: e58420c8 ($8.06 in chips)
Seat 4: 769f9172 ($5.64 in chips)
Seat 5: b86c29aa ($5.71 in chips)
Seat 6: 3ff27d73 ($5 in chips)
Hero: posts small blind $0.02
e58420c8: posts big blind $0.05
*** HOLE CARDS ***
Dealt to fe9dbb50 
Dealt to Hero [4d Kc]
Dealt to e58420c8 
Dealt to 769f9172 
Dealt to b86c29aa 
Dealt to 3ff27d73 
769f9172: folds
b86c29aa: folds
3ff27d73: folds
fe9dbb50: raises $0.05 to $0.1
Hero: folds
e58420c8: calls $0.05
*** FLOP *** [Ts 2s 8s]
e58420c8: checks
fe9dbb50: checks
*** TURN *** [Ts 2s 8s] [6d]
e58420c8: bets $0.08
fe9dbb50: calls $0.08
*** RIVER *** [Ts 2s 8s 6d] [Jh]
e58420c8: checks
fe9dbb50: checks
e58420c8: shows [As 8h] (Pair of Eights)
fe9dbb50: shows [Ac Qh] (Ace-High)
*** SHOWDOWN ***
e58420c8 collected $0.37 from pot
*** SUMMARY ***
Total pot $0.38 | Rake $0.01 | Jackpot $0 | Bingo $0 | Fortune $0 | Tax $0
Board [Ts 2s 8s 6d Jh]
Seat 1: fe9dbb50 (button) showed [Ac Qh] and lost with Ace-High
Seat 2: Hero (small blind) folded before Flop
Seat 3: e58420c8 (big blind) showed [As 8h] and won ($0.37) with Pair of Eights
Seat 4: 769f9172 folded before Flop (didn't bet)
Seat 5: b86c29aa folded before Flop (didn't bet)
Seat 6: 3ff27d73 folded before Flop (didn't bet)


Poker Hand #RC3334482981: Hold'em No Limit ($0.02/$0.05) - 2025/02/17 21:10:03
Table 'RushAndCash618241' 6-max Seat #1 is the button
Seat 1: db0f0c64 ($5 in chips)
Seat 2: 808dd9c ($5.79 in chips)
Seat 3: Hero ($8.99 in chips)
Seat 4: 43a05b2c ($5.14 in chips)
Seat 5: 5abb6a6d ($5.6 in chips)
Seat 6: 8e07c53 ($6.44 in chips)
808dd9c: posts small blind $0.02
Hero: posts big blind $0.05
*** HOLE CARDS ***
Dealt to db0f0c64 
Dealt to 808dd9c 
Dealt to Hero [5c Th]
Dealt to 43a05b2c 
Dealt to 5abb6a6d 
Dealt to 8e07c53 
43a05b2c: folds
5abb6a6d: folds
8e07c53: folds
db0f0c64: folds
808dd9c: raises $0.05 to $0.1
Hero: folds
Uncalled bet ($0.05) returned to 808dd9c
*** SHOWDOWN ***
808dd9c collected $0.1 from pot
*** SUMMARY ***
Total pot $0.1 | Rake $0 | Jackpot $0 | Bingo $0 | Fortune $0 | Tax $0
Seat 1: db0f0c64 (button) folded before Flop (didn't bet)
Seat 2: 808dd9c (small blind) collected ($0.1)
Seat 3: Hero (big blind) folded before Flop
Seat 4: 43a05b2c folded before Flop (didn't bet)
Seat 5: 5abb6a6d folded before Flop (didn't bet)
Seat 6: 8e07c53 folded before Flop (didn't bet)


Poker Hand #RC3334482770: Hold'em No Limit ($0.02/$0.05) - 2025/02/17 21:09:37
Table 'RushAndCash618030' 6-max Seat #1 is the button
Seat 1: 9dba8a1e ($5.88 in chips)
Seat 2: a8c71cd6 ($5.62 in chips)
Seat 3: Hero ($9.04 in chips)
Seat 4: 6d2abfa5 ($7.05 in chips)
Seat 5: f43eaf15 ($7.57 in chips)
Seat 6: 4190d158 ($7.11 in chips)
a8c71cd6: posts small blind $0.02
Hero: posts big blind $0.05
*** HOLE CARDS ***
Dealt to 9dba8a1e 
Dealt to a8c71cd6 
Dealt to Hero [Jc Qs]
Dealt to 6d2abfa5 
Dealt to f43eaf15 
Dealt to 4190d158 
6d2abfa5: folds
f43eaf15: raises $0.05 to $0.1
4190d158: folds
9dba8a1e: calls $0.1
a8c71cd6: raises $0.58 to $0.68
Hero: folds
f43eaf15: folds
9dba8a1e: folds
Uncalled bet ($0.58) returned to a8c71cd6
*** SHOWDOWN ***
a8c71cd6 collected $0.34 from pot
*** SUMMARY ***
Total pot $0.35 | Rake $0.01 | Jackpot $0 | Bingo $0 | Fortune $0 | Tax $0
Seat 1: 9dba8a1e (button) folded before Flop
Seat 2: a8c71cd6 (small blind) collected ($0.34)
Seat 3: Hero (big blind) folded before Flop
Seat 4: 6d2abfa5 folded before Flop (didn't bet)
Seat 5: f43eaf15 folded before Flop
Seat 6: 4190d158 folded before Flop (didn't bet)


Poker Hand #RC3334482739: Hold'em No Limit ($0.02/$0.05) - 2025/02/17 21:09:34
Table 'RushAndCash617999' 6-max Seat #1 is the button
Seat 1: e5e6041b ($6.31 in chips)
Seat 2: aaa792dc ($5.02 in chips)
Seat 3: ec3424f5 ($5 in chips)
Seat 4: Hero ($9.04 in chips)
Seat 5: 5fd404ad ($5 in chips)
Seat 6: 6c641898 ($5.23 in chips)
aaa792dc: posts small blind $0.02
ec3424f5: posts big blind $0.05
*** HOLE CARDS ***
Dealt to e5e6041b 
Dealt to aaa792dc 
Dealt to ec3424f5 
Dealt to Hero [6c 4s]
Dealt to 5fd404ad 
Dealt to 6c641898 
Hero: folds
5fd404ad: raises $0.1 to $0.15
6c641898: folds
e5e6041b: folds
aaa792dc: folds
ec3424f5: folds
Uncalled bet ($0.1) returned to 5fd404ad
*** SHOWDOWN ***
5fd404ad collected $0.12 from pot
*** SUMMARY ***
Total pot $0.12 | Rake $0 | Jackpot $0 | Bingo $0 | Fortune $0 | Tax $0
Seat 1: e5e6041b (button) folded before Flop (didn't bet)
Seat 2: aaa792dc (small blind) folded before Flop
Seat 3: ec3424f5 (big blind) folded before Flop
Seat 4: Hero folded before Flop (didn't bet)
Seat 5: 5fd404ad collected ($0.12)
Seat 6: 6c641898 folded before Flop (didn't bet)


Poker Hand #RC3334482710: Hold'em No Limit ($0.02/$0.05) - 2025/02/17 21:09:30
Table 'RushAndCash617970' 6-max Seat #1 is the button
Seat 1: 57d6169c ($5.82 in chips)
Seat 2: Hero ($9.06 in chips)
Seat 3: f52f15b4 ($5 in chips)
Seat 4: be86537 ($6.6 in chips)
Seat 5: 1fee54bc ($5.55 in chips)
Seat 6: 51ee7ca4 ($4.95 in chips)
Hero: posts small blind $0.02
f52f15b4: posts big blind $0.05
*** HOLE CARDS ***
Dealt to 57d6169c 
Dealt to Hero [8h 2c]
Dealt to f52f15b4 
Dealt to be86537 
Dealt to 1fee54bc 
Dealt to 51ee7ca4 
be86537: folds
1fee54bc: folds
51ee7ca4: folds
57d6169c: folds
Hero: folds
Uncalled bet ($0.03) returned to f52f15b4
*** SHOWDOWN ***
f52f15b4 collected $0.04 from pot
*** SUMMARY ***
Total pot $0.04 | Rake $0 | Jackpot $0 | Bingo $0 | Fortune $0 | Tax $0
Seat 1: 57d6169c (button) folded before Flop (didn't bet)
Seat 2: Hero (small blind) folded before Flop
Seat 3: f52f15b4 (big blind) collected ($0.04)
Seat 4: be86537 folded before Flop (didn't bet)
Seat 5: 1fee54bc folded before Flop (didn't bet)
Seat 6: 51ee7ca4 folded before Flop (didn't bet)


Poker Hand #RC3334482680: Hold'em No Limit ($0.02/$0.05) - 2025/02/17 21:09:27
Table 'RushAndCash617940' 6-max Seat #1 is the button
Seat 1: 7a24974a ($5.15 in chips)
Seat 2: 71f2556b ($3.04 in chips)
Seat 3: 48f54de5 ($1.79 in chips)
Seat 4: dbf5f543 ($5.84 in chips)
Seat 5: 89bcbb95 ($5.33 in chips)
Seat 6: Hero ($9.06 in chips)
71f2556b: posts small blind $0.02
48f54de5: posts big blind $0.05
*** HOLE CARDS ***
Dealt to 7a24974a 
Dealt to 71f2556b 
Dealt to 48f54de5 
Dealt to dbf5f543 
Dealt to 89bcbb95 
Dealt to Hero [7s 2d]
dbf5f543: folds
89bcbb95: raises $0.08 to $0.13
Hero: folds
7a24974a: folds
71f2556b: folds
48f54de5: folds
Uncalled bet ($0.08) returned to 89bcbb95
*** SHOWDOWN ***
89bcbb95 collected $0.12 from pot
*** SUMMARY ***
Total pot $0.12 | Rake $0 | Jackpot $0 | Bingo $0 | Fortune $0 | Tax $0
Seat 1: 7a24974a (button) folded before Flop (didn't bet)
Seat 2: 71f2556b (small blind) folded before Flop
Seat 3: 48f54de5 (big blind) folded before Flop
Seat 4: dbf5f543 folded before Flop (didn't bet)
Seat 5: 89bcbb95 collected ($0.12)
Seat 6: Hero folded before Flop (didn't bet)


Poker Hand #RC3334482627: Hold'em No Limit ($0.02/$0.05) - 2025/02/17 21:09:21
Table 'RushAndCash617887' 6-max Seat #1 is the button
Seat 1: 4262311b ($5.06 in chips)
Seat 2: 5c8c19b7 ($13.45 in chips)
Seat 3: 71f2556b ($3.09 in chips)
Seat 4: d916afa1 ($21.66 in chips)
Seat 5: Hero ($9.06 in chips)
Seat 6: ee3fdfd8 ($6.6 in chips)
5c8c19b7: posts small blind $0.02
71f2556b: posts big blind $0.05
*** HOLE CARDS ***
Dealt to 4262311b 
Dealt to 5c8c19b7 
Dealt to 71f2556b 
Dealt to d916afa1 
Dealt to Hero [Jh 9h]
Dealt to ee3fdfd8 
d916afa1: raises $0.1 to $0.15
Hero: folds
ee3fdfd8: folds
4262311b: folds
5c8c19b7: folds
71f2556b: folds
Uncalled bet ($0.1) returned to d916afa1
*** SHOWDOWN ***
d916afa1 collected $0.12 from pot
*** SUMMARY ***
Total pot $0.12 | Rake $0 | Jackpot $0 | Bingo $0 | Fortune $0 | Tax $0
Seat 1: 4262311b (button) folded before Flop (didn't bet)
Seat 2: 5c8c19b7 (small blind) folded before Flop
Seat 3: 71f2556b (big blind) folded before Flop
Seat 4: d916afa1 collected ($0.12)
Seat 5: Hero folded before Flop (didn't bet)
Seat 6: ee3fdfd8 folded before Flop (didn't bet)


Poker Hand #RC3334482598: Hold'em No Limit ($0.02/$0.05) - 2025/02/17 21:09:18
Table 'RushAndCash617858' 6-max Seat #1 is the button
Seat 1: ca462b6a ($6.36 in chips)
Seat 2: f18b40b7 ($5.93 in chips)
Seat 3: 9dd1ff39 ($7.05 in chips)
Seat 4: d278c831 ($5.77 in chips)
Seat 5: Hero ($9.06 in chips)
Seat 6: 3bfcd529 ($5.23 in chips)
f18b40b7: posts small blind $0.02
9dd1ff39: posts big blind $0.05
*** HOLE CARDS ***
Dealt to ca462b6a 
Dealt to f18b40b7 
Dealt to 9dd1ff39 
Dealt to d278c831 
Dealt to Hero [Tc 9s]
Dealt to 3bfcd529 
d278c831: folds
Hero: folds
3bfcd529: folds
ca462b6a: folds
f18b40b7: raises $0.1 to $0.15
9dd1ff39: raises $0.3 to $0.45
f18b40b7: calls $0.3
*** FLOP *** [8d 7d 7c]
f18b40b7: checks
9dd1ff39: checks
*** TURN *** [8d 7d 7c] [4d]
f18b40b7: bets $1.1
9dd1ff39: folds
Uncalled bet ($1.1) returned to f18b40b7
*** SHOWDOWN ***
f18b40b7 collected $0.86 from pot
*** SUMMARY ***
Total pot $0.9 | Rake $0.04 | Jackpot $0 | Bingo $0 | Fortune $0 | Tax $0
Board [8d 7d 7c 4d]
Seat 1: ca462b6a (button) folded before Flop (didn't bet)
Seat 2: f18b40b7 (small blind) won ($0.86)
Seat 3: 9dd1ff39 (big blind) folded on the Turn
Seat 4: d278c831 folded before Flop (didn't bet)
Seat 5: Hero folded before Flop (didn't bet)
Seat 6: 3bfcd529 folded before Flop (didn't bet)


Poker Hand #RC3334482572: Hold'em No Limit ($0.02/$0.05) - 2025/02/17 21:09:15
Table 'RushAndCash617832' 6-max Seat #1 is the button
Seat 1: a3b43a4c ($5.34 in chips)
Seat 2: 769f9172 ($5.57 in chips)
Seat 3: c27051e0 ($6.88 in chips)
Seat 4: Hero ($9.06 in chips)
Seat 5: d5b0e893 ($6.45 in chips)
Seat 6: 22a3f0e8 ($6.87 in chips)
769f9172: posts small blind $0.02
c27051e0: posts big blind $0.05
*** HOLE CARDS ***
Dealt to a3b43a4c 
Dealt to 769f9172 
Dealt to c27051e0 
Dealt to Hero [Kh 3c]
Dealt to d5b0e893 
Dealt to 22a3f0e8 
Hero: folds
d5b0e893: folds
22a3f0e8: raises $0.05 to $0.1
a3b43a4c: folds
769f9172: folds
c27051e0: raises $0.35 to $0.45
22a3f0e8: calls $0.35
*** FLOP *** [3s 2d Qs]
c27051e0: bets $0.31
22a3f0e8: calls $0.31
*** TURN *** [3s 2d Qs] [4h]
c27051e0: bets $0.51
22a3f0e8: calls $0.51
*** RIVER *** [3s 2d Qs 4h] [As]
c27051e0: checks
22a3f0e8: bets $3.77
c27051e0: folds
Uncalled bet ($3.77) returned to 22a3f0e8
*** SHOWDOWN ***
22a3f0e8 collected $2.37 from pot
*** SUMMARY ***
Total pot $2.56 | Rake $0.12 | Jackpot $0.07 | Bingo $0 | Fortune $0 | Tax $0
Board [3s 2d Qs 4h As]
Seat 1: a3b43a4c (button) folded before Flop (didn't bet)
Seat 2: 769f9172 (small blind) folded before Flop
Seat 3: c27051e0 (big blind) folded on the River
Seat 4: Hero folded before Flop (didn't bet)
Seat 5: d5b0e893 folded before Flop (didn't bet)
Seat 6: 22a3f0e8 won ($2.37)


Poker Hand #RC3334482547: Hold'em No Limit ($0.02/$0.05) - 2025/02/17 21:09:12
Table 'RushAndCash617807' 6-max Seat #1 is the button
Seat 1: c6158c9d ($5.72 in chips)
Seat 2: 92fa3d91 ($5.01 in chips)
Seat 3: b282789b ($5.04 in chips)
Seat 4: 8e07c53 ($6.06 in chips)
Seat 5: Hero ($8.99 in chips)
Seat 6: 5422bec9 ($5.08 in chips)
92fa3d91: posts small blind $0.02
b282789b: posts big blind $0.05
*** HOLE CARDS ***
Dealt to c6158c9d 
Dealt to 92fa3d91 
Dealt to b282789b 
Dealt to 8e07c53 
Dealt to Hero [5s Jh]
Dealt to 5422bec9 
8e07c53: folds
Hero: folds
5422bec9: folds
c6158c9d: folds
92fa3d91: folds
Uncalled bet ($0.03) returned to b282789b
*** SHOWDOWN ***
b282789b collected $0.04 from pot
*** SUMMARY ***
Total pot $0.04 | Rake $0 | Jackpot $0 | Bingo $0 | Fortune $0 | Tax $0
Seat 1: c6158c9d (button) folded before Flop (didn't bet)
Seat 2: 92fa3d91 (small blind) folded before Flop
Seat 3: b282789b (big blind) collected ($0.04)
Seat 4: 8e07c53 folded before Flop (didn't bet)
Seat 5: Hero folded before Flop (didn't bet)
Seat 6: 5422bec9 folded before Flop (didn't bet)


Poker Hand #RC3334482520: Hold'em No Limit ($0.02/$0.05) - 2025/02/17 21:09:09
Table 'RushAndCash617780' 6-max Seat #1 is the button
Seat 1: e89071f6 ($6.98 in chips)
Seat 2: 516da84c ($5.27 in chips)
Seat 3: b4c33f6c ($5 in chips)
Seat 4: Hero ($8.99 in chips)
Seat 5: 7a24974a ($5.22 in chips)
Seat 6: daf6ad6 ($6.91 in chips)
516da84c: posts small blind $0.02
b4c33f6c: posts big blind $0.05
*** HOLE CARDS ***
Dealt to e89071f6 
Dealt to 516da84c 
Dealt to b4c33f6c 
Dealt to Hero [4c Ts]
Dealt to 7a24974a 
Dealt to daf6ad6 
Hero: folds
7a24974a: folds
daf6ad6: raises $0.07 to $0.12
e89071f6: folds
516da84c: folds
b4c33f6c: raises $0.38 to $0.5
daf6ad6: raises $0.65 to $1.15
b4c33f6c: calls $0.65
*** FLOP *** [9d Qs 4d]
b4c33f6c: checks
daf6ad6: bets $0.56
b4c33f6c: raises $1.24 to $1.8
daf6ad6: folds
Uncalled bet ($1.24) returned to b4c33f6c
*** SHOWDOWN ***
b4c33f6c collected $3.22 from pot
*** SUMMARY ***
Total pot $3.44 | Rake $0.15 | Jackpot $0.07 | Bingo $0 | Fortune $0 | Tax $0
Board [9d Qs 4d]
Seat 1: e89071f6 (button) folded before Flop (didn't bet)
Seat 2: 516da84c (small blind) folded before Flop
Seat 3: b4c33f6c (big blind) won ($3.22)
Seat 4: Hero folded before Flop (didn't bet)
Seat 5: 7a24974a folded before Flop (didn't bet)
Seat 6: daf6ad6 folded on the Flop


Poker Hand #RC3334482497: Hold'em No Limit ($0.02/$0.05) - 2025/02/17 21:09:06
Table 'RushAndCash617757' 6-max Seat #1 is the button
Seat 1: 2dbc5afb ($5.31 in chips)
Seat 2: 573eb753 ($4.93 in chips)
Seat 3: Hero ($9.04 in chips)
Seat 4: 6a5a3ab6 ($3.82 in chips)
Seat 5: 8b76c8c6 ($4.36 in chips)
Seat 6: 70521b8f ($5.38 in chips)
573eb753: posts small blind $0.02
Hero: posts big blind $0.05
*** HOLE CARDS ***
Dealt to 2dbc5afb 
Dealt to 573eb753 
Dealt to Hero [6s Jc]
Dealt to 6a5a3ab6 
Dealt to 8b76c8c6 
Dealt to 70521b8f 
6a5a3ab6: folds
8b76c8c6: folds
70521b8f: folds
2dbc5afb: folds
573eb753: folds
Uncalled bet ($0.03) returned to Hero
*** SHOWDOWN ***
Hero collected $0.04 from pot
*** SUMMARY ***
Total pot $0.04 | Rake $0 | Jackpot $0 | Bingo $0 | Fortune $0 | Tax $0
Seat 1: 2dbc5afb (button) folded before Flop (didn't bet)
Seat 2: 573eb753 (small blind) folded before Flop
Seat 3: Hero (big blind) collected ($0.04)
Seat 4: 6a5a3ab6 folded before Flop (didn't bet)
Seat 5: 8b76c8c6 folded before Flop (didn't bet)
Seat 6: 70521b8f folded before Flop (didn't bet)


Poker Hand #RC3334482132: Hold'em No Limit ($0.02/$0.05) - 2025/02/17 21:08:18
Table 'RushAndCash617392' 6-max Seat #1 is the button
Seat 1: 54c506e4 ($5 in chips)
Seat 2: Hero ($8.57 in chips)
Seat 3: 8f9fd8b1 ($13.42 in chips)
Seat 4: fa499268 ($6.59 in chips)
Seat 5: f9d64f1a ($5.49 in chips)
Seat 6: 8b76c8c6 ($4.82 in chips)
Hero: posts small blind $0.02
8f9fd8b1: posts big blind $0.05
*** HOLE CARDS ***
Dealt to 54c506e4 
Dealt to Hero [Kd Kh]
Dealt to 8f9fd8b1 
Dealt to fa499268 
Dealt to f9d64f1a 
Dealt to 8b76c8c6 
fa499268: folds
f9d64f1a: folds
8b76c8c6: raises $0.06 to $0.11
54c506e4: folds
Hero: raises $0.35 to $0.46
8f9fd8b1: folds
8b76c8c6: calls $0.35
*** FLOP *** [Qd 5d 9c]
Hero: checks
8b76c8c6: checks
*** TURN *** [Qd 5d 9c] [6h]
Hero: bets $0.5
8b76c8c6: folds
Uncalled bet ($0.5) returned to Hero
*** SHOWDOWN ***
Hero collected $0.93 from pot
*** SUMMARY ***
Total pot $0.97 | Rake $0.04 | Jackpot $0 | Bingo $0 | Fortune $0 | Tax $0
Board [Qd 5d 9c 6h]
Seat 1: 54c506e4 (button) folded before Flop (didn't bet)
Seat 2: Hero (small blind) won ($0.93)
Seat 3: 8f9fd8b1 (big blind) folded before Flop
Seat 4: fa499268 folded before Flop (didn't bet)
Seat 5: f9d64f1a folded before Flop (didn't bet)
Seat 6: 8b76c8c6 folded on the Turn


Poker Hand #RC3334482045: Hold'em No Limit ($0.02/$0.05) - 2025/02/17 21:08:07
Table 'RushAndCash617305' 6-max Seat #1 is the button
Seat 1: 868521d5 ($5.22 in chips)
Seat 2: 3b2a8270 ($13.69 in chips)
Seat 3: a708a98a ($18.16 in chips)
Seat 4: Hero ($8.57 in chips)
Seat 5: 12cda2e0 ($22.08 in chips)
Seat 6: 1e76a4d8 ($6.31 in chips)
3b2a8270: posts small blind $0.02
a708a98a: posts big blind $0.05
*** HOLE CARDS ***
Dealt to 868521d5 
Dealt to 3b2a8270 
Dealt to a708a98a 
Dealt to Hero [5d 8c]
Dealt to 12cda2e0 
Dealt to 1e76a4d8 
Hero: folds
12cda2e0: folds
1e76a4d8: folds
868521d5: folds
3b2a8270: raises $0.08 to $0.13
a708a98a: raises $0.37 to $0.5
3b2a8270: calls $0.37
*** FLOP *** [As Ts 6c]
3b2a8270: checks
a708a98a: bets $0.38
3b2a8270: calls $0.38
*** TURN *** [As Ts 6c] [4h]
3b2a8270: checks
a708a98a: bets $1.32
3b2a8270: folds
Uncalled bet ($1.32) returned to a708a98a
*** SHOWDOWN ***
a708a98a collected $1.61 from pot
*** SUMMARY ***
Total pot $1.76 | Rake $0.08 | Jackpot $0.07 | Bingo $0 | Fortune $0 | Tax $0
Board [As Ts 6c 4h]
Seat 1: 868521d5 (button) folded before Flop (didn't bet)
Seat 2: 3b2a8270 (small blind) folded on the Turn
Seat 3: a708a98a (big blind) won ($1.61)
Seat 4: Hero folded before Flop (didn't bet)
Seat 5: 12cda2e0 folded before Flop (didn't bet)
Seat 6: 1e76a4d8 folded before Flop (didn't bet)


Poker Hand #RC3334481985: Hold'em No Limit ($0.02/$0.05) - 2025/02/17 21:08:00
Table 'RushAndCash617245' 6-max Seat #1 is the button
Seat 1: Hero ($8.57 in chips)
Seat 2: d57e790f ($6.49 in chips)
Seat 3: 54a16a21 ($6.25 in chips)
Seat 4: 4238ab48 ($6.52 in chips)
Seat 5: 20c536f4 ($5.65 in chips)
Seat 6: 21bff972 ($5.61 in chips)
d57e790f: posts small blind $0.02
54a16a21: posts big blind $0.05
*** HOLE CARDS ***
Dealt to Hero [Qs 5d]
Dealt to d57e790f 
Dealt to 54a16a21 
Dealt to 4238ab48 
Dealt to 20c536f4 
Dealt to 21bff972 
4238ab48: folds
20c536f4: folds
21bff972: folds
Hero: folds
d57e790f: raises $0.1 to $0.15
54a16a21: folds
Uncalled bet ($0.1) returned to d57e790f
*** SHOWDOWN ***
d57e790f collected $0.1 from pot
*** SUMMARY ***
Total pot $0.1 | Rake $0 | Jackpot $0 | Bingo $0 | Fortune $0 | Tax $0
Seat 1: Hero (button) folded before Flop (didn't bet)
Seat 2: d57e790f (small blind) collected ($0.1)
Seat 3: 54a16a21 (big blind) folded before Flop
Seat 4: 4238ab48 folded before Flop (didn't bet)
Seat 5: 20c536f4 folded before Flop (didn't bet)
Seat 6: 21bff972 folded before Flop (didn't bet)


Poker Hand #RC3334481963: Hold'em No Limit ($0.02/$0.05) - 2025/02/17 21:07:57
Table 'RushAndCash617223' 6-max Seat #1 is the button
Seat 1: 1e76a4d8 ($6.24 in chips)
Seat 2: d201e5fe ($9.22 in chips)
Seat 3: ec1214a6 ($5.3 in chips)
Seat 4: 8ed17f8c ($8.64 in chips)
Seat 5: Hero ($8.57 in chips)
Seat 6: a4e63c5 ($5.21 in chips)
d201e5fe: posts small blind $0.02
ec1214a6: posts big blind $0.05
*** HOLE CARDS ***
Dealt to 1e76a4d8 
Dealt to d201e5fe 
Dealt to ec1214a6 
Dealt to 8ed17f8c 
Dealt to Hero [4c Jh]
Dealt to a4e63c5 
8ed17f8c: folds
Hero: folds
a4e63c5: folds
1e76a4d8: raises $0.07 to $0.12
d201e5fe: folds
ec1214a6: folds
Uncalled bet ($0.07) returned to 1e76a4d8
*** SHOWDOWN ***
1e76a4d8 collected $0.12 from pot
*** SUMMARY ***
Total pot $0.12 | Rake $0 | Jackpot $0 | Bingo $0 | Fortune $0 | Tax $0
Seat 1: 1e76a4d8 (button) collected ($0.12)
Seat 2: d201e5fe (small blind) folded before Flop
Seat 3: ec1214a6 (big blind) folded before Flop
Seat 4: 8ed17f8c folded before Flop (didn't bet)
Seat 5: Hero folded before Flop (didn't bet)
Seat 6: a4e63c5 folded before Flop (didn't bet)


Poker Hand #RC3334481935: Hold'em No Limit ($0.02/$0.05) - 2025/02/17 21:07:53
Table 'RushAndCash617195' 6-max Seat #1 is the button
Seat 1: 5422bec9 ($5 in chips)
Seat 2: 55e0d4fe ($5.83 in chips)
Seat 3: f85679bb ($5.66 in chips)
Seat 4: f6efd55a ($8.74 in chips)
Seat 5: a8e12c85 ($4.99 in chips)
Seat 6: Hero ($8.57 in chips)
55e0d4fe: posts small blind $0.02
f85679bb: posts big blind $0.05
*** HOLE CARDS ***
Dealt to 5422bec9 
Dealt to 55e0d4fe 
Dealt to f85679bb 
Dealt to f6efd55a 
Dealt to a8e12c85 
Dealt to Hero [Js 7c]
f6efd55a: folds
a8e12c85: raises $0.08 to $0.13
Hero: folds
5422bec9: folds
55e0d4fe: folds
f85679bb: calls $0.08
*** FLOP *** [5d 5c 8s]
f85679bb: checks
a8e12c85: checks
*** TURN *** [5d 5c 8s] [9c]
f85679bb: checks
a8e12c85: checks
*** RIVER *** [5d 5c 8s 9c] [Kc]
f85679bb: checks
a8e12c85: checks
f85679bb: shows [Jd Td] (Pair of Fives)
a8e12c85: shows [Qd 7d] (Pair of Fives)
*** SHOWDOWN ***
a8e12c85 collected $0.27 from pot
*** SUMMARY ***
Total pot $0.28 | Rake $0.01 | Jackpot $0 | Bingo $0 | Fortune $0 | Tax $0
Board [5d 5c 8s 9c Kc]
Seat 1: 5422bec9 (button) folded before Flop (didn't bet)
Seat 2: 55e0d4fe (small blind) folded before Flop
Seat 3: f85679bb (big blind) showed [Jd Td] and lost with Pair of Fives
Seat 4: f6efd55a folded before Flop (didn't bet)
Seat 5: a8e12c85 showed [Qd 7d] and won ($0.27) with Pair of Fives
Seat 6: Hero folded before Flop (didn't bet)


Poker Hand #RC3334481908: Hold'em No Limit ($0.02/$0.05) - 2025/02/17 21:07:50
Table 'RushAndCash617168' 6-max Seat #1 is the button
Seat 1: 66be2112 ($5.07 in chips)
Seat 2: 1d0217bc ($10.32 in chips)
Seat 3: e0a9129e ($2.92 in chips)
Seat 4: fcdb0509 ($5.89 in chips)
Seat 5: Hero ($8.57 in chips)
Seat 6: 5c14c443 ($4.43 in chips)
1d0217bc: posts small blind $0.02
e0a9129e: posts big blind $0.05
*** HOLE CARDS ***
Dealt to 66be2112 
Dealt to 1d0217bc 
Dealt to e0a9129e 
Dealt to fcdb0509 
Dealt to Hero [8h 9s]
Dealt to 5c14c443 
fcdb0509: folds
Hero: folds
5c14c443: folds
66be2112: folds
1d0217bc: raises $0.1 to $0.15
e0a9129e: calls $0.1
*** FLOP *** [6s 7s Qs]
1d0217bc: checks
e0a9129e: checks
*** TURN *** [6s 7s Qs] [9c]
1d0217bc: bets $0.16
e0a9129e: calls $0.16
*** RIVER *** [6s 7s Qs 9c] [Ac]
1d0217bc: checks
e0a9129e: checks
1d0217bc: shows [6d 4d] (Pair of Sixes)
e0a9129e: shows [Jh Jc] (Pair of Jacks)
*** SHOWDOWN ***
e0a9129e collected $0.59 from pot
*** SUMMARY ***
Total pot $0.62 | Rake $0.03 | Jackpot $0 | Bingo $0 | Fortune $0 | Tax $0
Board [6s 7s Qs 9c Ac]
Seat 1: 66be2112 (button) folded before Flop (didn't bet)
Seat 2: 1d0217bc (small blind) showed [6d 4d] and lost with Pair of Sixes
Seat 3: e0a9129e (big blind) showed [Jh Jc] and won ($0.59) with Pair of Jacks
Seat 4: fcdb0509 folded before Flop (didn't bet)
Seat 5: Hero folded before Flop (didn't bet)
Seat 6: 5c14c443 folded before Flop (didn't bet)


Poker Hand #RC3334481885: Hold'em No Limit ($0.02/$0.05) - 2025/02/17 21:07:47
Table 'RushAndCash617145' 6-max Seat #1 is the button
Seat 1: 1f187ba0 ($6.09 in chips)
Seat 2: 534f7ad0 ($2.55 in chips)
Seat 3: 944e9aa3 ($5.07 in chips)
Seat 4: Hero ($8.57 in chips)
Seat 5: f4ed7f83 ($5.23 in chips)
Seat 6: 86e70506 ($5.09 in chips)
534f7ad0: posts small blind $0.02
944e9aa3: posts big blind $0.05
*** HOLE CARDS ***
Dealt to 1f187ba0 
Dealt to 534f7ad0 
Dealt to 944e9aa3 
Dealt to Hero [2d 5h]
Dealt to f4ed7f83 
Dealt to 86e70506 
Hero: folds
f4ed7f83: folds
86e70506: raises $0.05 to $0.1
1f187ba0: folds
534f7ad0: raises $0.2 to $0.3
944e9aa3: folds
86e70506: calls $0.2
*** FLOP *** [Kd Tc 8s]
534f7ad0: bets $0.23
86e70506: folds
Uncalled bet ($0.23) returned to 534f7ad0
*** SHOWDOWN ***
534f7ad0 collected $0.62 from pot
*** SUMMARY ***
Total pot $0.65 | Rake $0.03 | Jackpot $0 | Bingo $0 | Fortune $0 | Tax $0
Board [Kd Tc 8s]
Seat 1: 1f187ba0 (button) folded before Flop (didn't bet)
Seat 2: 534f7ad0 (small blind) won ($0.62)
Seat 3: 944e9aa3 (big blind) folded before Flop
Seat 4: Hero folded before Flop (didn't bet)
Seat 5: f4ed7f83 folded before Flop (didn't bet)
Seat 6: 86e70506 folded on the Flop


Poker Hand #RC3334481848: Hold'em No Limit ($0.02/$0.05) - 2025/02/17 21:07:42
Table 'RushAndCash617108' 6-max Seat #1 is the button
Seat 1: Hero ($8.57 in chips)
Seat 2: 2b8b2921 ($9.06 in chips)
Seat 3: 3ff27d73 ($5 in chips)
Seat 4: 2b13f4d5 ($3.52 in chips)
Seat 5: 757f29d9 ($4.84 in chips)
Seat 6: 4c9f897a ($8.22 in chips)
2b8b2921: posts small blind $0.02
3ff27d73: posts big blind $0.05
*** HOLE CARDS ***
Dealt to Hero [Td 4d]
Dealt to 2b8b2921 
Dealt to 3ff27d73 
Dealt to 2b13f4d5 
Dealt to 757f29d9 
Dealt to 4c9f897a 
2b13f4d5: folds
757f29d9: folds
4c9f897a: folds
Hero: folds
2b8b2921: folds
Uncalled bet ($0.03) returned to 3ff27d73
*** SHOWDOWN ***
3ff27d73 collected $0.04 from pot
*** SUMMARY ***
Total pot $0.04 | Rake $0 | Jackpot $0 | Bingo $0 | Fortune $0 | Tax $0
Seat 1: Hero (button) folded before Flop (didn't bet)
Seat 2: 2b8b2921 (small blind) folded before Flop
Seat 3: 3ff27d73 (big blind) collected ($0.04)
Seat 4: 2b13f4d5 folded before Flop (didn't bet)
Seat 5: 757f29d9 folded before Flop (didn't bet)
Seat 6: 4c9f897a folded before Flop (didn't bet)


Poker Hand #RC3334481821: Hold'em No Limit ($0.02/$0.05) - 2025/02/17 21:07:39
Table 'RushAndCash617081' 6-max Seat #1 is the button
Seat 1: 816260d0 ($9.73 in chips)
Seat 2: 9babc997 ($5.35 in chips)
Seat 3: Hero ($8.62 in chips)
Seat 4: caa19347 ($5.7 in chips)
Seat 5: 90c3e611 ($5.39 in chips)
Seat 6: f85679bb ($5.66 in chips)
9babc997: posts small blind $0.02
Hero: posts big blind $0.05
*** HOLE CARDS ***
Dealt to 816260d0 
Dealt to 9babc997 
Dealt to Hero [4s 3h]
Dealt to caa19347 
Dealt to 90c3e611 
Dealt to f85679bb 
caa19347: folds
90c3e611: folds
f85679bb: folds
816260d0: folds
9babc997: raises $0.08 to $0.13
Hero: folds
Uncalled bet ($0.08) returned to 9babc997
*** SHOWDOWN ***
9babc997 collected $0.1 from pot
*** SUMMARY ***
Total pot $0.1 | Rake $0 | Jackpot $0 | Bingo $0 | Fortune $0 | Tax $0
Seat 1: 816260d0 (button) folded before Flop (didn't bet)
Seat 2: 9babc997 (small blind) collected ($0.1)
Seat 3: Hero (big blind) folded before Flop
Seat 4: caa19347 folded before Flop (didn't bet)
Seat 5: 90c3e611 folded before Flop (didn't bet)
Seat 6: f85679bb folded before Flop (didn't bet)


Poker Hand #RC3334481602: Hold'em No Limit ($0.02/$0.05) - 2025/02/17 21:07:12
Table 'RushAndCash616862' 6-max Seat #1 is the button
Seat 1: fa30bfa7 ($5.67 in chips)
Seat 2: Hero ($8.57 in chips)
Seat 3: 8f1315bb ($6.02 in chips)
Seat 4: 22643080 ($9.57 in chips)
Seat 5: d11ba472 ($5.32 in chips)
Seat 6: d92ddef8 ($4.98 in chips)
Hero: posts small blind $0.02
8f1315bb: posts big blind $0.05
*** HOLE CARDS ***
Dealt to fa30bfa7 
Dealt to Hero [Jh Th]
Dealt to 8f1315bb 
Dealt to 22643080 
Dealt to d11ba472 
Dealt to d92ddef8 
22643080: folds
d11ba472: folds
d92ddef8: folds
fa30bfa7: folds
Hero: calls $0.03
8f1315bb: checks
*** FLOP *** [8h 3s Jd]
Hero: bets $0.05
8f1315bb: folds
Uncalled bet ($0.05) returned to Hero
*** SHOWDOWN ***
Hero collected $0.1 from pot
*** SUMMARY ***
Total pot $0.1 | Rake $0 | Jackpot $0 | Bingo $0 | Fortune $0 | Tax $0
Board [8h 3s Jd]
Seat 1: fa30bfa7 (button) folded before Flop (didn't bet)
Seat 2: Hero (small blind) won ($0.1)
Seat 3: 8f1315bb (big blind) folded on the Flop
Seat 4: 22643080 folded before Flop (didn't bet)
Seat 5: d11ba472 folded before Flop (didn't bet)
Seat 6: d92ddef8 folded before Flop (didn't bet)


Poker Hand #RC3334481576: Hold'em No Limit ($0.02/$0.05) - 2025/02/17 21:07:09
Table 'RushAndCash616836' 6-max Seat #1 is the button
Seat 1: d92ddef8 ($4.98 in chips)
Seat 2: Hero ($8.59 in chips)
Seat 3: eabdba88 ($10.69 in chips)
Seat 4: 6d5fa70b ($5.37 in chips)
Seat 5: 49b4f33a ($10.44 in chips)
Seat 6: 3d537b07 ($2.57 in chips)
Hero: posts small blind $0.02
eabdba88: posts big blind $0.05
*** HOLE CARDS ***
Dealt to d92ddef8 
Dealt to Hero [8h Js]
Dealt to eabdba88 
Dealt to 6d5fa70b 
Dealt to 49b4f33a 
Dealt to 3d537b07 
6d5fa70b: folds
49b4f33a: folds
3d537b07: folds
d92ddef8: folds
Hero: folds
Uncalled bet ($0.03) returned to eabdba88
*** SHOWDOWN ***
eabdba88 collected $0.04 from pot
*** SUMMARY ***
Total pot $0.04 | Rake $0 | Jackpot $0 | Bingo $0 | Fortune $0 | Tax $0
Seat 1: d92ddef8 (button) folded before Flop (didn't bet)
Seat 2: Hero (small blind) folded before Flop
Seat 3: eabdba88 (big blind) collected ($0.04)
Seat 4: 6d5fa70b folded before Flop (didn't bet)
Seat 5: 49b4f33a folded before Flop (didn't bet)
Seat 6: 3d537b07 folded before Flop (didn't bet)


Poker Hand #RC3334481529: Hold'em No Limit ($0.02/$0.05) - 2025/02/17 21:07:03
Table 'RushAndCash616789' 6-max Seat #1 is the button
Seat 1: 22e7e468 ($5.24 in chips)
Seat 2: fcdb0509 ($5.65 in chips)
Seat 3: baaf0b0d ($5.16 in chips)
Seat 4: fad7078a ($6.23 in chips)
Seat 5: Hero ($8.59 in chips)
Seat 6: 19259657 ($5.23 in chips)
fcdb0509: posts small blind $0.02
baaf0b0d: posts big blind $0.05
*** HOLE CARDS ***
Dealt to 22e7e468 
Dealt to fcdb0509 
Dealt to baaf0b0d 
Dealt to fad7078a 
Dealt to Hero [2c Qs]
Dealt to 19259657 
fad7078a: folds
Hero: folds
19259657: raises $0.08 to $0.13
22e7e468: folds
fcdb0509: raises $0.41 to $0.54
baaf0b0d: folds
19259657: folds
Uncalled bet ($0.41) returned to fcdb0509
*** SHOWDOWN ***
fcdb0509 collected $0.3 from pot
*** SUMMARY ***
Total pot $0.31 | Rake $0.01 | Jackpot $0 | Bingo $0 | Fortune $0 | Tax $0
Seat 1: 22e7e468 (button) folded before Flop (didn't bet)
Seat 2: fcdb0509 (small blind) collected ($0.3)
Seat 3: baaf0b0d (big blind) folded before Flop
Seat 4: fad7078a folded before Flop (didn't bet)
Seat 5: Hero folded before Flop (didn't bet)
Seat 6: 19259657 folded before Flop


Poker Hand #RC3334481422: Hold'em No Limit ($0.02/$0.05) - 2025/02/17 21:06:50
Table 'RushAndCash616682' 6-max Seat #1 is the button
Seat 1: d00f991c ($10.53 in chips)
Seat 2: 1fa8537 ($6.41 in chips)
Seat 3: afceb40a ($2.11 in chips)
Seat 4: 35fb946f ($7.21 in chips)
Seat 5: b7bd1225 ($5.41 in chips)
Seat 6: Hero ($8.52 in chips)
1fa8537: posts small blind $0.02
afceb40a: posts big blind $0.05
*** HOLE CARDS ***
Dealt to d00f991c 
Dealt to 1fa8537 
Dealt to afceb40a 
Dealt to 35fb946f 
Dealt to b7bd1225 
Dealt to Hero [Kh Ad]
35fb946f: folds
b7bd1225: folds
Hero: raises $0.05 to $0.1
d00f991c: folds
1fa8537: folds
afceb40a: folds
Uncalled bet ($0.05) returned to Hero
*** SHOWDOWN ***
Hero collected $0.12 from pot
*** SUMMARY ***
Total pot $0.12 | Rake $0 | Jackpot $0 | Bingo $0 | Fortune $0 | Tax $0
Seat 1: d00f991c (button) folded before Flop (didn't bet)
Seat 2: 1fa8537 (small blind) folded before Flop
Seat 3: afceb40a (big blind) folded before Flop
Seat 4: 35fb946f folded before Flop (didn't bet)
Seat 5: b7bd1225 folded before Flop (didn't bet)
Seat 6: Hero collected ($0.12)


Poker Hand #RC3334481393: Hold'em No Limit ($0.02/$0.05) - 2025/02/17 21:06:46
Table 'RushAndCash616653' 6-max Seat #1 is the button
Seat 1: Hero ($8.52 in chips)
Seat 2: 81acf14c ($5.02 in chips)
Seat 3: 688b40f9 ($6.01 in chips)
Seat 4: 71f2556b ($2.2 in chips)
Seat 5: e74a324 ($5.22 in chips)
Seat 6: 573eb753 ($5.42 in chips)
81acf14c: posts small blind $0.02
688b40f9: posts big blind $0.05
*** HOLE CARDS ***
Dealt to Hero [5c 4s]
Dealt to 81acf14c 
Dealt to 688b40f9 
Dealt to 71f2556b 
Dealt to e74a324 
Dealt to 573eb753 
71f2556b: folds
e74a324: folds
573eb753: folds
Hero: folds
81acf14c: raises $0.06 to $0.11
688b40f9: folds
Uncalled bet ($0.06) returned to 81acf14c
*** SHOWDOWN ***
81acf14c collected $0.1 from pot
*** SUMMARY ***
Total pot $0.1 | Rake $0 | Jackpot $0 | Bingo $0 | Fortune $0 | Tax $0
Seat 1: Hero (button) folded before Flop (didn't bet)
Seat 2: 81acf14c (small blind) collected ($0.1)
Seat 3: 688b40f9 (big blind) folded before Flop
Seat 4: 71f2556b folded before Flop (didn't bet)
Seat 5: e74a324 folded before Flop (didn't bet)
Seat 6: 573eb753 folded before Flop (didn't bet)


Poker Hand #RC3334481311: Hold'em No Limit ($0.02/$0.05) - 2025/02/17 21:06:37
Table 'RushAndCash616571' 6-max Seat #1 is the button
Seat 1: 4262311b ($5.06 in chips)
Seat 2: 35016d48 ($5.64 in chips)
Seat 3: Hero ($8.57 in chips)
Seat 4: 1fa8537 ($6.41 in chips)
Seat 5: 143ede8b ($11.33 in chips)
Seat 6: f68df189 ($5.68 in chips)
35016d48: posts small blind $0.02
Hero: posts big blind $0.05
*** HOLE CARDS ***
Dealt to 4262311b 
Dealt to 35016d48 
Dealt to Hero [7c 3c]
Dealt to 1fa8537 
Dealt to 143ede8b 
Dealt to f68df189 
1fa8537: folds
143ede8b: folds
f68df189: folds
4262311b: raises $0.07 to $0.12
35016d48: folds
Hero: folds
Uncalled bet ($0.07) returned to 4262311b
*** SHOWDOWN ***
4262311b collected $0.12 from pot
*** SUMMARY ***
Total pot $0.12 | Rake $0 | Jackpot $0 | Bingo $0 | Fortune $0 | Tax $0
Seat 1: 4262311b (button) collected ($0.12)
Seat 2: 35016d48 (small blind) folded before Flop
Seat 3: Hero (big blind) folded before Flop
Seat 4: 1fa8537 folded before Flop (didn't bet)
Seat 5: 143ede8b folded before Flop (didn't bet)
Seat 6: f68df189 folded before Flop (didn't bet)


Poker Hand #RC3334481214: Hold'em No Limit ($0.02/$0.05) - 2025/02/17 21:06:26
Table 'RushAndCash616474' 6-max Seat #1 is the button
Seat 1: 9e5a32b5 ($5.21 in chips)
Seat 2: 3db4c32a ($5.54 in chips)
Seat 3: 3d2a56c8 ($5 in chips)
Seat 4: Hero ($8.67 in chips)
Seat 5: 4812f5c8 ($5 in chips)
Seat 6: 14d03752 ($5.25 in chips)
3db4c32a: posts small blind $0.02
3d2a56c8: posts big blind $0.05
*** HOLE CARDS ***
Dealt to 9e5a32b5 
Dealt to 3db4c32a 
Dealt to 3d2a56c8 
Dealt to Hero [6h 5h]
Dealt to 4812f5c8 
Dealt to 14d03752 
Hero: raises $0.05 to $0.1
4812f5c8: folds
14d03752: folds
9e5a32b5: raises $0.27 to $0.37
3db4c32a: folds
3d2a56c8: folds
Hero: folds
Uncalled bet ($0.27) returned to 9e5a32b5
*** SHOWDOWN ***
9e5a32b5 collected $0.26 from pot
*** SUMMARY ***
Total pot $0.27 | Rake $0.01 | Jackpot $0 | Bingo $0 | Fortune $0 | Tax $0
Seat 1: 9e5a32b5 (button) collected ($0.26)
Seat 2: 3db4c32a (small blind) folded before Flop
Seat 3: 3d2a56c8 (big blind) folded before Flop
Seat 4: Hero folded before Flop
Seat 5: 4812f5c8 folded before Flop (didn't bet)
Seat 6: 14d03752 folded before Flop (didn't bet)


Poker Hand #RC3334481069: Hold'em No Limit ($0.02/$0.05) - 2025/02/17 21:06:09
Table 'RushAndCash616329' 6-max Seat #1 is the button
Seat 1: 23a65ab7 ($5.05 in chips)
Seat 2: 75a97e80 ($3.74 in chips)
Seat 3: 3db4c32a ($5.43 in chips)
Seat 4: d606d9 ($6.07 in chips)
Seat 5: f9d64f1a ($5 in chips)
Seat 6: Hero ($8.77 in chips)
75a97e80: posts small blind $0.02
3db4c32a: posts big blind $0.05
*** HOLE CARDS ***
Dealt to 23a65ab7 
Dealt to 75a97e80 
Dealt to 3db4c32a 
Dealt to d606d9 
Dealt to f9d64f1a 
Dealt to Hero [Ad 4d]
d606d9: folds
f9d64f1a: folds
Hero: raises $0.05 to $0.1
23a65ab7: folds
75a97e80: folds
3db4c32a: raises $0.29 to $0.39
Hero: folds
Uncalled bet ($0.29) returned to 3db4c32a
*** SHOWDOWN ***
3db4c32a collected $0.21 from pot
*** SUMMARY ***
Total pot $0.22 | Rake $0.01 | Jackpot $0 | Bingo $0 | Fortune $0 | Tax $0
Seat 1: 23a65ab7 (button) folded before Flop (didn't bet)
Seat 2: 75a97e80 (small blind) folded before Flop
Seat 3: 3db4c32a (big blind) collected ($0.21)
Seat 4: d606d9 folded before Flop (didn't bet)
Seat 5: f9d64f1a folded before Flop (didn't bet)
Seat 6: Hero folded before Flop


Poker Hand #RC3334481042: Hold'em No Limit ($0.02/$0.05) - 2025/02/17 21:06:06
Table 'RushAndCash616302' 6-max Seat #1 is the button
Seat 1: 4d8ae83 ($5.16 in chips)
Seat 2: Hero ($8.79 in chips)
Seat 3: fcc3c3cc ($8.54 in chips)
Seat 4: 45d33c76 ($9.99 in chips)
Seat 5: 742ccfee ($2.47 in chips)
Seat 6: 5a37a767 ($7.86 in chips)
Hero: posts small blind $0.02
fcc3c3cc: posts big blind $0.05
*** HOLE CARDS ***
Dealt to 4d8ae83 
Dealt to Hero [9h Qh]
Dealt to fcc3c3cc 
Dealt to 45d33c76 
Dealt to 742ccfee 
Dealt to 5a37a767 
45d33c76: folds
742ccfee: raises $0.05 to $0.1
5a37a767: folds
4d8ae83: folds
Hero: folds
fcc3c3cc: calls $0.05
*** FLOP *** [Qc 9c 3h]
fcc3c3cc: checks
742ccfee: checks
*** TURN *** [Qc 9c 3h] [5s]
fcc3c3cc: bets $0.07
742ccfee: calls $0.07
*** RIVER *** [Qc 9c 3h 5s] [7h]
fcc3c3cc: checks
742ccfee: checks
fcc3c3cc: shows [Tc Ah] (Ace-High)
742ccfee: shows [Ad 9d] (Pair of Nines)
*** SHOWDOWN ***
742ccfee collected $0.35 from pot
*** SUMMARY ***
Total pot $0.36 | Rake $0.01 | Jackpot $0 | Bingo $0 | Fortune $0 | Tax $0
Board [Qc 9c 3h 5s 7h]
Seat 1: 4d8ae83 (button) folded before Flop (didn't bet)
Seat 2: Hero (small blind) folded before Flop
Seat 3: fcc3c3cc (big blind) showed [Tc Ah] and lost with Ace-High
Seat 4: 45d33c76 folded before Flop (didn't bet)
Seat 5: 742ccfee showed [Ad 9d] and won ($0.35) with Pair of Nines
Seat 6: 5a37a767 folded before Flop (didn't bet)


Poker Hand #RC3334481017: Hold'em No Limit ($0.02/$0.05) - 2025/02/17 21:06:02
Table 'RushAndCash616277' 6-max Seat #1 is the button
Seat 1: 742ccfee ($2.47 in chips)
Seat 2: fdbac393 ($5.72 in chips)
Seat 3: 74f9576e ($8.12 in chips)
Seat 4: ac083cf2 ($4.1 in chips)
Seat 5: 6dcd0788 ($9.35 in chips)
Seat 6: Hero ($8.79 in chips)
fdbac393: posts small blind $0.02
74f9576e: posts big blind $0.05
*** HOLE CARDS ***
Dealt to 742ccfee 
Dealt to fdbac393 
Dealt to 74f9576e 
Dealt to ac083cf2 
Dealt to 6dcd0788 
Dealt to Hero [6s Jc]
ac083cf2: folds
6dcd0788: folds
Hero: folds
742ccfee: folds
fdbac393: raises $0.08 to $0.13
74f9576e: calls $0.08
*** FLOP *** [3s 2h 8h]
fdbac393: bets $0.07
74f9576e: folds
Uncalled bet ($0.07) returned to fdbac393
*** SHOWDOWN ***
fdbac393 collected $0.25 from pot
*** SUMMARY ***
Total pot $0.26 | Rake $0.01 | Jackpot $0 | Bingo $0 | Fortune $0 | Tax $0
Board [3s 2h 8h]
Seat 1: 742ccfee (button) folded before Flop (didn't bet)
Seat 2: fdbac393 (small blind) won ($0.25)
Seat 3: 74f9576e (big blind) folded on the Flop
Seat 4: ac083cf2 folded before Flop (didn't bet)
Seat 5: 6dcd0788 folded before Flop (didn't bet)
Seat 6: Hero folded before Flop (didn't bet)


Poker Hand #RC3334480961: Hold'em No Limit ($0.02/$0.05) - 2025/02/17 21:05:55
Table 'RushAndCash616221' 6-max Seat #1 is the button
Seat 1: 860fa4c9 ($9.14 in chips)
Seat 2: 40248f42 ($6.23 in chips)
Seat 3: Hero ($8.84 in chips)
Seat 4: 4c9f897a ($8.25 in chips)
Seat 5: 64526212 ($4.93 in chips)
Seat 6: fc71f850 ($5.8 in chips)
40248f42: posts small blind $0.02
Hero: posts big blind $0.05
*** HOLE CARDS ***
Dealt to 860fa4c9 
Dealt to 40248f42 
Dealt to Hero [2c 6s]
Dealt to 4c9f897a 
Dealt to 64526212 
Dealt to fc71f850 
4c9f897a: folds
64526212: folds
fc71f850: raises $0.05 to $0.1
860fa4c9: calls $0.1
40248f42: calls $0.08
Hero: folds
*** FLOP *** [9s 2d Th]
40248f42: checks
fc71f850: checks
860fa4c9: bets $0.1
40248f42: calls $0.1
fc71f850: calls $0.1
*** TURN *** [9s 2d Th] [2h]
40248f42: checks
fc71f850: checks
860fa4c9: checks
*** RIVER *** [9s 2d Th 2h] [8s]
40248f42: bets $0.22
fc71f850: folds
860fa4c9: folds
Uncalled bet ($0.22) returned to 40248f42
*** SHOWDOWN ***
40248f42 collected $0.62 from pot
*** SUMMARY ***
Total pot $0.65 | Rake $0.03 | Jackpot $0 | Bingo $0 | Fortune $0 | Tax $0
Board [9s 2d Th 2h 8s]
Seat 1: 860fa4c9 (button) folded on the River
Seat 2: 40248f42 (small blind) won ($0.62)
Seat 3: Hero (big blind) folded before Flop
Seat 4: 4c9f897a folded before Flop (didn't bet)
Seat 5: 64526212 folded before Flop (didn't bet)
Seat 6: fc71f850 folded on the River


Poker Hand #RC3334480920: Hold'em No Limit ($0.02/$0.05) - 2025/02/17 21:05:49
Table 'RushAndCash616180' 6-max Seat #1 is the button
Seat 1: a9472a77 ($3.73 in chips)
Seat 2: f994138c ($7.43 in chips)
Seat 3: 26e655d0 ($5.07 in chips)
Seat 4: 1e76a4d8 ($5.6 in chips)
Seat 5: Hero ($8.84 in chips)
Seat 6: f6efd55a ($8.14 in chips)
f994138c: posts small blind $0.02
26e655d0: posts big blind $0.05
*** HOLE CARDS ***
Dealt to a9472a77 
Dealt to f994138c 
Dealt to 26e655d0 
Dealt to 1e76a4d8 
Dealt to Hero [Qd 9c]
Dealt to f6efd55a 
1e76a4d8: folds
Hero: folds
f6efd55a: folds
a9472a77: raises $0.05 to $0.1
f994138c: folds
26e655d0: folds
Uncalled bet ($0.05) returned to a9472a77
*** SHOWDOWN ***
a9472a77 collected $0.12 from pot
*** SUMMARY ***
Total pot $0.12 | Rake $0 | Jackpot $0 | Bingo $0 | Fortune $0 | Tax $0
Seat 1: a9472a77 (button) collected ($0.12)
Seat 2: f994138c (small blind) folded before Flop
Seat 3: 26e655d0 (big blind) folded before Flop
Seat 4: 1e76a4d8 folded before Flop (didn't bet)
Seat 5: Hero folded before Flop (didn't bet)
Seat 6: f6efd55a folded before Flop (didn't bet)


Poker Hand #RC3334480891: Hold'em No Limit ($0.02/$0.05) - 2025/02/17 21:05:45
Table 'RushAndCash616151' 6-max Seat #1 is the button
Seat 1: Hero ($8.84 in chips)
Seat 2: b39a93ce ($5.05 in chips)
Seat 3: ceed678b ($7.16 in chips)
Seat 4: 66981141 ($11.88 in chips)
Seat 5: c24b20b9 ($19.18 in chips)
Seat 6: 6ebc3323 ($8.35 in chips)
b39a93ce: posts small blind $0.02
ceed678b: posts big blind $0.05
*** HOLE CARDS ***
Dealt to Hero [6h 7c]
Dealt to b39a93ce 
Dealt to ceed678b 
Dealt to 66981141 
Dealt to c24b20b9 
Dealt to 6ebc3323 
66981141: folds
c24b20b9: folds
6ebc3323: folds
Hero: folds
b39a93ce: folds
Uncalled bet ($0.03) returned to ceed678b
*** SHOWDOWN ***
ceed678b collected $0.04 from pot
*** SUMMARY ***
Total pot $0.04 | Rake $0 | Jackpot $0 | Bingo $0 | Fortune $0 | Tax $0
Seat 1: Hero (button) folded before Flop (didn't bet)
Seat 2: b39a93ce (small blind) folded before Flop
Seat 3: ceed678b (big blind) collected ($0.04)
Seat 4: 66981141 folded before Flop (didn't bet)
Seat 5: c24b20b9 folded before Flop (didn't bet)
Seat 6: 6ebc3323 folded before Flop (didn't bet)


Poker Hand #RC3334480848: Hold'em No Limit ($0.02/$0.05) - 2025/02/17 21:05:40
Table 'RushAndCash616108' 6-max Seat #1 is the button
Seat 1: fad7078a ($6.31 in chips)
Seat 2: Hero ($8.86 in chips)
Seat 3: 38a4c833 ($8.44 in chips)
Seat 4: 70545399 ($5 in chips)
Seat 5: 9604af2 ($6.39 in chips)
Seat 6: a3b43a4c ($5.48 in chips)
Hero: posts small blind $0.02
38a4c833: posts big blind $0.05
*** HOLE CARDS ***
Dealt to fad7078a 
Dealt to Hero [As 2d]
Dealt to 38a4c833 
Dealt to 70545399 
Dealt to 9604af2 
Dealt to a3b43a4c 
70545399: raises $0.07 to $0.12
9604af2: folds
a3b43a4c: folds
fad7078a: folds
Hero: folds
38a4c833: folds
Uncalled bet ($0.07) returned to 70545399
*** SHOWDOWN ***
70545399 collected $0.12 from pot
*** SUMMARY ***
Total pot $0.12 | Rake $0 | Jackpot $0 | Bingo $0 | Fortune $0 | Tax $0
Seat 1: fad7078a (button) folded before Flop (didn't bet)
Seat 2: Hero (small blind) folded before Flop
Seat 3: 38a4c833 (big blind) folded before Flop
Seat 4: 70545399 collected ($0.12)
Seat 5: 9604af2 folded before Flop (didn't bet)
Seat 6: a3b43a4c folded before Flop (didn't bet)


Poker Hand #RC3334480802: Hold'em No Limit ($0.02/$0.05) - 2025/02/17 21:05:34
Table 'RushAndCash616062' 6-max Seat #1 is the button
Seat 1: Hero ($8.86 in chips)
Seat 2: 3939bf98 ($5.64 in chips)
Seat 3: 278194f ($5.3 in chips)
Seat 4: c607d475 ($5.05 in chips)
Seat 5: 95096c6a ($6.16 in chips)
Seat 6: e9396ee6 ($6.64 in chips)
3939bf98: posts small blind $0.02
278194f: posts big blind $0.05
*** HOLE CARDS ***
Dealt to Hero [Qc 4d]
Dealt to 3939bf98 
Dealt to 278194f 
Dealt to c607d475 
Dealt to 95096c6a 
Dealt to e9396ee6 
c607d475: folds
95096c6a: raises $0.07 to $0.12
e9396ee6: raises $0.25 to $0.37
Hero: folds
3939bf98: folds
278194f: folds
95096c6a: folds
Uncalled bet ($0.25) returned to e9396ee6
*** SHOWDOWN ***
e9396ee6 collected $0.3 from pot
*** SUMMARY ***
Total pot $0.31 | Rake $0.01 | Jackpot $0 | Bingo $0 | Fortune $0 | Tax $0
Seat 1: Hero (button) folded before Flop (didn't bet)
Seat 2: 3939bf98 (small blind) folded before Flop
Seat 3: 278194f (big blind) folded before Flop
Seat 4: c607d475 folded before Flop (didn't bet)
Seat 5: 95096c6a folded before Flop
Seat 6: e9396ee6 collected ($0.3)


Poker Hand #RC3334480754: Hold'em No Limit ($0.02/$0.05) - 2025/02/17 21:05:28
Table 'RushAndCash616014' 6-max Seat #1 is the button
Seat 1: fb6c913 ($9.53 in chips)
Seat 2: 2b13f4d5 ($4.95 in chips)
Seat 3: Hero ($8.91 in chips)
Seat 4: bc64c9e6 ($5 in chips)
Seat 5: c607d475 ($5.05 in chips)
Seat 6: 73c2df1f ($16.01 in chips)
2b13f4d5: posts small blind $0.02
Hero: posts big blind $0.05
*** HOLE CARDS ***
Dealt to fb6c913 
Dealt to 2b13f4d5 
Dealt to Hero [9h Qc]
Dealt to bc64c9e6 
Dealt to c607d475 
Dealt to 73c2df1f 
bc64c9e6: folds
c607d475: folds
73c2df1f: folds
fb6c913: folds
2b13f4d5: raises $0.05 to $0.1
Hero: folds
Uncalled bet ($0.05) returned to 2b13f4d5
*** SHOWDOWN ***
2b13f4d5 collected $0.1 from pot
*** SUMMARY ***
Total pot $0.1 | Rake $0 | Jackpot $0 | Bingo $0 | Fortune $0 | Tax $0
Seat 1: fb6c913 (button) folded before Flop (didn't bet)
Seat 2: 2b13f4d5 (small blind) collected ($0.1)
Seat 3: Hero (big blind) folded before Flop
Seat 4: bc64c9e6 folded before Flop (didn't bet)
Seat 5: c607d475 folded before Flop (didn't bet)
Seat 6: 73c2df1f folded before Flop (didn't bet)


Poker Hand #RC3334480729: Hold'em No Limit ($0.02/$0.05) - 2025/02/17 21:05:24
Table 'RushAndCash615989' 6-max Seat #1 is the button
Seat 1: b9ea571d ($5.37 in chips)
Seat 2: 9dba8a1e ($6.18 in chips)
Seat 3: 8e07c53 ($5.07 in chips)
Seat 4: 26e655d0 ($5 in chips)
Seat 5: Hero ($8.91 in chips)
Seat 6: 48912120 ($4.82 in chips)
9dba8a1e: posts small blind $0.02
8e07c53: posts big blind $0.05
*** HOLE CARDS ***
Dealt to b9ea571d 
Dealt to 9dba8a1e 
Dealt to 8e07c53 
Dealt to 26e655d0 
Dealt to Hero [9d 4d]
Dealt to 48912120 
26e655d0: raises $0.05 to $0.1
Hero: folds
48912120: folds
b9ea571d: folds
9dba8a1e: folds
8e07c53: folds
Uncalled bet ($0.05) returned to 26e655d0
*** SHOWDOWN ***
26e655d0 collected $0.12 from pot
*** SUMMARY ***
Total pot $0.12 | Rake $0 | Jackpot $0 | Bingo $0 | Fortune $0 | Tax $0
Seat 1: b9ea571d (button) folded before Flop (didn't bet)
Seat 2: 9dba8a1e (small blind) folded before Flop
Seat 3: 8e07c53 (big blind) folded before Flop
Seat 4: 26e655d0 collected ($0.12)
Seat 5: Hero folded before Flop (didn't bet)
Seat 6: 48912120 folded before Flop (didn't bet)


Poker Hand #RC3334480689: Hold'em No Limit ($0.02/$0.05) - 2025/02/17 21:05:19
Table 'RushAndCash615949' 6-max Seat #1 is the button
Seat 1: 6a231779 ($16.52 in chips)
Seat 2: 29554a8c ($5.32 in chips)
Seat 3: 3d537b07 ($3.03 in chips)
Seat 4: Hero ($8.91 in chips)
Seat 5: 55630016 ($10.43 in chips)
Seat 6: 4b71998b ($5.45 in chips)
29554a8c: posts small blind $0.02
3d537b07: posts big blind $0.05
*** HOLE CARDS ***
Dealt to 6a231779 
Dealt to 29554a8c 
Dealt to 3d537b07 
Dealt to Hero [7c 8h]
Dealt to 55630016 
Dealt to 4b71998b 
Hero: folds
55630016: folds
4b71998b: raises $0.05 to $0.1
6a231779: folds
29554a8c: folds
3d537b07: calls $0.05
*** FLOP *** [Ah 5h 2s]
3d537b07: checks
4b71998b: bets $0.08
3d537b07: calls $0.08
*** TURN *** [Ah 5h 2s] [7d]
3d537b07: bets $0.2
4b71998b: calls $0.2
*** RIVER *** [Ah 5h 2s 7d] [Qd]
3d537b07: checks
4b71998b: bets $0.59
3d537b07: folds
Uncalled bet ($0.59) returned to 4b71998b
*** SHOWDOWN ***
4b71998b collected $0.75 from pot
*** SUMMARY ***
Total pot $0.78 | Rake $0.03 | Jackpot $0 | Bingo $0 | Fortune $0 | Tax $0
Board [Ah 5h 2s 7d Qd]
Seat 1: 6a231779 (button) folded before Flop (didn't bet)
Seat 2: 29554a8c (small blind) folded before Flop
Seat 3: 3d537b07 (big blind) folded on the River
Seat 4: Hero folded before Flop (didn't bet)
Seat 5: 55630016 folded before Flop (didn't bet)
Seat 6: 4b71998b won ($0.75)


Poker Hand #RC3334480439: Hold'em No Limit ($0.02/$0.05) - 2025/02/17 21:04:47
Table 'RushAndCash615699' 6-max Seat #1 is the button
Seat 1: 742ccfee ($2.44 in chips)
Seat 2: a1fd9df7 ($5.25 in chips)
Seat 3: Hero ($9.14 in chips)
Seat 4: 6a231779 ($16.29 in chips)
Seat 5: 2b9f39df ($5.88 in chips)
Seat 6: 24aff26b ($5 in chips)
a1fd9df7: posts small blind $0.02
Hero: posts big blind $0.05
*** HOLE CARDS ***
Dealt to 742ccfee 
Dealt to a1fd9df7 
Dealt to Hero [Ts Js]
Dealt to 6a231779 
Dealt to 2b9f39df 
Dealt to 24aff26b 
6a231779: raises $0.08 to $0.13
2b9f39df: folds
24aff26b: folds
742ccfee: folds
a1fd9df7: folds
Hero: calls $0.08
*** FLOP *** [6d Jd Ad]
Hero: checks
6a231779: bets $0.1
Hero: calls $0.1
*** TURN *** [6d Jd Ad] [5c]
Hero: checks
6a231779: bets $0.36
Hero: folds
Uncalled bet ($0.36) returned to 6a231779
*** SHOWDOWN ***
6a231779 collected $0.46 from pot
*** SUMMARY ***
Total pot $0.48 | Rake $0.02 | Jackpot $0 | Bingo $0 | Fortune $0 | Tax $0
Board [6d Jd Ad 5c]
Seat 1: 742ccfee (button) folded before Flop (didn't bet)
Seat 2: a1fd9df7 (small blind) folded before Flop
Seat 3: Hero (big blind) folded on the Turn
Seat 4: 6a231779 won ($0.46)
Seat 5: 2b9f39df folded before Flop (didn't bet)
Seat 6: 24aff26b folded before Flop (didn't bet)


Poker Hand #RC3334480333: Hold'em No Limit ($0.02/$0.05) - 2025/02/17 21:04:33
Table 'RushAndCash615593' 6-max Seat #1 is the button
Seat 1: a291e856 ($5.62 in chips)
Seat 2: Hero ($9.09 in chips)
Seat 3: 6aafda73 ($5.11 in chips)
Seat 4: ca601b39 ($5.02 in chips)
Seat 5: cf593991 ($9.85 in chips)
Seat 6: a28ca95c ($23.25 in chips)
Hero: posts small blind $0.02
6aafda73: posts big blind $0.05
*** HOLE CARDS ***
Dealt to a291e856 
Dealt to Hero [9h 9c]
Dealt to 6aafda73 
Dealt to ca601b39 
Dealt to cf593991 
Dealt to a28ca95c 
ca601b39: folds
cf593991: folds
a28ca95c: folds
a291e856: folds
Hero: raises $0.1 to $0.15
6aafda73: folds
Uncalled bet ($0.1) returned to Hero
*** SHOWDOWN ***
Hero collected $0.1 from pot
*** SUMMARY ***
Total pot $0.1 | Rake $0 | Jackpot $0 | Bingo $0 | Fortune $0 | Tax $0
Seat 1: a291e856 (button) folded before Flop (didn't bet)
Seat 2: Hero (small blind) collected ($0.1)
Seat 3: 6aafda73 (big blind) folded before Flop
Seat 4: ca601b39 folded before Flop (didn't bet)
Seat 5: cf593991 folded before Flop (didn't bet)
Seat 6: a28ca95c folded before Flop (didn't bet)


Poker Hand #RC3334480310: Hold'em No Limit ($0.02/$0.05) - 2025/02/17 21:04:30
Table 'RushAndCash615570' 6-max Seat #1 is the button
Seat 1: 860b5247 ($8.12 in chips)
Seat 2: e58420c8 ($8.26 in chips)
Seat 3: 9b7148f5 ($4.98 in chips)
Seat 4: f994138c ($7.56 in chips)
Seat 5: 21c758a ($5.88 in chips)
Seat 6: Hero ($9.09 in chips)
e58420c8: posts small blind $0.02
9b7148f5: posts big blind $0.05
*** HOLE CARDS ***
Dealt to 860b5247 
Dealt to e58420c8 
Dealt to 9b7148f5 
Dealt to f994138c 
Dealt to 21c758a 
Dealt to Hero [8s 9h]
f994138c: folds
21c758a: folds
Hero: folds
860b5247: raises $0.07 to $0.12
e58420c8: folds
9b7148f5: folds
Uncalled bet ($0.07) returned to 860b5247
*** SHOWDOWN ***
860b5247 collected $0.12 from pot
*** SUMMARY ***
Total pot $0.12 | Rake $0 | Jackpot $0 | Bingo $0 | Fortune $0 | Tax $0
Seat 1: 860b5247 (button) collected ($0.12)
Seat 2: e58420c8 (small blind) folded before Flop
Seat 3: 9b7148f5 (big blind) folded before Flop
Seat 4: f994138c folded before Flop (didn't bet)
Seat 5: 21c758a folded before Flop (didn't bet)
Seat 6: Hero folded before Flop (didn't bet)


Poker Hand #RC3334480289: Hold'em No Limit ($0.02/$0.05) - 2025/02/17 21:04:27
Table 'RushAndCash615549' 6-max Seat #1 is the button
Seat 1: 4d398f88 ($5 in chips)
Seat 2: 868c7021 ($7.81 in chips)
Seat 3: 258a2071 ($5 in chips)
Seat 4: fb6c913 ($9.72 in chips)
Seat 5: e74a324 ($5.4 in chips)
Seat 6: Hero ($9.09 in chips)
868c7021: posts small blind $0.02
258a2071: posts big blind $0.05
*** HOLE CARDS ***
Dealt to 4d398f88 
Dealt to 868c7021 
Dealt to 258a2071 
Dealt to fb6c913 
Dealt to e74a324 
Dealt to Hero [9d 3c]
fb6c913: folds
e74a324: folds
Hero: folds
4d398f88: folds
868c7021: folds
Uncalled bet ($0.03) returned to 258a2071
*** SHOWDOWN ***
258a2071 collected $0.04 from pot
*** SUMMARY ***
Total pot $0.04 | Rake $0 | Jackpot $0 | Bingo $0 | Fortune $0 | Tax $0
Seat 1: 4d398f88 (button) folded before Flop (didn't bet)
Seat 2: 868c7021 (small blind) folded before Flop
Seat 3: 258a2071 (big blind) collected ($0.04)
Seat 4: fb6c913 folded before Flop (didn't bet)
Seat 5: e74a324 folded before Flop (didn't bet)
Seat 6: Hero folded before Flop (didn't bet)


Poker Hand #RC3334480266: Hold'em No Limit ($0.02/$0.05) - 2025/02/17 21:04:24
Table 'RushAndCash615526' 6-max Seat #1 is the button
Seat 1: 94c257a9 ($9.13 in chips)
Seat 2: 6aa0c391 ($5.49 in chips)
Seat 3: 3723bfd4 ($4.41 in chips)
Seat 4: 5381eb4c ($7.3 in chips)
Seat 5: Hero ($9.09 in chips)
Seat 6: ae2aee6e ($5.84 in chips)
6aa0c391: posts small blind $0.02
3723bfd4: posts big blind $0.05
*** HOLE CARDS ***
Dealt to 94c257a9 
Dealt to 6aa0c391 
Dealt to 3723bfd4 
Dealt to 5381eb4c 
Dealt to Hero [9d 2c]
Dealt to ae2aee6e 
5381eb4c: raises $0.05 to $0.1
Hero: folds
ae2aee6e: folds
94c257a9: folds
6aa0c391: folds
3723bfd4: calls $0.05
*** FLOP *** [8d 3h Qh]
3723bfd4: checks
5381eb4c: checks
*** TURN *** [8d 3h Qh] [7h]
3723bfd4: checks
5381eb4c: checks
*** RIVER *** [8d 3h Qh 7h] [6s]
3723bfd4: checks
5381eb4c: checks
3723bfd4: shows [7s 4s] (Pair of Sevens)
5381eb4c: shows [Ad 7c] (Pair of Sevens)
*** SHOWDOWN ***
5381eb4c collected $0.21 from pot
*** SUMMARY ***
Total pot $0.22 | Rake $0.01 | Jackpot $0 | Bingo $0 | Fortune $0 | Tax $0
Board [8d 3h Qh 7h 6s]
Seat 1: 94c257a9 (button) folded before Flop (didn't bet)
Seat 2: 6aa0c391 (small blind) folded before Flop
Seat 3: 3723bfd4 (big blind) showed [7s 4s] and lost with Pair of Sevens
Seat 4: 5381eb4c showed [Ad 7c] and won ($0.21) with Pair of Sevens
Seat 5: Hero folded before Flop (didn't bet)
Seat 6: ae2aee6e folded before Flop (didn't bet)


Poker Hand #RC3334480235: Hold'em No Limit ($0.02/$0.05) - 2025/02/17 21:04:20
Table 'RushAndCash615495' 6-max Seat #1 is the button
Seat 1: Hero ($9.09 in chips)
Seat 2: 8e5db286 ($11.01 in chips)
Seat 3: 32d40ce0 ($6.14 in chips)
Seat 4: 2e388e95 ($7.66 in chips)
Seat 5: 32c94dea ($6.81 in chips)
Seat 6: dda0a24a ($6.04 in chips)
8e5db286: posts small blind $0.02
32d40ce0: posts big blind $0.05
*** HOLE CARDS ***
Dealt to Hero [3s 4d]
Dealt to 8e5db286 
Dealt to 32d40ce0 
Dealt to 2e388e95 
Dealt to 32c94dea 
Dealt to dda0a24a 
2e388e95: folds
32c94dea: raises $0.08 to $0.13
dda0a24a: folds
Hero: folds
8e5db286: folds
32d40ce0: folds
Uncalled bet ($0.08) returned to 32c94dea
*** SHOWDOWN ***
32c94dea collected $0.12 from pot
*** SUMMARY ***
Total pot $0.12 | Rake $0 | Jackpot $0 | Bingo $0 | Fortune $0 | Tax $0
Seat 1: Hero (button) folded before Flop (didn't bet)
Seat 2: 8e5db286 (small blind) folded before Flop
Seat 3: 32d40ce0 (big blind) folded before Flop
Seat 4: 2e388e95 folded before Flop (didn't bet)
Seat 5: 32c94dea collected ($0.12)
Seat 6: dda0a24a folded before Flop (didn't bet)


Poker Hand #RC3334480210: Hold'em No Limit ($0.02/$0.05) - 2025/02/17 21:04:17
Table 'RushAndCash615470' 6-max Seat #1 is the button
Seat 1: fb6c913 ($9.74 in chips)
Seat 2: c49da358 ($5.09 in chips)
Seat 3: 73d087f7 ($5.05 in chips)
Seat 4: Hero ($9.09 in chips)
Seat 5: d75cab93 ($5.76 in chips)
Seat 6: d29f701c ($5.57 in chips)
c49da358: posts small blind $0.02
73d087f7: posts big blind $0.05
*** HOLE CARDS ***
Dealt to fb6c913 
Dealt to c49da358 
Dealt to 73d087f7 
Dealt to Hero [Ts 3d]
Dealt to d75cab93 
Dealt to d29f701c 
Hero: folds
d75cab93: folds
d29f701c: folds
fb6c913: folds
c49da358: folds
Uncalled bet ($0.03) returned to 73d087f7
*** SHOWDOWN ***
73d087f7 collected $0.04 from pot
*** SUMMARY ***
Total pot $0.04 | Rake $0 | Jackpot $0 | Bingo $0 | Fortune $0 | Tax $0
Seat 1: fb6c913 (button) folded before Flop (didn't bet)
Seat 2: c49da358 (small blind) folded before Flop
Seat 3: 73d087f7 (big blind) collected ($0.04)
Seat 4: Hero folded before Flop (didn't bet)
Seat 5: d75cab93 folded before Flop (didn't bet)
Seat 6: d29f701c folded before Flop (didn't bet)


Poker Hand #RC3334480183: Hold'em No Limit ($0.02/$0.05) - 2025/02/17 21:04:14
Table 'RushAndCash615443' 6-max Seat #1 is the button
Seat 1: 4c9f897a ($7.86 in chips)
Seat 2: Hero ($9.11 in chips)
Seat 3: a9472a77 ($4.01 in chips)
Seat 4: 24aff26b ($5 in chips)
Seat 5: fdbac393 ($5.98 in chips)
Seat 6: 32d40ce0 ($6.14 in chips)
Hero: posts small blind $0.02
a9472a77: posts big blind $0.05
*** HOLE CARDS ***
Dealt to 4c9f897a 
Dealt to Hero [6h Th]
Dealt to a9472a77 
Dealt to 24aff26b 
Dealt to fdbac393 
Dealt to 32d40ce0 
24aff26b: folds
fdbac393: folds
32d40ce0: folds
4c9f897a: folds
Hero: folds
Uncalled bet ($0.03) returned to a9472a77
*** SHOWDOWN ***
a9472a77 collected $0.04 from pot
*** SUMMARY ***
Total pot $0.04 | Rake $0 | Jackpot $0 | Bingo $0 | Fortune $0 | Tax $0
Seat 1: 4c9f897a (button) folded before Flop (didn't bet)
Seat 2: Hero (small blind) folded before Flop
Seat 3: a9472a77 (big blind) collected ($0.04)
Seat 4: 24aff26b folded before Flop (didn't bet)
Seat 5: fdbac393 folded before Flop (didn't bet)
Seat 6: 32d40ce0 folded before Flop (didn't bet)


Poker Hand #RC3334480155: Hold'em No Limit ($0.02/$0.05) - 2025/02/17 21:04:11
Table 'RushAndCash615415' 6-max Seat #1 is the button
Seat 1: 24aff26b ($5 in chips)
Seat 2: a57ff8a7 ($5 in chips)
Seat 3: 1d2427ef ($5.35 in chips)
Seat 4: Hero ($9.11 in chips)
Seat 5: 95096c6a ($6.16 in chips)
Seat 6: 5fd404ad ($5.65 in chips)
a57ff8a7: posts small blind $0.02
1d2427ef: posts big blind $0.05
*** HOLE CARDS ***
Dealt to 24aff26b 
Dealt to a57ff8a7 
Dealt to 1d2427ef 
Dealt to Hero [Qs 3h]
Dealt to 95096c6a 
Dealt to 5fd404ad 
Hero: folds
95096c6a: folds
5fd404ad: raises $0.1 to $0.15
24aff26b: folds
a57ff8a7: folds
1d2427ef: folds
Uncalled bet ($0.1) returned to 5fd404ad
*** SHOWDOWN ***
5fd404ad collected $0.12 from pot
*** SUMMARY ***
Total pot $0.12 | Rake $0 | Jackpot $0 | Bingo $0 | Fortune $0 | Tax $0
Seat 1: 24aff26b (button) folded before Flop (didn't bet)
Seat 2: a57ff8a7 (small blind) folded before Flop
Seat 3: 1d2427ef (big blind) folded before Flop
Seat 4: Hero folded before Flop (didn't bet)
Seat 5: 95096c6a folded before Flop (didn't bet)
Seat 6: 5fd404ad collected ($0.12)


Poker Hand #RC3334480121: Hold'em No Limit ($0.02/$0.05) - 2025/02/17 21:04:06
Table 'RushAndCash615381' 6-max Seat #1 is the button
Seat 1: 688b40f9 ($6.1 in chips)
Seat 2: 157631a0 ($6.14 in chips)
Seat 3: Hero ($9.16 in chips)
Seat 4: c579f93c ($9.37 in chips)
Seat 5: ab43c8b8 ($6.53 in chips)
Seat 6: 1e76a4d8 ($5.47 in chips)
157631a0: posts small blind $0.02
Hero: posts big blind $0.05
*** HOLE CARDS ***
Dealt to 688b40f9 
Dealt to 157631a0 
Dealt to Hero [6d Kh]
Dealt to c579f93c 
Dealt to ab43c8b8 
Dealt to 1e76a4d8 
c579f93c: raises $0.08 to $0.13
ab43c8b8: folds
1e76a4d8: folds
688b40f9: folds
157631a0: folds
Hero: folds
Uncalled bet ($0.08) returned to c579f93c
*** SHOWDOWN ***
c579f93c collected $0.12 from pot
*** SUMMARY ***
Total pot $0.12 | Rake $0 | Jackpot $0 | Bingo $0 | Fortune $0 | Tax $0
Seat 1: 688b40f9 (button) folded before Flop (didn't bet)
Seat 2: 157631a0 (small blind) folded before Flop
Seat 3: Hero (big blind) folded before Flop
Seat 4: c579f93c collected ($0.12)
Seat 5: ab43c8b8 folded before Flop (didn't bet)
Seat 6: 1e76a4d8 folded before Flop (didn't bet)


Poker Hand #RC3334480095: Hold'em No Limit ($0.02/$0.05) - 2025/02/17 21:04:03
Table 'RushAndCash615355' 6-max Seat #1 is the button
Seat 1: b0ee20aa ($22.33 in chips)
Seat 2: 73d087f7 ($5 in chips)
Seat 3: c579f93c ($9.42 in chips)
Seat 4: Hero ($9.16 in chips)
Seat 5: 8e93231a ($5.01 in chips)
Seat 6: 573eb753 ($5.05 in chips)
73d087f7: posts small blind $0.02
c579f93c: posts big blind $0.05
*** HOLE CARDS ***
Dealt to b0ee20aa 
Dealt to 73d087f7 
Dealt to c579f93c 
Dealt to Hero [Kh 6d]
Dealt to 8e93231a 
Dealt to 573eb753 
Hero: folds
8e93231a: folds
573eb753: folds
b0ee20aa: folds
73d087f7: raises $0.05 to $0.1
c579f93c: folds
Uncalled bet ($0.05) returned to 73d087f7
*** SHOWDOWN ***
73d087f7 collected $0.1 from pot
*** SUMMARY ***
Total pot $0.1 | Rake $0 | Jackpot $0 | Bingo $0 | Fortune $0 | Tax $0
Seat 1: b0ee20aa (button) folded before Flop (didn't bet)
Seat 2: 73d087f7 (small blind) collected ($0.1)
Seat 3: c579f93c (big blind) folded before Flop
Seat 4: Hero folded before Flop (didn't bet)
Seat 5: 8e93231a folded before Flop (didn't bet)
Seat 6: 573eb753 folded before Flop (didn't bet)


Poker Hand #RC3334480068: Hold'em No Limit ($0.02/$0.05) - 2025/02/17 21:03:59
Table 'RushAndCash615328' 6-max Seat #1 is the button
Seat 1: Hero ($9.16 in chips)
Seat 2: 65ca9276 ($6.18 in chips)
Seat 3: bda9ba33 ($2.17 in chips)
Seat 4: 8012317b ($10.9 in chips)
Seat 5: c49da358 ($5.07 in chips)
Seat 6: d92ddef8 ($4.05 in chips)
65ca9276: posts small blind $0.02
bda9ba33: posts big blind $0.05
*** HOLE CARDS ***
Dealt to Hero [2h 7h]
Dealt to 65ca9276 
Dealt to bda9ba33 
Dealt to 8012317b 
Dealt to c49da358 
Dealt to d92ddef8 
8012317b: folds
c49da358: raises $0.05 to $0.1
d92ddef8: folds
Hero: folds
65ca9276: folds
bda9ba33: folds
Uncalled bet ($0.05) returned to c49da358
*** SHOWDOWN ***
c49da358 collected $0.12 from pot
*** SUMMARY ***
Total pot $0.12 | Rake $0 | Jackpot $0 | Bingo $0 | Fortune $0 | Tax $0
Seat 1: Hero (button) folded before Flop (didn't bet)
Seat 2: 65ca9276 (small blind) folded before Flop
Seat 3: bda9ba33 (big blind) folded before Flop
Seat 4: 8012317b folded before Flop (didn't bet)
Seat 5: c49da358 collected ($0.12)
Seat 6: d92ddef8 folded before Flop (didn't bet)


Poker Hand #RC3334480028: Hold'em No Limit ($0.02/$0.05) - 2025/02/17 21:03:55
Table 'RushAndCash615288' 6-max Seat #1 is the button
Seat 1: be86537 ($5.37 in chips)
Seat 2: 1095926a ($5.06 in chips)
Seat 3: 2c1a5c09 ($6.62 in chips)
Seat 4: 47494b5b ($5 in chips)
Seat 5: 6c6b017a ($5 in chips)
Seat 6: Hero ($9.16 in chips)
1095926a: posts small blind $0.02
2c1a5c09: posts big blind $0.05
*** HOLE CARDS ***
Dealt to be86537 
Dealt to 1095926a 
Dealt to 2c1a5c09 
Dealt to 47494b5b 
Dealt to 6c6b017a 
Dealt to Hero [9c Qd]
47494b5b: raises $0.05 to $0.1
6c6b017a: folds
Hero: folds
be86537: folds
1095926a: folds
2c1a5c09: folds
Uncalled bet ($0.05) returned to 47494b5b
*** SHOWDOWN ***
47494b5b collected $0.12 from pot
*** SUMMARY ***
Total pot $0.12 | Rake $0 | Jackpot $0 | Bingo $0 | Fortune $0 | Tax $0
Seat 1: be86537 (button) folded before Flop (didn't bet)
Seat 2: 1095926a (small blind) folded before Flop
Seat 3: 2c1a5c09 (big blind) folded before Flop
Seat 4: 47494b5b collected ($0.12)
Seat 5: 6c6b017a folded before Flop (didn't bet)
Seat 6: Hero folded before Flop (didn't bet)


Poker Hand #RC3334480004: Hold'em No Limit ($0.02/$0.05) - 2025/02/17 21:03:52
Table 'RushAndCash615264' 6-max Seat #1 is the button
Seat 1: 74d92f2b ($13.02 in chips)
Seat 2: 75d5d480 ($5 in chips)
Seat 3: 3dd0afef ($5.32 in chips)
Seat 4: d86379c5 ($6.56 in chips)
Seat 5: Hero ($9.16 in chips)
Seat 6: 516da84c ($5.91 in chips)
75d5d480: posts small blind $0.02
3dd0afef: posts big blind $0.05
*** HOLE CARDS ***
Dealt to 74d92f2b 
Dealt to 75d5d480 
Dealt to 3dd0afef 
Dealt to d86379c5 
Dealt to Hero [Ts 3h]
Dealt to 516da84c 
d86379c5: folds
Hero: folds
516da84c: folds
74d92f2b: folds
75d5d480: folds
Uncalled bet ($0.03) returned to 3dd0afef
*** SHOWDOWN ***
3dd0afef collected $0.04 from pot
*** SUMMARY ***
Total pot $0.04 | Rake $0 | Jackpot $0 | Bingo $0 | Fortune $0 | Tax $0
Seat 1: 74d92f2b (button) folded before Flop (didn't bet)
Seat 2: 75d5d480 (small blind) folded before Flop
Seat 3: 3dd0afef (big blind) collected ($0.04)
Seat 4: d86379c5 folded before Flop (didn't bet)
Seat 5: Hero folded before Flop (didn't bet)
Seat 6: 516da84c folded before Flop (didn't bet)


Poker Hand #RC3334479920: Hold'em No Limit ($0.02/$0.05) - 2025/02/17 21:03:41
Table 'RushAndCash615180' 6-max Seat #1 is the button
Seat 1: d86379c5 ($6.63 in chips)
Seat 2: Hero ($9.11 in chips)
Seat 3: 677c4b25 ($5 in chips)
Seat 4: 39109629 ($5.05 in chips)
Seat 5: 67b2dab9 ($5.18 in chips)
Seat 6: 1b6c31ec ($8.19 in chips)
Hero: posts small blind $0.02
677c4b25: posts big blind $0.05
*** HOLE CARDS ***
Dealt to d86379c5 
Dealt to Hero [7h 6h]
Dealt to 677c4b25 
Dealt to 39109629 
Dealt to 67b2dab9 
Dealt to 1b6c31ec 
39109629: folds
67b2dab9: folds
1b6c31ec: folds
d86379c5: folds
Hero: calls $0.03
677c4b25: checks
*** FLOP *** [Jc 2s 7d]
Hero: bets $0.05
677c4b25: folds
Uncalled bet ($0.05) returned to Hero
*** SHOWDOWN ***
Hero collected $0.1 from pot
*** SUMMARY ***
Total pot $0.1 | Rake $0 | Jackpot $0 | Bingo $0 | Fortune $0 | Tax $0
Board [Jc 2s 7d]
Seat 1: d86379c5 (button) folded before Flop (didn't bet)
Seat 2: Hero (small blind) won ($0.1)
Seat 3: 677c4b25 (big blind) folded on the Flop
Seat 4: 39109629 folded before Flop (didn't bet)
Seat 5: 67b2dab9 folded before Flop (didn't bet)
Seat 6: 1b6c31ec folded before Flop (didn't bet)


Poker Hand #RC3334479897: Hold'em No Limit ($0.02/$0.05) - 2025/02/17 21:03:38
Table 'RushAndCash615157' 6-max Seat #1 is the button
Seat 1: 74f9576e ($6.24 in chips)
Seat 2: 123dc5ea ($5.02 in chips)
Seat 3: Hero ($9.16 in chips)
Seat 4: 6d2abfa5 ($6.79 in chips)
Seat 5: 1b6c31ec ($8.19 in chips)
Seat 6: d57e790f ($8.26 in chips)
123dc5ea: posts small blind $0.02
Hero: posts big blind $0.05
*** HOLE CARDS ***
Dealt to 74f9576e 
Dealt to 123dc5ea 
Dealt to Hero [5h 7d]
Dealt to 6d2abfa5 
Dealt to 1b6c31ec 
Dealt to d57e790f 
6d2abfa5: folds
1b6c31ec: folds
d57e790f: raises $0.08 to $0.13
74f9576e: raises $0.25 to $0.38
123dc5ea: folds
Hero: folds
d57e790f: calls $0.25
*** FLOP *** [8d 6s 5c]
d57e790f: checks
74f9576e: checks
*** TURN *** [8d 6s 5c] [3d]
d57e790f: checks
74f9576e: checks
*** RIVER *** [8d 6s 5c 3d] [Jd]
d57e790f: checks
74f9576e: checks
d57e790f: shows [Qh Ad] (Ace-High)
74f9576e: shows [Ah Kh] (Ace-High)
*** SHOWDOWN ***
74f9576e collected $0.79 from pot
*** SUMMARY ***
Total pot $0.83 | Rake $0.04 | Jackpot $0 | Bingo $0 | Fortune $0 | Tax $0
Board [8d 6s 5c 3d Jd]
Seat 1: 74f9576e (button) showed [Ah Kh] and won ($0.79) with Ace-High
Seat 2: 123dc5ea (small blind) folded before Flop
Seat 3: Hero (big blind) folded before Flop
Seat 4: 6d2abfa5 folded before Flop (didn't bet)
Seat 5: 1b6c31ec folded before Flop (didn't bet)
Seat 6: d57e790f showed [Qh Ad] and lost with Ace-High


Poker Hand #RC3334479843: Hold'em No Limit ($0.02/$0.05) - 2025/02/17 21:03:32
Table 'RushAndCash615103' 6-max Seat #1 is the button
Seat 1: e58420c8 ($7.37 in chips)
Seat 2: 1157f85d ($9.2 in chips)
Seat 3: 3ffd6491 ($5.41 in chips)
Seat 4: a708a98a ($17.84 in chips)
Seat 5: Hero ($9.16 in chips)
Seat 6: c3b473c1 ($5.4 in chips)
1157f85d: posts small blind $0.02
3ffd6491: posts big blind $0.05
*** HOLE CARDS ***
Dealt to e58420c8 
Dealt to 1157f85d 
Dealt to 3ffd6491 
Dealt to a708a98a 
Dealt to Hero [Td 6h]
Dealt to c3b473c1 
a708a98a: folds
Hero: folds
c3b473c1: raises $0.08 to $0.13
e58420c8: folds
1157f85d: folds
3ffd6491: calls $0.08
*** FLOP *** [8c 8d Ts]
3ffd6491: checks
c3b473c1: bets $0.14
3ffd6491: calls $0.14
*** TURN *** [8c 8d Ts] [Ks]
3ffd6491: checks
c3b473c1: bets $0.28
3ffd6491: folds
Uncalled bet ($0.28) returned to c3b473c1
*** SHOWDOWN ***
c3b473c1 collected $0.54 from pot
*** SUMMARY ***
Total pot $0.56 | Rake $0.02 | Jackpot $0 | Bingo $0 | Fortune $0 | Tax $0
Board [8c 8d Ts Ks]
Seat 1: e58420c8 (button) folded before Flop (didn't bet)
Seat 2: 1157f85d (small blind) folded before Flop
Seat 3: 3ffd6491 (big blind) folded on the Turn
Seat 4: a708a98a folded before Flop (didn't bet)
Seat 5: Hero folded before Flop (didn't bet)
Seat 6: c3b473c1 won ($0.54)


Poker Hand #RC3334479740: Hold'em No Limit ($0.02/$0.05) - 2025/02/17 21:03:19
Table 'RushAndCash615000' 6-max Seat #1 is the button
Seat 1: Hero ($9.16 in chips)
Seat 2: cbfd6c92 ($9.56 in chips)
Seat 3: 97ae2208 ($5.24 in chips)
Seat 4: 1113ecdd ($5 in chips)
Seat 5: 49b4f33a ($11.14 in chips)
Seat 6: b4b34357 ($5.38 in chips)
cbfd6c92: posts small blind $0.02
97ae2208: posts big blind $0.05
*** HOLE CARDS ***
Dealt to Hero [5h Qh]
Dealt to cbfd6c92 
Dealt to 97ae2208 
Dealt to 1113ecdd 
Dealt to 49b4f33a 
Dealt to b4b34357 
1113ecdd: folds
49b4f33a: folds
b4b34357: folds
Hero: folds
cbfd6c92: raises $0.08 to $0.13
97ae2208: calls $0.08
*** FLOP *** [Ac 3h 6c]
cbfd6c92: checks
97ae2208: bets $0.13
cbfd6c92: folds
Uncalled bet ($0.13) returned to 97ae2208
*** SHOWDOWN ***
97ae2208 collected $0.25 from pot
*** SUMMARY ***
Total pot $0.26 | Rake $0.01 | Jackpot $0 | Bingo $0 | Fortune $0 | Tax $0
Board [Ac 3h 6c]
Seat 1: Hero (button) folded before Flop (didn't bet)
Seat 2: cbfd6c92 (small blind) folded on the Flop
Seat 3: 97ae2208 (big blind) won ($0.25)
Seat 4: 1113ecdd folded before Flop (didn't bet)
Seat 5: 49b4f33a folded before Flop (didn't bet)
Seat 6: b4b34357 folded before Flop (didn't bet)


Poker Hand #RC3334479697: Hold'em No Limit ($0.02/$0.05) - 2025/02/17 21:03:13
Table 'RushAndCash614957' 6-max Seat #1 is the button
Seat 1: c4483bd8 ($5.94 in chips)
Seat 2: 157631a0 ($6.43 in chips)
Seat 3: 9df8d688 ($5 in chips)
Seat 4: f651985 ($5.55 in chips)
Seat 5: 90c3e611 ($5.04 in chips)
Seat 6: Hero ($9.16 in chips)
157631a0: posts small blind $0.02
9df8d688: posts big blind $0.05
*** HOLE CARDS ***
Dealt to c4483bd8 
Dealt to 157631a0 
Dealt to 9df8d688 
Dealt to f651985 
Dealt to 90c3e611 
Dealt to Hero [Ks 8d]
f651985: raises $0.05 to $0.1
90c3e611: folds
Hero: folds
c4483bd8: folds
157631a0: folds
9df8d688: calls $0.05
*** FLOP *** [3c Jh 8c]
9df8d688: bets $0.11
f651985: folds
Uncalled bet ($0.11) returned to 9df8d688
*** SHOWDOWN ***
9df8d688 collected $0.21 from pot
*** SUMMARY ***
Total pot $0.22 | Rake $0.01 | Jackpot $0 | Bingo $0 | Fortune $0 | Tax $0
Board [3c Jh 8c]
Seat 1: c4483bd8 (button) folded before Flop (didn't bet)
Seat 2: 157631a0 (small blind) folded before Flop
Seat 3: 9df8d688 (big blind) won ($0.21)
Seat 4: f651985 folded on the Flop
Seat 5: 90c3e611 folded before Flop (didn't bet)
Seat 6: Hero folded before Flop (didn't bet)


Poker Hand #RC3334479613: Hold'em No Limit ($0.02/$0.05) - 2025/02/17 21:03:02
Table 'RushAndCash614873' 6-max Seat #1 is the button
Seat 1: a3b43a4c ($5.51 in chips)
Seat 2: 6be17d4e ($5.56 in chips)
Seat 3: Hero ($9.21 in chips)
Seat 4: 32d40ce0 ($5.53 in chips)
Seat 5: 38a4c833 ($7.58 in chips)
Seat 6: cb0795b5 ($6.9 in chips)
6be17d4e: posts small blind $0.02
Hero: posts big blind $0.05
*** HOLE CARDS ***
Dealt to a3b43a4c 
Dealt to 6be17d4e 
Dealt to Hero [5d 7c]
Dealt to 32d40ce0 
Dealt to 38a4c833 
Dealt to cb0795b5 
32d40ce0: raises $0.07 to $0.12
38a4c833: folds
cb0795b5: raises $0.24 to $0.36
a3b43a4c: folds
6be17d4e: raises $0.69 to $1.05
Hero: folds
32d40ce0: folds
cb0795b5: calls $0.69
*** FIRST FLOP *** [Jh Kh Tc]
6be17d4e: bets $1
cb0795b5: calls $1
*** FIRST TURN *** [Jh Kh Tc] [Js]
6be17d4e: bets $3.51 and is all-in
cb0795b5: calls $3.51
6be17d4e: shows [Qc Ah] (Aces-High Straight)
cb0795b5: shows [Ks Qs] (Pair of Kings and Pair of Jacks)
*** FIRST RIVER *** [Jh Kh Tc Js] [Kc]
*** SECOND RIVER *** [Jh Kh Tc Js] [Kd]
*** FIRST SHOWDOWN ***
cb0795b5 collected $5.54 from pot
*** SECOND SHOWDOWN ***
cb0795b5 collected $5.54 from pot
*** SUMMARY ***
Total pot $11.29 | Rake $0.14 | Jackpot $0.07 | Bingo $0 | Fortune $0 | Tax $0
Hand was run two times
FIRST Board [Jh Kh Tc Js Kc]
SECOND Board [Kd]
Seat 1: a3b43a4c (button) folded before Flop (didn't bet)
Seat 2: 6be17d4e (small blind) showed [Qc Ah] and lost with Aces-High Straight, and lost
Seat 3: Hero (big blind) folded before Flop
Seat 4: 32d40ce0 folded before Flop
Seat 5: 38a4c833 folded before Flop (didn't bet)
Seat 6: cb0795b5 showed [Ks Qs] and won ($5.54) with Kings Full over Jacks, and won ($5.54)


Poker Hand #RC3334479588: Hold'em No Limit ($0.02/$0.05) - 2025/02/17 21:02:59
Table 'RushAndCash614848' 6-max Seat #1 is the button
Seat 1: 47494b5b ($5 in chips)
Seat 2: 151b0c91 ($4.88 in chips)
Seat 3: 3bfcd529 ($5.44 in chips)
Seat 4: Hero ($9.21 in chips)
Seat 5: e632d40b ($7.64 in chips)
Seat 6: f43eaf15 ($7.99 in chips)
151b0c91: posts small blind $0.02
3bfcd529: posts big blind $0.05
*** HOLE CARDS ***
Dealt to 47494b5b 
Dealt to 151b0c91 
Dealt to 3bfcd529 
Dealt to Hero [Ad 3d]
Dealt to e632d40b 
Dealt to f43eaf15 
Hero: folds
e632d40b: folds
f43eaf15: folds
47494b5b: raises $0.05 to $0.1
151b0c91: folds
3bfcd529: calls $0.05
*** FLOP *** [Jd 3s Qd]
3bfcd529: checks
47494b5b: bets $0.05
3bfcd529: folds
Uncalled bet ($0.05) returned to 47494b5b
*** SHOWDOWN ***
47494b5b collected $0.21 from pot
*** SUMMARY ***
Total pot $0.22 | Rake $0.01 | Jackpot $0 | Bingo $0 | Fortune $0 | Tax $0
Board [Jd 3s Qd]
Seat 1: 47494b5b (button) won ($0.21)
Seat 2: 151b0c91 (small blind) folded before Flop
Seat 3: 3bfcd529 (big blind) folded on the Flop
Seat 4: Hero folded before Flop (didn't bet)
Seat 5: e632d40b folded before Flop (didn't bet)
Seat 6: f43eaf15 folded before Flop (didn't bet)


Poker Hand #RC3334479476: Hold'em No Limit ($0.02/$0.05) - 2025/02/17 21:02:45
Table 'RushAndCash614736' 6-max Seat #1 is the button
Seat 1: 868c7021 ($7.65 in chips)
Seat 2: Hero ($9.16 in chips)
Seat 3: d737deb4 ($5 in chips)
Seat 4: 8eb51349 ($4.93 in chips)
Seat 5: f3a68bc9 ($6.78 in chips)
Seat 6: 9babc997 ($4.81 in chips)
Hero: posts small blind $0.02
d737deb4: posts big blind $0.05
*** HOLE CARDS ***
Dealt to 868c7021 
Dealt to Hero [9c As]
Dealt to d737deb4 
Dealt to 8eb51349 
Dealt to f3a68bc9 
Dealt to 9babc997 
8eb51349: folds
f3a68bc9: folds
9babc997: folds
868c7021: folds
Hero: raises $0.1 to $0.15
d737deb4: folds
Uncalled bet ($0.1) returned to Hero
*** SHOWDOWN ***
Hero collected $0.1 from pot
*** SUMMARY ***
Total pot $0.1 | Rake $0 | Jackpot $0 | Bingo $0 | Fortune $0 | Tax $0
Seat 1: 868c7021 (button) folded before Flop (didn't bet)
Seat 2: Hero (small blind) collected ($0.1)
Seat 3: d737deb4 (big blind) folded before Flop
Seat 4: 8eb51349 folded before Flop (didn't bet)
Seat 5: f3a68bc9 folded before Flop (didn't bet)
Seat 6: 9babc997 folded before Flop (didn't bet)


Poker Hand #RC3334479446: Hold'em No Limit ($0.02/$0.05) - 2025/02/17 21:02:42
Table 'RushAndCash614706' 6-max Seat #1 is the button
Seat 1: ead9d64d ($8.79 in chips)
Seat 2: 90c3e611 ($5.06 in chips)
Seat 3: 258a2071 ($5.47 in chips)
Seat 4: Hero ($9.16 in chips)
Seat 5: e58420c8 ($7.92 in chips)
Seat 6: 9f09d482 ($7.74 in chips)
90c3e611: posts small blind $0.02
258a2071: posts big blind $0.05
*** HOLE CARDS ***
Dealt to ead9d64d 
Dealt to 90c3e611 
Dealt to 258a2071 
Dealt to Hero [Th 3d]
Dealt to e58420c8 
Dealt to 9f09d482 
Hero: folds
e58420c8: folds
9f09d482: folds
ead9d64d: folds
90c3e611: folds
Uncalled bet ($0.03) returned to 258a2071
*** SHOWDOWN ***
258a2071 collected $0.04 from pot
*** SUMMARY ***
Total pot $0.04 | Rake $0 | Jackpot $0 | Bingo $0 | Fortune $0 | Tax $0
Seat 1: ead9d64d (button) folded before Flop (didn't bet)
Seat 2: 90c3e611 (small blind) folded before Flop
Seat 3: 258a2071 (big blind) collected ($0.04)
Seat 4: Hero folded before Flop (didn't bet)
Seat 5: e58420c8 folded before Flop (didn't bet)
Seat 6: 9f09d482 folded before Flop (didn't bet)


Poker Hand #RC3334479421: Hold'em No Limit ($0.02/$0.05) - 2025/02/17 21:02:38
Table 'RushAndCash614681' 6-max Seat #1 is the button
Seat 1: 8e93231a ($5 in chips)
Seat 2: cedf4726 ($13.23 in chips)
Seat 3: cea9730b ($6.08 in chips)
Seat 4: 9165e0e3 ($8.06 in chips)
Seat 5: Hero ($9.16 in chips)
Seat 6: c7e9103c ($11.97 in chips)
cedf4726: posts small blind $0.02
cea9730b: posts big blind $0.05
*** HOLE CARDS ***
Dealt to 8e93231a 
Dealt to cedf4726 
Dealt to cea9730b 
Dealt to 9165e0e3 
Dealt to Hero [6s 2h]
Dealt to c7e9103c 
9165e0e3: folds
Hero: folds
c7e9103c: folds
8e93231a: folds
cedf4726: raises $0.08 to $0.13
cea9730b: folds
Uncalled bet ($0.08) returned to cedf4726
*** SHOWDOWN ***
cedf4726 collected $0.1 from pot
*** SUMMARY ***
Total pot $0.1 | Rake $0 | Jackpot $0 | Bingo $0 | Fortune $0 | Tax $0
Seat 1: 8e93231a (button) folded before Flop (didn't bet)
Seat 2: cedf4726 (small blind) collected ($0.1)
Seat 3: cea9730b (big blind) folded before Flop
Seat 4: 9165e0e3 folded before Flop (didn't bet)
Seat 5: Hero folded before Flop (didn't bet)
Seat 6: c7e9103c folded before Flop (didn't bet)


Poker Hand #RC3334479393: Hold'em No Limit ($0.02/$0.05) - 2025/02/17 21:02:35
Table 'RushAndCash614653' 6-max Seat #1 is the button
Seat 1: Hero ($9.16 in chips)
Seat 2: 74d92f2b ($12.95 in chips)
Seat 3: 5f1cdd27 ($5.67 in chips)
Seat 4: 9165e0e3 ($8.06 in chips)
Seat 5: 9b99e93a ($14.43 in chips)
Seat 6: 4b3dba4 ($7.23 in chips)
74d92f2b: posts small blind $0.02
5f1cdd27: posts big blind $0.05
*** HOLE CARDS ***
Dealt to Hero [8c 4d]
Dealt to 74d92f2b 
Dealt to 5f1cdd27 
Dealt to 9165e0e3 
Dealt to 9b99e93a 
Dealt to 4b3dba4 
9165e0e3: folds
9b99e93a: raises $0.05 to $0.1
4b3dba4: folds
Hero: folds
74d92f2b: folds
5f1cdd27: calls $0.05
*** FLOP *** [2c 5c 9h]
5f1cdd27: checks
9b99e93a: bets $0.11
5f1cdd27: calls $0.11
*** TURN *** [2c 5c 9h] [Ad]
5f1cdd27: checks
9b99e93a: bets $0.22
5f1cdd27: folds
Uncalled bet ($0.22) returned to 9b99e93a
*** SHOWDOWN ***
9b99e93a collected $0.42 from pot
*** SUMMARY ***
Total pot $0.44 | Rake $0.02 | Jackpot $0 | Bingo $0 | Fortune $0 | Tax $0
Board [2c 5c 9h Ad]
Seat 1: Hero (button) folded before Flop (didn't bet)
Seat 2: 74d92f2b (small blind) folded before Flop
Seat 3: 5f1cdd27 (big blind) folded on the Turn
Seat 4: 9165e0e3 folded before Flop (didn't bet)
Seat 5: 9b99e93a won ($0.42)
Seat 6: 4b3dba4 folded before Flop (didn't bet)


Poker Hand #RC3334479367: Hold'em No Limit ($0.02/$0.05) - 2025/02/17 21:02:32
Table 'RushAndCash614627' 6-max Seat #1 is the button
Seat 1: 5fe62400 ($5.62 in chips)
Seat 2: Hero ($9.18 in chips)
Seat 3: fb90f143 ($14.66 in chips)
Seat 4: 868c7021 ($7.67 in chips)
Seat 5: b7bd1225 ($6.05 in chips)
Seat 6: 468b216c ($6.47 in chips)
Hero: posts small blind $0.02
fb90f143: posts big blind $0.05
*** HOLE CARDS ***
Dealt to 5fe62400 
Dealt to Hero [5s 3h]
Dealt to fb90f143 
Dealt to 868c7021 
Dealt to b7bd1225 
Dealt to 468b216c 
868c7021: folds
b7bd1225: folds
468b216c: raises $0.1 to $0.15
5fe62400: folds
Hero: folds
fb90f143: folds
Uncalled bet ($0.1) returned to 468b216c
*** SHOWDOWN ***
468b216c collected $0.12 from pot
*** SUMMARY ***
Total pot $0.12 | Rake $0 | Jackpot $0 | Bingo $0 | Fortune $0 | Tax $0
Seat 1: 5fe62400 (button) folded before Flop (didn't bet)
Seat 2: Hero (small blind) folded before Flop
Seat 3: fb90f143 (big blind) folded before Flop
Seat 4: 868c7021 folded before Flop (didn't bet)
Seat 5: b7bd1225 folded before Flop (didn't bet)
Seat 6: 468b216c collected ($0.12)


Poker Hand #RC3334479167: Hold'em No Limit ($0.02/$0.05) - 2025/02/17 21:02:06
Table 'RushAndCash614427' 6-max Seat #1 is the button
Seat 1: Hero ($9.41 in chips)
Seat 2: 468b216c ($6.21 in chips)
Seat 3: b59fc0b9 ($5.68 in chips)
Seat 4: daf6ad6 ($6.09 in chips)
Seat 5: 22e7e468 ($5.29 in chips)
Seat 6: 75a97e80 ($4.35 in chips)
468b216c: posts small blind $0.02
b59fc0b9: posts big blind $0.05
*** HOLE CARDS ***
Dealt to Hero [Qd As]
Dealt to 468b216c 
Dealt to b59fc0b9 
Dealt to daf6ad6 
Dealt to 22e7e468 
Dealt to 75a97e80 
daf6ad6: folds
22e7e468: folds
75a97e80: folds
Hero: raises $0.05 to $0.1
468b216c: raises $0.13 to $0.23
b59fc0b9: folds
Hero: calls $0.13
*** FLOP *** [Jh 2d 2c]
468b216c: checks
Hero: checks
*** TURN *** [Jh 2d 2c] [6s]
468b216c: bets $0.26
Hero: folds
Uncalled bet ($0.26) returned to 468b216c
*** SHOWDOWN ***
468b216c collected $0.49 from pot
*** SUMMARY ***
Total pot $0.51 | Rake $0.02 | Jackpot $0 | Bingo $0 | Fortune $0 | Tax $0
Board [Jh 2d 2c 6s]
Seat 1: Hero (button) folded on the Turn
Seat 2: 468b216c (small blind) won ($0.49)
Seat 3: b59fc0b9 (big blind) folded before Flop
Seat 4: daf6ad6 folded before Flop (didn't bet)
Seat 5: 22e7e468 folded before Flop (didn't bet)
Seat 6: 75a97e80 folded before Flop (didn't bet)


Poker Hand #RC3334479145: Hold'em No Limit ($0.02/$0.05) - 2025/02/17 21:02:03
Table 'RushAndCash614405' 6-max Seat #1 is the button
Seat 1: 7d2d3f96 ($13.11 in chips)
Seat 2: 304e7bcd ($5.05 in chips)
Seat 3: 77368e62 ($5.75 in chips)
Seat 4: Hero ($9.41 in chips)
Seat 5: d57e790f ($8.29 in chips)
Seat 6: 717e9861 ($5.05 in chips)
304e7bcd: posts small blind $0.02
77368e62: posts big blind $0.05
*** HOLE CARDS ***
Dealt to 7d2d3f96 
Dealt to 304e7bcd 
Dealt to 77368e62 
Dealt to Hero [3s Jc]
Dealt to d57e790f 
Dealt to 717e9861 
Hero: folds
d57e790f: folds
717e9861: folds
7d2d3f96: raises $0.06 to $0.11
304e7bcd: folds
77368e62: folds
Uncalled bet ($0.06) returned to 7d2d3f96
*** SHOWDOWN ***
7d2d3f96 collected $0.12 from pot
*** SUMMARY ***
Total pot $0.12 | Rake $0 | Jackpot $0 | Bingo $0 | Fortune $0 | Tax $0
Seat 1: 7d2d3f96 (button) collected ($0.12)
Seat 2: 304e7bcd (small blind) folded before Flop
Seat 3: 77368e62 (big blind) folded before Flop
Seat 4: Hero folded before Flop (didn't bet)
Seat 5: d57e790f folded before Flop (didn't bet)
Seat 6: 717e9861 folded before Flop (didn't bet)


Poker Hand #RC3334478949: Hold'em No Limit ($0.02/$0.05) - 2025/02/17 21:01:39
Table 'RushAndCash614209' 6-max Seat #1 is the button
Seat 1: b19e7101 ($5.37 in chips)
Seat 2: f83d0c9c ($12.03 in chips)
Seat 3: Hero ($9.54 in chips)
Seat 4: cedf4726 ($12.69 in chips)
Seat 5: 1941fa92 ($3.08 in chips)
Seat 6: 6008538 ($2.8 in chips)
f83d0c9c: posts small blind $0.02
Hero: posts big blind $0.05
*** HOLE CARDS ***
Dealt to b19e7101 
Dealt to f83d0c9c 
Dealt to Hero [9d Tc]
Dealt to cedf4726 
Dealt to 1941fa92 
Dealt to 6008538 
cedf4726: folds
1941fa92: folds
6008538: folds
b19e7101: raises $0.08 to $0.13
f83d0c9c: folds
Hero: calls $0.08
*** FLOP *** [Qh 7d Ac]
Hero: checks
b19e7101: bets $0.16
Hero: folds
Uncalled bet ($0.16) returned to b19e7101
*** SHOWDOWN ***
b19e7101 collected $0.27 from pot
*** SUMMARY ***
Total pot $0.28 | Rake $0.01 | Jackpot $0 | Bingo $0 | Fortune $0 | Tax $0
Board [Qh 7d Ac]
Seat 1: b19e7101 (button) won ($0.27)
Seat 2: f83d0c9c (small blind) folded before Flop
Seat 3: Hero (big blind) folded on the Flop
Seat 4: cedf4726 folded before Flop (didn't bet)
Seat 5: 1941fa92 folded before Flop (didn't bet)
Seat 6: 6008538 folded before Flop (didn't bet)


Poker Hand #RC3334478916: Hold'em No Limit ($0.02/$0.05) - 2025/02/17 21:01:34
Table 'RushAndCash614176' 6-max Seat #1 is the button
Seat 1: fe0566a4 ($13.96 in chips)
Seat 2: d5f2b405 ($2.15 in chips)
Seat 3: 123dc5ea ($5 in chips)
Seat 4: e4025e7f ($5.12 in chips)
Seat 5: Hero ($9.54 in chips)
Seat 6: e352a329 ($5.06 in chips)
d5f2b405: posts small blind $0.02
123dc5ea: posts big blind $0.05
*** HOLE CARDS ***
Dealt to fe0566a4 
Dealt to d5f2b405 
Dealt to 123dc5ea 
Dealt to e4025e7f 
Dealt to Hero [Ad 5s]
Dealt to e352a329 
e4025e7f: folds
Hero: folds
e352a329: folds
fe0566a4: raises $0.05 to $0.1
d5f2b405: folds
123dc5ea: calls $0.05
*** FLOP *** [9h Kh 6h]
123dc5ea: checks
fe0566a4: bets $0.1
123dc5ea: folds
Uncalled bet ($0.1) returned to fe0566a4
*** SHOWDOWN ***
fe0566a4 collected $0.21 from pot
*** SUMMARY ***
Total pot $0.22 | Rake $0.01 | Jackpot $0 | Bingo $0 | Fortune $0 | Tax $0
Board [9h Kh 6h]
Seat 1: fe0566a4 (button) won ($0.21)
Seat 2: d5f2b405 (small blind) folded before Flop
Seat 3: 123dc5ea (big blind) folded on the Flop
Seat 4: e4025e7f folded before Flop (didn't bet)
Seat 5: Hero folded before Flop (didn't bet)
Seat 6: e352a329 folded before Flop (didn't bet)


Poker Hand #RC3334475406: Hold'em No Limit ($0.02/$0.05) - 2025/02/17 20:53:41
Table 'RushAndCash610666' 6-max Seat #1 is the button
Seat 1: 33bc9b8e ($6.22 in chips)
Seat 2: 20e2d62 ($5.32 in chips)
Seat 3: Hero ($9.33 in chips)
Seat 4: e4fd27d ($13.07 in chips)
Seat 5: 94b22b92 ($10.19 in chips)
Seat 6: 64b39229 ($6.05 in chips)
20e2d62: posts small blind $0.02
Hero: posts big blind $0.05
*** HOLE CARDS ***
Dealt to 33bc9b8e 
Dealt to 20e2d62 
Dealt to Hero [Ks Qc]
Dealt to e4fd27d 
Dealt to 94b22b92 
Dealt to 64b39229 
e4fd27d: raises $0.07 to $0.12
94b22b92: folds
64b39229: folds
33bc9b8e: folds
20e2d62: folds
Hero: calls $0.07
*** FLOP *** [7h Kd 6d]
Hero: checks
e4fd27d: bets $0.09
Hero: calls $0.09
*** TURN *** [7h Kd 6d] [Qh]
Hero: checks
e4fd27d: checks
*** RIVER *** [7h Kd 6d Qh] [4s]
Hero: bets $0.34
e4fd27d: folds
Uncalled bet ($0.34) returned to Hero
*** SHOWDOWN ***
Hero collected $0.42 from pot
*** SUMMARY ***
Total pot $0.44 | Rake $0.02 | Jackpot $0 | Bingo $0 | Fortune $0 | Tax $0
Board [7h Kd 6d Qh 4s]
Seat 1: 33bc9b8e (button) folded before Flop (didn't bet)
Seat 2: 20e2d62 (small blind) folded before Flop
Seat 3: Hero (big blind) won ($0.42)
Seat 4: e4fd27d folded on the River
Seat 5: 94b22b92 folded before Flop (didn't bet)
Seat 6: 64b39229 folded before Flop (didn't bet)


Poker Hand #RC3334475373: Hold'em No Limit ($0.02/$0.05) - 2025/02/17 20:53:37
Table 'RushAndCash610633' 6-max Seat #1 is the button
Seat 1: 21e0e4ee ($5 in chips)
Seat 2: 673e17b3 ($5.09 in chips)
Seat 3: eed867f5 ($4.93 in chips)
Seat 4: Hero ($9.33 in chips)
Seat 5: 1095926a ($6.23 in chips)
Seat 6: 15346d36 ($4.33 in chips)
673e17b3: posts small blind $0.02
eed867f5: posts big blind $0.05
*** HOLE CARDS ***
Dealt to 21e0e4ee 
Dealt to 673e17b3 
Dealt to eed867f5 
Dealt to Hero [Kc Ts]
Dealt to 1095926a 
Dealt to 15346d36 
Hero: folds
1095926a: folds
15346d36: folds
21e0e4ee: raises $0.07 to $0.12
673e17b3: folds
eed867f5: folds
Uncalled bet ($0.07) returned to 21e0e4ee
*** SHOWDOWN ***
21e0e4ee collected $0.12 from pot
*** SUMMARY ***
Total pot $0.12 | Rake $0 | Jackpot $0 | Bingo $0 | Fortune $0 | Tax $0
Seat 1: 21e0e4ee (button) collected ($0.12)
Seat 2: 673e17b3 (small blind) folded before Flop
Seat 3: eed867f5 (big blind) folded before Flop
Seat 4: Hero folded before Flop (didn't bet)
Seat 5: 1095926a folded before Flop (didn't bet)
Seat 6: 15346d36 folded before Flop (didn't bet)


Poker Hand #RC3334475254: Hold'em No Limit ($0.02/$0.05) - 2025/02/17 20:53:22
Table 'RushAndCash610514' 6-max Seat #1 is the button
Seat 1: Hero ($9.26 in chips)
Seat 2: 22a3f0e8 ($5 in chips)
Seat 3: 188390a5 ($5 in chips)
Seat 4: cbfd6c92 ($9.95 in chips)
Seat 5: 4238ab48 ($8.75 in chips)
Seat 6: bf2195f6 ($6.99 in chips)
22a3f0e8: posts small blind $0.02
188390a5: posts big blind $0.05
*** HOLE CARDS ***
Dealt to Hero [2c 2s]
Dealt to 22a3f0e8 
Dealt to 188390a5 
Dealt to cbfd6c92 
Dealt to 4238ab48 
Dealt to bf2195f6 
cbfd6c92: folds
4238ab48: folds
bf2195f6: folds
Hero: raises $0.05 to $0.1
22a3f0e8: folds
188390a5: folds
Uncalled bet ($0.05) returned to Hero
*** SHOWDOWN ***
Hero collected $0.12 from pot
*** SUMMARY ***
Total pot $0.12 | Rake $0 | Jackpot $0 | Bingo $0 | Fortune $0 | Tax $0
Seat 1: Hero (button) collected ($0.12)
Seat 2: 22a3f0e8 (small blind) folded before Flop
Seat 3: 188390a5 (big blind) folded before Flop
Seat 4: cbfd6c92 folded before Flop (didn't bet)
Seat 5: 4238ab48 folded before Flop (didn't bet)
Seat 6: bf2195f6 folded before Flop (didn't bet)


Poker Hand #RC3334475208: Hold'em No Limit ($0.02/$0.05) - 2025/02/17 20:53:16
Table 'RushAndCash610468' 6-max Seat #1 is the button
Seat 1: 6ac4af54 ($13.42 in chips)
Seat 2: Hero ($9.28 in chips)
Seat 3: fbb9d8f2 ($3.42 in chips)
Seat 4: cac5ff82 ($5 in chips)
Seat 5: dcee0577 ($6.95 in chips)
Seat 6: fa529b74 ($5 in chips)
Hero: posts small blind $0.02
fbb9d8f2: posts big blind $0.05
*** HOLE CARDS ***
Dealt to 6ac4af54 
Dealt to Hero [6d 7s]
Dealt to fbb9d8f2 
Dealt to cac5ff82 
Dealt to dcee0577 
Dealt to fa529b74 
cac5ff82: raises $0.05 to $0.1
dcee0577: folds
fa529b74: folds
6ac4af54: folds
Hero: folds
fbb9d8f2: folds
Uncalled bet ($0.05) returned to cac5ff82
*** SHOWDOWN ***
cac5ff82 collected $0.12 from pot
*** SUMMARY ***
Total pot $0.12 | Rake $0 | Jackpot $0 | Bingo $0 | Fortune $0 | Tax $0
Seat 1: 6ac4af54 (button) folded before Flop (didn't bet)
Seat 2: Hero (small blind) folded before Flop
Seat 3: fbb9d8f2 (big blind) folded before Flop
Seat 4: cac5ff82 collected ($0.12)
Seat 5: dcee0577 folded before Flop (didn't bet)
Seat 6: fa529b74 folded before Flop (didn't bet)


Poker Hand #RC3334475171: Hold'em No Limit ($0.02/$0.05) - 2025/02/17 20:53:12
Table 'RushAndCash610431' 6-max Seat #1 is the button
Seat 1: e58420c8 ($5.05 in chips)
Seat 2: 4ea8e2e ($13.71 in chips)
Seat 3: c864f9f6 ($5 in chips)
Seat 4: e30bf6a3 ($1.61 in chips)
Seat 5: 21c758a ($5.49 in chips)
Seat 6: Hero ($9.28 in chips)
4ea8e2e: posts small blind $0.02
c864f9f6: posts big blind $0.05
*** HOLE CARDS ***
Dealt to e58420c8 
Dealt to 4ea8e2e 
Dealt to c864f9f6 
Dealt to e30bf6a3 
Dealt to 21c758a 
Dealt to Hero [5d Jh]
e30bf6a3: folds
21c758a: folds
Hero: folds
e58420c8: folds
4ea8e2e: folds
Uncalled bet ($0.03) returned to c864f9f6
*** SHOWDOWN ***
c864f9f6 collected $0.04 from pot
*** SUMMARY ***
Total pot $0.04 | Rake $0 | Jackpot $0 | Bingo $0 | Fortune $0 | Tax $0
Seat 1: e58420c8 (button) folded before Flop (didn't bet)
Seat 2: 4ea8e2e (small blind) folded before Flop
Seat 3: c864f9f6 (big blind) collected ($0.04)
Seat 4: e30bf6a3 folded before Flop (didn't bet)
Seat 5: 21c758a folded before Flop (didn't bet)
Seat 6: Hero folded before Flop (didn't bet)


Poker Hand #RC3334475143: Hold'em No Limit ($0.02/$0.05) - 2025/02/17 20:53:09
Table 'RushAndCash610403' 6-max Seat #1 is the button
Seat 1: edbb0bb6 ($5.02 in chips)
Seat 2: 5466aa49 ($9.07 in chips)
Seat 3: d949b23d ($5 in chips)
Seat 4: 709ac205 ($11.92 in chips)
Seat 5: Hero ($9.28 in chips)
Seat 6: 775dfb45 ($5.09 in chips)
5466aa49: posts small blind $0.02
d949b23d: posts big blind $0.05
*** HOLE CARDS ***
Dealt to edbb0bb6 
Dealt to 5466aa49 
Dealt to d949b23d 
Dealt to 709ac205 
Dealt to Hero [6s 8d]
Dealt to 775dfb45 
709ac205: folds
Hero: folds
775dfb45: raises $0.06 to $0.11
edbb0bb6: raises $0.23 to $0.34
5466aa49: folds
d949b23d: folds
775dfb45: folds
Uncalled bet ($0.23) returned to edbb0bb6
*** SHOWDOWN ***
edbb0bb6 collected $0.28 from pot
*** SUMMARY ***
Total pot $0.29 | Rake $0.01 | Jackpot $0 | Bingo $0 | Fortune $0 | Tax $0
Seat 1: edbb0bb6 (button) collected ($0.28)
Seat 2: 5466aa49 (small blind) folded before Flop
Seat 3: d949b23d (big blind) folded before Flop
Seat 4: 709ac205 folded before Flop (didn't bet)
Seat 5: Hero folded before Flop (didn't bet)
Seat 6: 775dfb45 folded before Flop


Poker Hand #RC3334475116: Hold'em No Limit ($0.02/$0.05) - 2025/02/17 20:53:05
Table 'RushAndCash610376' 6-max Seat #1 is the button
Seat 1: 9f70f94d ($7.01 in chips)
Seat 2: 14d03752 ($5 in chips)
Seat 3: d2fb1cd9 ($7.85 in chips)
Seat 4: 69407b3a ($7.22 in chips)
Seat 5: 835df346 ($15.38 in chips)
Seat 6: Hero ($9.28 in chips)
14d03752: posts small blind $0.02
d2fb1cd9: posts big blind $0.05
*** HOLE CARDS ***
Dealt to 9f70f94d 
Dealt to 14d03752 
Dealt to d2fb1cd9 
Dealt to 69407b3a 
Dealt to 835df346 
Dealt to Hero [5d 3s]
69407b3a: folds
835df346: folds
Hero: folds
9f70f94d: raises $0.05 to $0.1
14d03752: folds
d2fb1cd9: raises $0.31 to $0.41
9f70f94d: folds
Uncalled bet ($0.31) returned to d2fb1cd9
*** SHOWDOWN ***
d2fb1cd9 collected $0.21 from pot
*** SUMMARY ***
Total pot $0.22 | Rake $0.01 | Jackpot $0 | Bingo $0 | Fortune $0 | Tax $0
Seat 1: 9f70f94d (button) folded before Flop
Seat 2: 14d03752 (small blind) folded before Flop
Seat 3: d2fb1cd9 (big blind) collected ($0.21)
Seat 4: 69407b3a folded before Flop (didn't bet)
Seat 5: 835df346 folded before Flop (didn't bet)
Seat 6: Hero folded before Flop (didn't bet)


Poker Hand #RC3334475092: Hold'em No Limit ($0.02/$0.05) - 2025/02/17 20:53:02
Table 'RushAndCash610352' 6-max Seat #1 is the button
Seat 1: 186b316a ($5 in chips)
Seat 2: d21ca4f4 ($3.64 in chips)
Seat 3: 65964033 ($5.46 in chips)
Seat 4: 74f9576e ($5 in chips)
Seat 5: Hero ($9.28 in chips)
Seat 6: 945593bf ($16.21 in chips)
d21ca4f4: posts small blind $0.02
65964033: posts big blind $0.05
*** HOLE CARDS ***
Dealt to 186b316a 
Dealt to d21ca4f4 
Dealt to 65964033 
Dealt to 74f9576e 
Dealt to Hero [3c As]
Dealt to 945593bf 
74f9576e: raises $0.05 to $0.1
Hero: folds
945593bf: folds
186b316a: folds
d21ca4f4: folds
65964033: folds
Uncalled bet ($0.05) returned to 74f9576e
*** SHOWDOWN ***
74f9576e collected $0.12 from pot
*** SUMMARY ***
Total pot $0.12 | Rake $0 | Jackpot $0 | Bingo $0 | Fortune $0 | Tax $0
Seat 1: 186b316a (button) folded before Flop (didn't bet)
Seat 2: d21ca4f4 (small blind) folded before Flop
Seat 3: 65964033 (big blind) folded before Flop
Seat 4: 74f9576e collected ($0.12)
Seat 5: Hero folded before Flop (didn't bet)
Seat 6: 945593bf folded before Flop (didn't bet)


Poker Hand #RC3334475059: Hold'em No Limit ($0.02/$0.05) - 2025/02/17 20:52:58
Table 'RushAndCash610319' 6-max Seat #1 is the button
Seat 1: 1fa8537 ($5.44 in chips)
Seat 2: e352a329 ($5.13 in chips)
Seat 3: 75091df4 ($7.36 in chips)
Seat 4: Hero ($9.28 in chips)
Seat 5: 38d2fc1e ($6.25 in chips)
Seat 6: 24cb9eae ($1.62 in chips)
e352a329: posts small blind $0.02
75091df4: posts big blind $0.05
*** HOLE CARDS ***
Dealt to 1fa8537 
Dealt to e352a329 
Dealt to 75091df4 
Dealt to Hero [6c 3d]
Dealt to 38d2fc1e 
Dealt to 24cb9eae 
Hero: folds
38d2fc1e: folds
24cb9eae: calls $0.05
1fa8537: folds
e352a329: folds
75091df4: checks
*** FLOP *** [9d 3c Ac]
75091df4: checks
24cb9eae: checks
*** TURN *** [9d 3c Ac] [Jc]
75091df4: checks
24cb9eae: checks
*** RIVER *** [9d 3c Ac Jc] [Qh]
75091df4: checks
24cb9eae: bets $0.09
75091df4: folds
Uncalled bet ($0.09) returned to 24cb9eae
*** SHOWDOWN ***
24cb9eae collected $0.12 from pot
*** SUMMARY ***
Total pot $0.12 | Rake $0 | Jackpot $0 | Bingo $0 | Fortune $0 | Tax $0
Board [9d 3c Ac Jc Qh]
Seat 1: 1fa8537 (button) folded before Flop (didn't bet)
Seat 2: e352a329 (small blind) folded before Flop
Seat 3: 75091df4 (big blind) folded on the River
Seat 4: Hero folded before Flop (didn't bet)
Seat 5: 38d2fc1e folded before Flop (didn't bet)
Seat 6: 24cb9eae won ($0.12)


Poker Hand #RC3334474928: Hold'em No Limit ($0.02/$0.05) - 2025/02/17 20:52:41
Table 'RushAndCash610188' 6-max Seat #1 is the button
Seat 1: 8c3789e ($6.52 in chips)
Seat 2: Hero ($9.3 in chips)
Seat 3: fb6c913 ($11.17 in chips)
Seat 4: d33976ee ($5.36 in chips)
Seat 5: 1a54a2fc ($10.18 in chips)
Seat 6: b8a41e4 ($6.32 in chips)
Hero: posts small blind $0.02
fb6c913: posts big blind $0.05
*** HOLE CARDS ***
Dealt to 8c3789e 
Dealt to Hero [7h 7c]
Dealt to fb6c913 
Dealt to d33976ee 
Dealt to 1a54a2fc 
Dealt to b8a41e4 
d33976ee: raises $0.05 to $0.1
1a54a2fc: raises $0.25 to $0.35
b8a41e4: folds
8c3789e: folds
Hero: folds
fb6c913: calls $0.3
d33976ee: raises $1.11 to $1.46
1a54a2fc: folds
fb6c913: folds
Uncalled bet ($1.11) returned to d33976ee
*** SHOWDOWN ***
d33976ee collected $1.02 from pot
*** SUMMARY ***
Total pot $1.07 | Rake $0.05 | Jackpot $0 | Bingo $0 | Fortune $0 | Tax $0
Seat 1: 8c3789e (button) folded before Flop (didn't bet)
Seat 2: Hero (small blind) folded before Flop
Seat 3: fb6c913 (big blind) folded before Flop
Seat 4: d33976ee collected ($1.02)
Seat 5: 1a54a2fc folded before Flop
Seat 6: b8a41e4 folded before Flop (didn't bet)


Poker Hand #RC3334444457: Hold'em No Limit ($0.02/$0.05) - 2025/02/17 20:51:39
Table 'RushAndCash609717' 6-max Seat #1 is the button
Seat 1: fb6c913 ($11.44 in chips)
Seat 2: 6d5fa70b ($5.16 in chips)
Seat 3: Hero ($9.4 in chips)
Seat 4: c806dd25 ($5.07 in chips)
Seat 5: d949b23d ($5 in chips)
Seat 6: d33976ee ($5 in chips)
6d5fa70b: posts small blind $0.02
Hero: posts big blind $0.05
*** HOLE CARDS ***
Dealt to fb6c913 
Dealt to 6d5fa70b 
Dealt to Hero [7s 7d]
Dealt to c806dd25 
Dealt to d949b23d 
Dealt to d33976ee 
c806dd25: folds
d949b23d: folds
d33976ee: raises $0.05 to $0.1
fb6c913: calls $0.1
6d5fa70b: folds
Hero: calls $0.05
*** FLOP *** [As 8c Js]
Hero: checks
d33976ee: bets $0.17
fb6c913: calls $0.17
Hero: folds
*** TURN *** [As 8c Js] [2c]
d33976ee: bets $0.51
fb6c913: folds
Uncalled bet ($0.51) returned to d33976ee
*** SHOWDOWN ***
d33976ee collected $0.63 from pot
*** SUMMARY ***
Total pot $0.66 | Rake $0.03 | Jackpot $0 | Bingo $0 | Fortune $0 | Tax $0
Board [As 8c Js 2c]
Seat 1: fb6c913 (button) folded on the Turn
Seat 2: 6d5fa70b (small blind) folded before Flop
Seat 3: Hero (big blind) folded on the Flop
Seat 4: c806dd25 folded before Flop (didn't bet)
Seat 5: d949b23d folded before Flop (didn't bet)
Seat 6: d33976ee won ($0.63)


Poker Hand #RC3334444397: Hold'em No Limit ($0.02/$0.05) - 2025/02/17 20:51:31
Table 'RushAndCash609657' 6-max Seat #1 is the button
Seat 1: Hero ($9.4 in chips)
Seat 2: fad7078a ($5.31 in chips)
Seat 3: 6662e866 ($17.64 in chips)
Seat 4: e4fd2097 ($24 in chips)
Seat 5: 653af57c ($5.14 in chips)
Seat 6: 87256f31 ($4.63 in chips)
fad7078a: posts small blind $0.02
6662e866: posts big blind $0.05
*** HOLE CARDS ***
Dealt to Hero [4h 3h]
Dealt to fad7078a 
Dealt to 6662e866 
Dealt to e4fd2097 
Dealt to 653af57c 
Dealt to 87256f31 
e4fd2097: folds
653af57c: folds
87256f31: folds
Hero: folds
fad7078a: folds
Uncalled bet ($0.03) returned to 6662e866
*** SHOWDOWN ***
6662e866 collected $0.04 from pot
*** SUMMARY ***
Total pot $0.04 | Rake $0 | Jackpot $0 | Bingo $0 | Fortune $0 | Tax $0
Seat 1: Hero (button) folded before Flop (didn't bet)
Seat 2: fad7078a (small blind) folded before Flop
Seat 3: 6662e866 (big blind) collected ($0.04)
Seat 4: e4fd2097 folded before Flop (didn't bet)
Seat 5: 653af57c folded before Flop (didn't bet)
Seat 6: 87256f31 folded before Flop (didn't bet)


Poker Hand #RC3334444349: Hold'em No Limit ($0.02/$0.05) - 2025/02/17 20:51:25
Table 'RushAndCash609609' 6-max Seat #1 is the button
Seat 1: ee368e2c ($5.48 in chips)
Seat 2: dcee0577 ($7.45 in chips)
Seat 3: 735c4afd ($6.48 in chips)
Seat 4: 123dc5ea ($10.38 in chips)
Seat 5: Hero ($9.4 in chips)
Seat 6: 187f2194 ($11.17 in chips)
dcee0577: posts small blind $0.02
735c4afd: posts big blind $0.05
*** HOLE CARDS ***
Dealt to ee368e2c 
Dealt to dcee0577 
Dealt to 735c4afd 
Dealt to 123dc5ea 
Dealt to Hero [6s 5c]
Dealt to 187f2194 
123dc5ea: folds
Hero: folds
187f2194: folds
ee368e2c: folds
dcee0577: folds
Uncalled bet ($0.03) returned to 735c4afd
*** SHOWDOWN ***
735c4afd collected $0.04 from pot
*** SUMMARY ***
Total pot $0.04 | Rake $0 | Jackpot $0 | Bingo $0 | Fortune $0 | Tax $0
Seat 1: ee368e2c (button) folded before Flop (didn't bet)
Seat 2: dcee0577 (small blind) folded before Flop
Seat 3: 735c4afd (big blind) collected ($0.04)
Seat 4: 123dc5ea folded before Flop (didn't bet)
Seat 5: Hero folded before Flop (didn't bet)
Seat 6: 187f2194 folded before Flop (didn't bet)


Poker Hand #RC3334444232: Hold'em No Limit ($0.02/$0.05) - 2025/02/17 20:51:08
Table 'RushAndCash609492' 6-max Seat #1 is the button
Seat 1: cac5ff82 ($4.43 in chips)
Seat 2: Hero ($9.35 in chips)
Seat 3: 2e8ab509 ($5.04 in chips)
Seat 4: ea7a7ae0 ($8.11 in chips)
Seat 5: 1a54a2fc ($10.15 in chips)
Seat 6: 3f138d48 ($6.34 in chips)
Hero: posts small blind $0.02
2e8ab509: posts big blind $0.05
*** HOLE CARDS ***
Dealt to cac5ff82 
Dealt to Hero [Jc Ah]
Dealt to 2e8ab509 
Dealt to ea7a7ae0 
Dealt to 1a54a2fc 
Dealt to 3f138d48 
ea7a7ae0: folds
1a54a2fc: folds
3f138d48: folds
cac5ff82: folds
Hero: raises $0.1 to $0.15
2e8ab509: folds
Uncalled bet ($0.1) returned to Hero
*** SHOWDOWN ***
Hero collected $0.1 from pot
*** SUMMARY ***
Total pot $0.1 | Rake $0 | Jackpot $0 | Bingo $0 | Fortune $0 | Tax $0
Seat 1: cac5ff82 (button) folded before Flop (didn't bet)
Seat 2: Hero (small blind) collected ($0.1)
Seat 3: 2e8ab509 (big blind) folded before Flop
Seat 4: ea7a7ae0 folded before Flop (didn't bet)
Seat 5: 1a54a2fc folded before Flop (didn't bet)
Seat 6: 3f138d48 folded before Flop (didn't bet)


Poker Hand #RC3334443835: Hold'em No Limit ($0.02/$0.05) - 2025/02/17 20:50:14
Table 'RushAndCash609095' 6-max Seat #1 is the button
Seat 1: de247624 ($5 in chips)
Seat 2: c3940b84 ($5.12 in chips)
Seat 3: 46cf35ec ($5.05 in chips)
Seat 4: eb7fd0bf ($5 in chips)
Seat 5: 3f138d48 ($7 in chips)
Seat 6: Hero ($8.69 in chips)
c3940b84: posts small blind $0.02
46cf35ec: posts big blind $0.05
*** HOLE CARDS ***
Dealt to de247624 
Dealt to c3940b84 
Dealt to 46cf35ec 
Dealt to eb7fd0bf 
Dealt to 3f138d48 
Dealt to Hero [As Ac]
eb7fd0bf: folds
3f138d48: raises $0.08 to $0.13
Hero: raises $0.25 to $0.38
de247624: folds
c3940b84: folds
46cf35ec: folds
3f138d48: calls $0.25
*** FLOP *** [6c Qc 3s]
3f138d48: checks
Hero: bets $0.28
3f138d48: calls $0.28
*** TURN *** [6c Qc 3s] [8h]
3f138d48: checks
Hero: checks
*** RIVER *** [6c Qc 3s 8h] [Ad]
3f138d48: checks
Hero: bets $0.7
3f138d48: folds
Uncalled bet ($0.7) returned to Hero
*** SHOWDOWN ***
Hero collected $1.32 from pot
*** SUMMARY ***
Total pot $1.39 | Rake $0.07 | Jackpot $0 | Bingo $0 | Fortune $0 | Tax $0
Board [6c Qc 3s 8h Ad]
Seat 1: de247624 (button) folded before Flop (didn't bet)
Seat 2: c3940b84 (small blind) folded before Flop
Seat 3: 46cf35ec (big blind) folded before Flop
Seat 4: eb7fd0bf folded before Flop (didn't bet)
Seat 5: 3f138d48 folded on the River
Seat 6: Hero won ($1.32)


Poker Hand #RC3334443783: Hold'em No Limit ($0.02/$0.05) - 2025/02/17 20:50:07
Table 'RushAndCash609043' 6-max Seat #1 is the button
Seat 1: 242c2683 ($1.07 in chips)
Seat 2: 717e9861 ($5.22 in chips)
Seat 3: 6ac4af54 ($13.37 in chips)
Seat 4: cb0795b5 ($6.38 in chips)
Seat 5: 780645d6 ($5.34 in chips)
Seat 6: Hero ($8.69 in chips)
717e9861: posts small blind $0.02
6ac4af54: posts big blind $0.05
*** HOLE CARDS ***
Dealt to 242c2683 
Dealt to 717e9861 
Dealt to 6ac4af54 
Dealt to cb0795b5 
Dealt to 780645d6 
Dealt to Hero [3s 8d]
cb0795b5: folds
780645d6: folds
Hero: folds
242c2683: calls $0.05
717e9861: folds
6ac4af54: checks
*** FLOP *** [6h 5c Tc]
6ac4af54: checks
242c2683: bets $0.06
6ac4af54: folds
Uncalled bet ($0.06) returned to 242c2683
*** SHOWDOWN ***
242c2683 collected $0.12 from pot
*** SUMMARY ***
Total pot $0.12 | Rake $0 | Jackpot $0 | Bingo $0 | Fortune $0 | Tax $0
Board [6h 5c Tc]
Seat 1: 242c2683 (button) won ($0.12)
Seat 2: 717e9861 (small blind) folded before Flop
Seat 3: 6ac4af54 (big blind) folded on the Flop
Seat 4: cb0795b5 folded before Flop (didn't bet)
Seat 5: 780645d6 folded before Flop (didn't bet)
Seat 6: Hero folded before Flop (didn't bet)


Poker Hand #RC3334443762: Hold'em No Limit ($0.02/$0.05) - 2025/02/17 20:50:04
Table 'RushAndCash609022' 6-max Seat #1 is the button
Seat 1: Hero ($8.69 in chips)
Seat 2: bfef046a ($26.99 in chips)
Seat 3: f3f5406e ($15.2 in chips)
Seat 4: edbb0bb6 ($5.11 in chips)
Seat 5: 9c13950e ($8.32 in chips)
Seat 6: 719071b8 ($5 in chips)
bfef046a: posts small blind $0.02
f3f5406e: posts big blind $0.05
*** HOLE CARDS ***
Dealt to Hero [3c 4h]
Dealt to bfef046a 
Dealt to f3f5406e 
Dealt to edbb0bb6 
Dealt to 9c13950e 
Dealt to 719071b8 
edbb0bb6: folds
9c13950e: folds
719071b8: raises $0.06 to $0.11
Hero: folds
bfef046a: folds
f3f5406e: folds
Uncalled bet ($0.06) returned to 719071b8
*** SHOWDOWN ***
719071b8 collected $0.12 from pot
*** SUMMARY ***
Total pot $0.12 | Rake $0 | Jackpot $0 | Bingo $0 | Fortune $0 | Tax $0
Seat 1: Hero (button) folded before Flop (didn't bet)
Seat 2: bfef046a (small blind) folded before Flop
Seat 3: f3f5406e (big blind) folded before Flop
Seat 4: edbb0bb6 folded before Flop (didn't bet)
Seat 5: 9c13950e folded before Flop (didn't bet)
Seat 6: 719071b8 collected ($0.12)


Poker Hand #RC3334443572: Hold'em No Limit ($0.02/$0.05) - 2025/02/17 20:49:38
Table 'RushAndCash608832' 6-max Seat #1 is the button
Seat 1: 56624886 ($5.76 in chips)
Seat 2: d58b99ca ($24.72 in chips)
Seat 3: Hero ($8.79 in chips)
Seat 4: 1754e33c ($5 in chips)
Seat 5: 200ba768 ($3.07 in chips)
Seat 6: edbb0bb6 ($5 in chips)
d58b99ca: posts small blind $0.02
Hero: posts big blind $0.05
*** HOLE CARDS ***
Dealt to 56624886 
Dealt to d58b99ca 
Dealt to Hero [Kd Qc]
Dealt to 1754e33c 
Dealt to 200ba768 
Dealt to edbb0bb6 
1754e33c: folds
200ba768: folds
edbb0bb6: raises $0.05 to $0.1
56624886: folds
d58b99ca: folds
Hero: calls $0.05
*** FLOP *** [Td Ts 6d]
Hero: checks
edbb0bb6: bets $0.16
Hero: folds
Uncalled bet ($0.16) returned to edbb0bb6
*** SHOWDOWN ***
edbb0bb6 collected $0.21 from pot
*** SUMMARY ***
Total pot $0.22 | Rake $0.01 | Jackpot $0 | Bingo $0 | Fortune $0 | Tax $0
Board [Td Ts 6d]
Seat 1: 56624886 (button) folded before Flop (didn't bet)
Seat 2: d58b99ca (small blind) folded before Flop
Seat 3: Hero (big blind) folded on the Flop
Seat 4: 1754e33c folded before Flop (didn't bet)
Seat 5: 200ba768 folded before Flop (didn't bet)
Seat 6: edbb0bb6 won ($0.21)


Poker Hand #RC3334443500: Hold'em No Limit ($0.02/$0.05) - 2025/02/17 20:49:29
Table 'RushAndCash608760' 6-max Seat #1 is the button
Seat 1: 1f85219b ($7 in chips)
Seat 2: b9ae439d ($7.27 in chips)
Seat 3: Hero ($8.84 in chips)
Seat 4: fb6c4072 ($6.04 in chips)
Seat 5: fa7bb2c5 ($5.09 in chips)
Seat 6: e74a324 ($6.83 in chips)
b9ae439d: posts small blind $0.02
Hero: posts big blind $0.05
*** HOLE CARDS ***
Dealt to 1f85219b 
Dealt to b9ae439d 
Dealt to Hero [6h 8h]
Dealt to fb6c4072 
Dealt to fa7bb2c5 
Dealt to e74a324 
fb6c4072: raises $0.08 to $0.13
fa7bb2c5: raises $0.25 to $0.38
e74a324: folds
1f85219b: folds
b9ae439d: folds
Hero: folds
fb6c4072: calls $0.25
*** FLOP *** [4d 4c 9c]
fb6c4072: checks
fa7bb2c5: bets $0.56
fb6c4072: folds
Uncalled bet ($0.56) returned to fa7bb2c5
*** SHOWDOWN ***
fa7bb2c5 collected $0.79 from pot
*** SUMMARY ***
Total pot $0.83 | Rake $0.04 | Jackpot $0 | Bingo $0 | Fortune $0 | Tax $0
Board [4d 4c 9c]
Seat 1: 1f85219b (button) folded before Flop (didn't bet)
Seat 2: b9ae439d (small blind) folded before Flop
Seat 3: Hero (big blind) folded before Flop
Seat 4: fb6c4072 folded on the Flop
Seat 5: fa7bb2c5 won ($0.79)
Seat 6: e74a324 folded before Flop (didn't bet)


Poker Hand #RC3334443473: Hold'em No Limit ($0.02/$0.05) - 2025/02/17 20:49:26
Table 'RushAndCash608733' 6-max Seat #1 is the button
Seat 1: 27baaa05 ($6.34 in chips)
Seat 2: c62b7a0b ($19.22 in chips)
Seat 3: 4c9f897a ($5 in chips)
Seat 4: 3f138d48 ($7.18 in chips)
Seat 5: 5e166e9a ($5 in chips)
Seat 6: Hero ($8.84 in chips)
c62b7a0b: posts small blind $0.02
4c9f897a: posts big blind $0.05
*** HOLE CARDS ***
Dealt to 27baaa05 
Dealt to c62b7a0b 
Dealt to 4c9f897a 
Dealt to 3f138d48 
Dealt to 5e166e9a 
Dealt to Hero [2h Jd]
3f138d48: folds
5e166e9a: folds
Hero: folds
27baaa05: folds
c62b7a0b: folds
Uncalled bet ($0.03) returned to 4c9f897a
*** SHOWDOWN ***
4c9f897a collected $0.04 from pot
*** SUMMARY ***
Total pot $0.04 | Rake $0 | Jackpot $0 | Bingo $0 | Fortune $0 | Tax $0
Seat 1: 27baaa05 (button) folded before Flop (didn't bet)
Seat 2: c62b7a0b (small blind) folded before Flop
Seat 3: 4c9f897a (big blind) collected ($0.04)
Seat 4: 3f138d48 folded before Flop (didn't bet)
Seat 5: 5e166e9a folded before Flop (didn't bet)
Seat 6: Hero folded before Flop (didn't bet)


Poker Hand #RC3334443432: Hold'em No Limit ($0.02/$0.05) - 2025/02/17 20:49:20
Table 'RushAndCash608692' 6-max Seat #1 is the button
Seat 1: e9c5dfd7 ($7.92 in chips)
Seat 2: af9df96 ($5.11 in chips)
Seat 3: 180f5daf ($9.54 in chips)
Seat 4: Hero ($8.84 in chips)
Seat 5: fc71f850 ($5.28 in chips)
Seat 6: 187f2194 ($11.42 in chips)
af9df96: posts small blind $0.02
180f5daf: posts big blind $0.05
*** HOLE CARDS ***
Dealt to e9c5dfd7 
Dealt to af9df96 
Dealt to 180f5daf 
Dealt to Hero [7h 2s]
Dealt to fc71f850 
Dealt to 187f2194 
Hero: folds
fc71f850: folds
187f2194: folds
e9c5dfd7: raises $0.05 to $0.1
af9df96: folds
180f5daf: folds
Uncalled bet ($0.05) returned to e9c5dfd7
*** SHOWDOWN ***
e9c5dfd7 collected $0.12 from pot
*** SUMMARY ***
Total pot $0.12 | Rake $0 | Jackpot $0 | Bingo $0 | Fortune $0 | Tax $0
Seat 1: e9c5dfd7 (button) collected ($0.12)
Seat 2: af9df96 (small blind) folded before Flop
Seat 3: 180f5daf (big blind) folded before Flop
Seat 4: Hero folded before Flop (didn't bet)
Seat 5: fc71f850 folded before Flop (didn't bet)
Seat 6: 187f2194 folded before Flop (didn't bet)


Poker Hand #RC3334443409: Hold'em No Limit ($0.02/$0.05) - 2025/02/17 20:49:17
Table 'RushAndCash608669' 6-max Seat #1 is the button
Seat 1: 18e8e582 ($10.02 in chips)
Seat 2: fa40c39c ($3 in chips)
Seat 3: 1b6c31ec ($6.08 in chips)
Seat 4: Hero ($8.84 in chips)
Seat 5: d58b99ca ($24.86 in chips)
Seat 6: e8b95847 ($5.07 in chips)
fa40c39c: posts small blind $0.02
1b6c31ec: posts big blind $0.05
*** HOLE CARDS ***
Dealt to 18e8e582 
Dealt to fa40c39c 
Dealt to 1b6c31ec 
Dealt to Hero [2d 7c]
Dealt to d58b99ca 
Dealt to e8b95847 
Hero: folds
d58b99ca: folds
e8b95847: folds
18e8e582: folds
fa40c39c: folds
Uncalled bet ($0.03) returned to 1b6c31ec
*** SHOWDOWN ***
1b6c31ec collected $0.04 from pot
*** SUMMARY ***
Total pot $0.04 | Rake $0 | Jackpot $0 | Bingo $0 | Fortune $0 | Tax $0
Seat 1: 18e8e582 (button) folded before Flop (didn't bet)
Seat 2: fa40c39c (small blind) folded before Flop
Seat 3: 1b6c31ec (big blind) collected ($0.04)
Seat 4: Hero folded before Flop (didn't bet)
Seat 5: d58b99ca folded before Flop (didn't bet)
Seat 6: e8b95847 folded before Flop (didn't bet)


Poker Hand #RC3334443379: Hold'em No Limit ($0.02/$0.05) - 2025/02/17 20:49:14
Table 'RushAndCash608639' 6-max Seat #1 is the button
Seat 1: Hero ($8.84 in chips)
Seat 2: b67f7812 ($8.93 in chips)
Seat 3: 75091df4 ($7.36 in chips)
Seat 4: 77368e62 ($5.72 in chips)
Seat 5: fa40c39c ($3 in chips)
Seat 6: 1063406 ($10.23 in chips)
b67f7812: posts small blind $0.02
75091df4: posts big blind $0.05
*** HOLE CARDS ***
Dealt to Hero [4d 6s]
Dealt to b67f7812 
Dealt to 75091df4 
Dealt to 77368e62 
Dealt to fa40c39c 
Dealt to 1063406 
77368e62: calls $0.05
fa40c39c: folds
1063406: folds
Hero: folds
b67f7812: folds
75091df4: checks
*** FLOP *** [5c 4s 6d]
75091df4: checks
77368e62: checks
*** TURN *** [5c 4s 6d] [Kh]
75091df4: bets $0.06
77368e62: folds
Uncalled bet ($0.06) returned to 75091df4
*** SHOWDOWN ***
75091df4 collected $0.12 from pot
*** SUMMARY ***
Total pot $0.12 | Rake $0 | Jackpot $0 | Bingo $0 | Fortune $0 | Tax $0
Board [5c 4s 6d Kh]
Seat 1: Hero (button) folded before Flop (didn't bet)
Seat 2: b67f7812 (small blind) folded before Flop
Seat 3: 75091df4 (big blind) won ($0.12)
Seat 4: 77368e62 folded on the Turn
Seat 5: fa40c39c folded before Flop (didn't bet)
Seat 6: 1063406 folded before Flop (didn't bet)


Poker Hand #RC3334443357: Hold'em No Limit ($0.02/$0.05) - 2025/02/17 20:49:11
Table 'RushAndCash608617' 6-max Seat #1 is the button
Seat 1: e8b95847 ($5.07 in chips)
Seat 2: Hero ($8.86 in chips)
Seat 3: 74f9576e ($5.07 in chips)
Seat 4: 940cc635 ($5.05 in chips)
Seat 5: fdbac393 ($5.24 in chips)
Seat 6: e662d075 ($4.77 in chips)
Hero: posts small blind $0.02
74f9576e: posts big blind $0.05
*** HOLE CARDS ***
Dealt to e8b95847 
Dealt to Hero [Jc Qs]
Dealt to 74f9576e 
Dealt to 940cc635 
Dealt to fdbac393 
Dealt to e662d075 
940cc635: folds
fdbac393: raises $0.05 to $0.1
e662d075: folds
e8b95847: folds
Hero: folds
74f9576e: folds
Uncalled bet ($0.05) returned to fdbac393
*** SHOWDOWN ***
fdbac393 collected $0.12 from pot
*** SUMMARY ***
Total pot $0.12 | Rake $0 | Jackpot $0 | Bingo $0 | Fortune $0 | Tax $0
Seat 1: e8b95847 (button) folded before Flop (didn't bet)
Seat 2: Hero (small blind) folded before Flop
Seat 3: 74f9576e (big blind) folded before Flop
Seat 4: 940cc635 folded before Flop (didn't bet)
Seat 5: fdbac393 collected ($0.12)
Seat 6: e662d075 folded before Flop (didn't bet)


Poker Hand #RC3334443334: Hold'em No Limit ($0.02/$0.05) - 2025/02/17 20:49:07
Table 'RushAndCash608594' 6-max Seat #1 is the button
Seat 1: f3614ba1 ($5.12 in chips)
Seat 2: 835df346 ($14.48 in chips)
Seat 3: 1095926a ($5.24 in chips)
Seat 4: Hero ($8.86 in chips)
Seat 5: 8c3789e ($6.72 in chips)
Seat 6: e662d075 ($4.77 in chips)
835df346: posts small blind $0.02
1095926a: posts big blind $0.05
*** HOLE CARDS ***
Dealt to f3614ba1 
Dealt to 835df346 
Dealt to 1095926a 
Dealt to Hero [4h 8s]
Dealt to 8c3789e 
Dealt to e662d075 
Hero: folds
8c3789e: raises $0.08 to $0.13
e662d075: folds
f3614ba1: folds
835df346: folds
1095926a: folds
Uncalled bet ($0.08) returned to 8c3789e
*** SHOWDOWN ***
8c3789e collected $0.12 from pot
*** SUMMARY ***
Total pot $0.12 | Rake $0 | Jackpot $0 | Bingo $0 | Fortune $0 | Tax $0
Seat 1: f3614ba1 (button) folded before Flop (didn't bet)
Seat 2: 835df346 (small blind) folded before Flop
Seat 3: 1095926a (big blind) folded before Flop
Seat 4: Hero folded before Flop (didn't bet)
Seat 5: 8c3789e collected ($0.12)
Seat 6: e662d075 folded before Flop (didn't bet)


Poker Hand #RC3334443310: Hold'em No Limit ($0.02/$0.05) - 2025/02/17 20:49:04
Table 'RushAndCash608570' 6-max Seat #1 is the button
Seat 1: 194ee370 ($7.46 in chips)
Seat 2: 55630016 ($8.56 in chips)
Seat 3: 157631a0 ($5.15 in chips)
Seat 4: Hero ($8.86 in chips)
Seat 5: 571b193 ($5.07 in chips)
Seat 6: f1a26906 ($5 in chips)
55630016: posts small blind $0.02
157631a0: posts big blind $0.05
*** HOLE CARDS ***
Dealt to 194ee370 
Dealt to 55630016 
Dealt to 157631a0 
Dealt to Hero [4c 9s]
Dealt to 571b193 
Dealt to f1a26906 
Hero: folds
571b193: folds
f1a26906: raises $0.05 to $0.1
194ee370: folds
55630016: folds
157631a0: calls $0.05
*** FLOP *** [3h 9c Qs]
157631a0: checks
f1a26906: bets $0.08
157631a0: calls $0.08
*** TURN *** [3h 9c Qs] [8s]
157631a0: checks
f1a26906: bets $0.21
157631a0: raises $0.5 to $0.71
f1a26906: calls $0.5
*** RIVER *** [3h 9c Qs 8s] [4d]
157631a0: bets $1.8
f1a26906: calls $1.8
157631a0: shows [8c Qc] (Pair of Queens and Pair of Eights)
f1a26906: shows [8h 9h] (Pair of Nines and Pair of Eights)
*** SHOWDOWN ***
157631a0 collected $5.18 from pot
*** SUMMARY ***
Total pot $5.4 | Rake $0.15 | Jackpot $0.07 | Bingo $0 | Fortune $0 | Tax $0
Board [3h 9c Qs 8s 4d]
Seat 1: 194ee370 (button) folded before Flop (didn't bet)
Seat 2: 55630016 (small blind) folded before Flop
Seat 3: 157631a0 (big blind) showed [8c Qc] and won ($5.18) with Pair of Queens and Pair of Eights
Seat 4: Hero folded before Flop (didn't bet)
Seat 5: 571b193 folded before Flop (didn't bet)
Seat 6: f1a26906 showed [8h 9h] and lost with Pair of Nines and Pair of Eights


Poker Hand #RC3334443112: Hold'em No Limit ($0.02/$0.05) - 2025/02/17 20:48:36
Table 'RushAndCash608372' 6-max Seat #1 is the button
Seat 1: 1f187ba0 ($4.25 in chips)
Seat 2: 6aa0c391 ($5.43 in chips)
Seat 3: 2eb4439f ($11.38 in chips)
Seat 4: Hero ($8.79 in chips)
Seat 5: fa7bb2c5 ($5 in chips)
Seat 6: 63de5630 ($6.28 in chips)
6aa0c391: posts small blind $0.02
2eb4439f: posts big blind $0.05
*** HOLE CARDS ***
Dealt to 1f187ba0 
Dealt to 6aa0c391 
Dealt to 2eb4439f 
Dealt to Hero [Qc Qs]
Dealt to fa7bb2c5 
Dealt to 63de5630 
Hero: raises $0.05 to $0.1
fa7bb2c5: folds
63de5630: folds
1f187ba0: folds
6aa0c391: folds
2eb4439f: folds
Uncalled bet ($0.05) returned to Hero
*** SHOWDOWN ***
Hero collected $0.12 from pot
*** SUMMARY ***
Total pot $0.12 | Rake $0 | Jackpot $0 | Bingo $0 | Fortune $0 | Tax $0
Seat 1: 1f187ba0 (button) folded before Flop (didn't bet)
Seat 2: 6aa0c391 (small blind) folded before Flop
Seat 3: 2eb4439f (big blind) folded before Flop
Seat 4: Hero collected ($0.12)
Seat 5: fa7bb2c5 folded before Flop (didn't bet)
Seat 6: 63de5630 folded before Flop (didn't bet)


Poker Hand #RC3334443053: Hold'em No Limit ($0.02/$0.05) - 2025/02/17 20:48:27
Table 'RushAndCash608313' 6-max Seat #1 is the button
Seat 1: 93dfef8b ($12.06 in chips)
Seat 2: a51b9462 ($5.09 in chips)
Seat 3: Hero ($8.77 in chips)
Seat 4: 842d7655 ($8.31 in chips)
Seat 5: e8b95847 ($5 in chips)
Seat 6: 8012317b ($11.68 in chips)
a51b9462: posts small blind $0.02
Hero: posts big blind $0.05
*** HOLE CARDS ***
Dealt to 93dfef8b 
Dealt to a51b9462 
Dealt to Hero [Qd As]
Dealt to 842d7655 
Dealt to e8b95847 
Dealt to 8012317b 
842d7655: folds
e8b95847: folds
8012317b: folds
93dfef8b: folds
a51b9462: folds
Uncalled bet ($0.03) returned to Hero
*** SHOWDOWN ***
Hero collected $0.04 from pot
*** SUMMARY ***
Total pot $0.04 | Rake $0 | Jackpot $0 | Bingo $0 | Fortune $0 | Tax $0
Seat 1: 93dfef8b (button) folded before Flop (didn't bet)
Seat 2: a51b9462 (small blind) folded before Flop
Seat 3: Hero (big blind) collected ($0.04)
Seat 4: 842d7655 folded before Flop (didn't bet)
Seat 5: e8b95847 folded before Flop (didn't bet)
Seat 6: 8012317b folded before Flop (didn't bet)


Poker Hand #RC3334443026: Hold'em No Limit ($0.02/$0.05) - 2025/02/17 20:48:23
Table 'RushAndCash608286' 6-max Seat #1 is the button
Seat 1: Hero ($8.77 in chips)
Seat 2: 84fb210c ($13.85 in chips)
Seat 3: 1696890b ($4.68 in chips)
Seat 4: 207d9345 ($22.53 in chips)
Seat 5: 41720de0 ($19.51 in chips)
Seat 6: 842d7655 ($8.31 in chips)
84fb210c: posts small blind $0.02
1696890b: posts big blind $0.05
*** HOLE CARDS ***
Dealt to Hero [4c Jh]
Dealt to 84fb210c 
Dealt to 1696890b 
Dealt to 207d9345 
Dealt to 41720de0 
Dealt to 842d7655 
207d9345: folds
41720de0: folds
842d7655: folds
Hero: folds
84fb210c: folds
Uncalled bet ($0.03) returned to 1696890b
*** SHOWDOWN ***
1696890b collected $0.04 from pot
*** SUMMARY ***
Total pot $0.04 | Rake $0 | Jackpot $0 | Bingo $0 | Fortune $0 | Tax $0
Seat 1: Hero (button) folded before Flop (didn't bet)
Seat 2: 84fb210c (small blind) folded before Flop
Seat 3: 1696890b (big blind) collected ($0.04)
Seat 4: 207d9345 folded before Flop (didn't bet)
Seat 5: 41720de0 folded before Flop (didn't bet)
Seat 6: 842d7655 folded before Flop (didn't bet)


Poker Hand #RC3334443000: Hold'em No Limit ($0.02/$0.05) - 2025/02/17 20:48:20
Table 'RushAndCash608260' 6-max Seat #1 is the button
Seat 1: f71501ed ($5.4 in chips)
Seat 2: eb7fd0bf ($5.14 in chips)
Seat 3: 18767060 ($12.63 in chips)
Seat 4: f18b40b7 ($3.58 in chips)
Seat 5: 94b22b92 ($5.12 in chips)
Seat 6: Hero ($8.77 in chips)
eb7fd0bf: posts small blind $0.02
18767060: posts big blind $0.05
*** HOLE CARDS ***
Dealt to f71501ed 
Dealt to eb7fd0bf 
Dealt to 18767060 
Dealt to f18b40b7 
Dealt to 94b22b92 
Dealt to Hero [5h 3s]
f18b40b7: raises $0.05 to $0.1
94b22b92: folds
Hero: folds
f71501ed: raises $0.25 to $0.35
eb7fd0bf: folds
18767060: calls $0.3
f18b40b7: calls $0.25
*** FLOP *** [2d 2c 5c]
18767060: checks
f18b40b7: checks
f71501ed: checks
*** TURN *** [2d 2c 5c] [Jc]
18767060: checks
f18b40b7: bets $0.36
f71501ed: folds
18767060: folds
Uncalled bet ($0.36) returned to f18b40b7
*** SHOWDOWN ***
f18b40b7 collected $1.02 from pot
*** SUMMARY ***
Total pot $1.07 | Rake $0.05 | Jackpot $0 | Bingo $0 | Fortune $0 | Tax $0
Board [2d 2c 5c Jc]
Seat 1: f71501ed (button) folded on the Turn
Seat 2: eb7fd0bf (small blind) folded before Flop
Seat 3: 18767060 (big blind) folded on the Turn
Seat 4: f18b40b7 won ($1.02)
Seat 5: 94b22b92 folded before Flop (didn't bet)
Seat 6: Hero folded before Flop (didn't bet)


Poker Hand #RC3334442665: Hold'em No Limit ($0.02/$0.05) - 2025/02/17 20:47:30
Table 'RushAndCash607925' 6-max Seat #1 is the button
Seat 1: 9b99e93a ($10.97 in chips)
Seat 2: Hero ($8.92 in chips)
Seat 3: eb7fd0bf ($5 in chips)
Seat 4: 6662e866 ($15.84 in chips)
Seat 5: 63499226 ($3.08 in chips)
Seat 6: b64a83d ($8.41 in chips)
Hero: posts small blind $0.02
eb7fd0bf: posts big blind $0.05
*** HOLE CARDS ***
Dealt to 9b99e93a 
Dealt to Hero [Ts Ac]
Dealt to eb7fd0bf 
Dealt to 6662e866 
Dealt to 63499226 
Dealt to b64a83d 
6662e866: folds
63499226: folds
b64a83d: folds
9b99e93a: folds
Hero: raises $0.1 to $0.15
eb7fd0bf: calls $0.1
*** FLOP *** [3s Kc 8s]
Hero: checks
eb7fd0bf: bets $0.15
Hero: folds
Uncalled bet ($0.15) returned to eb7fd0bf
*** SHOWDOWN ***
eb7fd0bf collected $0.29 from pot
*** SUMMARY ***
Total pot $0.3 | Rake $0.01 | Jackpot $0 | Bingo $0 | Fortune $0 | Tax $0
Board [3s Kc 8s]
Seat 1: 9b99e93a (button) folded before Flop (didn't bet)
Seat 2: Hero (small blind) folded on the Flop
Seat 3: eb7fd0bf (big blind) won ($0.29)
Seat 4: 6662e866 folded before Flop (didn't bet)
Seat 5: 63499226 folded before Flop (didn't bet)
Seat 6: b64a83d folded before Flop (didn't bet)


Poker Hand #RC3334442515: Hold'em No Limit ($0.02/$0.05) - 2025/02/17 20:47:08
Table 'RushAndCash607775' 6-max Seat #1 is the button
Seat 1: 2b6388ee ($6.23 in chips)
Seat 2: 29ffb7d5 ($6.05 in chips)
Seat 3: Hero ($8.83 in chips)
Seat 4: 9f09d482 ($6.99 in chips)
Seat 5: a223d3ca ($5.13 in chips)
Seat 6: 5fe62400 ($6.33 in chips)
29ffb7d5: posts small blind $0.02
Hero: posts big blind $0.05
*** HOLE CARDS ***
Dealt to 2b6388ee 
Dealt to 29ffb7d5 
Dealt to Hero [Ah As]
Dealt to 9f09d482 
Dealt to a223d3ca 
Dealt to 5fe62400 
9f09d482: folds
a223d3ca: folds
5fe62400: folds
2b6388ee: folds
29ffb7d5: raises $0.05 to $0.1
Hero: raises $0.26 to $0.36
29ffb7d5: folds
Uncalled bet ($0.26) returned to Hero
*** SHOWDOWN ***
Hero collected $0.19 from pot
*** SUMMARY ***
Total pot $0.2 | Rake $0.01 | Jackpot $0 | Bingo $0 | Fortune $0 | Tax $0
Seat 1: 2b6388ee (button) folded before Flop (didn't bet)
Seat 2: 29ffb7d5 (small blind) folded before Flop
Seat 3: Hero (big blind) collected ($0.19)
Seat 4: 9f09d482 folded before Flop (didn't bet)
Seat 5: a223d3ca folded before Flop (didn't bet)
Seat 6: 5fe62400 folded before Flop (didn't bet)


Poker Hand #RC3334442490: Hold'em No Limit ($0.02/$0.05) - 2025/02/17 20:47:05
Table 'RushAndCash607750' 6-max Seat #1 is the button
Seat 1: 1ce64dd8 ($5.28 in chips)
Seat 2: Hero ($8.85 in chips)
Seat 3: 8563d168 ($2 in chips)
Seat 4: 9ccadbb5 ($13.1 in chips)
Seat 5: 491e0e63 ($5.97 in chips)
Seat 6: 14d966a6 ($5.92 in chips)
Hero: posts small blind $0.02
8563d168: posts big blind $0.05
*** HOLE CARDS ***
Dealt to 1ce64dd8 
Dealt to Hero [6d Qc]
Dealt to 8563d168 
Dealt to 9ccadbb5 
Dealt to 491e0e63 
Dealt to 14d966a6 
9ccadbb5: folds
491e0e63: folds
14d966a6: folds
1ce64dd8: raises $0.08 to $0.13
Hero: folds
8563d168: calls $0.08
*** FLOP *** [9d 8h 5s]
8563d168: bets $0.1
1ce64dd8: calls $0.1
*** TURN *** [9d 8h 5s] [Jd]
8563d168: bets $0.48
1ce64dd8: calls $0.48
*** RIVER *** [9d 8h 5s Jd] [9c]
8563d168: bets $1.29 and is all-in
1ce64dd8: calls $1.29
8563d168: shows [3h 8c] (Pair of Nines and Pair of Eights)
1ce64dd8: shows [Ks Jc] (Pair of Jacks and Pair of Nines)
*** SHOWDOWN ***
1ce64dd8 collected $3.8 from pot
*** SUMMARY ***
Total pot $4.02 | Rake $0.15 | Jackpot $0.07 | Bingo $0 | Fortune $0 | Tax $0
Board [9d 8h 5s Jd 9c]
Seat 1: 1ce64dd8 (button) showed [Ks Jc] and won ($3.8) with Pair of Jacks and Pair of Nines
Seat 2: Hero (small blind) folded before Flop
Seat 3: 8563d168 (big blind) showed [3h 8c] and lost with Pair of Nines and Pair of Eights
Seat 4: 9ccadbb5 folded before Flop (didn't bet)
Seat 5: 491e0e63 folded before Flop (didn't bet)
Seat 6: 14d966a6 folded before Flop (didn't bet)


Poker Hand #RC3334442466: Hold'em No Limit ($0.02/$0.05) - 2025/02/17 20:47:01
Table 'RushAndCash607726' 6-max Seat #1 is the button
Seat 1: 868c7021 ($3.38 in chips)
Seat 2: e20e5cfc ($5.17 in chips)
Seat 3: 18cb11a ($6.4 in chips)
Seat 4: fc71f850 ($5.28 in chips)
Seat 5: Hero ($8.85 in chips)
Seat 6: e4fd2097 ($22.41 in chips)
e20e5cfc: posts small blind $0.02
18cb11a: posts big blind $0.05
*** HOLE CARDS ***
Dealt to 868c7021 
Dealt to e20e5cfc 
Dealt to 18cb11a 
Dealt to fc71f850 
Dealt to Hero [4h 6d]
Dealt to e4fd2097 
fc71f850: raises $0.05 to $0.1
Hero: folds
e4fd2097: folds
868c7021: folds
e20e5cfc: folds
18cb11a: folds
Uncalled bet ($0.05) returned to fc71f850
*** SHOWDOWN ***
fc71f850 collected $0.12 from pot
*** SUMMARY ***
Total pot $0.12 | Rake $0 | Jackpot $0 | Bingo $0 | Fortune $0 | Tax $0
Seat 1: 868c7021 (button) folded before Flop (didn't bet)
Seat 2: e20e5cfc (small blind) folded before Flop
Seat 3: 18cb11a (big blind) folded before Flop
Seat 4: fc71f850 collected ($0.12)
Seat 5: Hero folded before Flop (didn't bet)
Seat 6: e4fd2097 folded before Flop (didn't bet)


Poker Hand #RC3334442420: Hold'em No Limit ($0.02/$0.05) - 2025/02/17 20:46:54
Table 'RushAndCash607680' 6-max Seat #1 is the button
Seat 1: 84f270f8 ($7.27 in chips)
Seat 2: 3ffd6491 ($5.85 in chips)
Seat 3: 653af57c ($5.11 in chips)
Seat 4: 4e55fa29 ($5.18 in chips)
Seat 5: Hero ($8.85 in chips)
Seat 6: f2a32196 ($5.12 in chips)
3ffd6491: posts small blind $0.02
653af57c: posts big blind $0.05
*** HOLE CARDS ***
Dealt to 84f270f8 
Dealt to 3ffd6491 
Dealt to 653af57c 
Dealt to 4e55fa29 
Dealt to Hero [6h 8h]
Dealt to f2a32196 
4e55fa29: folds
Hero: folds
f2a32196: folds
84f270f8: folds
3ffd6491: folds
Uncalled bet ($0.03) returned to 653af57c
*** SHOWDOWN ***
653af57c collected $0.04 from pot
*** SUMMARY ***
Total pot $0.04 | Rake $0 | Jackpot $0 | Bingo $0 | Fortune $0 | Tax $0
Seat 1: 84f270f8 (button) folded before Flop (didn't bet)
Seat 2: 3ffd6491 (small blind) folded before Flop
Seat 3: 653af57c (big blind) collected ($0.04)
Seat 4: 4e55fa29 folded before Flop (didn't bet)
Seat 5: Hero folded before Flop (didn't bet)
Seat 6: f2a32196 folded before Flop (didn't bet)


Poker Hand #RC3334442392: Hold'em No Limit ($0.02/$0.05) - 2025/02/17 20:46:50
Table 'RushAndCash607652' 6-max Seat #1 is the button
Seat 1: Hero ($8.85 in chips)
Seat 2: d201e5fe ($7.45 in chips)
Seat 3: f0d238ad ($10.4 in chips)
Seat 4: 94cb065d ($5.07 in chips)
Seat 5: 1aca371e ($9.7 in chips)
Seat 6: 84f270f8 ($7.27 in chips)
d201e5fe: posts small blind $0.02
f0d238ad: posts big blind $0.05
*** HOLE CARDS ***
Dealt to Hero [4s 9c]
Dealt to d201e5fe 
Dealt to f0d238ad 
Dealt to 94cb065d 
Dealt to 1aca371e 
Dealt to 84f270f8 
94cb065d: raises $0.08 to $0.13
1aca371e: folds
84f270f8: folds
Hero: folds
d201e5fe: folds
f0d238ad: calls $0.08
*** FLOP *** [9d 4c 4d]
f0d238ad: checks
94cb065d: checks
*** TURN *** [9d 4c 4d] [5c]
f0d238ad: bets $0.2
94cb065d: folds
Uncalled bet ($0.2) returned to f0d238ad
*** SHOWDOWN ***
f0d238ad collected $0.27 from pot
*** SUMMARY ***
Total pot $0.28 | Rake $0.01 | Jackpot $0 | Bingo $0 | Fortune $0 | Tax $0
Board [9d 4c 4d 5c]
Seat 1: Hero (button) folded before Flop (didn't bet)
Seat 2: d201e5fe (small blind) folded before Flop
Seat 3: f0d238ad (big blind) won ($0.27)
Seat 4: 94cb065d folded on the Turn
Seat 5: 1aca371e folded before Flop (didn't bet)
Seat 6: 84f270f8 folded before Flop (didn't bet)


Poker Hand #RC3334442369: Hold'em No Limit ($0.02/$0.05) - 2025/02/17 20:46:47
Table 'RushAndCash607629' 6-max Seat #1 is the button
Seat 1: 11b91184 ($6.2 in chips)
Seat 2: d88bd80a ($5.62 in chips)
Seat 3: e20e5cfc ($5.22 in chips)
Seat 4: Hero ($8.85 in chips)
Seat 5: e4fd27d ($10.32 in chips)
Seat 6: 9b7e5117 ($3.16 in chips)
d88bd80a: posts small blind $0.02
e20e5cfc: posts big blind $0.05
*** HOLE CARDS ***
Dealt to 11b91184 
Dealt to d88bd80a 
Dealt to e20e5cfc 
Dealt to Hero [6d 3c]
Dealt to e4fd27d 
Dealt to 9b7e5117 
Hero: folds
e4fd27d: raises $0.07 to $0.12
9b7e5117: raises $0.25 to $0.37
11b91184: folds
d88bd80a: folds
e20e5cfc: folds
e4fd27d: raises $0.63 to $1
9b7e5117: raises $2.16 to $3.16 and is all-in
e4fd27d: calls $2.16
9b7e5117: shows [Tc Td]
e4fd27d: shows [Qc Qs]
*** FLOP *** [Ah 3h 7c]
*** TURN *** [Ah 3h 7c] [6c]
e4fd27d: Chooses to EV Cashout
*** RIVER *** [Ah 3h 7c 6c] [Jh]
e4fd27d: Pays Cashout Risk ($0.2)
*** SHOWDOWN ***
e4fd27d collected $6.17 from pot
*** SUMMARY ***
Total pot $6.39 | Rake $0.15 | Jackpot $0.07 | Bingo $0 | Fortune $0 | Tax $0
Board [Ah 3h 7c 6c Jh]
Seat 1: 11b91184 (button) folded before Flop (didn't bet)
Seat 2: d88bd80a (small blind) folded before Flop
Seat 3: e20e5cfc (big blind) folded before Flop
Seat 4: Hero folded before Flop (didn't bet)
Seat 5: e4fd27d showed [Qc Qs] and won ($6.17) with Pair of Queens, Cashout Risk ($0.2)
Seat 6: 9b7e5117 showed [Tc Td] and lost with Pair of Tens


Poker Hand #RC3334442350: Hold'em No Limit ($0.02/$0.05) - 2025/02/17 20:46:44
Table 'RushAndCash607610' 6-max Seat #1 is the button
Seat 1: 4b15f54e ($5 in chips)
Seat 2: 27baaa05 ($6.01 in chips)
Seat 3: 4238ab48 ($5 in chips)
Seat 4: a63aa4b7 ($5.37 in chips)
Seat 5: ee3fdfd8 ($6.36 in chips)
Seat 6: Hero ($8.85 in chips)
27baaa05: posts small blind $0.02
4238ab48: posts big blind $0.05
*** HOLE CARDS ***
Dealt to 4b15f54e 
Dealt to 27baaa05 
Dealt to 4238ab48 
Dealt to a63aa4b7 
Dealt to ee3fdfd8 
Dealt to Hero [3c 9c]
a63aa4b7: raises $0.05 to $0.1
ee3fdfd8: folds
Hero: folds
4b15f54e: folds
27baaa05: folds
4238ab48: folds
Uncalled bet ($0.05) returned to a63aa4b7
*** SHOWDOWN ***
a63aa4b7 collected $0.12 from pot
*** SUMMARY ***
Total pot $0.12 | Rake $0 | Jackpot $0 | Bingo $0 | Fortune $0 | Tax $0
Seat 1: 4b15f54e (button) folded before Flop (didn't bet)
Seat 2: 27baaa05 (small blind) folded before Flop
Seat 3: 4238ab48 (big blind) folded before Flop
Seat 4: a63aa4b7 collected ($0.12)
Seat 5: ee3fdfd8 folded before Flop (didn't bet)
Seat 6: Hero folded before Flop (didn't bet)


Poker Hand #RC3334442306: Hold'em No Limit ($0.02/$0.05) - 2025/02/17 20:46:38
Table 'RushAndCash607566' 6-max Seat #1 is the button
Seat 1: a51b9462 ($5 in chips)
Seat 2: 60df1ea0 ($4.89 in chips)
Seat 3: Hero ($8.9 in chips)
Seat 4: 1f85219b ($6.87 in chips)
Seat 5: 81e8e5cc ($5.11 in chips)
Seat 6: 9f9e1094 ($5.16 in chips)
60df1ea0: posts small blind $0.02
Hero: posts big blind $0.05
*** HOLE CARDS ***
Dealt to a51b9462 
Dealt to 60df1ea0 
Dealt to Hero [6c Ts]
Dealt to 1f85219b 
Dealt to 81e8e5cc 
Dealt to 9f9e1094 
1f85219b: folds
81e8e5cc: folds
9f9e1094: folds
a51b9462: folds
60df1ea0: raises $0.1 to $0.15
Hero: folds
Uncalled bet ($0.1) returned to 60df1ea0
*** SHOWDOWN ***
60df1ea0 collected $0.1 from pot
*** SUMMARY ***
Total pot $0.1 | Rake $0 | Jackpot $0 | Bingo $0 | Fortune $0 | Tax $0
Seat 1: a51b9462 (button) folded before Flop (didn't bet)
Seat 2: 60df1ea0 (small blind) collected ($0.1)
Seat 3: Hero (big blind) folded before Flop
Seat 4: 1f85219b folded before Flop (didn't bet)
Seat 5: 81e8e5cc folded before Flop (didn't bet)
Seat 6: 9f9e1094 folded before Flop (didn't bet)


Poker Hand #RC3334442218: Hold'em No Limit ($0.02/$0.05) - 2025/02/17 20:46:23
Table 'RushAndCash607478' 6-max Seat #1 is the button
Seat 1: 2dba12ed ($5 in chips)
Seat 2: 6a231779 ($9.1 in chips)
Seat 3: f3614ba1 ($5.09 in chips)
Seat 4: 73b4eb32 ($2.94 in chips)
Seat 5: 69c3afd2 ($6.53 in chips)
Seat 6: Hero ($8.83 in chips)
6a231779: posts small blind $0.02
f3614ba1: posts big blind $0.05
*** HOLE CARDS ***
Dealt to 2dba12ed 
Dealt to 6a231779 
Dealt to f3614ba1 
Dealt to 73b4eb32 
Dealt to 69c3afd2 
Dealt to Hero [Ks Qs]
73b4eb32: folds
69c3afd2: folds
Hero: raises $0.05 to $0.1
2dba12ed: folds
6a231779: folds
f3614ba1: folds
Uncalled bet ($0.05) returned to Hero
*** SHOWDOWN ***
Hero collected $0.12 from pot
*** SUMMARY ***
Total pot $0.12 | Rake $0 | Jackpot $0 | Bingo $0 | Fortune $0 | Tax $0
Seat 1: 2dba12ed (button) folded before Flop (didn't bet)
Seat 2: 6a231779 (small blind) folded before Flop
Seat 3: f3614ba1 (big blind) folded before Flop
Seat 4: 73b4eb32 folded before Flop (didn't bet)
Seat 5: 69c3afd2 folded before Flop (didn't bet)
Seat 6: Hero collected ($0.12)


Poker Hand #RC3334442140: Hold'em No Limit ($0.02/$0.05) - 2025/02/17 20:46:11
Table 'RushAndCash607400' 6-max Seat #1 is the button
Seat 1: 621c3c07 ($5.14 in chips)
Seat 2: eaafe260 ($10.68 in chips)
Seat 3: 7b6a3077 ($6.88 in chips)
Seat 4: 9e7c02e6 ($5 in chips)
Seat 5: 45d33c76 ($8.54 in chips)
Seat 6: Hero ($8.76 in chips)
eaafe260: posts small blind $0.02
7b6a3077: posts big blind $0.05
*** HOLE CARDS ***
Dealt to 621c3c07 
Dealt to eaafe260 
Dealt to 7b6a3077 
Dealt to 9e7c02e6 
Dealt to 45d33c76 
Dealt to Hero [Ts 9s]
9e7c02e6: folds
45d33c76: folds
Hero: raises $0.05 to $0.1
621c3c07: folds
eaafe260: folds
7b6a3077: folds
Uncalled bet ($0.05) returned to Hero
*** SHOWDOWN ***
Hero collected $0.12 from pot
*** SUMMARY ***
Total pot $0.12 | Rake $0 | Jackpot $0 | Bingo $0 | Fortune $0 | Tax $0
Seat 1: 621c3c07 (button) folded before Flop (didn't bet)
Seat 2: eaafe260 (small blind) folded before Flop
Seat 3: 7b6a3077 (big blind) folded before Flop
Seat 4: 9e7c02e6 folded before Flop (didn't bet)
Seat 5: 45d33c76 folded before Flop (didn't bet)
Seat 6: Hero collected ($0.12)


Poker Hand #RC3334441903: Hold'em No Limit ($0.02/$0.05) - 2025/02/17 20:45:34
Table 'RushAndCash607163' 6-max Seat #1 is the button
Seat 1: 60df1ea0 ($4.93 in chips)
Seat 2: Hero ($8.86 in chips)
Seat 3: fcc3c3cc ($8.49 in chips)
Seat 4: 1da8eae5 ($4.57 in chips)
Seat 5: 621c3c07 ($5 in chips)
Seat 6: 626359de ($13.47 in chips)
Hero: posts small blind $0.02
fcc3c3cc: posts big blind $0.05
*** HOLE CARDS ***
Dealt to 60df1ea0 
Dealt to Hero [Ad 8d]
Dealt to fcc3c3cc 
Dealt to 1da8eae5 
Dealt to 621c3c07 
Dealt to 626359de 
1da8eae5: folds
621c3c07: raises $0.05 to $0.1
626359de: folds
60df1ea0: folds
Hero: calls $0.08
fcc3c3cc: folds
*** FLOP *** [4h Kd Kc]
Hero: checks
621c3c07: bets $0.09
Hero: folds
Uncalled bet ($0.09) returned to 621c3c07
*** SHOWDOWN ***
621c3c07 collected $0.24 from pot
*** SUMMARY ***
Total pot $0.25 | Rake $0.01 | Jackpot $0 | Bingo $0 | Fortune $0 | Tax $0
Board [4h Kd Kc]
Seat 1: 60df1ea0 (button) folded before Flop (didn't bet)
Seat 2: Hero (small blind) folded on the Flop
Seat 3: fcc3c3cc (big blind) folded before Flop
Seat 4: 1da8eae5 folded before Flop (didn't bet)
Seat 5: 621c3c07 won ($0.24)
Seat 6: 626359de folded before Flop (didn't bet)


Poker Hand #RC3334441885: Hold'em No Limit ($0.02/$0.05) - 2025/02/17 20:45:32
Table 'RushAndCash607145' 6-max Seat #1 is the button
Seat 1: Hero ($8.86 in chips)
Seat 2: b59fc0b9 ($5.04 in chips)
Seat 3: 21bff972 ($5.03 in chips)
Seat 4: e9c5dfd7 ($8.65 in chips)
Seat 5: 886c894a ($10.32 in chips)
Seat 6: 4e3c3196 ($29.16 in chips)
b59fc0b9: posts small blind $0.02
21bff972: posts big blind $0.05
*** HOLE CARDS ***
Dealt to Hero [5c 8h]
Dealt to b59fc0b9 
Dealt to 21bff972 
Dealt to e9c5dfd7 
Dealt to 886c894a 
Dealt to 4e3c3196 
e9c5dfd7: raises $0.05 to $0.1
886c894a: folds
4e3c3196: folds
Hero: folds
b59fc0b9: folds
21bff972: calls $0.05
*** FLOP *** [4c Jd 9h]
21bff972: checks
e9c5dfd7: checks
*** TURN *** [4c Jd 9h] [8c]
21bff972: bets $0.1
e9c5dfd7: calls $0.1
*** RIVER *** [4c Jd 9h 8c] [5s]
21bff972: bets $0.35
e9c5dfd7: folds
Uncalled bet ($0.35) returned to 21bff972
*** SHOWDOWN ***
21bff972 collected $0.4 from pot
*** SUMMARY ***
Total pot $0.42 | Rake $0.02 | Jackpot $0 | Bingo $0 | Fortune $0 | Tax $0
Board [4c Jd 9h 8c 5s]
Seat 1: Hero (button) folded before Flop (didn't bet)
Seat 2: b59fc0b9 (small blind) folded before Flop
Seat 3: 21bff972 (big blind) won ($0.4)
Seat 4: e9c5dfd7 folded on the River
Seat 5: 886c894a folded before Flop (didn't bet)
Seat 6: 4e3c3196 folded before Flop (didn't bet)


Poker Hand #RC3334441864: Hold'em No Limit ($0.02/$0.05) - 2025/02/17 20:45:28
Table 'RushAndCash607124' 6-max Seat #1 is the button
Seat 1: 14620cce ($15.27 in chips)
Seat 2: Hero ($8.88 in chips)
Seat 3: d916afa1 ($6.45 in chips)
Seat 4: 6571f81e ($4.75 in chips)
Seat 5: dbf5f543 ($6.27 in chips)
Seat 6: a28ca95c ($20.14 in chips)
Hero: posts small blind $0.02
d916afa1: posts big blind $0.05
*** HOLE CARDS ***
Dealt to 14620cce 
Dealt to Hero [Th 9d]
Dealt to d916afa1 
Dealt to 6571f81e 
Dealt to dbf5f543 
Dealt to a28ca95c 
6571f81e: folds
dbf5f543: folds
a28ca95c: folds
14620cce: raises $0.08 to $0.13
Hero: folds
d916afa1: folds
Uncalled bet ($0.08) returned to 14620cce
*** SHOWDOWN ***
14620cce collected $0.12 from pot
*** SUMMARY ***
Total pot $0.12 | Rake $0 | Jackpot $0 | Bingo $0 | Fortune $0 | Tax $0
Seat 1: 14620cce (button) collected ($0.12)
Seat 2: Hero (small blind) folded before Flop
Seat 3: d916afa1 (big blind) folded before Flop
Seat 4: 6571f81e folded before Flop (didn't bet)
Seat 5: dbf5f543 folded before Flop (didn't bet)
Seat 6: a28ca95c folded before Flop (didn't bet)


Poker Hand #RC3334441829: Hold'em No Limit ($0.02/$0.05) - 2025/02/17 20:45:23
Table 'RushAndCash607089' 6-max Seat #1 is the button
Seat 1: 84a1bb5f ($5 in chips)
Seat 2: d738c756 ($3.41 in chips)
Seat 3: 8012317b ($11.98 in chips)
Seat 4: 16081ce9 ($14.21 in chips)
Seat 5: Hero ($8.88 in chips)
Seat 6: 570c97fe ($6.25 in chips)
d738c756: posts small blind $0.02
8012317b: posts big blind $0.05
*** HOLE CARDS ***
Dealt to 84a1bb5f 
Dealt to d738c756 
Dealt to 8012317b 
Dealt to 16081ce9 
Dealt to Hero [9h Qs]
Dealt to 570c97fe 
16081ce9: folds
Hero: folds
570c97fe: raises $0.1 to $0.15
84a1bb5f: folds
d738c756: folds
8012317b: folds
Uncalled bet ($0.1) returned to 570c97fe
*** SHOWDOWN ***
570c97fe collected $0.12 from pot
*** SUMMARY ***
Total pot $0.12 | Rake $0 | Jackpot $0 | Bingo $0 | Fortune $0 | Tax $0
Seat 1: 84a1bb5f (button) folded before Flop (didn't bet)
Seat 2: d738c756 (small blind) folded before Flop
Seat 3: 8012317b (big blind) folded before Flop
Seat 4: 16081ce9 folded before Flop (didn't bet)
Seat 5: Hero folded before Flop (didn't bet)
Seat 6: 570c97fe collected ($0.12)


Poker Hand #RC3334441534: Hold'em No Limit ($0.02/$0.05) - 2025/02/17 20:44:40
Table 'RushAndCash606794' 6-max Seat #1 is the button
Seat 1: Hero ($8.29 in chips)
Seat 2: dfe61c13 ($4.89 in chips)
Seat 3: f20f94d9 ($5 in chips)
Seat 4: 6ac4af54 ($14.86 in chips)
Seat 5: 8a2a3713 ($4.09 in chips)
Seat 6: 15125d65 ($10.74 in chips)
dfe61c13: posts small blind $0.02
f20f94d9: posts big blind $0.05
*** HOLE CARDS ***
Dealt to Hero [Ah Qh]
Dealt to dfe61c13 
Dealt to f20f94d9 
Dealt to 6ac4af54 
Dealt to 8a2a3713 
Dealt to 15125d65 
6ac4af54: folds
8a2a3713: folds
15125d65: folds
Hero: raises $0.05 to $0.1
dfe61c13: raises $0.25 to $0.35
f20f94d9: folds
Hero: calls $0.25
*** FLOP *** [Td Ac Tc]
dfe61c13: bets $0.25
Hero: calls $0.25
*** TURN *** [Td Ac Tc] [5c]
dfe61c13: checks
Hero: checks
*** RIVER *** [Td Ac Tc 5c] [Ks]
dfe61c13: checks
Hero: checks
dfe61c13: shows [6c 6d] (Pair of Tens and Pair of Sixes)
Hero: shows [Ah Qh] (Pair of Aces and Pair of Tens)
*** SHOWDOWN ***
Hero collected $1.19 from pot
*** SUMMARY ***
Total pot $1.25 | Rake $0.06 | Jackpot $0 | Bingo $0 | Fortune $0 | Tax $0
Board [Td Ac Tc 5c Ks]
Seat 1: Hero (button) showed [Ah Qh] and won ($1.19) with Pair of Aces and Pair of Tens
Seat 2: dfe61c13 (small blind) showed [6c 6d] and lost with Pair of Tens and Pair of Sixes
Seat 3: f20f94d9 (big blind) folded before Flop
Seat 4: 6ac4af54 folded before Flop (didn't bet)
Seat 5: 8a2a3713 folded before Flop (didn't bet)
Seat 6: 15125d65 folded before Flop (didn't bet)


Poker Hand #RC3334441464: Hold'em No Limit ($0.02/$0.05) - 2025/02/17 20:44:30
Table 'RushAndCash606724' 6-max Seat #1 is the button
Seat 1: fc9f1189 ($5.83 in chips)
Seat 2: 4264790d ($5 in chips)
Seat 3: Hero ($8.34 in chips)
Seat 4: 6a231779 ($9.64 in chips)
Seat 5: 95003d9e ($4.65 in chips)
Seat 6: b2966865 ($5 in chips)
4264790d: posts small blind $0.02
Hero: posts big blind $0.05
*** HOLE CARDS ***
Dealt to fc9f1189 
Dealt to 4264790d 
Dealt to Hero [7h 8h]
Dealt to 6a231779 
Dealt to 95003d9e 
Dealt to b2966865 
6a231779: folds
95003d9e: raises $0.05 to $0.1
b2966865: folds
fc9f1189: folds
4264790d: raises $0.38 to $0.48
Hero: folds
95003d9e: calls $0.38
*** FLOP *** [Ts Ac 2s]
4264790d: checks
95003d9e: checks
*** TURN *** [Ts Ac 2s] [9c]
4264790d: checks
95003d9e: checks
*** RIVER *** [Ts Ac 2s 9c] [9h]
4264790d: bets $0.76
95003d9e: folds
Uncalled bet ($0.76) returned to 4264790d
*** SHOWDOWN ***
4264790d collected $0.96 from pot
*** SUMMARY ***
Total pot $1.01 | Rake $0.05 | Jackpot $0 | Bingo $0 | Fortune $0 | Tax $0
Board [Ts Ac 2s 9c 9h]
Seat 1: fc9f1189 (button) folded before Flop (didn't bet)
Seat 2: 4264790d (small blind) won ($0.96)
Seat 3: Hero (big blind) folded before Flop
Seat 4: 6a231779 folded before Flop (didn't bet)
Seat 5: 95003d9e folded on the River
Seat 6: b2966865 folded before Flop (didn't bet)


Poker Hand #RC3334441437: Hold'em No Limit ($0.02/$0.05) - 2025/02/17 20:44:27
Table 'RushAndCash606697' 6-max Seat #1 is the button
Seat 1: d58b99ca ($13.55 in chips)
Seat 2: e7a0ba42 ($5 in chips)
Seat 3: 4264790d ($5 in chips)
Seat 4: 1696890b ($8.41 in chips)
Seat 5: 2b8b2921 ($8.22 in chips)
Seat 6: Hero ($8.34 in chips)
e7a0ba42: posts small blind $0.02
4264790d: posts big blind $0.05
*** HOLE CARDS ***
Dealt to d58b99ca 
Dealt to e7a0ba42 
Dealt to 4264790d 
Dealt to 1696890b 
Dealt to 2b8b2921 
Dealt to Hero [Ac 6h]
1696890b: raises $0.1 to $0.15
2b8b2921: folds
Hero: folds
d58b99ca: folds
e7a0ba42: raises $0.45 to $0.6
4264790d: folds
1696890b: raises $0.75 to $1.35
e7a0ba42: calls $0.75
*** FLOP *** [9d 8h 4h]
e7a0ba42: checks
1696890b: bets $0.8
e7a0ba42: calls $0.8
*** TURN *** [9d 8h 4h] [3h]
e7a0ba42: checks
1696890b: bets $3.27
e7a0ba42: calls $2.85 and is all-in
Uncalled bet ($0.42) returned to 1696890b
1696890b: shows [Ks Kh] (Pair of Kings)
e7a0ba42: shows [Ah As] (Pair of Aces)
*** RIVER *** [9d 8h 4h 3h] [2s]
*** SHOWDOWN ***
e7a0ba42 collected $9.83 from pot
*** SUMMARY ***
Total pot $10.05 | Rake $0.15 | Jackpot $0.07 | Bingo $0 | Fortune $0 | Tax $0
Board [9d 8h 4h 3h 2s]
Seat 1: d58b99ca (button) folded before Flop (didn't bet)
Seat 2: e7a0ba42 (small blind) showed [Ah As] and won ($9.83) with Pair of Aces
Seat 3: 4264790d (big blind) folded before Flop
Seat 4: 1696890b showed [Ks Kh] and lost with Pair of Kings
Seat 5: 2b8b2921 folded before Flop (didn't bet)
Seat 6: Hero folded before Flop (didn't bet)


Poker Hand #RC3334441413: Hold'em No Limit ($0.02/$0.05) - 2025/02/17 20:44:24
Table 'RushAndCash606673' 6-max Seat #1 is the button
Seat 1: e72c7748 ($9.33 in chips)
Seat 2: 18af90c ($11.71 in chips)
Seat 3: d1cd1071 ($14.34 in chips)
Seat 4: Hero ($8.34 in chips)
Seat 5: fc9f1189 ($5.83 in chips)
Seat 6: c6fd2d52 ($5.07 in chips)
18af90c: posts small blind $0.02
d1cd1071: posts big blind $0.05
*** HOLE CARDS ***
Dealt to e72c7748 
Dealt to 18af90c 
Dealt to d1cd1071 
Dealt to Hero [As 6s]
Dealt to fc9f1189 
Dealt to c6fd2d52 
Hero: folds
fc9f1189: folds
c6fd2d52: raises $0.05 to $0.1
e72c7748: folds
18af90c: folds
d1cd1071: calls $0.05
*** FLOP *** [6h 4s 9h]
d1cd1071: checks
c6fd2d52: bets $0.06
d1cd1071: raises $0.26 to $0.32
c6fd2d52: folds
Uncalled bet ($0.26) returned to d1cd1071
*** SHOWDOWN ***
d1cd1071 collected $0.33 from pot
*** SUMMARY ***
Total pot $0.34 | Rake $0.01 | Jackpot $0 | Bingo $0 | Fortune $0 | Tax $0
Board [6h 4s 9h]
Seat 1: e72c7748 (button) folded before Flop (didn't bet)
Seat 2: 18af90c (small blind) folded before Flop
Seat 3: d1cd1071 (big blind) won ($0.33)
Seat 4: Hero folded before Flop (didn't bet)
Seat 5: fc9f1189 folded before Flop (didn't bet)
Seat 6: c6fd2d52 folded on the Flop


Poker Hand #RC3334441326: Hold'em No Limit ($0.02/$0.05) - 2025/02/17 20:44:12
Table 'RushAndCash606586' 6-max Seat #1 is the button
Seat 1: e72c7748 ($9.33 in chips)
Seat 2: cf593991 ($5 in chips)
Seat 3: 72fa4c0f ($3.43 in chips)
Seat 4: 7b070d46 ($3.05 in chips)
Seat 5: 4ea8e2e ($15.08 in chips)
Seat 6: Hero ($8.27 in chips)
cf593991: posts small blind $0.02
72fa4c0f: posts big blind $0.05
*** HOLE CARDS ***
Dealt to e72c7748 
Dealt to cf593991 
Dealt to 72fa4c0f 
Dealt to 7b070d46 
Dealt to 4ea8e2e 
Dealt to Hero [Ad Qd]
7b070d46: folds
4ea8e2e: folds
Hero: raises $0.05 to $0.1
e72c7748: folds
cf593991: folds
72fa4c0f: folds
Uncalled bet ($0.05) returned to Hero
*** SHOWDOWN ***
Hero collected $0.12 from pot
*** SUMMARY ***
Total pot $0.12 | Rake $0 | Jackpot $0 | Bingo $0 | Fortune $0 | Tax $0
Seat 1: e72c7748 (button) folded before Flop (didn't bet)
Seat 2: cf593991 (small blind) folded before Flop
Seat 3: 72fa4c0f (big blind) folded before Flop
Seat 4: 7b070d46 folded before Flop (didn't bet)
Seat 5: 4ea8e2e folded before Flop (didn't bet)
Seat 6: Hero collected ($0.12)


Poker Hand #RC3334441299: Hold'em No Limit ($0.02/$0.05) - 2025/02/17 20:44:08
Table 'RushAndCash606559' 6-max Seat #1 is the button
Seat 1: e352a329 ($5.48 in chips)
Seat 2: 8c1b0cdf ($2.53 in chips)
Seat 3: 4e55fa29 ($4.4 in chips)
Seat 4: 72fa4c0f ($3.43 in chips)
Seat 5: 9f09d482 ($7.02 in chips)
Seat 6: Hero ($8.27 in chips)
8c1b0cdf: posts small blind $0.02
4e55fa29: posts big blind $0.05
*** HOLE CARDS ***
Dealt to e352a329 
Dealt to 8c1b0cdf 
Dealt to 4e55fa29 
Dealt to 72fa4c0f 
Dealt to 9f09d482 
Dealt to Hero [Ks 8h]
72fa4c0f: folds
9f09d482: folds
Hero: folds
e352a329: raises $0.08 to $0.13
8c1b0cdf: folds
4e55fa29: folds
Uncalled bet ($0.08) returned to e352a329
*** SHOWDOWN ***
e352a329 collected $0.12 from pot
*** SUMMARY ***
Total pot $0.12 | Rake $0 | Jackpot $0 | Bingo $0 | Fortune $0 | Tax $0
Seat 1: e352a329 (button) collected ($0.12)
Seat 2: 8c1b0cdf (small blind) folded before Flop
Seat 3: 4e55fa29 (big blind) folded before Flop
Seat 4: 72fa4c0f folded before Flop (didn't bet)
Seat 5: 9f09d482 folded before Flop (didn't bet)
Seat 6: Hero folded before Flop (didn't bet)


Poker Hand #RC3334441222: Hold'em No Limit ($0.02/$0.05) - 2025/02/17 20:43:58
Table 'RushAndCash606482' 6-max Seat #1 is the button
Seat 1: 9dd1ff39 ($6.88 in chips)
Seat 2: f724ee99 ($5.09 in chips)
Seat 3: Hero ($8.25 in chips)
Seat 4: 65ca9276 ($7.19 in chips)
Seat 5: 7df4712d ($7.86 in chips)
Seat 6: cd1f87c8 ($8.52 in chips)
f724ee99: posts small blind $0.02
Hero: posts big blind $0.05
*** HOLE CARDS ***
Dealt to 9dd1ff39 
Dealt to f724ee99 
Dealt to Hero [4h Ts]
Dealt to 65ca9276 
Dealt to 7df4712d 
Dealt to cd1f87c8 
65ca9276: folds
7df4712d: folds
cd1f87c8: folds
9dd1ff39: folds
f724ee99: folds
Uncalled bet ($0.03) returned to Hero
*** SHOWDOWN ***
Hero collected $0.04 from pot
*** SUMMARY ***
Total pot $0.04 | Rake $0 | Jackpot $0 | Bingo $0 | Fortune $0 | Tax $0
Seat 1: 9dd1ff39 (button) folded before Flop (didn't bet)
Seat 2: f724ee99 (small blind) folded before Flop
Seat 3: Hero (big blind) collected ($0.04)
Seat 4: 65ca9276 folded before Flop (didn't bet)
Seat 5: 7df4712d folded before Flop (didn't bet)
Seat 6: cd1f87c8 folded before Flop (didn't bet)


Poker Hand #RC3334441132: Hold'em No Limit ($0.02/$0.05) - 2025/02/17 20:43:46
Table 'RushAndCash606392' 6-max Seat #1 is the button
Seat 1: Hero ($8.18 in chips)
Seat 2: c6fd2d52 ($5 in chips)
Seat 3: 6dc21e6a ($5 in chips)
Seat 4: 1157f85d ($5.54 in chips)
Seat 5: 151b0c91 ($4.28 in chips)
Seat 6: 18cb11a ($5.88 in chips)
c6fd2d52: posts small blind $0.02
6dc21e6a: posts big blind $0.05
*** HOLE CARDS ***
Dealt to Hero [Kd 9d]
Dealt to c6fd2d52 
Dealt to 6dc21e6a 
Dealt to 1157f85d 
Dealt to 151b0c91 
Dealt to 18cb11a 
1157f85d: folds
151b0c91: folds
18cb11a: folds
Hero: raises $0.05 to $0.1
c6fd2d52: folds
6dc21e6a: folds
Uncalled bet ($0.05) returned to Hero
*** SHOWDOWN ***
Hero collected $0.12 from pot
*** SUMMARY ***
Total pot $0.12 | Rake $0 | Jackpot $0 | Bingo $0 | Fortune $0 | Tax $0
Seat 1: Hero (button) collected ($0.12)
Seat 2: c6fd2d52 (small blind) folded before Flop
Seat 3: 6dc21e6a (big blind) folded before Flop
Seat 4: 1157f85d folded before Flop (didn't bet)
Seat 5: 151b0c91 folded before Flop (didn't bet)
Seat 6: 18cb11a folded before Flop (didn't bet)


Poker Hand #RC3334440868: Hold'em No Limit ($0.02/$0.05) - 2025/02/17 20:43:12
Table 'RushAndCash606128' 6-max Seat #1 is the button
Seat 1: 5a53cba2 ($5.33 in chips)
Seat 2: Hero ($8.33 in chips)
Seat 3: ded3640 ($5 in chips)
Seat 4: 18e1b476 ($5 in chips)
Seat 5: 7e8993bd ($4.41 in chips)
Seat 6: a86de18f ($1.55 in chips)
Hero: posts small blind $0.02
ded3640: posts big blind $0.05
*** HOLE CARDS ***
Dealt to 5a53cba2 
Dealt to Hero [Ad 8d]
Dealt to ded3640 
Dealt to 18e1b476 
Dealt to 7e8993bd 
Dealt to a86de18f 
18e1b476: folds
7e8993bd: folds
a86de18f: folds
5a53cba2: folds
Hero: raises $0.1 to $0.15
ded3640: calls $0.1
*** FLOP *** [Kc 4s 3s]
Hero: checks
ded3640: checks
*** TURN *** [Kc 4s 3s] [7h]
Hero: checks
ded3640: bets $0.24
Hero: folds
Uncalled bet ($0.24) returned to ded3640
*** SHOWDOWN ***
ded3640 collected $0.29 from pot
*** SUMMARY ***
Total pot $0.3 | Rake $0.01 | Jackpot $0 | Bingo $0 | Fortune $0 | Tax $0
Board [Kc 4s 3s 7h]
Seat 1: 5a53cba2 (button) folded before Flop (didn't bet)
Seat 2: Hero (small blind) folded on the Turn
Seat 3: ded3640 (big blind) won ($0.29)
Seat 4: 18e1b476 folded before Flop (didn't bet)
Seat 5: 7e8993bd folded before Flop (didn't bet)
Seat 6: a86de18f folded before Flop (didn't bet)


Poker Hand #RC3334440844: Hold'em No Limit ($0.02/$0.05) - 2025/02/17 20:43:08
Table 'RushAndCash606104' 6-max Seat #1 is the button
Seat 1: 16f2e5ce ($5.96 in chips)
Seat 2: 15346d36 ($3.58 in chips)
Seat 3: 84667b37 ($4.72 in chips)
Seat 4: c5f53436 ($7.9 in chips)
Seat 5: 8a2a3713 ($3.89 in chips)
Seat 6: Hero ($8.33 in chips)
15346d36: posts small blind $0.02
84667b37: posts big blind $0.05
*** HOLE CARDS ***
Dealt to 16f2e5ce 
Dealt to 15346d36 
Dealt to 84667b37 
Dealt to c5f53436 
Dealt to 8a2a3713 
Dealt to Hero [6s 3h]
c5f53436: calls $0.05
8a2a3713: folds
Hero: folds
16f2e5ce: folds
15346d36: calls $0.03
84667b37: checks
*** FLOP *** [Kh 6h 5s]
15346d36: checks
84667b37: checks
c5f53436: checks
*** TURN *** [Kh 6h 5s] [6c]
15346d36: checks
84667b37: checks
c5f53436: checks
*** RIVER *** [Kh 6h 5s 6c] [Ac]
15346d36: checks
84667b37: checks
c5f53436: bets $0.08
15346d36: folds
84667b37: folds
Uncalled bet ($0.08) returned to c5f53436
*** SHOWDOWN ***
c5f53436 collected $0.15 from pot
*** SUMMARY ***
Total pot $0.15 | Rake $0 | Jackpot $0 | Bingo $0 | Fortune $0 | Tax $0
Board [Kh 6h 5s 6c Ac]
Seat 1: 16f2e5ce (button) folded before Flop (didn't bet)
Seat 2: 15346d36 (small blind) folded on the River
Seat 3: 84667b37 (big blind) folded on the River
Seat 4: c5f53436 won ($0.15)
Seat 5: 8a2a3713 folded before Flop (didn't bet)
Seat 6: Hero folded before Flop (didn't bet)


Poker Hand #RC3334440788: Hold'em No Limit ($0.02/$0.05) - 2025/02/17 20:43:01
Table 'RushAndCash606048' 6-max Seat #1 is the button
Seat 1: 91e92de9 ($9.14 in chips)
Seat 2: 4abcea5e ($5.28 in chips)
Seat 3: 767730bd ($5 in chips)
Seat 4: 9283105e ($5.9 in chips)
Seat 5: Hero ($8.33 in chips)
Seat 6: 200ba768 ($4.19 in chips)
4abcea5e: posts small blind $0.02
767730bd: posts big blind $0.05
*** HOLE CARDS ***
Dealt to 91e92de9 
Dealt to 4abcea5e 
Dealt to 767730bd 
Dealt to 9283105e 
Dealt to Hero [Td Qs]
Dealt to 200ba768 
9283105e: folds
Hero: folds
200ba768: folds
91e92de9: folds
4abcea5e: folds
Uncalled bet ($0.03) returned to 767730bd
*** SHOWDOWN ***
767730bd collected $0.04 from pot
*** SUMMARY ***
Total pot $0.04 | Rake $0 | Jackpot $0 | Bingo $0 | Fortune $0 | Tax $0
Seat 1: 91e92de9 (button) folded before Flop (didn't bet)
Seat 2: 4abcea5e (small blind) folded before Flop
Seat 3: 767730bd (big blind) collected ($0.04)
Seat 4: 9283105e folded before Flop (didn't bet)
Seat 5: Hero folded before Flop (didn't bet)
Seat 6: 200ba768 folded before Flop (didn't bet)


Poker Hand #RC3334440697: Hold'em No Limit ($0.02/$0.05) - 2025/02/17 20:42:50
Table 'RushAndCash605957' 6-max Seat #1 is the button
Seat 1: 5c64b878 ($5.43 in chips)
Seat 2: 753b3d59 ($5 in chips)
Seat 3: 5381eb4c ($5.94 in chips)
Seat 4: 6db42a47 ($9.5 in chips)
Seat 5: Hero ($8.26 in chips)
Seat 6: 41926fd ($5.73 in chips)
753b3d59: posts small blind $0.02
5381eb4c: posts big blind $0.05
*** HOLE CARDS ***
Dealt to 5c64b878 
Dealt to 753b3d59 
Dealt to 5381eb4c 
Dealt to 6db42a47 
Dealt to Hero [As Qs]
Dealt to 41926fd 
6db42a47: folds
Hero: raises $0.05 to $0.1
41926fd: folds
5c64b878: folds
753b3d59: folds
5381eb4c: folds
Uncalled bet ($0.05) returned to Hero
*** SHOWDOWN ***
Hero collected $0.12 from pot
*** SUMMARY ***
Total pot $0.12 | Rake $0 | Jackpot $0 | Bingo $0 | Fortune $0 | Tax $0
Seat 1: 5c64b878 (button) folded before Flop (didn't bet)
Seat 2: 753b3d59 (small blind) folded before Flop
Seat 3: 5381eb4c (big blind) folded before Flop
Seat 4: 6db42a47 folded before Flop (didn't bet)
Seat 5: Hero collected ($0.12)
Seat 6: 41926fd folded before Flop (didn't bet)


Poker Hand #RC3334440673: Hold'em No Limit ($0.02/$0.05) - 2025/02/17 20:42:47
Table 'RushAndCash605933' 6-max Seat #1 is the button
Seat 1: 6c8cb957 ($5.05 in chips)
Seat 2: 77936ad9 ($6.35 in chips)
Seat 3: e69e22e ($14.59 in chips)
Seat 4: 8ec32764 ($5 in chips)
Seat 5: Hero ($8.26 in chips)
Seat 6: c92a5ecb ($7.02 in chips)
77936ad9: posts small blind $0.02
e69e22e: posts big blind $0.05
*** HOLE CARDS ***
Dealt to 6c8cb957 
Dealt to 77936ad9 
Dealt to e69e22e 
Dealt to 8ec32764 
Dealt to Hero [9s 2d]
Dealt to c92a5ecb 
8ec32764: raises $0.05 to $0.1
Hero: folds
c92a5ecb: folds
6c8cb957: folds
77936ad9: folds
e69e22e: folds
Uncalled bet ($0.05) returned to 8ec32764
*** SHOWDOWN ***
8ec32764 collected $0.12 from pot
*** SUMMARY ***
Total pot $0.12 | Rake $0 | Jackpot $0 | Bingo $0 | Fortune $0 | Tax $0
Seat 1: 6c8cb957 (button) folded before Flop (didn't bet)
Seat 2: 77936ad9 (small blind) folded before Flop
Seat 3: e69e22e (big blind) folded before Flop
Seat 4: 8ec32764 collected ($0.12)
Seat 5: Hero folded before Flop (didn't bet)
Seat 6: c92a5ecb folded before Flop (didn't bet)


Poker Hand #RC3334440642: Hold'em No Limit ($0.02/$0.05) - 2025/02/17 20:42:43
Table 'RushAndCash605902' 6-max Seat #1 is the button
Seat 1: Hero ($8.26 in chips)
Seat 2: 1f187ba0 ($4.69 in chips)
Seat 3: c7e9103c ($20.32 in chips)
Seat 4: c096c24 ($6.12 in chips)
Seat 5: f83d0c9c ($6.51 in chips)
Seat 6: 7ac56771 ($1.9 in chips)
1f187ba0: posts small blind $0.02
c7e9103c: posts big blind $0.05
*** HOLE CARDS ***
Dealt to Hero [2h 6s]
Dealt to 1f187ba0 
Dealt to c7e9103c 
Dealt to c096c24 
Dealt to f83d0c9c 
Dealt to 7ac56771 
c096c24: folds
f83d0c9c: folds
7ac56771: folds
Hero: folds
1f187ba0: raises $0.05 to $0.1
c7e9103c: folds
Uncalled bet ($0.05) returned to 1f187ba0
*** SHOWDOWN ***
1f187ba0 collected $0.1 from pot
*** SUMMARY ***
Total pot $0.1 | Rake $0 | Jackpot $0 | Bingo $0 | Fortune $0 | Tax $0
Seat 1: Hero (button) folded before Flop (didn't bet)
Seat 2: 1f187ba0 (small blind) collected ($0.1)
Seat 3: c7e9103c (big blind) folded before Flop
Seat 4: c096c24 folded before Flop (didn't bet)
Seat 5: f83d0c9c folded before Flop (didn't bet)
Seat 6: 7ac56771 folded before Flop (didn't bet)


Poker Hand #RC3334440618: Hold'em No Limit ($0.02/$0.05) - 2025/02/17 20:42:39
Table 'RushAndCash605878' 6-max Seat #1 is the button
Seat 1: dbb7a28 ($11.72 in chips)
Seat 2: 8e07c53 ($6.34 in chips)
Seat 3: Hero ($8.31 in chips)
Seat 4: 8f9fd8b1 ($7.12 in chips)
Seat 5: fe374609 ($5.43 in chips)
Seat 6: 95003d9e ($5.07 in chips)
8e07c53: posts small blind $0.02
Hero: posts big blind $0.05
*** HOLE CARDS ***
Dealt to dbb7a28 
Dealt to 8e07c53 
Dealt to Hero [3h 7s]
Dealt to 8f9fd8b1 
Dealt to fe374609 
Dealt to 95003d9e 
8f9fd8b1: folds
fe374609: folds
95003d9e: folds
dbb7a28: raises $0.05 to $0.1
8e07c53: folds
Hero: folds
Uncalled bet ($0.05) returned to dbb7a28
*** SHOWDOWN ***
dbb7a28 collected $0.12 from pot
*** SUMMARY ***
Total pot $0.12 | Rake $0 | Jackpot $0 | Bingo $0 | Fortune $0 | Tax $0
Seat 1: dbb7a28 (button) collected ($0.12)
Seat 2: 8e07c53 (small blind) folded before Flop
Seat 3: Hero (big blind) folded before Flop
Seat 4: 8f9fd8b1 folded before Flop (didn't bet)
Seat 5: fe374609 folded before Flop (didn't bet)
Seat 6: 95003d9e folded before Flop (didn't bet)


Poker Hand #RC3334440547: Hold'em No Limit ($0.02/$0.05) - 2025/02/17 20:42:29
Table 'RushAndCash605807' 6-max Seat #1 is the button
Seat 1: d201e5fe ($7.41 in chips)
Seat 2: 650e9dc7 ($5.31 in chips)
Seat 3: cf6b193c ($5.25 in chips)
Seat 4: Hero ($8.24 in chips)
Seat 5: 1f187ba0 ($4.69 in chips)
Seat 6: 679a8f7 ($5.14 in chips)
650e9dc7: posts small blind $0.02
cf6b193c: posts big blind $0.05
*** HOLE CARDS ***
Dealt to d201e5fe 
Dealt to 650e9dc7 
Dealt to cf6b193c 
Dealt to Hero [8h 8c]
Dealt to 1f187ba0 
Dealt to 679a8f7 
Hero: raises $0.05 to $0.1
1f187ba0: folds
679a8f7: folds
d201e5fe: folds
650e9dc7: folds
cf6b193c: folds
Uncalled bet ($0.05) returned to Hero
*** SHOWDOWN ***
Hero collected $0.12 from pot
*** SUMMARY ***
Total pot $0.12 | Rake $0 | Jackpot $0 | Bingo $0 | Fortune $0 | Tax $0
Seat 1: d201e5fe (button) folded before Flop (didn't bet)
Seat 2: 650e9dc7 (small blind) folded before Flop
Seat 3: cf6b193c (big blind) folded before Flop
Seat 4: Hero collected ($0.12)
Seat 5: 1f187ba0 folded before Flop (didn't bet)
Seat 6: 679a8f7 folded before Flop (didn't bet)


Poker Hand #RC3334440519: Hold'em No Limit ($0.02/$0.05) - 2025/02/17 20:42:26
Table 'RushAndCash605779' 6-max Seat #1 is the button
Seat 1: 6f4a31af ($5 in chips)
Seat 2: Hero ($8.26 in chips)
Seat 3: 1a54a2fc ($5.14 in chips)
Seat 4: 2b8b2921 ($8.47 in chips)
Seat 5: 191b60c1 ($12.5 in chips)
Seat 6: 22a3f0e8 ($5 in chips)
Hero: posts small blind $0.02
1a54a2fc: posts big blind $0.05
*** HOLE CARDS ***
Dealt to 6f4a31af 
Dealt to Hero [Js 9h]
Dealt to 1a54a2fc 
Dealt to 2b8b2921 
Dealt to 191b60c1 
Dealt to 22a3f0e8 
2b8b2921: folds
191b60c1: folds
22a3f0e8: folds
6f4a31af: folds
Hero: folds
Uncalled bet ($0.03) returned to 1a54a2fc
*** SHOWDOWN ***
1a54a2fc collected $0.04 from pot
*** SUMMARY ***
Total pot $0.04 | Rake $0 | Jackpot $0 | Bingo $0 | Fortune $0 | Tax $0
Seat 1: 6f4a31af (button) folded before Flop (didn't bet)
Seat 2: Hero (small blind) folded before Flop
Seat 3: 1a54a2fc (big blind) collected ($0.04)
Seat 4: 2b8b2921 folded before Flop (didn't bet)
Seat 5: 191b60c1 folded before Flop (didn't bet)
Seat 6: 22a3f0e8 folded before Flop (didn't bet)


Poker Hand #RC3334440496: Hold'em No Limit ($0.02/$0.05) - 2025/02/17 20:42:22
Table 'RushAndCash605756' 6-max Seat #1 is the button
Seat 1: 730098b8 ($7.86 in chips)
Seat 2: 94a63b6c ($5 in chips)
Seat 3: 735c4afd ($5.47 in chips)
Seat 4: 1df270b6 ($8.61 in chips)
Seat 5: Hero ($8.26 in chips)
Seat 6: 15fcb4bc ($2.6 in chips)
94a63b6c: posts small blind $0.02
735c4afd: posts big blind $0.05
*** HOLE CARDS ***
Dealt to 730098b8 
Dealt to 94a63b6c 
Dealt to 735c4afd 
Dealt to 1df270b6 
Dealt to Hero [5h Kh]
Dealt to 15fcb4bc 
1df270b6: folds
Hero: folds
15fcb4bc: calls $0.05
730098b8: folds
94a63b6c: folds
735c4afd: checks
*** FLOP *** [Jh Qs Jc]
735c4afd: checks
15fcb4bc: checks
*** TURN *** [Jh Qs Jc] [2d]
735c4afd: checks
15fcb4bc: checks
*** RIVER *** [Jh Qs Jc 2d] [Ts]
735c4afd: checks
15fcb4bc: checks
735c4afd: shows [2h 3c] (Pair of Jacks and Pair of Twos)
15fcb4bc: shows [4d 4c] (Pair of Jacks and Pair of Fours)
*** SHOWDOWN ***
15fcb4bc collected $0.12 from pot
*** SUMMARY ***
Total pot $0.12 | Rake $0 | Jackpot $0 | Bingo $0 | Fortune $0 | Tax $0
Board [Jh Qs Jc 2d Ts]
Seat 1: 730098b8 (button) folded before Flop (didn't bet)
Seat 2: 94a63b6c (small blind) folded before Flop
Seat 3: 735c4afd (big blind) showed [2h 3c] and lost with Pair of Jacks and Pair of Twos
Seat 4: 1df270b6 folded before Flop (didn't bet)
Seat 5: Hero folded before Flop (didn't bet)
Seat 6: 15fcb4bc showed [4d 4c] and won ($0.12) with Pair of Jacks and Pair of Fours


Poker Hand #RC3334440450: Hold'em No Limit ($0.02/$0.05) - 2025/02/17 20:42:15
Table 'RushAndCash605710' 6-max Seat #1 is the button
Seat 1: Hero ($8.26 in chips)
Seat 2: e74a324 ($5 in chips)
Seat 3: 1f06f573 ($5.16 in chips)
Seat 4: c11c2441 ($5.14 in chips)
Seat 5: e92b360e ($14.67 in chips)
Seat 6: 38a4c833 ($11.45 in chips)
e74a324: posts small blind $0.02
1f06f573: posts big blind $0.05
*** HOLE CARDS ***
Dealt to Hero [9s Qs]
Dealt to e74a324 
Dealt to 1f06f573 
Dealt to c11c2441 
Dealt to e92b360e 
Dealt to 38a4c833 
c11c2441: folds
e92b360e: raises $0.05 to $0.1
38a4c833: folds
Hero: folds
e74a324: folds
1f06f573: folds
Uncalled bet ($0.05) returned to e92b360e
*** SHOWDOWN ***
e92b360e collected $0.12 from pot
*** SUMMARY ***
Total pot $0.12 | Rake $0 | Jackpot $0 | Bingo $0 | Fortune $0 | Tax $0
Seat 1: Hero (button) folded before Flop (didn't bet)
Seat 2: e74a324 (small blind) folded before Flop
Seat 3: 1f06f573 (big blind) folded before Flop
Seat 4: c11c2441 folded before Flop (didn't bet)
Seat 5: e92b360e collected ($0.12)
Seat 6: 38a4c833 folded before Flop (didn't bet)


Poker Hand #RC3334440430: Hold'em No Limit ($0.02/$0.05) - 2025/02/17 20:42:12
Table 'RushAndCash605690' 6-max Seat #1 is the button
Seat 1: 8012317b ($12.38 in chips)
Seat 2: 577aa3d3 ($3.76 in chips)
Seat 3: Hero ($8.31 in chips)
Seat 4: 79df293 ($5 in chips)
Seat 5: 69492ace ($4.29 in chips)
Seat 6: 34a123ac ($5 in chips)
577aa3d3: posts small blind $0.02
Hero: posts big blind $0.05
*** HOLE CARDS ***
Dealt to 8012317b 
Dealt to 577aa3d3 
Dealt to Hero [Kh 2h]
Dealt to 79df293 
Dealt to 69492ace 
Dealt to 34a123ac 
79df293: folds
69492ace: folds
34a123ac: folds
8012317b: raises $0.07 to $0.12
577aa3d3: folds
Hero: folds
Uncalled bet ($0.07) returned to 8012317b
*** SHOWDOWN ***
8012317b collected $0.12 from pot
*** SUMMARY ***
Total pot $0.12 | Rake $0 | Jackpot $0 | Bingo $0 | Fortune $0 | Tax $0
Seat 1: 8012317b (button) collected ($0.12)
Seat 2: 577aa3d3 (small blind) folded before Flop
Seat 3: Hero (big blind) folded before Flop
Seat 4: 79df293 folded before Flop (didn't bet)
Seat 5: 69492ace folded before Flop (didn't bet)
Seat 6: 34a123ac folded before Flop (didn't bet)


Poker Hand #RC3334440407: Hold'em No Limit ($0.02/$0.05) - 2025/02/17 20:42:09
Table 'RushAndCash605667' 6-max Seat #1 is the button
Seat 1: 9b7e5117 ($3.97 in chips)
Seat 2: Hero ($8.33 in chips)
Seat 3: 1df270b6 ($8.66 in chips)
Seat 4: 93417a69 ($9.92 in chips)
Seat 5: 868c7021 ($3.92 in chips)
Seat 6: e26361cd ($5.39 in chips)
Hero: posts small blind $0.02
1df270b6: posts big blind $0.05
*** HOLE CARDS ***
Dealt to 9b7e5117 
Dealt to Hero [4h Qc]
Dealt to 1df270b6 
Dealt to 93417a69 
Dealt to 868c7021 
Dealt to e26361cd 
93417a69: folds
868c7021: folds
e26361cd: raises $0.06 to $0.11
9b7e5117: folds
Hero: folds
1df270b6: folds
Uncalled bet ($0.06) returned to e26361cd
*** SHOWDOWN ***
e26361cd collected $0.12 from pot
*** SUMMARY ***
Total pot $0.12 | Rake $0 | Jackpot $0 | Bingo $0 | Fortune $0 | Tax $0
Seat 1: 9b7e5117 (button) folded before Flop (didn't bet)
Seat 2: Hero (small blind) folded before Flop
Seat 3: 1df270b6 (big blind) folded before Flop
Seat 4: 93417a69 folded before Flop (didn't bet)
Seat 5: 868c7021 folded before Flop (didn't bet)
Seat 6: e26361cd collected ($0.12)


Poker Hand #RC3334440021: Hold'em No Limit ($0.02/$0.05) - 2025/02/17 20:41:15
Table 'RushAndCash605281' 6-max Seat #1 is the button
Seat 1: 95003d9e ($4.82 in chips)
Seat 2: 94cb065d ($5.19 in chips)
Seat 3: 9b7e5117 ($3.56 in chips)
Seat 4: cf593991 ($6.54 in chips)
Seat 5: 16f2e5ce ($6.49 in chips)
Seat 6: Hero ($8.76 in chips)
94cb065d: posts small blind $0.02
9b7e5117: posts big blind $0.05
*** HOLE CARDS ***
Dealt to 95003d9e 
Dealt to 94cb065d 
Dealt to 9b7e5117 
Dealt to cf593991 
Dealt to 16f2e5ce 
Dealt to Hero [Qd Jc]
cf593991: folds
16f2e5ce: folds
Hero: raises $0.05 to $0.1
95003d9e: folds
94cb065d: folds
9b7e5117: calls $0.05
*** FLOP *** [7s Ts Kh]
9b7e5117: bets $0.11
Hero: calls $0.11
*** TURN *** [7s Ts Kh] [5h]
9b7e5117: checks
Hero: checks
*** RIVER *** [7s Ts Kh 5h] [9s]
9b7e5117: checks
Hero: bets $0.22
9b7e5117: raises $0.71 to $0.93
Hero: folds
Uncalled bet ($0.71) returned to 9b7e5117
*** SHOWDOWN ***
9b7e5117 collected $0.84 from pot
*** SUMMARY ***
Total pot $0.88 | Rake $0.04 | Jackpot $0 | Bingo $0 | Fortune $0 | Tax $0
Board [7s Ts Kh 5h 9s]
Seat 1: 95003d9e (button) folded before Flop (didn't bet)
Seat 2: 94cb065d (small blind) folded before Flop
Seat 3: 9b7e5117 (big blind) showed [3s] and won ($0.84)
Seat 4: cf593991 folded before Flop (didn't bet)
Seat 5: 16f2e5ce folded before Flop (didn't bet)
Seat 6: Hero folded on the River


Poker Hand #RC3334440001: Hold'em No Limit ($0.02/$0.05) - 2025/02/17 20:41:12
Table 'RushAndCash605261' 6-max Seat #1 is the button
Seat 1: 70bcf256 ($5.37 in chips)
Seat 2: bfef046a ($12.29 in chips)
Seat 3: cf7f09c2 ($11.03 in chips)
Seat 4: Hero ($8.76 in chips)
Seat 5: 74f9576e ($5.11 in chips)
Seat 6: 16b0b958 ($5.59 in chips)
bfef046a: posts small blind $0.02
cf7f09c2: posts big blind $0.05
*** HOLE CARDS ***
Dealt to 70bcf256 
Dealt to bfef046a 
Dealt to cf7f09c2 
Dealt to Hero [As 3c]
Dealt to 74f9576e 
Dealt to 16b0b958 
Hero: folds
74f9576e: folds
16b0b958: folds
70bcf256: raises $0.08 to $0.13
bfef046a: folds
cf7f09c2: calls $0.08
*** FLOP *** [6d 2d 9s]
cf7f09c2: checks
70bcf256: bets $0.05
cf7f09c2: calls $0.05
*** TURN *** [6d 2d 9s] [4h]
cf7f09c2: checks
70bcf256: bets $0.05
cf7f09c2: calls $0.05
*** RIVER *** [6d 2d 9s 4h] [8h]
cf7f09c2: checks
70bcf256: bets $0.05
cf7f09c2: calls $0.05
70bcf256: shows [Ac Jd] (Ace-High)
cf7f09c2: shows [Tc 8s] (Pair of Eights)
*** SHOWDOWN ***
cf7f09c2 collected $0.56 from pot
*** SUMMARY ***
Total pot $0.58 | Rake $0.02 | Jackpot $0 | Bingo $0 | Fortune $0 | Tax $0
Board [6d 2d 9s 4h 8h]
Seat 1: 70bcf256 (button) showed [Ac Jd] and lost with Ace-High
Seat 2: bfef046a (small blind) folded before Flop
Seat 3: cf7f09c2 (big blind) showed [Tc 8s] and won ($0.56) with Pair of Eights
Seat 4: Hero folded before Flop (didn't bet)
Seat 5: 74f9576e folded before Flop (didn't bet)
Seat 6: 16b0b958 folded before Flop (didn't bet)


Poker Hand #RC3334439980: Hold'em No Limit ($0.02/$0.05) - 2025/02/17 20:41:09
Table 'RushAndCash605240' 6-max Seat #1 is the button
Seat 1: eed867f5 ($5.19 in chips)
Seat 2: Hero ($8.78 in chips)
Seat 3: 868521d5 ($5.12 in chips)
Seat 4: 4f7979c7 ($5.11 in chips)
Seat 5: dc00ecae ($5 in chips)
Seat 6: 7df4712d ($6.32 in chips)
Hero: posts small blind $0.02
868521d5: posts big blind $0.05
*** HOLE CARDS ***
Dealt to eed867f5 
Dealt to Hero [Tc 3s]
Dealt to 868521d5 
Dealt to 4f7979c7 
Dealt to dc00ecae 
Dealt to 7df4712d 
4f7979c7: raises $0.05 to $0.1
dc00ecae: folds
7df4712d: folds
eed867f5: calls $0.1
Hero: folds
868521d5: folds
*** FLOP *** [Kh Ks Jc]
4f7979c7: bets $0.09
eed867f5: folds
Uncalled bet ($0.09) returned to 4f7979c7
*** SHOWDOWN ***
4f7979c7 collected $0.26 from pot
*** SUMMARY ***
Total pot $0.27 | Rake $0.01 | Jackpot $0 | Bingo $0 | Fortune $0 | Tax $0
Board [Kh Ks Jc]
Seat 1: eed867f5 (button) folded on the Flop
Seat 2: Hero (small blind) folded before Flop
Seat 3: 868521d5 (big blind) folded before Flop
Seat 4: 4f7979c7 won ($0.26)
Seat 5: dc00ecae folded before Flop (didn't bet)
Seat 6: 7df4712d folded before Flop (didn't bet)


Poker Hand #RC3334439882: Hold'em No Limit ($0.02/$0.05) - 2025/02/17 20:40:54
Table 'RushAndCash605142' 6-max Seat #1 is the button
Seat 1: Hero ($8.91 in chips)
Seat 2: f898e827 ($5.04 in chips)
Seat 3: c607d475 ($8.32 in chips)
Seat 4: 12cda2e0 ($22.39 in chips)
Seat 5: 86768906 ($9.94 in chips)
Seat 6: eed867f5 ($5.21 in chips)
f898e827: posts small blind $0.02
c607d475: posts big blind $0.05
*** HOLE CARDS ***
Dealt to Hero [Th Jh]
Dealt to f898e827 
Dealt to c607d475 
Dealt to 12cda2e0 
Dealt to 86768906 
Dealt to eed867f5 
12cda2e0: raises $0.08 to $0.13
86768906: folds
eed867f5: folds
Hero: calls $0.13
f898e827: folds
c607d475: calls $0.08
*** FLOP *** [6h 9s 4s]
c607d475: checks
12cda2e0: bets $0.31
Hero: folds
c607d475: folds
Uncalled bet ($0.31) returned to 12cda2e0
*** SHOWDOWN ***
12cda2e0 collected $0.39 from pot
*** SUMMARY ***
Total pot $0.41 | Rake $0.02 | Jackpot $0 | Bingo $0 | Fortune $0 | Tax $0
Board [6h 9s 4s]
Seat 1: Hero (button) folded on the Flop
Seat 2: f898e827 (small blind) folded before Flop
Seat 3: c607d475 (big blind) folded on the Flop
Seat 4: 12cda2e0 won ($0.39)
Seat 5: 86768906 folded before Flop (didn't bet)
Seat 6: eed867f5 folded before Flop (didn't bet)


Poker Hand #RC3334439718: Hold'em No Limit ($0.02/$0.05) - 2025/02/17 20:40:33
Table 'RushAndCash604978' 6-max Seat #1 is the button
Seat 1: 87d5083b ($16.87 in chips)
Seat 2: 12cda2e0 ($22.47 in chips)
Seat 3: Hero ($8.72 in chips)
Seat 4: 5fe62400 ($5.07 in chips)
Seat 5: 86768906 ($10.04 in chips)
Seat 6: d75cab93 ($5.05 in chips)
12cda2e0: posts small blind $0.02
Hero: posts big blind $0.05
*** HOLE CARDS ***
Dealt to 87d5083b 
Dealt to 12cda2e0 
Dealt to Hero [Ah Kh]
Dealt to 5fe62400 
Dealt to 86768906 
Dealt to d75cab93 
5fe62400: folds
86768906: raises $0.05 to $0.1
d75cab93: folds
87d5083b: folds
12cda2e0: calls $0.08
Hero: raises $0.38 to $0.48
86768906: folds
12cda2e0: folds
Uncalled bet ($0.38) returned to Hero
*** SHOWDOWN ***
Hero collected $0.29 from pot
*** SUMMARY ***
Total pot $0.3 | Rake $0.01 | Jackpot $0 | Bingo $0 | Fortune $0 | Tax $0
Seat 1: 87d5083b (button) folded before Flop (didn't bet)
Seat 2: 12cda2e0 (small blind) folded before Flop
Seat 3: Hero (big blind) collected ($0.29)
Seat 4: 5fe62400 folded before Flop (didn't bet)
Seat 5: 86768906 folded before Flop
Seat 6: d75cab93 folded before Flop (didn't bet)


Poker Hand #RC3334439683: Hold'em No Limit ($0.02/$0.05) - 2025/02/17 20:40:28
Table 'RushAndCash604943' 6-max Seat #1 is the button
Seat 1: b9ae439d ($4.93 in chips)
Seat 2: 5e166e9a ($5 in chips)
Seat 3: 1640de52 ($15.02 in chips)
Seat 4: 3fe67f8 ($4.87 in chips)
Seat 5: Hero ($8.72 in chips)
Seat 6: 24d6dfa4 ($6.03 in chips)
5e166e9a: posts small blind $0.02
1640de52: posts big blind $0.05
*** HOLE CARDS ***
Dealt to b9ae439d 
Dealt to 5e166e9a 
Dealt to 1640de52 
Dealt to 3fe67f8 
Dealt to Hero [6c Ad]
Dealt to 24d6dfa4 
3fe67f8: folds
Hero: folds
24d6dfa4: folds
b9ae439d: raises $0.08 to $0.13
5e166e9a: folds
1640de52: calls $0.08
*** FLOP *** [5c Jc Jh]
1640de52: bets $0.28
b9ae439d: folds
Uncalled bet ($0.28) returned to 1640de52
*** SHOWDOWN ***
1640de52 collected $0.27 from pot
*** SUMMARY ***
Total pot $0.28 | Rake $0.01 | Jackpot $0 | Bingo $0 | Fortune $0 | Tax $0
Board [5c Jc Jh]
Seat 1: b9ae439d (button) folded on the Flop
Seat 2: 5e166e9a (small blind) folded before Flop
Seat 3: 1640de52 (big blind) won ($0.27)
Seat 4: 3fe67f8 folded before Flop (didn't bet)
Seat 5: Hero folded before Flop (didn't bet)
Seat 6: 24d6dfa4 folded before Flop (didn't bet)


Poker Hand #RC3334439608: Hold'em No Limit ($0.02/$0.05) - 2025/02/17 20:40:18
Table 'RushAndCash604868' 6-max Seat #1 is the button
Seat 1: 2e8ab509 ($5 in chips)
Seat 2: 8d7c8253 ($5.25 in chips)
Seat 3: fad7078a ($5.3 in chips)
Seat 4: Hero ($8.82 in chips)
Seat 5: 554a29a7 ($7.14 in chips)
Seat 6: e6dc3dd2 ($7.1 in chips)
8d7c8253: posts small blind $0.02
fad7078a: posts big blind $0.05
*** HOLE CARDS ***
Dealt to 2e8ab509 
Dealt to 8d7c8253 
Dealt to fad7078a 
Dealt to Hero [Ah Js]
Dealt to 554a29a7 
Dealt to e6dc3dd2 
Hero: raises $0.05 to $0.1
554a29a7: folds
e6dc3dd2: raises $0.21 to $0.31
2e8ab509: folds
8d7c8253: folds
fad7078a: folds
Hero: folds
Uncalled bet ($0.21) returned to e6dc3dd2
*** SHOWDOWN ***
e6dc3dd2 collected $0.26 from pot
*** SUMMARY ***
Total pot $0.27 | Rake $0.01 | Jackpot $0 | Bingo $0 | Fortune $0 | Tax $0
Seat 1: 2e8ab509 (button) folded before Flop (didn't bet)
Seat 2: 8d7c8253 (small blind) folded before Flop
Seat 3: fad7078a (big blind) folded before Flop
Seat 4: Hero folded before Flop
Seat 5: 554a29a7 folded before Flop (didn't bet)
Seat 6: e6dc3dd2 collected ($0.26)


Poker Hand #RC3334439587: Hold'em No Limit ($0.02/$0.05) - 2025/02/17 20:40:15
Table 'RushAndCash604847' 6-max Seat #1 is the button
Seat 1: Hero ($8.82 in chips)
Seat 2: 7f79d927 ($9.72 in chips)
Seat 3: 6f8bb9d1 ($5.52 in chips)
Seat 4: 97fe2676 ($9.9 in chips)
Seat 5: 1ce64dd8 ($4.49 in chips)
Seat 6: 8dbd0a2d ($5.26 in chips)
7f79d927: posts small blind $0.02
6f8bb9d1: posts big blind $0.05
*** HOLE CARDS ***
Dealt to Hero [Qd 7h]
Dealt to 7f79d927 
Dealt to 6f8bb9d1 
Dealt to 97fe2676 
Dealt to 1ce64dd8 
Dealt to 8dbd0a2d 
97fe2676: folds
1ce64dd8: folds
8dbd0a2d: raises $0.08 to $0.13
Hero: folds
7f79d927: calls $0.11
6f8bb9d1: folds
*** FLOP *** [3h 5h Ts]
7f79d927: bets $0.17
8dbd0a2d: folds
Uncalled bet ($0.17) returned to 7f79d927
*** SHOWDOWN ***
7f79d927 collected $0.3 from pot
*** SUMMARY ***
Total pot $0.31 | Rake $0.01 | Jackpot $0 | Bingo $0 | Fortune $0 | Tax $0
Board [3h 5h Ts]
Seat 1: Hero (button) folded before Flop (didn't bet)
Seat 2: 7f79d927 (small blind) won ($0.3)
Seat 3: 6f8bb9d1 (big blind) folded before Flop
Seat 4: 97fe2676 folded before Flop (didn't bet)
Seat 5: 1ce64dd8 folded before Flop (didn't bet)
Seat 6: 8dbd0a2d folded on the Flop


Poker Hand #RC3334439528: Hold'em No Limit ($0.02/$0.05) - 2025/02/17 20:40:07
Table 'RushAndCash604788' 6-max Seat #1 is the button
Seat 1: bfef046a ($12.2 in chips)
Seat 2: 904f2b1b ($3.96 in chips)
Seat 3: 4e55fa29 ($4.25 in chips)
Seat 4: e74a324 ($5.3 in chips)
Seat 5: 32d40ce0 ($7.84 in chips)
Seat 6: Hero ($8.75 in chips)
904f2b1b: posts small blind $0.02
4e55fa29: posts big blind $0.05
*** HOLE CARDS ***
Dealt to bfef046a 
Dealt to 904f2b1b 
Dealt to 4e55fa29 
Dealt to e74a324 
Dealt to 32d40ce0 
Dealt to Hero [Ks 8s]
e74a324: folds
32d40ce0: folds
Hero: raises $0.05 to $0.1
bfef046a: folds
904f2b1b: folds
4e55fa29: folds
Uncalled bet ($0.05) returned to Hero
*** SHOWDOWN ***
Hero collected $0.12 from pot
*** SUMMARY ***
Total pot $0.12 | Rake $0 | Jackpot $0 | Bingo $0 | Fortune $0 | Tax $0
Seat 1: bfef046a (button) folded before Flop (didn't bet)
Seat 2: 904f2b1b (small blind) folded before Flop
Seat 3: 4e55fa29 (big blind) folded before Flop
Seat 4: e74a324 folded before Flop (didn't bet)
Seat 5: 32d40ce0 folded before Flop (didn't bet)
Seat 6: Hero collected ($0.12)


Poker Hand #RC3334439450: Hold'em No Limit ($0.02/$0.05) - 2025/02/17 20:39:55
Table 'RushAndCash604710' 6-max Seat #1 is the button
Seat 1: 8a5a4b28 ($4 in chips)
Seat 2: 5381eb4c ($5.16 in chips)
Seat 3: 22a3f0e8 ($5.16 in chips)
Seat 4: Hero ($8.75 in chips)
Seat 5: e632d40b ($6.35 in chips)
Seat 6: 27baaa05 ($6.93 in chips)
5381eb4c: posts small blind $0.02
22a3f0e8: posts big blind $0.05
*** HOLE CARDS ***
Dealt to 8a5a4b28 
Dealt to 5381eb4c 
Dealt to 22a3f0e8 
Dealt to Hero [5c 7c]
Dealt to e632d40b 
Dealt to 27baaa05 
Hero: folds
e632d40b: folds
27baaa05: folds
8a5a4b28: folds
5381eb4c: raises $0.1 to $0.15
22a3f0e8: raises $0.35 to $0.5
5381eb4c: folds
Uncalled bet ($0.35) returned to 22a3f0e8
*** SHOWDOWN ***
22a3f0e8 collected $0.29 from pot
*** SUMMARY ***
Total pot $0.3 | Rake $0.01 | Jackpot $0 | Bingo $0 | Fortune $0 | Tax $0
Seat 1: 8a5a4b28 (button) folded before Flop (didn't bet)
Seat 2: 5381eb4c (small blind) folded before Flop
Seat 3: 22a3f0e8 (big blind) collected ($0.29)
Seat 4: Hero folded before Flop (didn't bet)
Seat 5: e632d40b folded before Flop (didn't bet)
Seat 6: 27baaa05 folded before Flop (didn't bet)


Poker Hand #RC3334439130: Hold'em No Limit ($0.02/$0.05) - 2025/02/17 20:39:11
Table 'RushAndCash604390' 6-max Seat #1 is the button
Seat 1: 650e9dc7 ($5.62 in chips)
Seat 2: 8a5a4b28 ($4.84 in chips)
Seat 3: Hero ($8.06 in chips)
Seat 4: daaf4280 ($4.99 in chips)
Seat 5: 9eb2937a ($5.7 in chips)
Seat 6: f6e684ae ($7.38 in chips)
8a5a4b28: posts small blind $0.02
Hero: posts big blind $0.05
*** HOLE CARDS ***
Dealt to 650e9dc7 
Dealt to 8a5a4b28 
Dealt to Hero [Jc Jd]
Dealt to daaf4280 
Dealt to 9eb2937a 
Dealt to f6e684ae 
daaf4280: folds
9eb2937a: folds
f6e684ae: folds
650e9dc7: folds
8a5a4b28: raises $0.07 to $0.12
Hero: raises $0.3 to $0.42
8a5a4b28: calls $0.3
*** FLOP *** [9d 8s 9c]
8a5a4b28: checks
Hero: checks
*** TURN *** [9d 8s 9c] [9s]
8a5a4b28: checks
Hero: bets $0.42
8a5a4b28: calls $0.42
*** RIVER *** [9d 8s 9c 9s] [Js]
8a5a4b28: checks
Hero: bets $0.84
8a5a4b28: folds
Uncalled bet ($0.84) returned to Hero
*** SHOWDOWN ***
Hero collected $1.53 from pot
*** SUMMARY ***
Total pot $1.68 | Rake $0.08 | Jackpot $0.07 | Bingo $0 | Fortune $0 | Tax $0
Board [9d 8s 9c 9s Js]
Seat 1: 650e9dc7 (button) folded before Flop (didn't bet)
Seat 2: 8a5a4b28 (small blind) folded on the River
Seat 3: Hero (big blind) won ($1.53)
Seat 4: daaf4280 folded before Flop (didn't bet)
Seat 5: 9eb2937a folded before Flop (didn't bet)
Seat 6: f6e684ae folded before Flop (didn't bet)


Poker Hand #RC3334439098: Hold'em No Limit ($0.02/$0.05) - 2025/02/17 20:39:07
Table 'RushAndCash604358' 6-max Seat #1 is the button
Seat 1: 5f1cdd27 ($5.6 in chips)
Seat 2: Hero ($8.08 in chips)
Seat 3: fcc3c3cc ($8.33 in chips)
Seat 4: f6e684ae ($7.38 in chips)
Seat 5: 52f43d28 ($7.04 in chips)
Seat 6: c585480d ($5 in chips)
Hero: posts small blind $0.02
fcc3c3cc: posts big blind $0.05
*** HOLE CARDS ***
Dealt to 5f1cdd27 
Dealt to Hero [3c 6s]
Dealt to fcc3c3cc 
Dealt to f6e684ae 
Dealt to 52f43d28 
Dealt to c585480d 
f6e684ae: folds
52f43d28: raises $0.05 to $0.1
c585480d: folds
5f1cdd27: raises $0.05 to $0.15
Hero: folds
fcc3c3cc: folds
52f43d28: calls $0.05
*** FLOP *** [5h Kc 2h]
52f43d28: checks
5f1cdd27: checks
*** TURN *** [5h Kc 2h] [6h]
52f43d28: bets $0.19
5f1cdd27: calls $0.19
*** RIVER *** [5h Kc 2h 6h] [Jd]
52f43d28: checks
5f1cdd27: checks
52f43d28: shows [7h 7s] (Pair of Sevens)
5f1cdd27: shows [6d Ad] (Pair of Sixes)
*** SHOWDOWN ***
52f43d28 collected $0.72 from pot
*** SUMMARY ***
Total pot $0.75 | Rake $0.03 | Jackpot $0 | Bingo $0 | Fortune $0 | Tax $0
Board [5h Kc 2h 6h Jd]
Seat 1: 5f1cdd27 (button) showed [6d Ad] and lost with Pair of Sixes
Seat 2: Hero (small blind) folded before Flop
Seat 3: fcc3c3cc (big blind) folded before Flop
Seat 4: f6e684ae folded before Flop (didn't bet)
Seat 5: 52f43d28 showed [7h 7s] and won ($0.72) with Pair of Sevens
Seat 6: c585480d folded before Flop (didn't bet)


Poker Hand #RC3334438738: Hold'em No Limit ($0.02/$0.05) - 2025/02/17 20:38:22
Table 'RushAndCash603998' 6-max Seat #1 is the button
Seat 1: 8023de0f ($6.31 in chips)
Seat 2: 2a5d53e8 ($5.02 in chips)
Seat 3: 7f79d927 ($9.22 in chips)
Seat 4: 22a3f0e8 ($5 in chips)
Seat 5: Hero ($7.24 in chips)
Seat 6: 9864109b ($5 in chips)
2a5d53e8: posts small blind $0.02
7f79d927: posts big blind $0.05
*** HOLE CARDS ***
Dealt to 8023de0f 
Dealt to 2a5d53e8 
Dealt to 7f79d927 
Dealt to 22a3f0e8 
Dealt to Hero [9s Ks]
Dealt to 9864109b 
22a3f0e8: folds
Hero: raises $0.05 to $0.1
9864109b: folds
8023de0f: raises $0.05 to $0.15
2a5d53e8: folds
7f79d927: folds
Hero: calls $0.05
*** FLOP *** [Kh 3d Jh]
Hero: checks
8023de0f: checks
*** TURN *** [Kh 3d Jh] [2d]
Hero: bets $0.2
8023de0f: calls $0.2
*** RIVER *** [Kh 3d Jh 2d] [Kc]
Hero: checks
8023de0f: bets $0.58
Hero: calls $0.58
8023de0f: shows [4s Ah] (Pair of Kings)
Hero: shows [9s Ks] (Three Kings)
*** SHOWDOWN ***
Hero collected $1.77 from pot
*** SUMMARY ***
Total pot $1.93 | Rake $0.09 | Jackpot $0.07 | Bingo $0 | Fortune $0 | Tax $0
Board [Kh 3d Jh 2d Kc]
Seat 1: 8023de0f (button) showed [4s Ah] and lost with Pair of Kings
Seat 2: 2a5d53e8 (small blind) folded before Flop
Seat 3: 7f79d927 (big blind) folded before Flop
Seat 4: 22a3f0e8 folded before Flop (didn't bet)
Seat 5: Hero showed [9s Ks] and won ($1.77) with Three Kings
Seat 6: 9864109b folded before Flop (didn't bet)


Poker Hand #RC3334438713: Hold'em No Limit ($0.02/$0.05) - 2025/02/17 20:38:19
Table 'RushAndCash603973' 6-max Seat #1 is the button
Seat 1: Hero ($7.24 in chips)
Seat 2: 87205baf ($8.88 in chips)
Seat 3: b67f7812 ($8.59 in chips)
Seat 4: 860fa4c9 ($5.21 in chips)
Seat 5: fe0566a4 ($11.12 in chips)
Seat 6: 6f4a31af ($5 in chips)
87205baf: posts small blind $0.02
b67f7812: posts big blind $0.05
*** HOLE CARDS ***
Dealt to Hero [6h 2d]
Dealt to 87205baf 
Dealt to b67f7812 
Dealt to 860fa4c9 
Dealt to fe0566a4 
Dealt to 6f4a31af 
860fa4c9: folds
fe0566a4: folds
6f4a31af: folds
Hero: folds
87205baf: folds
Uncalled bet ($0.03) returned to b67f7812
*** SHOWDOWN ***
b67f7812 collected $0.04 from pot
*** SUMMARY ***
Total pot $0.04 | Rake $0 | Jackpot $0 | Bingo $0 | Fortune $0 | Tax $0
Seat 1: Hero (button) folded before Flop (didn't bet)
Seat 2: 87205baf (small blind) folded before Flop
Seat 3: b67f7812 (big blind) collected ($0.04)
Seat 4: 860fa4c9 folded before Flop (didn't bet)
Seat 5: fe0566a4 folded before Flop (didn't bet)
Seat 6: 6f4a31af folded before Flop (didn't bet)


Poker Hand #RC3334438689: Hold'em No Limit ($0.02/$0.05) - 2025/02/17 20:38:15
Table 'RushAndCash603949' 6-max Seat #1 is the button
Seat 1: 858b70a7 ($1.78 in chips)
Seat 2: 51f33dae ($17.21 in chips)
Seat 3: 29bdeb43 ($6.15 in chips)
Seat 4: 98ea32b ($5 in chips)
Seat 5: Hero ($7.24 in chips)
Seat 6: 4e55fa29 ($3.84 in chips)
51f33dae: posts small blind $0.02
29bdeb43: posts big blind $0.05
*** HOLE CARDS ***
Dealt to 858b70a7 
Dealt to 51f33dae 
Dealt to 29bdeb43 
Dealt to 98ea32b 
Dealt to Hero [3h 6h]
Dealt to 4e55fa29 
98ea32b: folds
Hero: folds
4e55fa29: folds
858b70a7: raises $0.05 to $0.1
51f33dae: folds
29bdeb43: calls $0.05
*** FLOP *** [9c Kc 5s]
29bdeb43: checks
858b70a7: checks
*** TURN *** [9c Kc 5s] [Kh]
29bdeb43: bets $0.08
858b70a7: calls $0.08
*** RIVER *** [9c Kc 5s Kh] [8d]
29bdeb43: bets $0.13
858b70a7: folds
Uncalled bet ($0.13) returned to 29bdeb43
*** SHOWDOWN ***
29bdeb43 collected $0.37 from pot
*** SUMMARY ***
Total pot $0.38 | Rake $0.01 | Jackpot $0 | Bingo $0 | Fortune $0 | Tax $0
Board [9c Kc 5s Kh 8d]
Seat 1: 858b70a7 (button) folded on the River
Seat 2: 51f33dae (small blind) folded before Flop
Seat 3: 29bdeb43 (big blind) won ($0.37)
Seat 4: 98ea32b folded before Flop (didn't bet)
Seat 5: Hero folded before Flop (didn't bet)
Seat 6: 4e55fa29 folded before Flop (didn't bet)


Poker Hand #RC3334438669: Hold'em No Limit ($0.02/$0.05) - 2025/02/17 20:38:12
Table 'RushAndCash603929' 6-max Seat #1 is the button
Seat 1: b9d877b0 ($6.67 in chips)
Seat 2: ef82d036 ($21.9 in chips)
Seat 3: 50053f22 ($6.88 in chips)
Seat 4: Hero ($7.24 in chips)
Seat 5: 38ef00 ($1.78 in chips)
Seat 6: 90fb5891 ($14.47 in chips)
ef82d036: posts small blind $0.02
50053f22: posts big blind $0.05
*** HOLE CARDS ***
Dealt to b9d877b0 
Dealt to ef82d036 
Dealt to 50053f22 
Dealt to Hero [5c 9c]
Dealt to 38ef00 
Dealt to 90fb5891 
Hero: folds
38ef00: folds
90fb5891: raises $0.07 to $0.12
b9d877b0: folds
ef82d036: folds
50053f22: calls $0.07
*** FLOP *** [9s 8d Ah]
50053f22: checks
90fb5891: bets $0.12
50053f22: folds
Uncalled bet ($0.12) returned to 90fb5891
*** SHOWDOWN ***
90fb5891 collected $0.25 from pot
*** SUMMARY ***
Total pot $0.26 | Rake $0.01 | Jackpot $0 | Bingo $0 | Fortune $0 | Tax $0
Board [9s 8d Ah]
Seat 1: b9d877b0 (button) folded before Flop (didn't bet)
Seat 2: ef82d036 (small blind) folded before Flop
Seat 3: 50053f22 (big blind) folded on the Flop
Seat 4: Hero folded before Flop (didn't bet)
Seat 5: 38ef00 folded before Flop (didn't bet)
Seat 6: 90fb5891 won ($0.25)


Poker Hand #RC3334438605: Hold'em No Limit ($0.02/$0.05) - 2025/02/17 20:38:04
Table 'RushAndCash603865' 6-max Seat #1 is the button
Seat 1: 835df346 ($13.69 in chips)
Seat 2: 7da8a368 ($5 in chips)
Seat 3: Hero ($7.22 in chips)
Seat 4: 9a69a3a0 ($6 in chips)
Seat 5: c1784884 ($7.5 in chips)
Seat 6: 6e885b98 ($4.95 in chips)
7da8a368: posts small blind $0.02
Hero: posts big blind $0.05
*** HOLE CARDS ***
Dealt to 835df346 
Dealt to 7da8a368 
Dealt to Hero [Jc 9c]
Dealt to 9a69a3a0 
Dealt to c1784884 
Dealt to 6e885b98 
9a69a3a0: folds
c1784884: folds
6e885b98: folds
835df346: folds
7da8a368: folds
Uncalled bet ($0.03) returned to Hero
*** SHOWDOWN ***
Hero collected $0.04 from pot
*** SUMMARY ***
Total pot $0.04 | Rake $0 | Jackpot $0 | Bingo $0 | Fortune $0 | Tax $0
Seat 1: 835df346 (button) folded before Flop (didn't bet)
Seat 2: 7da8a368 (small blind) folded before Flop
Seat 3: Hero (big blind) collected ($0.04)
Seat 4: 9a69a3a0 folded before Flop (didn't bet)
Seat 5: c1784884 folded before Flop (didn't bet)
Seat 6: 6e885b98 folded before Flop (didn't bet)


Poker Hand #RC3334438578: Hold'em No Limit ($0.02/$0.05) - 2025/02/17 20:38:00
Table 'RushAndCash603838' 6-max Seat #1 is the button
Seat 1: 32d40ce0 ($8.06 in chips)
Seat 2: Hero ($7.24 in chips)
Seat 3: ef1a0dc2 ($5.3 in chips)
Seat 4: 835df346 ($13.69 in chips)
Seat 5: 5db4cca ($4.21 in chips)
Seat 6: 5f1cdd27 ($5.41 in chips)
Hero: posts small blind $0.02
ef1a0dc2: posts big blind $0.05
*** HOLE CARDS ***
Dealt to 32d40ce0 
Dealt to Hero [9c As]
Dealt to ef1a0dc2 
Dealt to 835df346 
Dealt to 5db4cca 
Dealt to 5f1cdd27 
835df346: folds
5db4cca: folds
5f1cdd27: folds
32d40ce0: raises $0.05 to $0.1
Hero: folds
ef1a0dc2: calls $0.05
*** FLOP *** [9s Kh Jc]
ef1a0dc2: checks
32d40ce0: bets $0.1
ef1a0dc2: folds
Uncalled bet ($0.1) returned to 32d40ce0
*** SHOWDOWN ***
32d40ce0 collected $0.21 from pot
*** SUMMARY ***
Total pot $0.22 | Rake $0.01 | Jackpot $0 | Bingo $0 | Fortune $0 | Tax $0
Board [9s Kh Jc]
Seat 1: 32d40ce0 (button) won ($0.21)
Seat 2: Hero (small blind) folded before Flop
Seat 3: ef1a0dc2 (big blind) folded on the Flop
Seat 4: 835df346 folded before Flop (didn't bet)
Seat 5: 5db4cca folded before Flop (didn't bet)
Seat 6: 5f1cdd27 folded before Flop (didn't bet)


Poker Hand #RC3334438534: Hold'em No Limit ($0.02/$0.05) - 2025/02/17 20:37:54
Table 'RushAndCash603794' 6-max Seat #1 is the button
Seat 1: 7df4712d ($7.11 in chips)
Seat 2: 19bb03b5 ($12.41 in chips)
Seat 3: f4a03af7 ($5 in chips)
Seat 4: 491e0e63 ($5 in chips)
Seat 5: 51f33dae ($17.21 in chips)
Seat 6: Hero ($7.24 in chips)
19bb03b5: posts small blind $0.02
f4a03af7: posts big blind $0.05
*** HOLE CARDS ***
Dealt to 7df4712d 
Dealt to 19bb03b5 
Dealt to f4a03af7 
Dealt to 491e0e63 
Dealt to 51f33dae 
Dealt to Hero [Kh 7c]
491e0e63: folds
51f33dae: folds
Hero: folds
7df4712d: folds
19bb03b5: folds
Uncalled bet ($0.03) returned to f4a03af7
*** SHOWDOWN ***
f4a03af7 collected $0.04 from pot
*** SUMMARY ***
Total pot $0.04 | Rake $0 | Jackpot $0 | Bingo $0 | Fortune $0 | Tax $0
Seat 1: 7df4712d (button) folded before Flop (didn't bet)
Seat 2: 19bb03b5 (small blind) folded before Flop
Seat 3: f4a03af7 (big blind) collected ($0.04)
Seat 4: 491e0e63 folded before Flop (didn't bet)
Seat 5: 51f33dae folded before Flop (didn't bet)
Seat 6: Hero folded before Flop (didn't bet)


Poker Hand #RC3334438515: Hold'em No Limit ($0.02/$0.05) - 2025/02/17 20:37:51
Table 'RushAndCash603775' 6-max Seat #1 is the button
Seat 1: 904f2b1b ($4.62 in chips)
Seat 2: 7b1c045a ($5.05 in chips)
Seat 3: 191b60c1 ($11.94 in chips)
Seat 4: f71f9fc0 ($4.3 in chips)
Seat 5: 653af57c ($5.74 in chips)
Seat 6: Hero ($7.24 in chips)
7b1c045a: posts small blind $0.02
191b60c1: posts big blind $0.05
*** HOLE CARDS ***
Dealt to 904f2b1b 
Dealt to 7b1c045a 
Dealt to 191b60c1 
Dealt to f71f9fc0 
Dealt to 653af57c 
Dealt to Hero [Jc 4s]
f71f9fc0: folds
653af57c: folds
Hero: folds
904f2b1b: folds
7b1c045a: folds
Uncalled bet ($0.03) returned to 191b60c1
*** SHOWDOWN ***
191b60c1 collected $0.04 from pot
*** SUMMARY ***
Total pot $0.04 | Rake $0 | Jackpot $0 | Bingo $0 | Fortune $0 | Tax $0
Seat 1: 904f2b1b (button) folded before Flop (didn't bet)
Seat 2: 7b1c045a (small blind) folded before Flop
Seat 3: 191b60c1 (big blind) collected ($0.04)
Seat 4: f71f9fc0 folded before Flop (didn't bet)
Seat 5: 653af57c folded before Flop (didn't bet)
Seat 6: Hero folded before Flop (didn't bet)


Poker Hand #RC3334438478: Hold'em No Limit ($0.02/$0.05) - 2025/02/17 20:37:45
Table 'RushAndCash603738' 6-max Seat #1 is the button
Seat 1: 31bef4 ($2.46 in chips)
Seat 2: 93735ac4 ($2.68 in chips)
Seat 3: 7de3ae0a ($5 in chips)
Seat 4: f898e827 ($4.64 in chips)
Seat 5: Hero ($7.24 in chips)
Seat 6: 50d9f656 ($7.25 in chips)
93735ac4: posts small blind $0.02
7de3ae0a: posts big blind $0.05
*** HOLE CARDS ***
Dealt to 31bef4 
Dealt to 93735ac4 
Dealt to 7de3ae0a 
Dealt to f898e827 
Dealt to Hero [Js 2d]
Dealt to 50d9f656 
f898e827: folds
Hero: folds
50d9f656: folds
31bef4: folds
93735ac4: calls $0.03
7de3ae0a: checks
*** FLOP *** [6c Qc Qd]
93735ac4: checks
7de3ae0a: bets $0.05
93735ac4: calls $0.05
*** TURN *** [6c Qc Qd] [3h]
93735ac4: checks
7de3ae0a: checks
*** RIVER *** [6c Qc Qd 3h] [8d]
93735ac4: checks
7de3ae0a: checks
93735ac4: shows [Qh Td] (Three Queens)
7de3ae0a: shows [6s 9s] (Pair of Queens and Pair of Sixes)
*** SHOWDOWN ***
93735ac4 collected $0.19 from pot
*** SUMMARY ***
Total pot $0.2 | Rake $0.01 | Jackpot $0 | Bingo $0 | Fortune $0 | Tax $0
Board [6c Qc Qd 3h 8d]
Seat 1: 31bef4 (button) folded before Flop (didn't bet)
Seat 2: 93735ac4 (small blind) showed [Qh Td] and won ($0.19) with Three Queens
Seat 3: 7de3ae0a (big blind) showed [6s 9s] and lost with Pair of Queens and Pair of Sixes
Seat 4: f898e827 folded before Flop (didn't bet)
Seat 5: Hero folded before Flop (didn't bet)
Seat 6: 50d9f656 folded before Flop (didn't bet)


Poker Hand #RC3334438447: Hold'em No Limit ($0.02/$0.05) - 2025/02/17 20:37:40
Table 'RushAndCash603707' 6-max Seat #1 is the button
Seat 1: 1c01f5f5 ($3.23 in chips)
Seat 2: 1d2427ef ($5.06 in chips)
Seat 3: Hero ($7.29 in chips)
Seat 4: 4c5ef89 ($6.08 in chips)
Seat 5: 2d54fb34 ($5.41 in chips)
Seat 6: e74a324 ($5 in chips)
1d2427ef: posts small blind $0.02
Hero: posts big blind $0.05
*** HOLE CARDS ***
Dealt to 1c01f5f5 
Dealt to 1d2427ef 
Dealt to Hero [3s 4c]
Dealt to 4c5ef89 
Dealt to 2d54fb34 
Dealt to e74a324 
4c5ef89: folds
2d54fb34: folds
e74a324: raises $0.05 to $0.1
1c01f5f5: folds
1d2427ef: folds
Hero: folds
Uncalled bet ($0.05) returned to e74a324
*** SHOWDOWN ***
e74a324 collected $0.12 from pot
*** SUMMARY ***
Total pot $0.12 | Rake $0 | Jackpot $0 | Bingo $0 | Fortune $0 | Tax $0
Seat 1: 1c01f5f5 (button) folded before Flop (didn't bet)
Seat 2: 1d2427ef (small blind) folded before Flop
Seat 3: Hero (big blind) folded before Flop
Seat 4: 4c5ef89 folded before Flop (didn't bet)
Seat 5: 2d54fb34 folded before Flop (didn't bet)
Seat 6: e74a324 collected ($0.12)


Poker Hand #RC3334438426: Hold'em No Limit ($0.02/$0.05) - 2025/02/17 20:37:37
Table 'RushAndCash603686' 6-max Seat #1 is the button
Seat 1: cf7f09c2 ($12.7 in chips)
Seat 2: Hero ($7.31 in chips)
Seat 3: 5f1cdd27 ($5.39 in chips)
Seat 4: e8f41d33 ($3.76 in chips)
Seat 5: 6de2662f ($5.16 in chips)
Seat 6: bf01edb3 ($5 in chips)
Hero: posts small blind $0.02
5f1cdd27: posts big blind $0.05
*** HOLE CARDS ***
Dealt to cf7f09c2 
Dealt to Hero [4c 5s]
Dealt to 5f1cdd27 
Dealt to e8f41d33 
Dealt to 6de2662f 
Dealt to bf01edb3 
e8f41d33: folds
6de2662f: folds
bf01edb3: folds
cf7f09c2: folds
Hero: folds
Uncalled bet ($0.03) returned to 5f1cdd27
*** SHOWDOWN ***
5f1cdd27 collected $0.04 from pot
*** SUMMARY ***
Total pot $0.04 | Rake $0 | Jackpot $0 | Bingo $0 | Fortune $0 | Tax $0
Seat 1: cf7f09c2 (button) folded before Flop (didn't bet)
Seat 2: Hero (small blind) folded before Flop
Seat 3: 5f1cdd27 (big blind) collected ($0.04)
Seat 4: e8f41d33 folded before Flop (didn't bet)
Seat 5: 6de2662f folded before Flop (didn't bet)
Seat 6: bf01edb3 folded before Flop (didn't bet)


Poker Hand #RC3334438393: Hold'em No Limit ($0.02/$0.05) - 2025/02/17 20:37:33
Table 'RushAndCash603653' 6-max Seat #1 is the button
Seat 1: ef7b5599 ($15.21 in chips)
Seat 2: 2b15bcc3 ($2.13 in chips)
Seat 3: e3a10bfa ($5.11 in chips)
Seat 4: 45d33c76 ($9.05 in chips)
Seat 5: Hero ($7.31 in chips)
Seat 6: c62b7a0b ($19.92 in chips)
2b15bcc3: posts small blind $0.02
e3a10bfa: posts big blind $0.05
*** HOLE CARDS ***
Dealt to ef7b5599 
Dealt to 2b15bcc3 
Dealt to e3a10bfa 
Dealt to 45d33c76 
Dealt to Hero [Qh 3h]
Dealt to c62b7a0b 
45d33c76: folds
Hero: folds
c62b7a0b: folds
ef7b5599: folds
2b15bcc3: folds
Uncalled bet ($0.03) returned to e3a10bfa
*** SHOWDOWN ***
e3a10bfa collected $0.04 from pot
*** SUMMARY ***
Total pot $0.04 | Rake $0 | Jackpot $0 | Bingo $0 | Fortune $0 | Tax $0
Seat 1: ef7b5599 (button) folded before Flop (didn't bet)
Seat 2: 2b15bcc3 (small blind) folded before Flop
Seat 3: e3a10bfa (big blind) collected ($0.04)
Seat 4: 45d33c76 folded before Flop (didn't bet)
Seat 5: Hero folded before Flop (didn't bet)
Seat 6: c62b7a0b folded before Flop (didn't bet)


Poker Hand #RC3334438363: Hold'em No Limit ($0.02/$0.05) - 2025/02/17 20:37:28
Table 'RushAndCash603623' 6-max Seat #1 is the button
Seat 1: Hero ($7.31 in chips)
Seat 2: 4190d158 ($10.77 in chips)
Seat 3: 56cefdc9 ($7.52 in chips)
Seat 4: c92a5ecb ($6.63 in chips)
Seat 5: 727998e7 ($8.33 in chips)
Seat 6: 87d5083b ($17.37 in chips)
4190d158: posts small blind $0.02
56cefdc9: posts big blind $0.05
*** HOLE CARDS ***
Dealt to Hero [Qd 8h]
Dealt to 4190d158 
Dealt to 56cefdc9 
Dealt to c92a5ecb 
Dealt to 727998e7 
Dealt to 87d5083b 
c92a5ecb: raises $0.05 to $0.1
727998e7: raises $0.23 to $0.33
87d5083b: folds
Hero: folds
4190d158: calls $0.31
56cefdc9: folds
c92a5ecb: folds
*** FLOP *** [8d 9c Jh]
4190d158: checks
727998e7: checks
*** TURN *** [8d 9c Jh] [9d]
4190d158: bets $0.35
727998e7: folds
Uncalled bet ($0.35) returned to 4190d158
*** SHOWDOWN ***
4190d158 collected $0.77 from pot
*** SUMMARY ***
Total pot $0.81 | Rake $0.04 | Jackpot $0 | Bingo $0 | Fortune $0 | Tax $0
Board [8d 9c Jh 9d]
Seat 1: Hero (button) folded before Flop (didn't bet)
Seat 2: 4190d158 (small blind) won ($0.77)
Seat 3: 56cefdc9 (big blind) folded before Flop
Seat 4: c92a5ecb folded before Flop
Seat 5: 727998e7 folded on the Turn
Seat 6: 87d5083b folded before Flop (didn't bet)


Poker Hand #RC3334438339: Hold'em No Limit ($0.02/$0.05) - 2025/02/17 20:37:25
Table 'RushAndCash603599' 6-max Seat #1 is the button
Seat 1: a2794999 ($7.5 in chips)
Seat 2: 6c6b017a ($8.83 in chips)
Seat 3: 8c1b0cdf ($2.18 in chips)
Seat 4: 1dbfd698 ($8.27 in chips)
Seat 5: Hero ($7.31 in chips)
Seat 6: 127f997c ($5.17 in chips)
6c6b017a: posts small blind $0.02
8c1b0cdf: posts big blind $0.05
*** HOLE CARDS ***
Dealt to a2794999 
Dealt to 6c6b017a 
Dealt to 8c1b0cdf 
Dealt to 1dbfd698 
Dealt to Hero [4d 2c]
Dealt to 127f997c 
1dbfd698: folds
Hero: folds
127f997c: folds
a2794999: folds
6c6b017a: raises $0.05 to $0.1
8c1b0cdf: calls $0.05
*** FLOP *** [2d Ad 7h]
6c6b017a: checks
8c1b0cdf: bets $0.14
6c6b017a: folds
Uncalled bet ($0.14) returned to 8c1b0cdf
*** SHOWDOWN ***
8c1b0cdf collected $0.19 from pot
*** SUMMARY ***
Total pot $0.2 | Rake $0.01 | Jackpot $0 | Bingo $0 | Fortune $0 | Tax $0
Board [2d Ad 7h]
Seat 1: a2794999 (button) folded before Flop (didn't bet)
Seat 2: 6c6b017a (small blind) folded on the Flop
Seat 3: 8c1b0cdf (big blind) won ($0.19)
Seat 4: 1dbfd698 folded before Flop (didn't bet)
Seat 5: Hero folded before Flop (didn't bet)
Seat 6: 127f997c folded before Flop (didn't bet)


Poker Hand #RC3334438184: Hold'em No Limit ($0.02/$0.05) - 2025/02/17 20:37:05
Table 'RushAndCash603444' 6-max Seat #1 is the button
Seat 1: 52f43d28 ($6.99 in chips)
Seat 2: Hero ($7.44 in chips)
Seat 3: 9a4345c8 ($17.22 in chips)
Seat 4: e4d8df1d ($7.74 in chips)
Seat 5: 127f997c ($5 in chips)
Seat 6: 1923de41 ($5 in chips)
Hero: posts small blind $0.02
9a4345c8: posts big blind $0.05
*** HOLE CARDS ***
Dealt to 52f43d28 
Dealt to Hero [5h 5s]
Dealt to 9a4345c8 
Dealt to e4d8df1d 
Dealt to 127f997c 
Dealt to 1923de41 
e4d8df1d: folds
127f997c: raises $0.08 to $0.13
1923de41: folds
52f43d28: folds
Hero: calls $0.11
9a4345c8: folds
*** FLOP *** [4s Td Qc]
Hero: checks
127f997c: bets $0.11
Hero: folds
Uncalled bet ($0.11) returned to 127f997c
*** SHOWDOWN ***
127f997c collected $0.3 from pot
*** SUMMARY ***
Total pot $0.31 | Rake $0.01 | Jackpot $0 | Bingo $0 | Fortune $0 | Tax $0
Board [4s Td Qc]
Seat 1: 52f43d28 (button) folded before Flop (didn't bet)
Seat 2: Hero (small blind) folded on the Flop
Seat 3: 9a4345c8 (big blind) folded before Flop
Seat 4: e4d8df1d folded before Flop (didn't bet)
Seat 5: 127f997c won ($0.3)
Seat 6: 1923de41 folded before Flop (didn't bet)


Poker Hand #RC3334437789: Hold'em No Limit ($0.02/$0.05) - 2025/02/17 20:36:11
Table 'RushAndCash603049' 6-max Seat #1 is the button
Seat 1: ae49e9c ($6.14 in chips)
Seat 2: 187f2194 ($11.25 in chips)
Seat 3: Hero ($7.28 in chips)
Seat 4: 1e76a4d8 ($6.36 in chips)
Seat 5: 9a4345c8 ($17.37 in chips)
Seat 6: 63499226 ($3.62 in chips)
187f2194: posts small blind $0.02
Hero: posts big blind $0.05
*** HOLE CARDS ***
Dealt to ae49e9c 
Dealt to 187f2194 
Dealt to Hero [Jh Ad]
Dealt to 1e76a4d8 
Dealt to 9a4345c8 
Dealt to 63499226 
1e76a4d8: folds
9a4345c8: raises $0.05 to $0.1
63499226: folds
ae49e9c: folds
187f2194: folds
Hero: calls $0.05
*** FLOP *** [9s As 7c]
Hero: checks
9a4345c8: checks
*** TURN *** [9s As 7c] [2s]
Hero: checks
9a4345c8: bets $0.05
Hero: calls $0.05
*** RIVER *** [9s As 7c 2s] [4d]
Hero: checks
9a4345c8: checks
Hero: shows [Jh Ad] (Pair of Aces)
9a4345c8: shows [7d 8d] (Pair of Sevens)
*** SHOWDOWN ***
Hero collected $0.31 from pot
*** SUMMARY ***
Total pot $0.32 | Rake $0.01 | Jackpot $0 | Bingo $0 | Fortune $0 | Tax $0
Board [9s As 7c 2s 4d]
Seat 1: ae49e9c (button) folded before Flop (didn't bet)
Seat 2: 187f2194 (small blind) folded before Flop
Seat 3: Hero (big blind) showed [Jh Ad] and won ($0.31) with Pair of Aces
Seat 4: 1e76a4d8 folded before Flop (didn't bet)
Seat 5: 9a4345c8 showed [7d 8d] and lost with Pair of Sevens
Seat 6: 63499226 folded before Flop (didn't bet)


Poker Hand #RC3334437590: Hold'em No Limit ($0.02/$0.05) - 2025/02/17 20:35:44
Table 'RushAndCash602850' 6-max Seat #1 is the button
Seat 1: Hero ($7.28 in chips)
Seat 2: ae49e9c ($6.16 in chips)
Seat 3: 127f997c ($5.12 in chips)
Seat 4: 187f2194 ($10.71 in chips)
Seat 5: 8c6d38f2 ($5.21 in chips)
Seat 6: 9a4345c8 ($17.37 in chips)
Cash Drop to Pot : total $0.5 
ae49e9c: posts small blind $0.02
127f997c: posts big blind $0.05
*** HOLE CARDS ***
Dealt to Hero [Qc Ts]
Dealt to ae49e9c 
Dealt to 127f997c 
Dealt to 187f2194 
Dealt to 8c6d38f2 
Dealt to 9a4345c8 
187f2194: raises $0.35 to $0.4
8c6d38f2: folds
9a4345c8: folds
Hero: folds
ae49e9c: folds
127f997c: folds
Uncalled bet ($0.35) returned to 187f2194
*** SHOWDOWN ***
187f2194 collected $0.59 from pot
*** SUMMARY ***
Total pot $0.62 | Rake $0.03 | Jackpot $0 | Bingo $0 | Fortune $0 | Tax $0
Seat 1: Hero (button) folded before Flop (didn't bet)
Seat 2: ae49e9c (small blind) folded before Flop
Seat 3: 127f997c (big blind) folded before Flop
Seat 4: 187f2194 collected ($0.59)
Seat 5: 8c6d38f2 folded before Flop (didn't bet)
Seat 6: 9a4345c8 folded before Flop (didn't bet)


Poker Hand #RC3334437563: Hold'em No Limit ($0.02/$0.05) - 2025/02/17 20:35:40
Table 'RushAndCash602823' 6-max Seat #1 is the button
Seat 1: 107b7bb3 ($6.32 in chips)
Seat 2: f553bfb4 ($8.69 in chips)
Seat 3: 6ac4af54 ($10.63 in chips)
Seat 4: Hero ($7.28 in chips)
Seat 5: 76f4e455 ($4.86 in chips)
Seat 6: 6aa0c391 ($5.65 in chips)
f553bfb4: posts small blind $0.02
6ac4af54: posts big blind $0.05
*** HOLE CARDS ***
Dealt to 107b7bb3 
Dealt to f553bfb4 
Dealt to 6ac4af54 
Dealt to Hero [9d Jc]
Dealt to 76f4e455 
Dealt to 6aa0c391 
Hero: folds
76f4e455: folds
6aa0c391: raises $0.08 to $0.13
107b7bb3: folds
f553bfb4: folds
6ac4af54: folds
Uncalled bet ($0.08) returned to 6aa0c391
*** SHOWDOWN ***
6aa0c391 collected $0.12 from pot
*** SUMMARY ***
Total pot $0.12 | Rake $0 | Jackpot $0 | Bingo $0 | Fortune $0 | Tax $0
Seat 1: 107b7bb3 (button) folded before Flop (didn't bet)
Seat 2: f553bfb4 (small blind) folded before Flop
Seat 3: 6ac4af54 (big blind) folded before Flop
Seat 4: Hero folded before Flop (didn't bet)
Seat 5: 76f4e455 folded before Flop (didn't bet)
Seat 6: 6aa0c391 collected ($0.12)


Poker Hand #RC3334437413: Hold'em No Limit ($0.02/$0.05) - 2025/02/17 20:35:20
Table 'RushAndCash602673' 6-max Seat #1 is the button
Seat 1: 6662e866 ($15.83 in chips)
Seat 2: 3100dcf0 ($5.76 in chips)
Seat 3: 9a4345c8 ($17.42 in chips)
Seat 4: Hero ($7.21 in chips)
Seat 5: 123dc5ea ($10.83 in chips)
Seat 6: f6013c83 ($5.1 in chips)
3100dcf0: posts small blind $0.02
9a4345c8: posts big blind $0.05
*** HOLE CARDS ***
Dealt to 6662e866 
Dealt to 3100dcf0 
Dealt to 9a4345c8 
Dealt to Hero [Ac Jh]
Dealt to 123dc5ea 
Dealt to f6013c83 
Hero: raises $0.05 to $0.1
123dc5ea: folds
f6013c83: folds
6662e866: folds
3100dcf0: folds
9a4345c8: folds
Uncalled bet ($0.05) returned to Hero
*** SHOWDOWN ***
Hero collected $0.12 from pot
*** SUMMARY ***
Total pot $0.12 | Rake $0 | Jackpot $0 | Bingo $0 | Fortune $0 | Tax $0
Seat 1: 6662e866 (button) folded before Flop (didn't bet)
Seat 2: 3100dcf0 (small blind) folded before Flop
Seat 3: 9a4345c8 (big blind) folded before Flop
Seat 4: Hero collected ($0.12)
Seat 5: 123dc5ea folded before Flop (didn't bet)
Seat 6: f6013c83 folded before Flop (didn't bet)


Poker Hand #RC3334437388: Hold'em No Limit ($0.02/$0.05) - 2025/02/17 20:35:17
Table 'RushAndCash602648' 6-max Seat #1 is the button
Seat 1: Hero ($7.21 in chips)
Seat 2: 100d4f9e ($5.76 in chips)
Seat 3: b501555b ($4.52 in chips)
Seat 4: 75145cfe ($5.2 in chips)
Seat 5: 3dbbdac8 ($5.19 in chips)
Seat 6: 4d9372d1 ($5.34 in chips)
100d4f9e: posts small blind $0.02
b501555b: posts big blind $0.05
*** HOLE CARDS ***
Dealt to Hero [7c 2d]
Dealt to 100d4f9e 
Dealt to b501555b 
Dealt to 75145cfe 
Dealt to 3dbbdac8 
Dealt to 4d9372d1 
75145cfe: raises $0.06 to $0.11
3dbbdac8: folds
4d9372d1: folds
Hero: folds
100d4f9e: folds
b501555b: raises $0.19 to $0.3
75145cfe: calls $0.19
*** FIRST FLOP *** [Jc 5c 9c]
b501555b: bets $0.6
75145cfe: calls $0.6
*** FIRST TURN *** [Jc 5c 9c] [Td]
b501555b: bets $3.62 and is all-in
75145cfe: calls $3.62
b501555b: shows [Kc Ks] (Pair of Kings)
75145cfe: shows [5d 5h] (Three Fives)
*** FIRST RIVER *** [Jc 5c 9c Td] [Tc]
*** SECOND RIVER *** [Jc 5c 9c Td] [9h]
*** FIRST SHOWDOWN ***
75145cfe collected $4.43 from pot
*** SECOND SHOWDOWN ***
75145cfe collected $4.42 from pot
*** SUMMARY ***
Total pot $9.06 | Rake $0.14 | Jackpot $0.07 | Bingo $0 | Fortune $0 | Tax $0
Hand was run two times
FIRST Board [Jc 5c 9c Td Tc]
SECOND Board [9h]
Seat 1: Hero (button) folded before Flop (didn't bet)
Seat 2: 100d4f9e (small blind) folded before Flop
Seat 3: b501555b (big blind) showed [Kc Ks] and lost with King High Flush, and lost
Seat 4: 75145cfe showed [5d 5h] and won ($4.43) with Fives Full over Tens, and won ($4.42)
Seat 5: 3dbbdac8 folded before Flop (didn't bet)
Seat 6: 4d9372d1 folded before Flop (didn't bet)


Poker Hand #RC3334437370: Hold'em No Limit ($0.02/$0.05) - 2025/02/17 20:35:14
Table 'RushAndCash602630' 6-max Seat #1 is the button
Seat 1: 9885e0a0 ($5 in chips)
Seat 2: 45d33c76 ($9.08 in chips)
Seat 3: Hero ($7.26 in chips)
Seat 4: 679a8f7 ($5.11 in chips)
Seat 5: 6d0c8ff6 ($5.71 in chips)
Seat 6: fa7bb2c5 ($5 in chips)
45d33c76: posts small blind $0.02
Hero: posts big blind $0.05
*** HOLE CARDS ***
Dealt to 9885e0a0 
Dealt to 45d33c76 
Dealt to Hero [Td 6s]
Dealt to 679a8f7 
Dealt to 6d0c8ff6 
Dealt to fa7bb2c5 
679a8f7: folds
6d0c8ff6: folds
fa7bb2c5: folds
9885e0a0: folds
45d33c76: raises $0.13 to $0.18
Hero: folds
Uncalled bet ($0.13) returned to 45d33c76
*** SHOWDOWN ***
45d33c76 collected $0.1 from pot
*** SUMMARY ***
Total pot $0.1 | Rake $0 | Jackpot $0 | Bingo $0 | Fortune $0 | Tax $0
Seat 1: 9885e0a0 (button) folded before Flop (didn't bet)
Seat 2: 45d33c76 (small blind) collected ($0.1)
Seat 3: Hero (big blind) folded before Flop
Seat 4: 679a8f7 folded before Flop (didn't bet)
Seat 5: 6d0c8ff6 folded before Flop (didn't bet)
Seat 6: fa7bb2c5 folded before Flop (didn't bet)


Poker Hand #RC3334437324: Hold'em No Limit ($0.02/$0.05) - 2025/02/17 20:35:07
Table 'RushAndCash602584' 6-max Seat #1 is the button
Seat 1: f20f94d9 ($5.3 in chips)
Seat 2: 72fa4c0f ($2.88 in chips)
Seat 3: ac6a1821 ($5 in chips)
Seat 4: Hero ($7.26 in chips)
Seat 5: 79df293 ($6.07 in chips)
Seat 6: 1f6299b6 ($5.27 in chips)
72fa4c0f: posts small blind $0.02
ac6a1821: posts big blind $0.05
*** HOLE CARDS ***
Dealt to f20f94d9 
Dealt to 72fa4c0f 
Dealt to ac6a1821 
Dealt to Hero [Jh 8c]
Dealt to 79df293 
Dealt to 1f6299b6 
Hero: folds
79df293: folds
1f6299b6: raises $0.05 to $0.1
f20f94d9: folds
72fa4c0f: folds
ac6a1821: calls $0.05
*** FLOP *** [Qd 8d 2s]
ac6a1821: checks
1f6299b6: checks
*** TURN *** [Qd 8d 2s] [3h]
ac6a1821: bets $0.17
1f6299b6: folds
Uncalled bet ($0.17) returned to ac6a1821
*** SHOWDOWN ***
ac6a1821 collected $0.21 from pot
*** SUMMARY ***
Total pot $0.22 | Rake $0.01 | Jackpot $0 | Bingo $0 | Fortune $0 | Tax $0
Board [Qd 8d 2s 3h]
Seat 1: f20f94d9 (button) folded before Flop (didn't bet)
Seat 2: 72fa4c0f (small blind) folded before Flop
Seat 3: ac6a1821 (big blind) won ($0.21)
Seat 4: Hero folded before Flop (didn't bet)
Seat 5: 79df293 folded before Flop (didn't bet)
Seat 6: 1f6299b6 folded on the Turn


Poker Hand #RC3334437291: Hold'em No Limit ($0.02/$0.05) - 2025/02/17 20:35:02
Table 'RushAndCash602551' 6-max Seat #1 is the button
Seat 1: 7f3dcda7 ($9.32 in chips)
Seat 2: Hero ($7.28 in chips)
Seat 3: 48fa5407 ($5.89 in chips)
Seat 4: fa40c39c ($5.38 in chips)
Seat 5: 64e5de41 ($5.54 in chips)
Seat 6: dea8bb2e ($5 in chips)
Hero: posts small blind $0.02
48fa5407: posts big blind $0.05
*** HOLE CARDS ***
Dealt to 7f3dcda7 
Dealt to Hero [6d 3s]
Dealt to 48fa5407 
Dealt to fa40c39c 
Dealt to 64e5de41 
Dealt to dea8bb2e 
fa40c39c: folds
64e5de41: folds
dea8bb2e: folds
7f3dcda7: raises $0.08 to $0.13
Hero: folds
48fa5407: calls $0.08
*** FLOP *** [Kc Ad 9d]
48fa5407: checks
7f3dcda7: bets $0.15
48fa5407: calls $0.15
*** TURN *** [Kc Ad 9d] [7c]
48fa5407: checks
7f3dcda7: bets $0.2
48fa5407: calls $0.2
*** RIVER *** [Kc Ad 9d 7c] [Qs]
48fa5407: checks
7f3dcda7: checks
48fa5407: shows [Kh Tc] (Pair of Kings)
7f3dcda7: shows [Ac 4c] (Pair of Aces)
*** SHOWDOWN ***
7f3dcda7 collected $0.94 from pot
*** SUMMARY ***
Total pot $0.98 | Rake $0.04 | Jackpot $0 | Bingo $0 | Fortune $0 | Tax $0
Board [Kc Ad 9d 7c Qs]
Seat 1: 7f3dcda7 (button) showed [Ac 4c] and won ($0.94) with Pair of Aces
Seat 2: Hero (small blind) folded before Flop
Seat 3: 48fa5407 (big blind) showed [Kh Tc] and lost with Pair of Kings
Seat 4: fa40c39c folded before Flop (didn't bet)
Seat 5: 64e5de41 folded before Flop (didn't bet)
Seat 6: dea8bb2e folded before Flop (didn't bet)


Poker Hand #RC3334437253: Hold'em No Limit ($0.02/$0.05) - 2025/02/17 20:34:56
Table 'RushAndCash602513' 6-max Seat #1 is the button
Seat 1: 63a77bff ($4.74 in chips)
Seat 2: b501555b ($4.54 in chips)
Seat 3: 1d0217bc ($5.27 in chips)
Seat 4: Hero ($7.28 in chips)
Seat 5: 2b6388ee ($5.63 in chips)
Seat 6: 7fe74cc5 ($5.86 in chips)
b501555b: posts small blind $0.02
1d0217bc: posts big blind $0.05
*** HOLE CARDS ***
Dealt to 63a77bff 
Dealt to b501555b 
Dealt to 1d0217bc 
Dealt to Hero [8d Qd]
Dealt to 2b6388ee 
Dealt to 7fe74cc5 
Hero: folds
2b6388ee: folds
7fe74cc5: raises $0.06 to $0.11
63a77bff: folds
b501555b: folds
1d0217bc: calls $0.06
*** FLOP *** [5c Kc Ah]
1d0217bc: checks
7fe74cc5: checks
*** TURN *** [5c Kc Ah] [9d]
1d0217bc: bets $0.12
7fe74cc5: calls $0.12
*** RIVER *** [5c Kc Ah 9d] [5h]
1d0217bc: bets $0.24
7fe74cc5: folds
Uncalled bet ($0.24) returned to 1d0217bc
*** SHOWDOWN ***
1d0217bc collected $0.46 from pot
*** SUMMARY ***
Total pot $0.48 | Rake $0.02 | Jackpot $0 | Bingo $0 | Fortune $0 | Tax $0
Board [5c Kc Ah 9d 5h]
Seat 1: 63a77bff (button) folded before Flop (didn't bet)
Seat 2: b501555b (small blind) folded before Flop
Seat 3: 1d0217bc (big blind) won ($0.46)
Seat 4: Hero folded before Flop (didn't bet)
Seat 5: 2b6388ee folded before Flop (didn't bet)
Seat 6: 7fe74cc5 folded on the River


Poker Hand #RC3334437215: Hold'em No Limit ($0.02/$0.05) - 2025/02/17 20:34:50
Table 'RushAndCash602475' 6-max Seat #1 is the button
Seat 1: 68e67dc8 ($6.14 in chips)
Seat 2: 9013f95e ($13.72 in chips)
Seat 3: 100d4f9e ($5.81 in chips)
Seat 4: Hero ($7.28 in chips)
Seat 5: f171b990 ($7.14 in chips)
Seat 6: 62156df3 ($5.22 in chips)
9013f95e: posts small blind $0.02
100d4f9e: posts big blind $0.05
*** HOLE CARDS ***
Dealt to 68e67dc8 
Dealt to 9013f95e 
Dealt to 100d4f9e 
Dealt to Hero [2c 8d]
Dealt to f171b990 
Dealt to 62156df3 
Hero: folds
f171b990: folds
62156df3: raises $0.06 to $0.11
68e67dc8: raises $0.22 to $0.33
9013f95e: folds
100d4f9e: folds
62156df3: calls $0.22
*** FLOP *** [9s 4h Tc]
62156df3: checks
68e67dc8: bets $0.25
62156df3: calls $0.25
*** TURN *** [9s 4h Tc] [4c]
62156df3: checks
68e67dc8: checks
*** RIVER *** [9s 4h Tc 4c] [Ts]
62156df3: checks
68e67dc8: checks
62156df3: shows [9c Ac] (Pair of Tens and Pair of Nines)
68e67dc8: shows [Ad Kc] (Pair of Tens and Pair of Fours)
*** SHOWDOWN ***
62156df3 collected $1.17 from pot
*** SUMMARY ***
Total pot $1.23 | Rake $0.06 | Jackpot $0 | Bingo $0 | Fortune $0 | Tax $0
Board [9s 4h Tc 4c Ts]
Seat 1: 68e67dc8 (button) showed [Ad Kc] and lost with Pair of Tens and Pair of Fours
Seat 2: 9013f95e (small blind) folded before Flop
Seat 3: 100d4f9e (big blind) folded before Flop
Seat 4: Hero folded before Flop (didn't bet)
Seat 5: f171b990 folded before Flop (didn't bet)
Seat 6: 62156df3 showed [9c Ac] and won ($1.17) with Pair of Tens and Pair of Nines


Poker Hand #RC3334437165: Hold'em No Limit ($0.02/$0.05) - 2025/02/17 20:34:43
Table 'RushAndCash602425' 6-max Seat #1 is the button
Seat 1: 11fb4d12 ($8.07 in chips)
Seat 2: Hero ($7.3 in chips)
Seat 3: 15346d36 ($1.53 in chips)
Seat 4: 7f79d927 ($9.7 in chips)
Seat 5: 2f12456d ($5.31 in chips)
Seat 6: eed867f5 ($4.68 in chips)
Hero: posts small blind $0.02
15346d36: posts big blind $0.05
*** HOLE CARDS ***
Dealt to 11fb4d12 
Dealt to Hero [Jd 9s]
Dealt to 15346d36 
Dealt to 7f79d927 
Dealt to 2f12456d 
Dealt to eed867f5 
7f79d927: folds
2f12456d: raises $0.06 to $0.11
eed867f5: folds
11fb4d12: folds
Hero: folds
15346d36: raises $0.24 to $0.35
2f12456d: raises $2.55 to $2.9
15346d36: calls $1.18 and is all-in
Uncalled bet ($1.37) returned to 2f12456d
2f12456d: shows [4c 4d]
15346d36: shows [Jc Js]
*** FLOP *** [Th 3d Tc]
*** TURN *** [Th 3d Tc] [6h]
*** RIVER *** [Th 3d Tc 6h] [3c]
*** SHOWDOWN ***
15346d36 collected $2.86 from pot
*** SUMMARY ***
Total pot $3.08 | Rake $0.15 | Jackpot $0.07 | Bingo $0 | Fortune $0 | Tax $0
Board [Th 3d Tc 6h 3c]
Seat 1: 11fb4d12 (button) folded before Flop (didn't bet)
Seat 2: Hero (small blind) folded before Flop
Seat 3: 15346d36 (big blind) showed [Jc Js] and won ($2.86) with Pair of Jacks and Pair of Tens
Seat 4: 7f79d927 folded before Flop (didn't bet)
Seat 5: 2f12456d showed [4c 4d] and lost with Pair of Tens and Pair of Fours
Seat 6: eed867f5 folded before Flop (didn't bet)


Poker Hand #RC3334437142: Hold'em No Limit ($0.02/$0.05) - 2025/02/17 20:34:40
Table 'RushAndCash602402' 6-max Seat #1 is the button
Seat 1: Hero ($7.3 in chips)
Seat 2: 77936ad9 ($6.12 in chips)
Seat 3: c1784884 ($6.62 in chips)
Seat 4: 731e166b ($5.45 in chips)
Seat 5: 1aca371e ($6.98 in chips)
Seat 6: b59fc0b9 ($5 in chips)
77936ad9: posts small blind $0.02
c1784884: posts big blind $0.05
*** HOLE CARDS ***
Dealt to Hero [2c 9d]
Dealt to 77936ad9 
Dealt to c1784884 
Dealt to 731e166b 
Dealt to 1aca371e 
Dealt to b59fc0b9 
731e166b: folds
1aca371e: raises $0.08 to $0.13
b59fc0b9: folds
Hero: folds
77936ad9: folds
c1784884: calls $0.08
*** FLOP *** [Kc 8c 4d]
c1784884: checks
1aca371e: bets $0.1
c1784884: calls $0.1
*** TURN *** [Kc 8c 4d] [Qh]
c1784884: checks
1aca371e: bets $0.38
c1784884: folds
Uncalled bet ($0.38) returned to 1aca371e
*** SHOWDOWN ***
1aca371e collected $0.46 from pot
*** SUMMARY ***
Total pot $0.48 | Rake $0.02 | Jackpot $0 | Bingo $0 | Fortune $0 | Tax $0
Board [Kc 8c 4d Qh]
Seat 1: Hero (button) folded before Flop (didn't bet)
Seat 2: 77936ad9 (small blind) folded before Flop
Seat 3: c1784884 (big blind) folded on the Turn
Seat 4: 731e166b folded before Flop (didn't bet)
Seat 5: 1aca371e won ($0.46)
Seat 6: b59fc0b9 folded before Flop (didn't bet)


Poker Hand #RC3334437063: Hold'em No Limit ($0.02/$0.05) - 2025/02/17 20:34:28
Table 'RushAndCash602323' 6-max Seat #1 is the button
Seat 1: ec1d0d44 ($11.21 in chips)
Seat 2: 95003d9e ($4.46 in chips)
Seat 3: Hero ($7.28 in chips)
Seat 4: 4238ab48 ($4.46 in chips)
Seat 5: 99df5763 ($5.25 in chips)
Seat 6: 2d54fb34 ($5.02 in chips)
95003d9e: posts small blind $0.02
Hero: posts big blind $0.05
*** HOLE CARDS ***
Dealt to ec1d0d44 
Dealt to 95003d9e 
Dealt to Hero [Jd Jc]
Dealt to 4238ab48 
Dealt to 99df5763 
Dealt to 2d54fb34 
4238ab48: folds
99df5763: folds
2d54fb34: folds
ec1d0d44: folds
95003d9e: folds
Uncalled bet ($0.03) returned to Hero
*** SHOWDOWN ***
Hero collected $0.04 from pot
*** SUMMARY ***
Total pot $0.04 | Rake $0 | Jackpot $0 | Bingo $0 | Fortune $0 | Tax $0
Seat 1: ec1d0d44 (button) folded before Flop (didn't bet)
Seat 2: 95003d9e (small blind) folded before Flop
Seat 3: Hero (big blind) collected ($0.04)
Seat 4: 4238ab48 folded before Flop (didn't bet)
Seat 5: 99df5763 folded before Flop (didn't bet)
Seat 6: 2d54fb34 folded before Flop (didn't bet)


Poker Hand #RC3334436557: Hold'em No Limit ($0.02/$0.05) - 2025/02/17 20:33:15
Table 'RushAndCash601817' 6-max Seat #1 is the button
Seat 1: 6c8cb957 ($5.42 in chips)
Seat 2: 11fb4d12 ($9.33 in chips)
Seat 3: 95003d9e ($5 in chips)
Seat 4: 491e0e63 ($5 in chips)
Seat 5: 38d2fc1e ($5.32 in chips)
Seat 6: Hero ($6.77 in chips)
11fb4d12: posts small blind $0.02
95003d9e: posts big blind $0.05
*** HOLE CARDS ***
Dealt to 6c8cb957 
Dealt to 11fb4d12 
Dealt to 95003d9e 
Dealt to 491e0e63 
Dealt to 38d2fc1e 
Dealt to Hero [5d 5s]
491e0e63: folds
38d2fc1e: folds
Hero: raises $0.05 to $0.1
6c8cb957: folds
11fb4d12: folds
95003d9e: raises $0.22 to $0.32
Hero: calls $0.22
*** FLOP *** [Jd 9c 3d]
95003d9e: bets $0.22
Hero: calls $0.22
*** TURN *** [Jd 9c 3d] [Kd]
95003d9e: checks
Hero: bets $0.38
95003d9e: folds
Uncalled bet ($0.38) returned to Hero
*** SHOWDOWN ***
Hero collected $1.05 from pot
*** SUMMARY ***
Total pot $1.1 | Rake $0.05 | Jackpot $0 | Bingo $0 | Fortune $0 | Tax $0
Board [Jd 9c 3d Kd]
Seat 1: 6c8cb957 (button) folded before Flop (didn't bet)
Seat 2: 11fb4d12 (small blind) folded before Flop
Seat 3: 95003d9e (big blind) folded on the Turn
Seat 4: 491e0e63 folded before Flop (didn't bet)
Seat 5: 38d2fc1e folded before Flop (didn't bet)
Seat 6: Hero won ($1.05)


Poker Hand #RC3334436532: Hold'em No Limit ($0.02/$0.05) - 2025/02/17 20:33:11
Table 'RushAndCash601792' 6-max Seat #1 is the button
Seat 1: ae49e9c ($5.46 in chips)
Seat 2: 1b6c31ec ($5.56 in chips)
Seat 3: d9a113f2 ($6.54 in chips)
Seat 4: Hero ($6.77 in chips)
Seat 5: 8508a44f ($5 in chips)
Seat 6: 735c4afd ($5 in chips)
1b6c31ec: posts small blind $0.02
d9a113f2: posts big blind $0.05
*** HOLE CARDS ***
Dealt to ae49e9c 
Dealt to 1b6c31ec 
Dealt to d9a113f2 
Dealt to Hero [Kd 8c]
Dealt to 8508a44f 
Dealt to 735c4afd 
Hero: folds
8508a44f: folds
735c4afd: folds
ae49e9c: raises $0.08 to $0.13
1b6c31ec: folds
d9a113f2: calls $0.08
*** FLOP *** [8h Tc Kh]
d9a113f2: checks
ae49e9c: bets $0.1
d9a113f2: calls $0.1
*** TURN *** [8h Tc Kh] [Ks]
d9a113f2: checks
ae49e9c: checks
*** RIVER *** [8h Tc Kh Ks] [Th]
d9a113f2: bets $0.36
ae49e9c: calls $0.36
d9a113f2: shows [7d Td] (Tens Full over Kings)
ae49e9c: shows [As Qs] (Pair of Kings and Pair of Tens)
*** SHOWDOWN ***
d9a113f2 collected $1.14 from pot
*** SUMMARY ***
Total pot $1.2 | Rake $0.06 | Jackpot $0 | Bingo $0 | Fortune $0 | Tax $0
Board [8h Tc Kh Ks Th]
Seat 1: ae49e9c (button) showed [As Qs] and lost with Pair of Kings and Pair of Tens
Seat 2: 1b6c31ec (small blind) folded before Flop
Seat 3: d9a113f2 (big blind) showed [7d Td] and won ($1.14) with Tens Full over Kings
Seat 4: Hero folded before Flop (didn't bet)
Seat 5: 8508a44f folded before Flop (didn't bet)
Seat 6: 735c4afd folded before Flop (didn't bet)


Poker Hand #RC3334436500: Hold'em No Limit ($0.02/$0.05) - 2025/02/17 20:33:07
Table 'RushAndCash601760' 6-max Seat #1 is the button
Seat 1: Hero ($6.77 in chips)
Seat 2: e3a10bfa ($5.22 in chips)
Seat 3: f724ee99 ($5.1 in chips)
Seat 4: 735c4afd ($5 in chips)
Seat 5: 21bff972 ($6.06 in chips)
Seat 6: 73382638 ($6.74 in chips)
e3a10bfa: posts small blind $0.02
f724ee99: posts big blind $0.05
*** HOLE CARDS ***
Dealt to Hero [7d Jc]
Dealt to e3a10bfa 
Dealt to f724ee99 
Dealt to 735c4afd 
Dealt to 21bff972 
Dealt to 73382638 
735c4afd: folds
21bff972: folds
73382638: folds
Hero: folds
e3a10bfa: folds
Uncalled bet ($0.03) returned to f724ee99
*** SHOWDOWN ***
f724ee99 collected $0.04 from pot
*** SUMMARY ***
Total pot $0.04 | Rake $0 | Jackpot $0 | Bingo $0 | Fortune $0 | Tax $0
Seat 1: Hero (button) folded before Flop (didn't bet)
Seat 2: e3a10bfa (small blind) folded before Flop
Seat 3: f724ee99 (big blind) collected ($0.04)
Seat 4: 735c4afd folded before Flop (didn't bet)
Seat 5: 21bff972 folded before Flop (didn't bet)
Seat 6: 73382638 folded before Flop (didn't bet)


Poker Hand #RC3334436459: Hold'em No Limit ($0.02/$0.05) - 2025/02/17 20:33:02
Table 'RushAndCash601719' 6-max Seat #1 is the button
Seat 1: 653af57c ($5.29 in chips)
Seat 2: 23cd2f90 ($2.82 in chips)
Seat 3: 1dbfd698 ($8.21 in chips)
Seat 4: 9684e9f0 ($6.55 in chips)
Seat 5: Hero ($6.77 in chips)
Seat 6: fc8b0177 ($6.52 in chips)
23cd2f90: posts small blind $0.02
1dbfd698: posts big blind $0.05
*** HOLE CARDS ***
Dealt to 653af57c 
Dealt to 23cd2f90 
Dealt to 1dbfd698 
Dealt to 9684e9f0 
Dealt to Hero [Kd Th]
Dealt to fc8b0177 
9684e9f0: folds
Hero: folds
fc8b0177: folds
653af57c: raises $0.07 to $0.12
23cd2f90: folds
1dbfd698: calls $0.07
*** FLOP *** [2s 2h 7d]
1dbfd698: checks
653af57c: checks
*** TURN *** [2s 2h 7d] [6s]
1dbfd698: bets $0.14
653af57c: calls $0.14
*** RIVER *** [2s 2h 7d 6s] [Qd]
1dbfd698: checks
653af57c: bets $0.41
1dbfd698: folds
Uncalled bet ($0.41) returned to 653af57c
*** SHOWDOWN ***
653af57c collected $0.52 from pot
*** SUMMARY ***
Total pot $0.54 | Rake $0.02 | Jackpot $0 | Bingo $0 | Fortune $0 | Tax $0
Board [2s 2h 7d 6s Qd]
Seat 1: 653af57c (button) won ($0.52)
Seat 2: 23cd2f90 (small blind) folded before Flop
Seat 3: 1dbfd698 (big blind) folded on the River
Seat 4: 9684e9f0 folded before Flop (didn't bet)
Seat 5: Hero folded before Flop (didn't bet)
Seat 6: fc8b0177 folded before Flop (didn't bet)


Poker Hand #RC3334436152: Hold'em No Limit ($0.02/$0.05) - 2025/02/17 20:32:19
Table 'RushAndCash601412' 6-max Seat #1 is the button
Seat 1: 860fa4c9 ($5 in chips)
Seat 2: db83c16e ($6.67 in chips)
Seat 3: 730098b8 ($7.67 in chips)
Seat 4: 93735ac4 ($2.67 in chips)
Seat 5: 995c838b ($5.09 in chips)
Seat 6: Hero ($6.04 in chips)
db83c16e: posts small blind $0.02
730098b8: posts big blind $0.05
*** HOLE CARDS ***
Dealt to 860fa4c9 
Dealt to db83c16e 
Dealt to 730098b8 
Dealt to 93735ac4 
Dealt to 995c838b 
Dealt to Hero [Ah As]
93735ac4: folds
995c838b: folds
Hero: raises $0.05 to $0.1
860fa4c9: calls $0.1
db83c16e: folds
730098b8: calls $0.05
*** FLOP *** [Js 7c Kc]
730098b8: checks
Hero: bets $0.12
860fa4c9: calls $0.12
730098b8: calls $0.12
*** TURN *** [Js 7c Kc] [4s]
730098b8: checks
Hero: checks
860fa4c9: bets $0.33
730098b8: folds
Hero: calls $0.33
*** RIVER *** [Js 7c Kc 4s] [8s]
Hero: checks
860fa4c9: checks
Hero: shows [Ah As] (Pair of Aces)
860fa4c9: shows [Kd Qh] (Pair of Kings)
*** SHOWDOWN ***
Hero collected $1.28 from pot
*** SUMMARY ***
Total pot $1.34 | Rake $0.06 | Jackpot $0 | Bingo $0 | Fortune $0 | Tax $0
Board [Js 7c Kc 4s 8s]
Seat 1: 860fa4c9 (button) showed [Kd Qh] and lost with Pair of Kings
Seat 2: db83c16e (small blind) folded before Flop
Seat 3: 730098b8 (big blind) folded on the Turn
Seat 4: 93735ac4 folded before Flop (didn't bet)
Seat 5: 995c838b folded before Flop (didn't bet)
Seat 6: Hero showed [Ah As] and won ($1.28) with Pair of Aces


Poker Hand #RC3334436016: Hold'em No Limit ($0.02/$0.05) - 2025/02/17 20:31:59
Table 'RushAndCash601276' 6-max Seat #1 is the button
Seat 1: e8f41d33 ($4.36 in chips)
Seat 2: 87a9a23b ($4.9 in chips)
Seat 3: Hero ($6.16 in chips)
Seat 4: d0475ba7 ($5.22 in chips)
Seat 5: 99df5763 ($4.93 in chips)
Seat 6: 6c8cb957 ($5.36 in chips)
87a9a23b: posts small blind $0.02
Hero: posts big blind $0.05
*** HOLE CARDS ***
Dealt to e8f41d33 
Dealt to 87a9a23b 
Dealt to Hero [Js Td]
Dealt to d0475ba7 
Dealt to 99df5763 
Dealt to 6c8cb957 
d0475ba7: folds
99df5763: folds
6c8cb957: raises $0.07 to $0.12
e8f41d33: folds
87a9a23b: folds
Hero: calls $0.07
*** FLOP *** [6h 6s As]
Hero: checks
6c8cb957: bets $0.09
Hero: folds
Uncalled bet ($0.09) returned to 6c8cb957
*** SHOWDOWN ***
6c8cb957 collected $0.25 from pot
*** SUMMARY ***
Total pot $0.26 | Rake $0.01 | Jackpot $0 | Bingo $0 | Fortune $0 | Tax $0
Board [6h 6s As]
Seat 1: e8f41d33 (button) folded before Flop (didn't bet)
Seat 2: 87a9a23b (small blind) folded before Flop
Seat 3: Hero (big blind) folded on the Flop
Seat 4: d0475ba7 folded before Flop (didn't bet)
Seat 5: 99df5763 folded before Flop (didn't bet)
Seat 6: 6c8cb957 won ($0.25)


Poker Hand #RC3334435978: Hold'em No Limit ($0.02/$0.05) - 2025/02/17 20:31:53
Table 'RushAndCash601238' 6-max Seat #1 is the button
Seat 1: f1f26d78 ($9.19 in chips)
Seat 2: Hero ($6.18 in chips)
Seat 3: dc9e794c ($5 in chips)
Seat 4: 45833808 ($6.53 in chips)
Seat 5: d58b99ca ($6.85 in chips)
Seat 6: 41720de0 ($20.99 in chips)
Hero: posts small blind $0.02
dc9e794c: posts big blind $0.05
*** HOLE CARDS ***
Dealt to f1f26d78 
Dealt to Hero [8h 5s]
Dealt to dc9e794c 
Dealt to 45833808 
Dealt to d58b99ca 
Dealt to 41720de0 
45833808: folds
d58b99ca: folds
41720de0: folds
f1f26d78: raises $0.08 to $0.13
Hero: folds
dc9e794c: calls $0.08
*** FLOP *** [Ks Ad 9d]
dc9e794c: bets $0.05
f1f26d78: calls $0.05
*** TURN *** [Ks Ad 9d] [8s]
dc9e794c: bets $0.05
f1f26d78: calls $0.05
*** RIVER *** [Ks Ad 9d 8s] [Jd]
dc9e794c: bets $0.05
f1f26d78: calls $0.05
dc9e794c: shows [4s 4c] (Pair of Fours)
f1f26d78: shows [Td As] (Pair of Aces)
*** SHOWDOWN ***
f1f26d78 collected $0.56 from pot
*** SUMMARY ***
Total pot $0.58 | Rake $0.02 | Jackpot $0 | Bingo $0 | Fortune $0 | Tax $0
Board [Ks Ad 9d 8s Jd]
Seat 1: f1f26d78 (button) showed [Td As] and won ($0.56) with Pair of Aces
Seat 2: Hero (small blind) folded before Flop
Seat 3: dc9e794c (big blind) showed [4s 4c] and lost with Pair of Fours
Seat 4: 45833808 folded before Flop (didn't bet)
Seat 5: d58b99ca folded before Flop (didn't bet)
Seat 6: 41720de0 folded before Flop (didn't bet)


Poker Hand #RC3334435958: Hold'em No Limit ($0.02/$0.05) - 2025/02/17 20:31:50
Table 'RushAndCash601218' 6-max Seat #1 is the button
Seat 1: 15e8a442 ($5.36 in chips)
Seat 2: 24c4874c ($4.93 in chips)
Seat 3: 87a9a23b ($4.88 in chips)
Seat 4: d58b99ca ($6.85 in chips)
Seat 5: fc8b0177 ($6.59 in chips)
Seat 6: Hero ($6.18 in chips)
24c4874c: posts small blind $0.02
87a9a23b: posts big blind $0.05
*** HOLE CARDS ***
Dealt to 15e8a442 
Dealt to 24c4874c 
Dealt to 87a9a23b 
Dealt to d58b99ca 
Dealt to fc8b0177 
Dealt to Hero [Tc 2d]
d58b99ca: folds
fc8b0177: folds
Hero: folds
15e8a442: folds
24c4874c: folds
Uncalled bet ($0.03) returned to 87a9a23b
*** SHOWDOWN ***
87a9a23b collected $0.04 from pot
*** SUMMARY ***
Total pot $0.04 | Rake $0 | Jackpot $0 | Bingo $0 | Fortune $0 | Tax $0
Seat 1: 15e8a442 (button) folded before Flop (didn't bet)
Seat 2: 24c4874c (small blind) folded before Flop
Seat 3: 87a9a23b (big blind) collected ($0.04)
Seat 4: d58b99ca folded before Flop (didn't bet)
Seat 5: fc8b0177 folded before Flop (didn't bet)
Seat 6: Hero folded before Flop (didn't bet)


Poker Hand #RC3334435940: Hold'em No Limit ($0.02/$0.05) - 2025/02/17 20:31:47
Table 'RushAndCash601200' 6-max Seat #1 is the button
Seat 1: 2353ba72 ($8.85 in chips)
Seat 2: 6662e866 ($16.02 in chips)
Seat 3: b3aefb75 ($10.66 in chips)
Seat 4: 8d7c8253 ($5.07 in chips)
Seat 5: Hero ($6.18 in chips)
Seat 6: ab5e89b2 ($5.75 in chips)
6662e866: posts small blind $0.02
b3aefb75: posts big blind $0.05
*** HOLE CARDS ***
Dealt to 2353ba72 
Dealt to 6662e866 
Dealt to b3aefb75 
Dealt to 8d7c8253 
Dealt to Hero [2h Jc]
Dealt to ab5e89b2 
8d7c8253: raises $0.05 to $0.1
Hero: folds
ab5e89b2: folds
2353ba72: folds
6662e866: calls $0.08
b3aefb75: folds
*** FLOP *** [4d Td 8h]
6662e866: checks
8d7c8253: bets $0.18
6662e866: folds
Uncalled bet ($0.18) returned to 8d7c8253
*** SHOWDOWN ***
8d7c8253 collected $0.24 from pot
*** SUMMARY ***
Total pot $0.25 | Rake $0.01 | Jackpot $0 | Bingo $0 | Fortune $0 | Tax $0
Board [4d Td 8h]
Seat 1: 2353ba72 (button) folded before Flop (didn't bet)
Seat 2: 6662e866 (small blind) folded on the Flop
Seat 3: b3aefb75 (big blind) folded before Flop
Seat 4: 8d7c8253 won ($0.24)
Seat 5: Hero folded before Flop (didn't bet)
Seat 6: ab5e89b2 folded before Flop (didn't bet)


Poker Hand #RC3334435919: Hold'em No Limit ($0.02/$0.05) - 2025/02/17 20:31:44
Table 'RushAndCash601179' 6-max Seat #1 is the button
Seat 1: 18af90c ($11.55 in chips)
Seat 2: 63a77bff ($4.24 in chips)
Seat 3: 87d9de00 ($4.41 in chips)
Seat 4: 4238ab48 ($4.51 in chips)
Seat 5: Hero ($6.18 in chips)
Seat 6: 35fb946f ($5.02 in chips)
63a77bff: posts small blind $0.02
87d9de00: posts big blind $0.05
*** HOLE CARDS ***
Dealt to 18af90c 
Dealt to 63a77bff 
Dealt to 87d9de00 
Dealt to 4238ab48 
Dealt to Hero [Ad 2s]
Dealt to 35fb946f 
4238ab48: folds
Hero: folds
35fb946f: folds
18af90c: folds
63a77bff: raises $0.06 to $0.11
87d9de00: folds
Uncalled bet ($0.06) returned to 63a77bff
*** SHOWDOWN ***
63a77bff collected $0.1 from pot
*** SUMMARY ***
Total pot $0.1 | Rake $0 | Jackpot $0 | Bingo $0 | Fortune $0 | Tax $0
Seat 1: 18af90c (button) folded before Flop (didn't bet)
Seat 2: 63a77bff (small blind) collected ($0.1)
Seat 3: 87d9de00 (big blind) folded before Flop
Seat 4: 4238ab48 folded before Flop (didn't bet)
Seat 5: Hero folded before Flop (didn't bet)
Seat 6: 35fb946f folded before Flop (didn't bet)


Poker Hand #RC3334435534: Hold'em No Limit ($0.02/$0.05) - 2025/02/17 20:30:44
Table 'RushAndCash600794' 6-max Seat #1 is the button
Seat 1: d58b99ca ($7.53 in chips)
Seat 2: cbfd6c92 ($4.76 in chips)
Seat 3: ead6cfaf ($5.14 in chips)
Seat 4: b67f7812 ($10.75 in chips)
Seat 5: Hero ($5 in chips)
Seat 6: 41926fd ($5.17 in chips)
cbfd6c92: posts small blind $0.02
ead6cfaf: posts big blind $0.05
*** HOLE CARDS ***
Dealt to d58b99ca 
Dealt to cbfd6c92 
Dealt to ead6cfaf 
Dealt to b67f7812 
Dealt to Hero [Kd Qd]
Dealt to 41926fd 
b67f7812: folds
Hero: raises $0.05 to $0.1
41926fd: raises $0.2 to $0.3
d58b99ca: folds
cbfd6c92: folds
ead6cfaf: folds
Hero: calls $0.2
*** FLOP *** [7d 9c 4s]
Hero: checks
41926fd: bets $0.28
Hero: calls $0.28
*** TURN *** [7d 9c 4s] [Qs]
Hero: checks
41926fd: bets $0.73
Hero: calls $0.73
*** RIVER *** [7d 9c 4s Qs] [Tc]
Hero: checks
41926fd: checks
Hero: shows [Kd Qd] (Pair of Queens)
41926fd: shows [Jh Js] (Pair of Jacks)
*** SHOWDOWN ***
Hero collected $2.49 from pot
*** SUMMARY ***
Total pot $2.69 | Rake $0.13 | Jackpot $0.07 | Bingo $0 | Fortune $0 | Tax $0
Board [7d 9c 4s Qs Tc]
Seat 1: d58b99ca (button) folded before Flop (didn't bet)
Seat 2: cbfd6c92 (small blind) folded before Flop
Seat 3: ead6cfaf (big blind) folded before Flop
Seat 4: b67f7812 folded before Flop (didn't bet)
Seat 5: Hero showed [Kd Qd] and won ($2.49) with Pair of Queens
Seat 6: 41926fd showed [Jh Js] and lost with Pair of Jacks


Poker Hand #RC3334435398: Hold'em No Limit ($0.02/$0.05) - 2025/02/17 20:30:23
Table 'RushAndCash600658' 6-max Seat #1 is the button
Seat 1: Hero ($5 in chips)
Seat 2: 1aca371e ($7.65 in chips)
Seat 3: 94c257a9 ($5.07 in chips)
Seat 4: 84d78f72 ($5 in chips)
Seat 5: 188c8947 ($4.13 in chips)
Seat 6: 187f2194 ($9.89 in chips)
1aca371e: posts small blind $0.02
94c257a9: posts big blind $0.05
*** HOLE CARDS ***
Dealt to Hero [Ts Kd]
Dealt to 1aca371e 
Dealt to 94c257a9 
Dealt to 84d78f72 
Dealt to 188c8947 
Dealt to 187f2194 
84d78f72: folds
188c8947: folds
187f2194: raises $0.05 to $0.1
Hero: folds
1aca371e: folds
94c257a9: folds
Uncalled bet ($0.05) returned to 187f2194
*** SHOWDOWN ***
187f2194 collected $0.12 from pot
*** SUMMARY ***
Total pot $0.12 | Rake $0 | Jackpot $0 | Bingo $0 | Fortune $0 | Tax $0
Seat 1: Hero (button) folded before Flop (didn't bet)
Seat 2: 1aca371e (small blind) folded before Flop
Seat 3: 94c257a9 (big blind) folded before Flop
Seat 4: 84d78f72 folded before Flop (didn't bet)
Seat 5: 188c8947 folded before Flop (didn't bet)
Seat 6: 187f2194 collected ($0.12)


Poker Hand #RC3334435147: Hold'em No Limit ($0.02/$0.05) - 2025/02/17 20:29:44
Table 'RushAndCash600407' 6-max Seat #1 is the button
Seat 1: ef7b5599 ($16.11 in chips)
Seat 2: 7da1f29c ($5.09 in chips)
Seat 3: Hero ($5 in chips)
Seat 4: 64f89f4b ($5.51 in chips)
Seat 5: cf85f0e5 ($5.27 in chips)
Seat 6: 6da96b4d ($5.28 in chips)
7da1f29c: posts small blind $0.02
Hero: posts big blind $0.05
*** HOLE CARDS ***
Dealt to ef7b5599 
Dealt to 7da1f29c 
Dealt to Hero [Js Qc]
Dealt to 64f89f4b 
Dealt to cf85f0e5 
Dealt to 6da96b4d 
64f89f4b: folds
cf85f0e5: folds
6da96b4d: folds
ef7b5599: folds
7da1f29c: raises $0.08 to $0.13
Hero: calls $0.08
*** FLOP *** [4c Kd 2h]
7da1f29c: checks
Hero: checks
*** TURN *** [4c Kd 2h] [7c]
7da1f29c: bets $0.2
Hero: folds
Uncalled bet ($0.2) returned to 7da1f29c
*** SHOWDOWN ***
7da1f29c collected $0.25 from pot
*** SUMMARY ***
Total pot $0.26 | Rake $0.01 | Jackpot $0 | Bingo $0 | Fortune $0 | Tax $0
Board [4c Kd 2h 7c]
Seat 1: ef7b5599 (button) folded before Flop (didn't bet)
Seat 2: 7da1f29c (small blind) won ($0.25)
Seat 3: Hero (big blind) folded on the Turn
Seat 4: 64f89f4b folded before Flop (didn't bet)
Seat 5: cf85f0e5 folded before Flop (didn't bet)
Seat 6: 6da96b4d folded before Flop (didn't bet)


Poker Hand #RC3334435124: Hold'em No Limit ($0.02/$0.05) - 2025/02/17 20:29:41
Table 'RushAndCash600384' 6-max Seat #1 is the button
Seat 1: 6a5a3ab6 ($6.52 in chips)
Seat 2: Hero ($5 in chips)
Seat 3: fa7bb2c5 ($5.06 in chips)
Seat 4: 157631a0 ($6.87 in chips)
Seat 5: a6ca20e7 ($35.19 in chips)
Seat 6: 1aca371e ($7.71 in chips)
Hero: posts small blind $0.02
fa7bb2c5: posts big blind $0.05
*** HOLE CARDS ***
Dealt to 6a5a3ab6 
Dealt to Hero [6c Th]
Dealt to fa7bb2c5 
Dealt to 157631a0 
Dealt to a6ca20e7 
Dealt to 1aca371e 
157631a0: folds
a6ca20e7: folds
1aca371e: raises $0.08 to $0.13
6a5a3ab6: folds
Hero: folds
fa7bb2c5: folds
Uncalled bet ($0.08) returned to 1aca371e
*** SHOWDOWN ***
1aca371e collected $0.12 from pot
*** SUMMARY ***
Total pot $0.12 | Rake $0 | Jackpot $0 | Bingo $0 | Fortune $0 | Tax $0
Seat 1: 6a5a3ab6 (button) folded before Flop (didn't bet)
Seat 2: Hero (small blind) folded before Flop
Seat 3: fa7bb2c5 (big blind) folded before Flop
Seat 4: 157631a0 folded before Flop (didn't bet)
Seat 5: a6ca20e7 folded before Flop (didn't bet)
Seat 6: 1aca371e collected ($0.12)


Poker Hand #RC3334435102: Hold'em No Limit ($0.02/$0.05) - 2025/02/17 20:29:38
Table 'RushAndCash600362' 6-max Seat #1 is the button
Seat 1: 57d6169c ($5.49 in chips)
Seat 2: ae49e9c ($5 in chips)
Seat 3: 24c4874c ($3.49 in chips)
Seat 4: 6c8cb957 ($5.56 in chips)
Seat 5: e9c5dfd7 ($7.51 in chips)
Seat 6: Hero ($5 in chips)
ae49e9c: posts small blind $0.02
24c4874c: posts big blind $0.05
*** HOLE CARDS ***
Dealt to 57d6169c 
Dealt to ae49e9c 
Dealt to 24c4874c 
Dealt to 6c8cb957 
Dealt to e9c5dfd7 
Dealt to Hero [3s Ad]
6c8cb957: folds
e9c5dfd7: raises $0.05 to $0.1
Hero: folds
57d6169c: folds
ae49e9c: calls $0.08
24c4874c: folds
*** FLOP *** [4c 2s Js]
ae49e9c: checks
e9c5dfd7: checks
*** TURN *** [4c 2s Js] [4h]
ae49e9c: checks
e9c5dfd7: checks
*** RIVER *** [4c 2s Js 4h] [2h]
ae49e9c: bets $0.06
e9c5dfd7: folds
Uncalled bet ($0.06) returned to ae49e9c
*** SHOWDOWN ***
ae49e9c collected $0.24 from pot
*** SUMMARY ***
Total pot $0.25 | Rake $0.01 | Jackpot $0 | Bingo $0 | Fortune $0 | Tax $0
Board [4c 2s Js 4h 2h]
Seat 1: 57d6169c (button) folded before Flop (didn't bet)
Seat 2: ae49e9c (small blind) won ($0.24)
Seat 3: 24c4874c (big blind) folded before Flop
Seat 4: 6c8cb957 folded before Flop (didn't bet)
Seat 5: e9c5dfd7 folded on the River
Seat 6: Hero folded before Flop (didn't bet)


Poker Hand #RC3334435079: Hold'em No Limit ($0.02/$0.05) - 2025/02/17 20:29:35
Table 'RushAndCash600339' 6-max Seat #1 is the button
Seat 1: 7570303b ($5 in chips)
Seat 2: d58b99ca ($7.55 in chips)
Seat 3: d913286e ($5.87 in chips)
Seat 4: Hero ($5 in chips)
Seat 5: 6f4a31af ($5 in chips)
Seat 6: ae49e9c ($5 in chips)
d58b99ca: posts small blind $0.02
d913286e: posts big blind $0.05
*** HOLE CARDS ***
Dealt to 7570303b 
Dealt to d58b99ca 
Dealt to d913286e 
Dealt to Hero [As 2s]
Dealt to 6f4a31af 
Dealt to ae49e9c 
Hero: folds
6f4a31af: folds
ae49e9c: folds
7570303b: raises $0.06 to $0.11
d58b99ca: raises $0.39 to $0.5
d913286e: folds
7570303b: folds
Uncalled bet ($0.39) returned to d58b99ca
*** SHOWDOWN ***
d58b99ca collected $0.26 from pot
*** SUMMARY ***
Total pot $0.27 | Rake $0.01 | Jackpot $0 | Bingo $0 | Fortune $0 | Tax $0
Seat 1: 7570303b (button) folded before Flop
Seat 2: d58b99ca (small blind) collected ($0.26)
Seat 3: d913286e (big blind) folded before Flop
Seat 4: Hero folded before Flop (didn't bet)
Seat 5: 6f4a31af folded before Flop (didn't bet)
Seat 6: ae49e9c folded before Flop (didn't bet)


Poker Hand #RC3334435046: Hold'em No Limit ($0.02/$0.05) - 2025/02/17 20:29:30
Table 'RushAndCash600306' 6-max Seat #1 is the button
Seat 1: 18cb11a ($5 in chips)
Seat 2: c8e834fc ($4.55 in chips)
Seat 3: 9564515b ($5 in chips)
Seat 4: 72fa4c0f ($2.65 in chips)
Seat 5: Hero ($5 in chips)
Seat 6: b7d97ee0 ($5.76 in chips)
c8e834fc: posts small blind $0.02
9564515b: posts big blind $0.05
*** HOLE CARDS ***
Dealt to 18cb11a 
Dealt to c8e834fc 
Dealt to 9564515b 
Dealt to 72fa4c0f 
Dealt to Hero [3h 5s]
Dealt to b7d97ee0 
72fa4c0f: folds
Hero: folds
b7d97ee0: raises $0.07 to $0.12
18cb11a: folds
c8e834fc: folds
9564515b: folds
Uncalled bet ($0.07) returned to b7d97ee0
*** SHOWDOWN ***
b7d97ee0 collected $0.12 from pot
*** SUMMARY ***
Total pot $0.12 | Rake $0 | Jackpot $0 | Bingo $0 | Fortune $0 | Tax $0
Seat 1: 18cb11a (button) folded before Flop (didn't bet)
Seat 2: c8e834fc (small blind) folded before Flop
Seat 3: 9564515b (big blind) folded before Flop
Seat 4: 72fa4c0f folded before Flop (didn't bet)
Seat 5: Hero folded before Flop (didn't bet)
Seat 6: b7d97ee0 collected ($0.12)


Poker Hand #RC3334435020: Hold'em No Limit ($0.02/$0.05) - 2025/02/17 20:29:26
Table 'RushAndCash600280' 6-max Seat #1 is the button
Seat 1: 8ab4a2f1 ($5 in chips)
Seat 2: d201e5fe ($6.65 in chips)
Seat 3: Hero ($5 in chips)
Seat 4: 87b4e331 ($6.4 in chips)
Seat 5: 207d9345 ($22.71 in chips)
Seat 6: bbdadd69 ($5.61 in chips)
d201e5fe: posts small blind $0.02
Hero: posts big blind $0.05
*** HOLE CARDS ***
Dealt to 8ab4a2f1 
Dealt to d201e5fe 
Dealt to Hero [3s 4d]
Dealt to 87b4e331 
Dealt to 207d9345 
Dealt to bbdadd69 
87b4e331: folds
207d9345: folds
bbdadd69: folds
8ab4a2f1: folds
d201e5fe: raises $0.13 to $0.18
Hero: folds
Uncalled bet ($0.13) returned to d201e5fe
*** SHOWDOWN ***
d201e5fe collected $0.1 from pot
*** SUMMARY ***
Total pot $0.1 | Rake $0 | Jackpot $0 | Bingo $0 | Fortune $0 | Tax $0
Seat 1: 8ab4a2f1 (button) folded before Flop (didn't bet)
Seat 2: d201e5fe (small blind) collected ($0.1)
Seat 3: Hero (big blind) folded before Flop
Seat 4: 87b4e331 folded before Flop (didn't bet)
Seat 5: 207d9345 folded before Flop (didn't bet)
Seat 6: bbdadd69 folded before Flop (didn't bet)


Poker Hand #RC3334434998: Hold'em No Limit ($0.02/$0.05) - 2025/02/17 20:29:22
Table 'RushAndCash600258' 6-max Seat #1 is the button
Seat 1: 8e07c53 ($5 in chips)
Seat 2: Hero ($5 in chips)
Seat 3: 16b0b958 ($5.59 in chips)
Seat 4: d913286e ($5.87 in chips)
Seat 5: c6158c9d ($8.02 in chips)
Seat 6: 6ebc3323 ($13.03 in chips)
Hero: posts small blind $0.02
16b0b958: posts big blind $0.05
*** HOLE CARDS ***
Dealt to 8e07c53 
Dealt to Hero [2h 9s]
Dealt to 16b0b958 
Dealt to d913286e 
Dealt to c6158c9d 
Dealt to 6ebc3323 
d913286e: folds
c6158c9d: folds
6ebc3323: folds
8e07c53: folds
Hero: folds
Uncalled bet ($0.03) returned to 16b0b958
*** SHOWDOWN ***
16b0b958 collected $0.04 from pot
*** SUMMARY ***
Total pot $0.04 | Rake $0 | Jackpot $0 | Bingo $0 | Fortune $0 | Tax $0
Seat 1: 8e07c53 (button) folded before Flop (didn't bet)
Seat 2: Hero (small blind) folded before Flop
Seat 3: 16b0b958 (big blind) collected ($0.04)
Seat 4: d913286e folded before Flop (didn't bet)
Seat 5: c6158c9d folded before Flop (didn't bet)
Seat 6: 6ebc3323 folded before Flop (didn't bet)


Poker Hand #RC3334434971: Hold'em No Limit ($0.02/$0.05) - 2025/02/17 20:29:18
Table 'RushAndCash600231' 6-max Seat #1 is the button
Seat 1: Hero ($5 in chips)
Seat 2: b7bd1225 ($5.33 in chips)
Seat 3: a223d3ca ($5 in chips)
Seat 4: 5f8248c5 ($3.69 in chips)
Seat 5: e92b360e ($13 in chips)
Seat 6: 1c01f5f5 ($5.17 in chips)
b7bd1225: posts small blind $0.02
a223d3ca: posts big blind $0.05
*** HOLE CARDS ***
Dealt to Hero [Kh 6c]
Dealt to b7bd1225 
Dealt to a223d3ca 
Dealt to 5f8248c5 
Dealt to e92b360e 
Dealt to 1c01f5f5 
5f8248c5: folds
e92b360e: folds
1c01f5f5: raises $0.08 to $0.13
Hero: folds
b7bd1225: calls $0.11
a223d3ca: folds
*** FLOP *** [Jc Jh As]
b7bd1225: checks
1c01f5f5: bets $0.15
b7bd1225: calls $0.15
*** TURN *** [Jc Jh As] [7h]
b7bd1225: checks
1c01f5f5: bets $0.4
b7bd1225: raises $0.81 to $1.21
1c01f5f5: calls $0.81
*** RIVER *** [Jc Jh As 7h] [4h]
b7bd1225: bets $3.84 and is all-in
1c01f5f5: calls $3.68 and is all-in
Uncalled bet ($0.16) returned to b7bd1225
b7bd1225: shows [Ac Js] (Jacks Full over Aces)
1c01f5f5: shows [Kc Ah] (Pair of Aces and Pair of Jacks)
*** SHOWDOWN ***
b7bd1225 collected $10.17 from pot
*** SUMMARY ***
Total pot $10.39 | Rake $0.15 | Jackpot $0.07 | Bingo $0 | Fortune $0 | Tax $0
Board [Jc Jh As 7h 4h]
Seat 1: Hero (button) folded before Flop (didn't bet)
Seat 2: b7bd1225 (small blind) showed [Ac Js] and won ($10.17) with Jacks Full over Aces
Seat 3: a223d3ca (big blind) folded before Flop
Seat 4: 5f8248c5 folded before Flop (didn't bet)
Seat 5: e92b360e folded before Flop (didn't bet)
Seat 6: 1c01f5f5 showed [Kc Ah] and lost with Pair of Aces and Pair of Jacks


Poker Hand #RC3334434933: Hold'em No Limit ($0.02/$0.05) - 2025/02/17 20:29:11
Table 'RushAndCash600193' 6-max Seat #1 is the button
Seat 1: 42fca4f9 ($4.96 in chips)
Seat 2: f20f94d9 ($5 in chips)
Seat 3: 290b880 ($6.64 in chips)
Seat 4: dc9e794c ($5.34 in chips)
Seat 5: Hero ($5 in chips)
Seat 6: cd1f87c8 ($4.86 in chips)
f20f94d9: posts small blind $0.02
290b880: posts big blind $0.05
*** HOLE CARDS ***
Dealt to 42fca4f9 
Dealt to f20f94d9 
Dealt to 290b880 
Dealt to dc9e794c 
Dealt to Hero [4d Ad]
Dealt to cd1f87c8 
dc9e794c: raises $0.08 to $0.13
Hero: folds
cd1f87c8: folds
42fca4f9: raises $0.25 to $0.38
f20f94d9: folds
290b880: folds
dc9e794c: calls $0.25
*** FLOP *** [Ah 7s Kh]
dc9e794c: checks
42fca4f9: checks
*** TURN *** [Ah 7s Kh] [Js]
dc9e794c: bets $0.83
42fca4f9: raises $0.83 to $1.66
dc9e794c: raises $3.3 to $4.96 and is all-in
42fca4f9: calls $2.92 and is all-in
Uncalled bet ($0.38) returned to dc9e794c
dc9e794c: shows [Jh Jd] (Three Jacks)
42fca4f9: shows [Kd Kc] (Three Kings)
*** RIVER *** [Ah 7s Kh Js] [Tc]
*** SHOWDOWN ***
42fca4f9 collected $9.77 from pot
*** SUMMARY ***
Total pot $9.99 | Rake $0.15 | Jackpot $0.07 | Bingo $0 | Fortune $0 | Tax $0
Board [Ah 7s Kh Js Tc]
Seat 1: 42fca4f9 (button) showed [Kd Kc] and won ($9.77) with Three Kings
Seat 2: f20f94d9 (small blind) folded before Flop
Seat 3: 290b880 (big blind) folded before Flop
Seat 4: dc9e794c showed [Jh Jd] and lost with Three Jacks
Seat 5: Hero folded before Flop (didn't bet)
Seat 6: cd1f87c8 folded before Flop (didn't bet)


Poker Hand #RC3334434905: Hold'em No Limit ($0.02/$0.05) - 2025/02/17 20:29:07
Table 'RushAndCash600165' 6-max Seat #1 is the button
Seat 1: 9f09d482 ($6.91 in chips)
Seat 2: 198f6b0e ($5.04 in chips)
Seat 3: ead6cfaf ($5 in chips)
Seat 4: 64e5de41 ($5.3 in chips)
Seat 5: eb14a598 ($5.77 in chips)
Seat 6: Hero ($5 in chips)
198f6b0e: posts small blind $0.02
ead6cfaf: posts big blind $0.05
*** HOLE CARDS ***
Dealt to 9f09d482 
Dealt to 198f6b0e 
Dealt to ead6cfaf 
Dealt to 64e5de41 
Dealt to eb14a598 
Dealt to Hero [Jd 3c]
64e5de41: folds
eb14a598: raises $0.1 to $0.15
Hero: folds
9f09d482: folds
198f6b0e: folds
ead6cfaf: folds
Uncalled bet ($0.1) returned to eb14a598
*** SHOWDOWN ***
eb14a598 collected $0.12 from pot
*** SUMMARY ***
Total pot $0.12 | Rake $0 | Jackpot $0 | Bingo $0 | Fortune $0 | Tax $0
Seat 1: 9f09d482 (button) folded before Flop (didn't bet)
Seat 2: 198f6b0e (small blind) folded before Flop
Seat 3: ead6cfaf (big blind) folded before Flop
Seat 4: 64e5de41 folded before Flop (didn't bet)
Seat 5: eb14a598 collected ($0.12)
Seat 6: Hero folded before Flop (didn't bet)


Poker Hand #RC3334434888: Hold'em No Limit ($0.02/$0.05) - 2025/02/17 20:29:04
Table 'RushAndCash600148' 6-max Seat #1 is the button
Seat 1: 42fca4f9 ($4.96 in chips)
Seat 2: 16f2e5ce ($6.03 in chips)
Seat 3: c0de4e76 ($4.43 in chips)
Seat 4: Hero ($5 in chips)
Seat 5: f8db84a ($5.1 in chips)
Seat 6: cd1f87c8 ($4.86 in chips)
16f2e5ce: posts small blind $0.02
c0de4e76: posts big blind $0.05
*** HOLE CARDS ***
Dealt to 42fca4f9 
Dealt to 16f2e5ce 
Dealt to c0de4e76 
Dealt to Hero [5c Td]
Dealt to f8db84a 
Dealt to cd1f87c8 
Hero: folds
f8db84a: folds
cd1f87c8: folds
42fca4f9: folds
16f2e5ce: raises $0.1 to $0.15
c0de4e76: calls $0.1
*** FLOP *** [Kd 4d As]
16f2e5ce: bets $0.1
c0de4e76: calls $0.1
*** TURN *** [Kd 4d As] [Th]
16f2e5ce: checks
c0de4e76: bets $0.25
16f2e5ce: folds
Uncalled bet ($0.25) returned to c0de4e76
*** SHOWDOWN ***
c0de4e76 collected $0.48 from pot
*** SUMMARY ***
Total pot $0.5 | Rake $0.02 | Jackpot $0 | Bingo $0 | Fortune $0 | Tax $0
Board [Kd 4d As Th]
Seat 1: 42fca4f9 (button) folded before Flop (didn't bet)
Seat 2: 16f2e5ce (small blind) folded on the Turn
Seat 3: c0de4e76 (big blind) won ($0.48)
Seat 4: Hero folded before Flop (didn't bet)
Seat 5: f8db84a folded before Flop (didn't bet)
Seat 6: cd1f87c8 folded before Flop (didn't bet)


Poker Hand #RC3334434865: Hold'em No Limit ($0.02/$0.05) - 2025/02/17 20:29:00
Table 'RushAndCash600125' 6-max Seat #1 is the button
Seat 1: 37cb1e1b ($5.04 in chips)
Seat 2: Hero ($5.02 in chips)
Seat 3: 12cda2e0 ($17.15 in chips)
Seat 4: 742ccfee ($3.63 in chips)
Seat 5: cd1f87c8 ($4.86 in chips)
Seat 6: 2e8ab509 ($5.4 in chips)
Hero: posts small blind $0.02
12cda2e0: posts big blind $0.05
*** HOLE CARDS ***
Dealt to 37cb1e1b 
Dealt to Hero [8s 9d]
Dealt to 12cda2e0 
Dealt to 742ccfee 
Dealt to cd1f87c8 
Dealt to 2e8ab509 
742ccfee: raises $0.05 to $0.1
cd1f87c8: folds
2e8ab509: folds
37cb1e1b: folds
Hero: folds
12cda2e0: calls $0.05
*** FLOP *** [8h Jh 6s]
12cda2e0: checks
742ccfee: checks
*** TURN *** [8h Jh 6s] [5c]
12cda2e0: bets $0.09
742ccfee: folds
Uncalled bet ($0.09) returned to 12cda2e0
*** SHOWDOWN ***
12cda2e0 collected $0.21 from pot
*** SUMMARY ***
Total pot $0.22 | Rake $0.01 | Jackpot $0 | Bingo $0 | Fortune $0 | Tax $0
Board [8h Jh 6s 5c]
Seat 1: 37cb1e1b (button) folded before Flop (didn't bet)
Seat 2: Hero (small blind) folded before Flop
Seat 3: 12cda2e0 (big blind) won ($0.21)
Seat 4: 742ccfee folded on the Turn
Seat 5: cd1f87c8 folded before Flop (didn't bet)
Seat 6: 2e8ab509 folded before Flop (didn't bet)


Poker Hand #RC3334434788: Hold'em No Limit ($0.02/$0.05) - 2025/02/17 20:28:49
Table 'RushAndCash600048' 6-max Seat #1 is the button
Seat 1: e74a324 ($5.92 in chips)
Seat 2: 27baaa05 ($6.59 in chips)
Seat 3: Hero ($5.07 in chips)
Seat 4: bfef046a ($5 in chips)
Seat 5: d58b99ca ($6.82 in chips)
Seat 6: 41720de0 ($21.49 in chips)
27baaa05: posts small blind $0.02
Hero: posts big blind $0.05
*** HOLE CARDS ***
Dealt to e74a324 
Dealt to 27baaa05 
Dealt to Hero [8s 4s]
Dealt to bfef046a 
Dealt to d58b99ca 
Dealt to 41720de0 
bfef046a: folds
d58b99ca: raises $0.07 to $0.12
41720de0: folds
e74a324: raises $0.24 to $0.36
27baaa05: folds
Hero: folds
d58b99ca: calls $0.24
*** FLOP *** [7h 4h 3h]
d58b99ca: checks
e74a324: bets $0.2
d58b99ca: raises $0.58 to $0.78
e74a324: folds
Uncalled bet ($0.58) returned to d58b99ca
*** SHOWDOWN ***
d58b99ca collected $1.13 from pot
*** SUMMARY ***
Total pot $1.19 | Rake $0.06 | Jackpot $0 | Bingo $0 | Fortune $0 | Tax $0
Board [7h 4h 3h]
Seat 1: e74a324 (button) folded on the Flop
Seat 2: 27baaa05 (small blind) folded before Flop
Seat 3: Hero (big blind) folded before Flop
Seat 4: bfef046a folded before Flop (didn't bet)
Seat 5: d58b99ca won ($1.13)
Seat 6: 41720de0 folded before Flop (didn't bet)


Poker Hand #RC3334434763: Hold'em No Limit ($0.02/$0.05) - 2025/02/17 20:28:46
Table 'RushAndCash600023' 6-max Seat #1 is the button
Seat 1: 86768906 ($8.86 in chips)
Seat 2: 6b62a9a6 ($5.28 in chips)
Seat 3: 78b1f985 ($4.55 in chips)
Seat 4: d201e5fe ($6.49 in chips)
Seat 5: Hero ($5.07 in chips)
Seat 6: ef82d036 ($23.04 in chips)
6b62a9a6: posts small blind $0.02
78b1f985: posts big blind $0.05
*** HOLE CARDS ***
Dealt to 86768906 
Dealt to 6b62a9a6 
Dealt to 78b1f985 
Dealt to d201e5fe 
Dealt to Hero [9c 4d]
Dealt to ef82d036 
d201e5fe: folds
Hero: folds
ef82d036: folds
86768906: raises $0.05 to $0.1
6b62a9a6: folds
78b1f985: folds
Uncalled bet ($0.05) returned to 86768906
*** SHOWDOWN ***
86768906 collected $0.12 from pot
*** SUMMARY ***
Total pot $0.12 | Rake $0 | Jackpot $0 | Bingo $0 | Fortune $0 | Tax $0
Seat 1: 86768906 (button) collected ($0.12)
Seat 2: 6b62a9a6 (small blind) folded before Flop
Seat 3: 78b1f985 (big blind) folded before Flop
Seat 4: d201e5fe folded before Flop (didn't bet)
Seat 5: Hero folded before Flop (didn't bet)
Seat 6: ef82d036 folded before Flop (didn't bet)


Poker Hand #RC3334374564: Hold'em No Limit ($0.02/$0.05) - 2025/02/17 20:28:18
Table 'RushAndCash599824' 6-max Seat #1 is the button
Seat 1: Hero ($5 in chips)
Seat 2: 3dbbdac8 ($5.23 in chips)
Seat 3: 721df422 ($4.98 in chips)
Seat 4: 5acd5e40 ($5.23 in chips)
Seat 5: 56cefdc9 ($2.85 in chips)
Seat 6: 1c01f5f5 ($4.33 in chips)
3dbbdac8: posts small blind $0.02
721df422: posts big blind $0.05
*** HOLE CARDS ***
Dealt to Hero [8s 8d]
Dealt to 3dbbdac8 
Dealt to 721df422 
Dealt to 5acd5e40 
Dealt to 56cefdc9 
Dealt to 1c01f5f5 
5acd5e40: folds
56cefdc9: folds
1c01f5f5: folds
Hero: raises $0.05 to $0.1
3dbbdac8: folds
721df422: folds
Uncalled bet ($0.05) returned to Hero
*** SHOWDOWN ***
Hero collected $0.12 from pot
*** SUMMARY ***
Total pot $0.12 | Rake $0 | Jackpot $0 | Bingo $0 | Fortune $0 | Tax $0
Seat 1: Hero (button) collected ($0.12)
Seat 2: 3dbbdac8 (small blind) folded before Flop
Seat 3: 721df422 (big blind) folded before Flop
Seat 4: 5acd5e40 folded before Flop (didn't bet)
Seat 5: 56cefdc9 folded before Flop (didn't bet)
Seat 6: 1c01f5f5 folded before Flop (didn't bet)


Poker Hand #RC3334374545: Hold'em No Limit ($0.02/$0.05) - 2025/02/17 20:28:15
Table 'RushAndCash599805' 6-max Seat #1 is the button
Seat 1: e4d8df1d ($6.6 in chips)
Seat 2: b3aefb75 ($10.68 in chips)
Seat 3: 709ac205 ($12.05 in chips)
Seat 4: 97fe2676 ($11.05 in chips)
Seat 5: bfef046a ($5.07 in chips)
Seat 6: Hero ($5 in chips)
b3aefb75: posts small blind $0.02
709ac205: posts big blind $0.05
*** HOLE CARDS ***
Dealt to e4d8df1d 
Dealt to b3aefb75 
Dealt to 709ac205 
Dealt to 97fe2676 
Dealt to bfef046a 
Dealt to Hero [9c 7s]
97fe2676: folds
bfef046a: folds
Hero: folds
e4d8df1d: folds
b3aefb75: folds
Uncalled bet ($0.03) returned to 709ac205
*** SHOWDOWN ***
709ac205 collected $0.04 from pot
*** SUMMARY ***
Total pot $0.04 | Rake $0 | Jackpot $0 | Bingo $0 | Fortune $0 | Tax $0
Seat 1: e4d8df1d (button) folded before Flop (didn't bet)
Seat 2: b3aefb75 (small blind) folded before Flop
Seat 3: 709ac205 (big blind) collected ($0.04)
Seat 4: 97fe2676 folded before Flop (didn't bet)
Seat 5: bfef046a folded before Flop (didn't bet)
Seat 6: Hero folded before Flop (didn't bet)


Poker Hand #RC3334374522: Hold'em No Limit ($0.02/$0.05) - 2025/02/17 20:28:11
Table 'RushAndCash599782' 6-max Seat #1 is the button
Seat 1: 1e290a15 ($9.62 in chips)
Seat 2: f8db84a ($5.12 in chips)
Seat 3: 64f89f4b ($5.61 in chips)
Seat 4: Hero ($5 in chips)
Seat 5: 63a77bff ($5.47 in chips)
Seat 6: 229ec9a7 ($5.03 in chips)
f8db84a: posts small blind $0.02
64f89f4b: posts big blind $0.05
*** HOLE CARDS ***
Dealt to 1e290a15 
Dealt to f8db84a 
Dealt to 64f89f4b 
Dealt to Hero [9c 3c]
Dealt to 63a77bff 
Dealt to 229ec9a7 
Hero: folds
63a77bff: raises $0.05 to $0.1
229ec9a7: raises $0.41 to $0.51
1e290a15: folds
f8db84a: folds
64f89f4b: folds
63a77bff: calls $0.41
*** FLOP *** [5d Ad As]
63a77bff: checks
229ec9a7: bets $0.22
63a77bff: calls $0.22
*** TURN *** [5d Ad As] [5h]
63a77bff: checks
229ec9a7: checks
*** RIVER *** [5d Ad As 5h] [7s]
63a77bff: bets $0.5
229ec9a7: calls $0.5
63a77bff: shows [Jd Jh] (Pair of Aces and Pair of Jacks)
229ec9a7: shows [Tc Ac] (Aces Full over Fives)
*** SHOWDOWN ***
229ec9a7 collected $2.34 from pot
*** SUMMARY ***
Total pot $2.53 | Rake $0.12 | Jackpot $0.07 | Bingo $0 | Fortune $0 | Tax $0
Board [5d Ad As 5h 7s]
Seat 1: 1e290a15 (button) folded before Flop (didn't bet)
Seat 2: f8db84a (small blind) folded before Flop
Seat 3: 64f89f4b (big blind) folded before Flop
Seat 4: Hero folded before Flop (didn't bet)
Seat 5: 63a77bff showed [Jd Jh] and lost with Pair of Aces and Pair of Jacks
Seat 6: 229ec9a7 showed [Tc Ac] and won ($2.34) with Aces Full over Fives


Poker Hand #RC3334374492: Hold'em No Limit ($0.02/$0.05) - 2025/02/17 20:28:06
Table 'RushAndCash599752' 6-max Seat #1 is the button
Seat 1: Hero ($5 in chips)
Seat 2: c4483bd8 ($5.42 in chips)
Seat 3: 8ffbb474 ($7.35 in chips)
Seat 4: 87d5083b ($19.24 in chips)
Seat 5: 7dd18ea7 ($7.24 in chips)
Seat 6: 7fe74cc5 ($5 in chips)
c4483bd8: posts small blind $0.02
8ffbb474: posts big blind $0.05
*** HOLE CARDS ***
Dealt to Hero [3d As]
Dealt to c4483bd8 
Dealt to 8ffbb474 
Dealt to 87d5083b 
Dealt to 7dd18ea7 
Dealt to 7fe74cc5 
87d5083b: folds
7dd18ea7: folds
7fe74cc5: raises $0.06 to $0.11
Hero: folds
c4483bd8: raises $0.21 to $0.32
8ffbb474: folds
7fe74cc5: calls $0.21
*** FLOP *** [8h 9s 2c]
c4483bd8: bets $0.54
7fe74cc5: folds
Uncalled bet ($0.54) returned to c4483bd8
*** SHOWDOWN ***
c4483bd8 collected $0.66 from pot
*** SUMMARY ***
Total pot $0.69 | Rake $0.03 | Jackpot $0 | Bingo $0 | Fortune $0 | Tax $0
Board [8h 9s 2c]
Seat 1: Hero (button) folded before Flop (didn't bet)
Seat 2: c4483bd8 (small blind) won ($0.66)
Seat 3: 8ffbb474 (big blind) folded before Flop
Seat 4: 87d5083b folded before Flop (didn't bet)
Seat 5: 7dd18ea7 folded before Flop (didn't bet)
Seat 6: 7fe74cc5 folded on the Flop


Poker Hand #RC3334374452: Hold'em No Limit ($0.02/$0.05) - 2025/02/17 20:27:59
Table 'RushAndCash599712' 6-max Seat #1 is the button
Seat 1: 9013f95e ($13.41 in chips)
Seat 2: Hero ($5 in chips)
Seat 3: 54fe77bd ($6.85 in chips)
Seat 4: d58b99ca ($6.78 in chips)
Seat 5: 2486dbda ($2.28 in chips)
Seat 6: 87d9de00 ($2.64 in chips)
Hero: posts small blind $0.02
54fe77bd: posts big blind $0.05
*** HOLE CARDS ***
Dealt to 9013f95e 
Dealt to Hero [Th Js]
Dealt to 54fe77bd 
Dealt to d58b99ca 
Dealt to 2486dbda 
Dealt to 87d9de00 
d58b99ca: folds
2486dbda: raises $0.05 to $0.1
87d9de00: calls $0.1
9013f95e: folds
Hero: folds
54fe77bd: folds
*** FLOP *** [Td Ad 4d]
2486dbda: bets $0.14
87d9de00: calls $0.14
*** TURN *** [Td Ad 4d] [8s]
2486dbda: checks
87d9de00: checks
*** RIVER *** [Td Ad 4d 8s] [8c]
2486dbda: checks
87d9de00: bets $0.28
2486dbda: folds
Uncalled bet ($0.28) returned to 87d9de00
*** SHOWDOWN ***
87d9de00 collected $0.53 from pot
*** SUMMARY ***
Total pot $0.55 | Rake $0.02 | Jackpot $0 | Bingo $0 | Fortune $0 | Tax $0
Board [Td Ad 4d 8s 8c]
Seat 1: 9013f95e (button) folded before Flop (didn't bet)
Seat 2: Hero (small blind) folded before Flop
Seat 3: 54fe77bd (big blind) folded before Flop
Seat 4: d58b99ca folded before Flop (didn't bet)
Seat 5: 2486dbda folded on the River
Seat 6: 87d9de00 showed [4c] and won ($0.53)


Poker Hand #RC3334374257: Hold'em No Limit ($0.02/$0.05) - 2025/02/17 20:27:28
Table 'RushAndCash599517' 6-max Seat #1 is the button
Seat 1: a9af8bb8 ($5 in chips)
Seat 2: 4238ab48 ($4.83 in chips)
Seat 3: Hero ($5 in chips)
Seat 4: c9ea832 ($7.26 in chips)
Seat 5: dea8bb2e ($5 in chips)
Seat 6: 2486dbda ($2.17 in chips)
4238ab48: posts small blind $0.02
Hero: posts big blind $0.05
*** HOLE CARDS ***
Dealt to a9af8bb8 
Dealt to 4238ab48 
Dealt to Hero [4h 3h]
Dealt to c9ea832 
Dealt to dea8bb2e 
Dealt to 2486dbda 
c9ea832: folds
dea8bb2e: folds
2486dbda: calls $0.05
a9af8bb8: folds
4238ab48: folds
Hero: checks
*** FLOP *** [6h 3c 7c]
Hero: checks
2486dbda: bets $0.05
Hero: calls $0.05
*** TURN *** [6h 3c 7c] [8s]
Hero: checks
2486dbda: checks
*** RIVER *** [6h 3c 7c 8s] [Ks]
Hero: checks
2486dbda: bets $0.11
Hero: folds
Uncalled bet ($0.11) returned to 2486dbda
*** SHOWDOWN ***
2486dbda collected $0.21 from pot
*** SUMMARY ***
Total pot $0.22 | Rake $0.01 | Jackpot $0 | Bingo $0 | Fortune $0 | Tax $0
Board [6h 3c 7c 8s Ks]
Seat 1: a9af8bb8 (button) folded before Flop (didn't bet)
Seat 2: 4238ab48 (small blind) folded before Flop
Seat 3: Hero (big blind) folded on the River
Seat 4: c9ea832 folded before Flop (didn't bet)
Seat 5: dea8bb2e folded before Flop (didn't bet)
Seat 6: 2486dbda won ($0.21)


Poker Hand #RC3334374236: Hold'em No Limit ($0.02/$0.05) - 2025/02/17 20:27:25
Table 'RushAndCash599496' 6-max Seat #1 is the button
Seat 1: 32d40ce0 ($5.89 in chips)
Seat 2: 8be10cd0 ($12.04 in chips)
Seat 3: ed38df5e ($5.09 in chips)
Seat 4: Hero ($5 in chips)
Seat 5: faba3abb ($5 in chips)
Seat 6: 796ed2b8 ($5.07 in chips)
8be10cd0: posts small blind $0.02
ed38df5e: posts big blind $0.05
*** HOLE CARDS ***
Dealt to 32d40ce0 
Dealt to 8be10cd0 
Dealt to ed38df5e 
Dealt to Hero [8c Js]
Dealt to faba3abb 
Dealt to 796ed2b8 
Hero: folds
faba3abb: folds
796ed2b8: folds
32d40ce0: folds
8be10cd0: folds
Uncalled bet ($0.03) returned to ed38df5e
*** SHOWDOWN ***
ed38df5e collected $0.04 from pot
*** SUMMARY ***
Total pot $0.04 | Rake $0 | Jackpot $0 | Bingo $0 | Fortune $0 | Tax $0
Seat 1: 32d40ce0 (button) folded before Flop (didn't bet)
Seat 2: 8be10cd0 (small blind) folded before Flop
Seat 3: ed38df5e (big blind) collected ($0.04)
Seat 4: Hero folded before Flop (didn't bet)
Seat 5: faba3abb folded before Flop (didn't bet)
Seat 6: 796ed2b8 folded before Flop (didn't bet)


Poker Hand #RC3334374116: Hold'em No Limit ($0.02/$0.05) - 2025/02/17 20:27:07
Table 'RushAndCash599376' 6-max Seat #1 is the button
Seat 1: 144ea2b0 ($10.66 in chips)
Seat 2: 100d4f9e ($5.92 in chips)
Seat 3: 32d40ce0 ($5.78 in chips)
Seat 4: 45833808 ($7.03 in chips)
Seat 5: bda9ba33 ($2.23 in chips)
Seat 6: Hero ($5.06 in chips)
100d4f9e: posts small blind $0.02
32d40ce0: posts big blind $0.05
*** HOLE CARDS ***
Dealt to 144ea2b0 
Dealt to 100d4f9e 
Dealt to 32d40ce0 
Dealt to 45833808 
Dealt to bda9ba33 
Dealt to Hero [Jc Qc]
45833808: folds
bda9ba33: folds
Hero: raises $0.05 to $0.1
144ea2b0: folds
100d4f9e: folds
32d40ce0: raises $0.36 to $0.46
Hero: folds
Uncalled bet ($0.36) returned to 32d40ce0
*** SHOWDOWN ***
32d40ce0 collected $0.21 from pot
*** SUMMARY ***
Total pot $0.22 | Rake $0.01 | Jackpot $0 | Bingo $0 | Fortune $0 | Tax $0
Seat 1: 144ea2b0 (button) folded before Flop (didn't bet)
Seat 2: 100d4f9e (small blind) folded before Flop
Seat 3: 32d40ce0 (big blind) collected ($0.21)
Seat 4: 45833808 folded before Flop (didn't bet)
Seat 5: bda9ba33 folded before Flop (didn't bet)
Seat 6: Hero folded before Flop


Poker Hand #RC3334374092: Hold'em No Limit ($0.02/$0.05) - 2025/02/17 20:27:03
Table 'RushAndCash599352' 6-max Seat #1 is the button
Seat 1: 902b47de ($5.24 in chips)
Seat 2: 54fe77bd ($6.85 in chips)
Seat 3: 721df422 ($2 in chips)
Seat 4: 144ea2b0 ($10.66 in chips)
Seat 5: Hero ($5.06 in chips)
Seat 6: 13ffafdd ($5.38 in chips)
54fe77bd: posts small blind $0.02
721df422: posts big blind $0.05
*** HOLE CARDS ***
Dealt to 902b47de 
Dealt to 54fe77bd 
Dealt to 721df422 
Dealt to 144ea2b0 
Dealt to Hero [Jc 5d]
Dealt to 13ffafdd 
144ea2b0: folds
Hero: folds
13ffafdd: folds
902b47de: raises $0.05 to $0.1
54fe77bd: folds
721df422: calls $0.05
*** FLOP *** [8s 5c 4h]
721df422: checks
902b47de: bets $0.14
721df422: calls $0.14
*** TURN *** [8s 5c 4h] [Ac]
721df422: checks
902b47de: bets $0.5
721df422: folds
Uncalled bet ($0.5) returned to 902b47de
*** SHOWDOWN ***
902b47de collected $0.48 from pot
*** SUMMARY ***
Total pot $0.5 | Rake $0.02 | Jackpot $0 | Bingo $0 | Fortune $0 | Tax $0
Board [8s 5c 4h Ac]
Seat 1: 902b47de (button) won ($0.48)
Seat 2: 54fe77bd (small blind) folded before Flop
Seat 3: 721df422 (big blind) folded on the Turn
Seat 4: 144ea2b0 folded before Flop (didn't bet)
Seat 5: Hero folded before Flop (didn't bet)
Seat 6: 13ffafdd folded before Flop (didn't bet)


Poker Hand #RC3334374071: Hold'em No Limit ($0.02/$0.05) - 2025/02/17 20:27:00
Table 'RushAndCash599331' 6-max Seat #1 is the button
Seat 1: Hero ($5.06 in chips)
Seat 2: 4d8ae83 ($5.04 in chips)
Seat 3: d86379c5 ($6.99 in chips)
Seat 4: f739af93 ($8.41 in chips)
Seat 5: 6da96b4d ($5.07 in chips)
Seat 6: 883394d6 ($5.8 in chips)
4d8ae83: posts small blind $0.02
d86379c5: posts big blind $0.05
*** HOLE CARDS ***
Dealt to Hero [Ad 6s]
Dealt to 4d8ae83 
Dealt to d86379c5 
Dealt to f739af93 
Dealt to 6da96b4d 
Dealt to 883394d6 
f739af93: folds
6da96b4d: folds
883394d6: folds
Hero: folds
4d8ae83: raises $0.05 to $0.1
d86379c5: folds
Uncalled bet ($0.05) returned to 4d8ae83
*** SHOWDOWN ***
4d8ae83 collected $0.1 from pot
*** SUMMARY ***
Total pot $0.1 | Rake $0 | Jackpot $0 | Bingo $0 | Fortune $0 | Tax $0
Seat 1: Hero (button) folded before Flop (didn't bet)
Seat 2: 4d8ae83 (small blind) collected ($0.1)
Seat 3: d86379c5 (big blind) folded before Flop
Seat 4: f739af93 folded before Flop (didn't bet)
Seat 5: 6da96b4d folded before Flop (didn't bet)
Seat 6: 883394d6 folded before Flop (didn't bet)


Poker Hand #RC3334374045: Hold'em No Limit ($0.02/$0.05) - 2025/02/17 20:26:57
Table 'RushAndCash599305' 6-max Seat #1 is the button
Seat 1: c4eb9775 ($17.8 in chips)
Seat 2: 6f7140f6 ($4.83 in chips)
Seat 3: Hero ($5.11 in chips)
Seat 4: 53c3b7da ($4.24 in chips)
Seat 5: c11c2441 ($5 in chips)
Seat 6: 27020fb4 ($8.1 in chips)
6f7140f6: posts small blind $0.02
Hero: posts big blind $0.05
*** HOLE CARDS ***
Dealt to c4eb9775 
Dealt to 6f7140f6 
Dealt to Hero [7s 5d]
Dealt to 53c3b7da 
Dealt to c11c2441 
Dealt to 27020fb4 
53c3b7da: raises $0.05 to $0.1
c11c2441: folds
27020fb4: folds
c4eb9775: folds
6f7140f6: folds
Hero: folds
Uncalled bet ($0.05) returned to 53c3b7da
*** SHOWDOWN ***
53c3b7da collected $0.12 from pot
*** SUMMARY ***
Total pot $0.12 | Rake $0 | Jackpot $0 | Bingo $0 | Fortune $0 | Tax $0
Seat 1: c4eb9775 (button) folded before Flop (didn't bet)
Seat 2: 6f7140f6 (small blind) folded before Flop
Seat 3: Hero (big blind) folded before Flop
Seat 4: 53c3b7da collected ($0.12)
Seat 5: c11c2441 folded before Flop (didn't bet)
Seat 6: 27020fb4 folded before Flop (didn't bet)


Poker Hand #RC3334374019: Hold'em No Limit ($0.02/$0.05) - 2025/02/17 20:26:53
Table 'RushAndCash599279' 6-max Seat #1 is the button
Seat 1: d738c756 ($3.26 in chips)
Seat 2: 6c6b017a ($5 in chips)
Seat 3: e69e22e ($8.09 in chips)
Seat 4: Hero ($5.11 in chips)
Seat 5: ef82d036 ($23.38 in chips)
Seat 6: 5acd5e40 ($5.14 in chips)
6c6b017a: posts small blind $0.02
e69e22e: posts big blind $0.05
*** HOLE CARDS ***
Dealt to d738c756 
Dealt to 6c6b017a 
Dealt to e69e22e 
Dealt to Hero [Qc 9c]
Dealt to ef82d036 
Dealt to 5acd5e40 
Hero: folds
ef82d036: folds
5acd5e40: folds
d738c756: raises $0.05 to $0.1
6c6b017a: folds
e69e22e: folds
Uncalled bet ($0.05) returned to d738c756
*** SHOWDOWN ***
d738c756 collected $0.12 from pot
*** SUMMARY ***
Total pot $0.12 | Rake $0 | Jackpot $0 | Bingo $0 | Fortune $0 | Tax $0
Seat 1: d738c756 (button) collected ($0.12)
Seat 2: 6c6b017a (small blind) folded before Flop
Seat 3: e69e22e (big blind) folded before Flop
Seat 4: Hero folded before Flop (didn't bet)
Seat 5: ef82d036 folded before Flop (didn't bet)
Seat 6: 5acd5e40 folded before Flop (didn't bet)


Poker Hand #RC3334373976: Hold'em No Limit ($0.02/$0.05) - 2025/02/17 20:26:47
Table 'RushAndCash599236' 6-max Seat #1 is the button
Seat 1: b9e511a ($21.69 in chips)
Seat 2: Hero ($5.13 in chips)
Seat 3: 9babc997 ($5.54 in chips)
Seat 4: 8896706d ($5.87 in chips)
Seat 5: 72fa4c0f ($2.87 in chips)
Seat 6: ce23f617 ($5 in chips)
Hero: posts small blind $0.02
9babc997: posts big blind $0.05
*** HOLE CARDS ***
Dealt to b9e511a 
Dealt to Hero [4s 2s]
Dealt to 9babc997 
Dealt to 8896706d 
Dealt to 72fa4c0f 
Dealt to ce23f617 
8896706d: folds
72fa4c0f: folds
ce23f617: folds
b9e511a: folds
Hero: folds
Uncalled bet ($0.03) returned to 9babc997
*** SHOWDOWN ***
9babc997 collected $0.04 from pot
*** SUMMARY ***
Total pot $0.04 | Rake $0 | Jackpot $0 | Bingo $0 | Fortune $0 | Tax $0
Seat 1: b9e511a (button) folded before Flop (didn't bet)
Seat 2: Hero (small blind) folded before Flop
Seat 3: 9babc997 (big blind) collected ($0.04)
Seat 4: 8896706d folded before Flop (didn't bet)
Seat 5: 72fa4c0f folded before Flop (didn't bet)
Seat 6: ce23f617 folded before Flop (didn't bet)


Poker Hand #RC3334373855: Hold'em No Limit ($0.02/$0.05) - 2025/02/17 20:26:28
Table 'RushAndCash599115' 6-max Seat #1 is the button
Seat 1: bbdadd69 ($5.42 in chips)
Seat 2: 656af102 ($7.1 in chips)
Seat 3: 9b4fbe63 ($7.28 in chips)
Seat 4: Hero ($5.06 in chips)
Seat 5: 886c894a ($9.23 in chips)
Seat 6: 72fa4c0f ($2.87 in chips)
656af102: posts small blind $0.02
9b4fbe63: posts big blind $0.05
*** HOLE CARDS ***
Dealt to bbdadd69 
Dealt to 656af102 
Dealt to 9b4fbe63 
Dealt to Hero [6c 6h]
Dealt to 886c894a 
Dealt to 72fa4c0f 
Hero: raises $0.05 to $0.1
886c894a: folds
72fa4c0f: folds
bbdadd69: folds
656af102: folds
9b4fbe63: folds
Uncalled bet ($0.05) returned to Hero
*** SHOWDOWN ***
Hero collected $0.12 from pot
*** SUMMARY ***
Total pot $0.12 | Rake $0 | Jackpot $0 | Bingo $0 | Fortune $0 | Tax $0
Seat 1: bbdadd69 (button) folded before Flop (didn't bet)
Seat 2: 656af102 (small blind) folded before Flop
Seat 3: 9b4fbe63 (big blind) folded before Flop
Seat 4: Hero collected ($0.12)
Seat 5: 886c894a folded before Flop (didn't bet)
Seat 6: 72fa4c0f folded before Flop (didn't bet)


Poker Hand #RC3334373836: Hold'em No Limit ($0.02/$0.05) - 2025/02/17 20:26:25
Table 'RushAndCash599096' 6-max Seat #1 is the button
Seat 1: 2ae4e16 ($15.57 in chips)
Seat 2: Hero ($5.08 in chips)
Seat 3: 634fda30 ($7.84 in chips)
Seat 4: c4483bd8 ($4.69 in chips)
Seat 5: 52f43d28 ($7.1 in chips)
Seat 6: d201e5fe ($6.65 in chips)
Hero: posts small blind $0.02
634fda30: posts big blind $0.05
*** HOLE CARDS ***
Dealt to 2ae4e16 
Dealt to Hero [Ts 5s]
Dealt to 634fda30 
Dealt to c4483bd8 
Dealt to 52f43d28 
Dealt to d201e5fe 
c4483bd8: raises $0.05 to $0.1
52f43d28: folds
d201e5fe: folds
2ae4e16: folds
Hero: folds
634fda30: folds
Uncalled bet ($0.05) returned to c4483bd8
*** SHOWDOWN ***
c4483bd8 collected $0.12 from pot
*** SUMMARY ***
Total pot $0.12 | Rake $0 | Jackpot $0 | Bingo $0 | Fortune $0 | Tax $0
Seat 1: 2ae4e16 (button) folded before Flop (didn't bet)
Seat 2: Hero (small blind) folded before Flop
Seat 3: 634fda30 (big blind) folded before Flop
Seat 4: c4483bd8 collected ($0.12)
Seat 5: 52f43d28 folded before Flop (didn't bet)
Seat 6: d201e5fe folded before Flop (didn't bet)


Poker Hand #RC3334373814: Hold'em No Limit ($0.02/$0.05) - 2025/02/17 20:26:22
Table 'RushAndCash599074' 6-max Seat #1 is the button
Seat 1: 77936ad9 ($5.86 in chips)
Seat 2: 7381628 ($5.02 in chips)
Seat 3: 93dfef8b ($5 in chips)
Seat 4: 8e07c53 ($5.19 in chips)
Seat 5: Hero ($5.08 in chips)
Seat 6: e3a10bfa ($5 in chips)
7381628: posts small blind $0.02
93dfef8b: posts big blind $0.05
*** HOLE CARDS ***
Dealt to 77936ad9 
Dealt to 7381628 
Dealt to 93dfef8b 
Dealt to 8e07c53 
Dealt to Hero [4c Qh]
Dealt to e3a10bfa 
8e07c53: raises $0.06 to $0.11
Hero: folds
e3a10bfa: folds
77936ad9: folds
7381628: calls $0.09
93dfef8b: folds
*** FLOP *** [9d Qs Qc]
7381628: checks
8e07c53: checks
*** TURN *** [9d Qs Qc] [Th]
7381628: checks
8e07c53: checks
*** RIVER *** [9d Qs Qc Th] [6d]
7381628: checks
8e07c53: checks
7381628: shows [9h 8h] (Pair of Queens and Pair of Nines)
8e07c53: shows [3c 3d] (Pair of Queens and Pair of Treys)
*** SHOWDOWN ***
7381628 collected $0.26 from pot
*** SUMMARY ***
Total pot $0.27 | Rake $0.01 | Jackpot $0 | Bingo $0 | Fortune $0 | Tax $0
Board [9d Qs Qc Th 6d]
Seat 1: 77936ad9 (button) folded before Flop (didn't bet)
Seat 2: 7381628 (small blind) showed [9h 8h] and won ($0.26) with Pair of Queens and Pair of Nines
Seat 3: 93dfef8b (big blind) folded before Flop
Seat 4: 8e07c53 showed [3c 3d] and lost with Pair of Queens and Pair of Treys
Seat 5: Hero folded before Flop (didn't bet)
Seat 6: e3a10bfa folded before Flop (didn't bet)


Poker Hand #RC3334373793: Hold'em No Limit ($0.02/$0.05) - 2025/02/17 20:26:19
Table 'RushAndCash599053' 6-max Seat #1 is the button
Seat 1: Hero ($5.08 in chips)
Seat 2: 4c8dd192 ($12.32 in chips)
Seat 3: 130fc8d7 ($10.63 in chips)
Seat 4: 41926fd ($5.38 in chips)
Seat 5: 64f89f4b ($5.73 in chips)
Seat 6: 6c122cb5 ($7.19 in chips)
4c8dd192: posts small blind $0.02
130fc8d7: posts big blind $0.05
*** HOLE CARDS ***
Dealt to Hero [3s 9d]
Dealt to 4c8dd192 
Dealt to 130fc8d7 
Dealt to 41926fd 
Dealt to 64f89f4b 
Dealt to 6c122cb5 
41926fd: folds
64f89f4b: folds
6c122cb5: folds
Hero: folds
4c8dd192: folds
Uncalled bet ($0.03) returned to 130fc8d7
*** SHOWDOWN ***
130fc8d7 collected $0.04 from pot
*** SUMMARY ***
Total pot $0.04 | Rake $0 | Jackpot $0 | Bingo $0 | Fortune $0 | Tax $0
Seat 1: Hero (button) folded before Flop (didn't bet)
Seat 2: 4c8dd192 (small blind) folded before Flop
Seat 3: 130fc8d7 (big blind) collected ($0.04)
Seat 4: 41926fd folded before Flop (didn't bet)
Seat 5: 64f89f4b folded before Flop (didn't bet)
Seat 6: 6c122cb5 folded before Flop (didn't bet)


Poker Hand #RC3334373551: Hold'em No Limit ($0.02/$0.05) - 2025/02/17 20:25:43
Table 'RushAndCash598811' 6-max Seat #1 is the button
Seat 1: 4c8dd192 ($12.18 in chips)
Seat 2: 92ac71f9 ($5.98 in chips)
Seat 3: Hero ($5.21 in chips)
Seat 4: 52f43d28 ($7.17 in chips)
Seat 5: c1784884 ($5.16 in chips)
Seat 6: deccd7eb ($5 in chips)
92ac71f9: posts small blind $0.02
Hero: posts big blind $0.05
*** HOLE CARDS ***
Dealt to 4c8dd192 
Dealt to 92ac71f9 
Dealt to Hero [8s Jh]
Dealt to 52f43d28 
Dealt to c1784884 
Dealt to deccd7eb 
52f43d28: folds
c1784884: folds
deccd7eb: folds
4c8dd192: raises $0.08 to $0.13
92ac71f9: folds
Hero: calls $0.08
*** FLOP *** [2c Ac 9h]
Hero: checks
4c8dd192: bets $0.21
Hero: folds
Uncalled bet ($0.21) returned to 4c8dd192
*** SHOWDOWN ***
4c8dd192 collected $0.27 from pot
*** SUMMARY ***
Total pot $0.28 | Rake $0.01 | Jackpot $0 | Bingo $0 | Fortune $0 | Tax $0
Board [2c Ac 9h]
Seat 1: 4c8dd192 (button) won ($0.27)
Seat 2: 92ac71f9 (small blind) folded before Flop
Seat 3: Hero (big blind) folded on the Flop
Seat 4: 52f43d28 folded before Flop (didn't bet)
Seat 5: c1784884 folded before Flop (didn't bet)
Seat 6: deccd7eb folded before Flop (didn't bet)


Poker Hand #RC3334373527: Hold'em No Limit ($0.02/$0.05) - 2025/02/17 20:25:39
Table 'RushAndCash598787' 6-max Seat #1 is the button
Seat 1: fa84cc2d ($17.6 in chips)
Seat 2: 6ab8e60e ($13.72 in chips)
Seat 3: 4e3c3196 ($22.6 in chips)
Seat 4: Hero ($5.21 in chips)
Seat 5: 32a238cd ($4.57 in chips)
Seat 6: 91e92de9 ($5.14 in chips)
6ab8e60e: posts small blind $0.02
4e3c3196: posts big blind $0.05
*** HOLE CARDS ***
Dealt to fa84cc2d 
Dealt to 6ab8e60e 
Dealt to 4e3c3196 
Dealt to Hero [7s 8h]
Dealt to 32a238cd 
Dealt to 91e92de9 
Hero: folds
32a238cd: folds
91e92de9: folds
fa84cc2d: folds
6ab8e60e: raises $0.05 to $0.1
4e3c3196: folds
Uncalled bet ($0.05) returned to 6ab8e60e
*** SHOWDOWN ***
6ab8e60e collected $0.1 from pot
*** SUMMARY ***
Total pot $0.1 | Rake $0 | Jackpot $0 | Bingo $0 | Fortune $0 | Tax $0
Seat 1: fa84cc2d (button) folded before Flop (didn't bet)
Seat 2: 6ab8e60e (small blind) collected ($0.1)
Seat 3: 4e3c3196 (big blind) folded before Flop
Seat 4: Hero folded before Flop (didn't bet)
Seat 5: 32a238cd folded before Flop (didn't bet)
Seat 6: 91e92de9 folded before Flop (didn't bet)


Poker Hand #RC3334373505: Hold'em No Limit ($0.02/$0.05) - 2025/02/17 20:25:36
Table 'RushAndCash598765' 6-max Seat #1 is the button
Seat 1: 2b8b2921 ($6.05 in chips)
Seat 2: c7d7e6aa ($12.09 in chips)
Seat 3: ac2aecf ($1.56 in chips)
Seat 4: Hero ($5.21 in chips)
Seat 5: 1ed08fba ($10.31 in chips)
Seat 6: b67f7812 ($10.06 in chips)
c7d7e6aa: posts small blind $0.02
ac2aecf: posts big blind $0.05
*** HOLE CARDS ***
Dealt to 2b8b2921 
Dealt to c7d7e6aa 
Dealt to ac2aecf 
Dealt to Hero [2h 7d]
Dealt to 1ed08fba 
Dealt to b67f7812 
Hero: folds
1ed08fba: folds
b67f7812: folds
2b8b2921: folds
c7d7e6aa: raises $0.07 to $0.12
ac2aecf: folds
Uncalled bet ($0.07) returned to c7d7e6aa
*** SHOWDOWN ***
c7d7e6aa collected $0.1 from pot
*** SUMMARY ***
Total pot $0.1 | Rake $0 | Jackpot $0 | Bingo $0 | Fortune $0 | Tax $0
Seat 1: 2b8b2921 (button) folded before Flop (didn't bet)
Seat 2: c7d7e6aa (small blind) collected ($0.1)
Seat 3: ac2aecf (big blind) folded before Flop
Seat 4: Hero folded before Flop (didn't bet)
Seat 5: 1ed08fba folded before Flop (didn't bet)
Seat 6: b67f7812 folded before Flop (didn't bet)


Poker Hand #RC3334373480: Hold'em No Limit ($0.02/$0.05) - 2025/02/17 20:25:32
Table 'RushAndCash598740' 6-max Seat #1 is the button
Seat 1: c2e88c14 ($5 in chips)
Seat 2: cedf4726 ($10.64 in chips)
Seat 3: 1df270b6 ($8.05 in chips)
Seat 4: 9d364714 ($5.07 in chips)
Seat 5: Hero ($5.21 in chips)
Seat 6: 8340b24c ($4.83 in chips)
cedf4726: posts small blind $0.02
1df270b6: posts big blind $0.05
*** HOLE CARDS ***
Dealt to c2e88c14 
Dealt to cedf4726 
Dealt to 1df270b6 
Dealt to 9d364714 
Dealt to Hero [7d Kc]
Dealt to 8340b24c 
9d364714: raises $0.05 to $0.1
Hero: folds
8340b24c: folds
c2e88c14: folds
cedf4726: folds
1df270b6: calls $0.05
*** FLOP *** [2s 6s Td]
1df270b6: checks
9d364714: checks
*** TURN *** [2s 6s Td] [3c]
1df270b6: bets $0.17
9d364714: raises $0.42 to $0.59
1df270b6: folds
Uncalled bet ($0.42) returned to 9d364714
*** SHOWDOWN ***
9d364714 collected $0.54 from pot
*** SUMMARY ***
Total pot $0.56 | Rake $0.02 | Jackpot $0 | Bingo $0 | Fortune $0 | Tax $0
Board [2s 6s Td 3c]
Seat 1: c2e88c14 (button) folded before Flop (didn't bet)
Seat 2: cedf4726 (small blind) folded before Flop
Seat 3: 1df270b6 (big blind) folded on the Turn
Seat 4: 9d364714 won ($0.54)
Seat 5: Hero folded before Flop (didn't bet)
Seat 6: 8340b24c folded before Flop (didn't bet)


Poker Hand #RC3334373405: Hold'em No Limit ($0.02/$0.05) - 2025/02/17 20:25:21
Table 'RushAndCash598665' 6-max Seat #1 is the button
Seat 1: Hero ($5.14 in chips)
Seat 2: 9564515b ($4.73 in chips)
Seat 3: af002596 ($6.22 in chips)
Seat 4: 3b85f8e6 ($14.52 in chips)
Seat 5: 9013f95e ($13.32 in chips)
Seat 6: 835df346 ($15.9 in chips)
9564515b: posts small blind $0.02
af002596: posts big blind $0.05
*** HOLE CARDS ***
Dealt to Hero [Ah 9s]
Dealt to 9564515b 
Dealt to af002596 
Dealt to 3b85f8e6 
Dealt to 9013f95e 
Dealt to 835df346 
3b85f8e6: folds
9013f95e: folds
835df346: folds
Hero: raises $0.05 to $0.1
9564515b: folds
af002596: folds
Uncalled bet ($0.05) returned to Hero
*** SHOWDOWN ***
Hero collected $0.12 from pot
*** SUMMARY ***
Total pot $0.12 | Rake $0 | Jackpot $0 | Bingo $0 | Fortune $0 | Tax $0
Seat 1: Hero (button) collected ($0.12)
Seat 2: 9564515b (small blind) folded before Flop
Seat 3: af002596 (big blind) folded before Flop
Seat 4: 3b85f8e6 folded before Flop (didn't bet)
Seat 5: 9013f95e folded before Flop (didn't bet)
Seat 6: 835df346 folded before Flop (didn't bet)


Poker Hand #RC3334373096: Hold'em No Limit ($0.02/$0.05) - 2025/02/17 20:24:31
Table 'RushAndCash598356' 6-max Seat #1 is the button
Seat 1: 56cefdc9 ($2.85 in chips)
Seat 2: 92ac71f9 ($5.89 in chips)
Seat 3: Hero ($5 in chips)
Seat 4: 6662e866 ($16.3 in chips)
Seat 5: ef82d036 ($23.15 in chips)
Seat 6: 835df346 ($16.03 in chips)
92ac71f9: posts small blind $0.02
Hero: posts big blind $0.05
*** HOLE CARDS ***
Dealt to 56cefdc9 
Dealt to 92ac71f9 
Dealt to Hero [Jh Ad]
Dealt to 6662e866 
Dealt to ef82d036 
Dealt to 835df346 
6662e866: folds
ef82d036: folds
835df346: raises $0.08 to $0.13
56cefdc9: folds
92ac71f9: folds
Hero: calls $0.08
*** FLOP *** [4s Qc 7d]
Hero: checks
835df346: checks
*** TURN *** [4s Qc 7d] [3c]
Hero: checks
835df346: checks
*** RIVER *** [4s Qc 7d 3c] [Td]
Hero: checks
835df346: checks
Hero: shows [Jh Ad] (Ace-High)
835df346: shows [8h 9h] (Queen-High)
*** SHOWDOWN ***
Hero collected $0.27 from pot
*** SUMMARY ***
Total pot $0.28 | Rake $0.01 | Jackpot $0 | Bingo $0 | Fortune $0 | Tax $0
Board [4s Qc 7d 3c Td]
Seat 1: 56cefdc9 (button) folded before Flop (didn't bet)
Seat 2: 92ac71f9 (small blind) folded before Flop
Seat 3: Hero (big blind) showed [Jh Ad] and won ($0.27) with Ace-High
Seat 4: 6662e866 folded before Flop (didn't bet)
Seat 5: ef82d036 folded before Flop (didn't bet)
Seat 6: 835df346 showed [8h 9h] and lost with Queen-High


Poker Hand #RC3334373061: Hold'em No Limit ($0.02/$0.05) - 2025/02/17 20:24:26
Table 'RushAndCash598321' 6-max Seat #1 is the button
Seat 1: 45a5085b ($1.57 in chips)
Seat 2: Hero ($5 in chips)
Seat 3: 3ad61ed1 ($5.25 in chips)
Seat 4: b9e511a ($22.93 in chips)
Seat 5: d58b99ca ($6.84 in chips)
Seat 6: 2809b559 ($5 in chips)
Hero: posts small blind $0.02
3ad61ed1: posts big blind $0.05
*** HOLE CARDS ***
Dealt to 45a5085b 
Dealt to Hero [9d 3h]
Dealt to 3ad61ed1 
Dealt to b9e511a 
Dealt to d58b99ca 
Dealt to 2809b559 
b9e511a: folds
d58b99ca: folds
2809b559: folds
45a5085b: folds
Hero: folds
Uncalled bet ($0.03) returned to 3ad61ed1
*** SHOWDOWN ***
3ad61ed1 collected $0.04 from pot
*** SUMMARY ***
Total pot $0.04 | Rake $0 | Jackpot $0 | Bingo $0 | Fortune $0 | Tax $0
Seat 1: 45a5085b (button) folded before Flop (didn't bet)
Seat 2: Hero (small blind) folded before Flop
Seat 3: 3ad61ed1 (big blind) collected ($0.04)
Seat 4: b9e511a folded before Flop (didn't bet)
Seat 5: d58b99ca folded before Flop (didn't bet)
Seat 6: 2809b559 folded before Flop (didn't bet)


Poker Hand #RC3334373022: Hold'em No Limit ($0.02/$0.05) - 2025/02/17 20:24:20
Table 'RushAndCash598282' 6-max Seat #1 is the button
Seat 1: 1937cebf ($5 in chips)
Seat 2: 945a4f ($5 in chips)
Seat 3: 7b1c045a ($4.66 in chips)
Seat 4: 767730bd ($5 in chips)
Seat 5: Hero ($5 in chips)
Seat 6: 84d78f72 ($5.66 in chips)
945a4f: posts small blind $0.02
7b1c045a: posts big blind $0.05
*** HOLE CARDS ***
Dealt to 1937cebf 
Dealt to 945a4f 
Dealt to 7b1c045a 
Dealt to 767730bd 
Dealt to Hero [8c 9d]
Dealt to 84d78f72 
767730bd: raises $0.05 to $0.1
Hero: folds
84d78f72: folds
1937cebf: folds
945a4f: folds
7b1c045a: calls $0.05
*** FLOP *** [4d Ts 4h]
7b1c045a: checks
767730bd: checks
*** TURN *** [4d Ts 4h] [Tc]
7b1c045a: checks
767730bd: checks
*** RIVER *** [4d Ts 4h Tc] [As]
7b1c045a: checks
767730bd: checks
7b1c045a: shows [Jc 5c] (Pair of Tens and Pair of Fours)
767730bd: shows [Kh 9h] (Pair of Tens and Pair of Fours)
*** SHOWDOWN ***
7b1c045a collected $0.11 from pot
767730bd collected $0.11 from pot
*** SUMMARY ***
Total pot $0.22 | Rake $0 | Jackpot $0 | Bingo $0 | Fortune $0 | Tax $0
Board [4d Ts 4h Tc As]
Seat 1: 1937cebf (button) folded before Flop (didn't bet)
Seat 2: 945a4f (small blind) folded before Flop
Seat 3: 7b1c045a (big blind) showed [Jc 5c] and won ($0.11) with Pair of Tens and Pair of Fours
Seat 4: 767730bd showed [Kh 9h] and won ($0.11) with Pair of Tens and Pair of Fours
Seat 5: Hero folded before Flop (didn't bet)
Seat 6: 84d78f72 folded before Flop (didn't bet)


Poker Hand #RC3334372992: Hold'em No Limit ($0.02/$0.05) - 2025/02/17 20:24:15
Table 'RushAndCash598252' 6-max Seat #1 is the button
Seat 1: 69d7bf2c ($3.48 in chips)
Seat 2: e390e48e ($6.06 in chips)
Seat 3: 4190d158 ($5.03 in chips)
Seat 4: ead6cfaf ($5 in chips)
Seat 5: Hero ($5 in chips)
Seat 6: ef7e6107 ($5.02 in chips)
e390e48e: posts small blind $0.02
4190d158: posts big blind $0.05
*** HOLE CARDS ***
Dealt to 69d7bf2c 
Dealt to e390e48e 
Dealt to 4190d158 
Dealt to ead6cfaf 
Dealt to Hero [Ad 5s]
Dealt to ef7e6107 
ead6cfaf: folds
Hero: folds
ef7e6107: folds
69d7bf2c: folds
e390e48e: folds
Uncalled bet ($0.03) returned to 4190d158
*** SHOWDOWN ***
4190d158 collected $0.04 from pot
*** SUMMARY ***
Total pot $0.04 | Rake $0 | Jackpot $0 | Bingo $0 | Fortune $0 | Tax $0
Seat 1: 69d7bf2c (button) folded before Flop (didn't bet)
Seat 2: e390e48e (small blind) folded before Flop
Seat 3: 4190d158 (big blind) collected ($0.04)
Seat 4: ead6cfaf folded before Flop (didn't bet)
Seat 5: Hero folded before Flop (didn't bet)
Seat 6: ef7e6107 folded before Flop (didn't bet)


Poker Hand #RC3334372969: Hold'em No Limit ($0.02/$0.05) - 2025/02/17 20:24:12
Table 'RushAndCash598229' 6-max Seat #1 is the button
Seat 1: 5fe62400 ($5.13 in chips)
Seat 2: 45a5085b ($1.52 in chips)
Seat 3: 8a2a3713 ($4.79 in chips)
Seat 4: Hero ($5 in chips)
Seat 5: 860b5247 ($8.36 in chips)
Seat 6: 5f78b1e2 ($4.65 in chips)
45a5085b: posts small blind $0.02
8a2a3713: posts big blind $0.05
*** HOLE CARDS ***
Dealt to 5fe62400 
Dealt to 45a5085b 
Dealt to 8a2a3713 
Dealt to Hero [2c 7d]
Dealt to 860b5247 
Dealt to 5f78b1e2 
Hero: folds
860b5247: folds
5f78b1e2: folds
5fe62400: folds
45a5085b: raises $0.05 to $0.1
8a2a3713: folds
Uncalled bet ($0.05) returned to 45a5085b
*** SHOWDOWN ***
45a5085b collected $0.1 from pot
*** SUMMARY ***
Total pot $0.1 | Rake $0 | Jackpot $0 | Bingo $0 | Fortune $0 | Tax $0
Seat 1: 5fe62400 (button) folded before Flop (didn't bet)
Seat 2: 45a5085b (small blind) collected ($0.1)
Seat 3: 8a2a3713 (big blind) folded before Flop
Seat 4: Hero folded before Flop (didn't bet)
Seat 5: 860b5247 folded before Flop (didn't bet)
Seat 6: 5f78b1e2 folded before Flop (didn't bet)


Poker Hand #RC3334372948: Hold'em No Limit ($0.02/$0.05) - 2025/02/17 20:24:09
Table 'RushAndCash598208' 6-max Seat #1 is the button
Seat 1: 33bc9b8e ($9.87 in chips)
Seat 2: b00c4f8 ($9.13 in chips)
Seat 3: Hero ($5 in chips)
Seat 4: 8a2a3713 ($4.79 in chips)
Seat 5: e5903036 ($16.83 in chips)
Seat 6: 9864109b ($5.29 in chips)
b00c4f8: posts small blind $0.02
Hero: posts big blind $0.05
*** HOLE CARDS ***
Dealt to 33bc9b8e 
Dealt to b00c4f8 
Dealt to Hero [3s Th]
Dealt to 8a2a3713 
Dealt to e5903036 
Dealt to 9864109b 
8a2a3713: folds
e5903036: folds
9864109b: folds
33bc9b8e: raises $0.09 to $0.14
b00c4f8: raises $0.25 to $0.39
Hero: folds
33bc9b8e: calls $0.25
*** FLOP *** [Ac 3c 9d]
b00c4f8: bets $0.42
33bc9b8e: folds
Uncalled bet ($0.42) returned to b00c4f8
*** SHOWDOWN ***
b00c4f8 collected $0.79 from pot
*** SUMMARY ***
Total pot $0.83 | Rake $0.04 | Jackpot $0 | Bingo $0 | Fortune $0 | Tax $0
Board [Ac 3c 9d]
Seat 1: 33bc9b8e (button) folded on the Flop
Seat 2: b00c4f8 (small blind) won ($0.79)
Seat 3: Hero (big blind) folded before Flop
Seat 4: 8a2a3713 folded before Flop (didn't bet)
Seat 5: e5903036 folded before Flop (didn't bet)
Seat 6: 9864109b folded before Flop (didn't bet)


Poker Hand #RC3334372929: Hold'em No Limit ($0.02/$0.05) - 2025/02/17 20:24:06
Table 'RushAndCash598189' 6-max Seat #1 is the button
Seat 1: b501555b ($9.59 in chips)
Seat 2: 38d2fc1e ($5.35 in chips)
Seat 3: 7af747dc ($8.59 in chips)
Seat 4: c585480d ($6.36 in chips)
Seat 5: 54fe77bd ($7.21 in chips)
Seat 6: Hero ($5 in chips)
38d2fc1e: posts small blind $0.02
7af747dc: posts big blind $0.05
*** HOLE CARDS ***
Dealt to b501555b 
Dealt to 38d2fc1e 
Dealt to 7af747dc 
Dealt to c585480d 
Dealt to 54fe77bd 
Dealt to Hero [Qh 7h]
c585480d: raises $0.05 to $0.1
54fe77bd: calls $0.1
Hero: folds
b501555b: folds
38d2fc1e: folds
7af747dc: calls $0.05
*** FLOP *** [As Qs 4c]
7af747dc: checks
c585480d: bets $0.24
54fe77bd: calls $0.24
7af747dc: calls $0.24
*** TURN *** [As Qs 4c] [Kh]
7af747dc: checks
c585480d: bets $1.04
54fe77bd: folds
7af747dc: raises $1.56 to $2.6
c585480d: calls $1.56
*** RIVER *** [As Qs 4c Kh] [7d]
7af747dc: bets $3.98
c585480d: calls $3.42 and is all-in
Uncalled bet ($0.56) returned to 7af747dc
7af747dc: shows [Jc Td] (Aces-High Straight)
c585480d: shows [Ac Kc] (Pair of Aces and Pair of Kings)
*** SHOWDOWN ***
7af747dc collected $12.76 from pot
*** SUMMARY ***
Total pot $13.08 | Rake $0.25 | Jackpot $0.07 | Bingo $0 | Fortune $0 | Tax $0
Board [As Qs 4c Kh 7d]
Seat 1: b501555b (button) folded before Flop (didn't bet)
Seat 2: 38d2fc1e (small blind) folded before Flop
Seat 3: 7af747dc (big blind) showed [Jc Td] and won ($12.76) with Aces-High Straight
Seat 4: c585480d showed [Ac Kc] and lost with Pair of Aces and Pair of Kings
Seat 5: 54fe77bd folded on the Turn
Seat 6: Hero folded before Flop (didn't bet)


Poker Hand #RC3334372911: Hold'em No Limit ($0.02/$0.05) - 2025/02/17 20:24:03
Table 'RushAndCash598171' 6-max Seat #1 is the button
Seat 1: Hero ($5 in chips)
Seat 2: 7cfb455f ($5.98 in chips)
Seat 3: 796ed2b8 ($5.09 in chips)
Seat 4: 6e885b98 ($5.11 in chips)
Seat 5: ae49e9c ($5.21 in chips)
Seat 6: 63499226 ($3.64 in chips)
7cfb455f: posts small blind $0.02
796ed2b8: posts big blind $0.05
*** HOLE CARDS ***
Dealt to Hero [Qh 4s]
Dealt to 7cfb455f 
Dealt to 796ed2b8 
Dealt to 6e885b98 
Dealt to ae49e9c 
Dealt to 63499226 
6e885b98: folds
ae49e9c: folds
63499226: folds
Hero: folds
7cfb455f: calls $0.03
796ed2b8: checks
*** FLOP *** [Jh Ah Js]
7cfb455f: bets $0.05
796ed2b8: folds
Uncalled bet ($0.05) returned to 7cfb455f
*** SHOWDOWN ***
7cfb455f collected $0.1 from pot
*** SUMMARY ***
Total pot $0.1 | Rake $0 | Jackpot $0 | Bingo $0 | Fortune $0 | Tax $0
Board [Jh Ah Js]
Seat 1: Hero (button) folded before Flop (didn't bet)
Seat 2: 7cfb455f (small blind) won ($0.1)
Seat 3: 796ed2b8 (big blind) folded on the Flop
Seat 4: 6e885b98 folded before Flop (didn't bet)
Seat 5: ae49e9c folded before Flop (didn't bet)
Seat 6: 63499226 folded before Flop (didn't bet)


Poker Hand #RC3334372613: Hold'em No Limit ($0.02/$0.05) - 2025/02/17 20:23:13
Table 'RushAndCash597873' 6-max Seat #1 is the button
Seat 1: 59b37309 ($5.56 in chips)
Seat 2: Hero ($5 in chips)
Seat 3: ccd13bc4 ($11.23 in chips)
Seat 4: 6c0f6dbf ($7.24 in chips)
Seat 5: 56cefdc9 ($3.11 in chips)
Seat 6: 53c3b7da ($3.92 in chips)
Hero: posts small blind $0.02
ccd13bc4: posts big blind $0.05
*** HOLE CARDS ***
Dealt to 59b37309 
Dealt to Hero [Qd Kc]
Dealt to ccd13bc4 
Dealt to 6c0f6dbf 
Dealt to 56cefdc9 
Dealt to 53c3b7da 
6c0f6dbf: folds
56cefdc9: raises $0.05 to $0.1
53c3b7da: folds
59b37309: folds
Hero: calls $0.08
ccd13bc4: calls $0.05
*** FLOP *** [8c 5h 6d]
Hero: checks
ccd13bc4: checks
56cefdc9: bets $0.09
Hero: folds
ccd13bc4: raises $0.48 to $0.57
56cefdc9: folds
Uncalled bet ($0.48) returned to ccd13bc4
*** SHOWDOWN ***
ccd13bc4 collected $0.46 from pot
*** SUMMARY ***
Total pot $0.48 | Rake $0.02 | Jackpot $0 | Bingo $0 | Fortune $0 | Tax $0
Board [8c 5h 6d]
Seat 1: 59b37309 (button) folded before Flop (didn't bet)
Seat 2: Hero (small blind) folded on the Flop
Seat 3: ccd13bc4 (big blind) won ($0.46)
Seat 4: 6c0f6dbf folded before Flop (didn't bet)
Seat 5: 56cefdc9 folded on the Flop
Seat 6: 53c3b7da folded before Flop (didn't bet)


Poker Hand #RC3334372530: Hold'em No Limit ($0.02/$0.05) - 2025/02/17 20:23:00
Table 'RushAndCash597790' 6-max Seat #1 is the button
Seat 1: Hero ($5 in chips)
Seat 2: 6c0f6dbf ($7.26 in chips)
Seat 3: 5db4cca ($5.51 in chips)
Seat 4: 38d2fc1e ($5.29 in chips)
Seat 5: 7455e221 ($4.93 in chips)
Seat 6: d58b99ca ($8.59 in chips)
6c0f6dbf: posts small blind $0.02
5db4cca: posts big blind $0.05
*** HOLE CARDS ***
Dealt to Hero [6c 4c]
Dealt to 6c0f6dbf 
Dealt to 5db4cca 
Dealt to 38d2fc1e 
Dealt to 7455e221 
Dealt to d58b99ca 
38d2fc1e: folds
7455e221: raises $0.06 to $0.11
d58b99ca: raises $0.29 to $0.4
Hero: folds
6c0f6dbf: folds
5db4cca: folds
7455e221: calls $0.29
*** FLOP *** [Th 7d Ks]
7455e221: checks
d58b99ca: bets $0.29
7455e221: calls $0.29
*** TURN *** [Th 7d Ks] [Jh]
7455e221: checks
d58b99ca: bets $0.99
7455e221: calls $0.99
*** RIVER *** [Th 7d Ks Jh] [4d]
7455e221: checks
d58b99ca: checks
7455e221: shows [Qd Qc] (Pair of Queens)
d58b99ca: shows [Ah 4h] (Pair of Fours)
*** SHOWDOWN ***
7455e221 collected $3.21 from pot
*** SUMMARY ***
Total pot $3.43 | Rake $0.15 | Jackpot $0.07 | Bingo $0 | Fortune $0 | Tax $0
Board [Th 7d Ks Jh 4d]
Seat 1: Hero (button) folded before Flop (didn't bet)
Seat 2: 6c0f6dbf (small blind) folded before Flop
Seat 3: 5db4cca (big blind) folded before Flop
Seat 4: 38d2fc1e folded before Flop (didn't bet)
Seat 5: 7455e221 showed [Qd Qc] and won ($3.21) with Pair of Queens
Seat 6: d58b99ca showed [Ah 4h] and lost with Pair of Fours


Poker Hand #RC3334372452: Hold'em No Limit ($0.02/$0.05) - 2025/02/17 20:22:48
Table 'RushAndCash597712' 6-max Seat #1 is the button
Seat 1: 626359de ($5.68 in chips)
Seat 2: Hero ($5 in chips)
Seat 3: f5592199 ($6 in chips)
Seat 4: eaafe260 ($5 in chips)
Seat 5: 130fc8d7 ($10.51 in chips)
Seat 6: 767730bd ($5.11 in chips)
Hero: posts small blind $0.02
f5592199: posts big blind $0.05
*** HOLE CARDS ***
Dealt to 626359de 
Dealt to Hero [4s 9s]
Dealt to f5592199 
Dealt to eaafe260 
Dealt to 130fc8d7 
Dealt to 767730bd 
eaafe260: folds
130fc8d7: folds
767730bd: folds
626359de: raises $0.08 to $0.13
Hero: folds
f5592199: folds
Uncalled bet ($0.08) returned to 626359de
*** SHOWDOWN ***
626359de collected $0.12 from pot
*** SUMMARY ***
Total pot $0.12 | Rake $0 | Jackpot $0 | Bingo $0 | Fortune $0 | Tax $0
Seat 1: 626359de (button) collected ($0.12)
Seat 2: Hero (small blind) folded before Flop
Seat 3: f5592199 (big blind) folded before Flop
Seat 4: eaafe260 folded before Flop (didn't bet)
Seat 5: 130fc8d7 folded before Flop (didn't bet)
Seat 6: 767730bd folded before Flop (didn't bet)


Poker Hand #RC3334372137: Hold'em No Limit ($0.02/$0.05) - 2025/02/17 20:21:55
Table 'RushAndCash597397' 6-max Seat #1 is the button
Seat 1: 6bc74d1d ($5 in chips)
Seat 2: d8071500 ($5 in chips)
Seat 3: f71f9fc0 ($4.93 in chips)
Seat 4: cbfd6c92 ($1.74 in chips)
Seat 5: Hero ($5.07 in chips)
Seat 6: 48dc6454 ($4.57 in chips)
d8071500: posts small blind $0.02
f71f9fc0: posts big blind $0.05
*** HOLE CARDS ***
Dealt to 6bc74d1d 
Dealt to d8071500 
Dealt to f71f9fc0 
Dealt to cbfd6c92 
Dealt to Hero [7c 6c]
Dealt to 48dc6454 
cbfd6c92: folds
Hero: raises $0.05 to $0.1
48dc6454: folds
6bc74d1d: raises $0.12 to $0.22
d8071500: calls $0.2
f71f9fc0: folds
Hero: calls $0.12
*** FLOP *** [Qh Tc 4d]
d8071500: checks
Hero: checks
6bc74d1d: checks
*** TURN *** [Qh Tc 4d] [Qd]
d8071500: checks
Hero: checks
6bc74d1d: checks
*** RIVER *** [Qh Tc 4d Qd] [Jd]
d8071500: bets $0.54
Hero: folds
6bc74d1d: folds
Uncalled bet ($0.54) returned to d8071500
*** SHOWDOWN ***
d8071500 collected $0.67 from pot
*** SUMMARY ***
Total pot $0.71 | Rake $0.04 | Jackpot $0 | Bingo $0 | Fortune $0 | Tax $0
Board [Qh Tc 4d Qd Jd]
Seat 1: 6bc74d1d (button) folded on the River
Seat 2: d8071500 (small blind) won ($0.67)
Seat 3: f71f9fc0 (big blind) folded before Flop
Seat 4: cbfd6c92 folded before Flop (didn't bet)
Seat 5: Hero folded on the River
Seat 6: 48dc6454 folded before Flop (didn't bet)


Poker Hand #RC3334372103: Hold'em No Limit ($0.02/$0.05) - 2025/02/17 20:21:50
Table 'RushAndCash597363' 6-max Seat #1 is the button
Seat 1: e2777133 ($5.46 in chips)
Seat 2: 194ee370 ($6.09 in chips)
Seat 3: 57d6169c ($5.07 in chips)
Seat 4: Hero ($5.07 in chips)
Seat 5: 98795191 ($2.23 in chips)
Seat 6: 491e0e63 ($5.33 in chips)
194ee370: posts small blind $0.02
57d6169c: posts big blind $0.05
*** HOLE CARDS ***
Dealt to e2777133 
Dealt to 194ee370 
Dealt to 57d6169c 
Dealt to Hero [Tc 8d]
Dealt to 98795191 
Dealt to 491e0e63 
Hero: folds
98795191: folds
491e0e63: folds
e2777133: raises $0.06 to $0.11
194ee370: folds
57d6169c: calls $0.06
*** FLOP *** [4d Qc Jh]
57d6169c: checks
e2777133: bets $0.07
57d6169c: folds
Uncalled bet ($0.07) returned to e2777133
*** SHOWDOWN ***
e2777133 collected $0.23 from pot
*** SUMMARY ***
Total pot $0.24 | Rake $0.01 | Jackpot $0 | Bingo $0 | Fortune $0 | Tax $0
Board [4d Qc Jh]
Seat 1: e2777133 (button) won ($0.23)
Seat 2: 194ee370 (small blind) folded before Flop
Seat 3: 57d6169c (big blind) folded on the Flop
Seat 4: Hero folded before Flop (didn't bet)
Seat 5: 98795191 folded before Flop (didn't bet)
Seat 6: 491e0e63 folded before Flop (didn't bet)


Poker Hand #RC3334372078: Hold'em No Limit ($0.02/$0.05) - 2025/02/17 20:21:47
Table 'RushAndCash597338' 6-max Seat #1 is the button
Seat 1: 188c8947 ($4.43 in chips)
Seat 2: c585480d ($6.31 in chips)
Seat 3: Hero ($5.12 in chips)
Seat 4: 4052bb6f ($5.23 in chips)
Seat 5: ab8d5924 ($5.61 in chips)
Seat 6: 9b1a3dd2 ($7.15 in chips)
c585480d: posts small blind $0.02
Hero: posts big blind $0.05
*** HOLE CARDS ***
Dealt to 188c8947 
Dealt to c585480d 
Dealt to Hero [8s 5c]
Dealt to 4052bb6f 
Dealt to ab8d5924 
Dealt to 9b1a3dd2 
4052bb6f: raises $0.08 to $0.13
ab8d5924: folds
9b1a3dd2: calls $0.13
188c8947: calls $0.13
c585480d: folds
Hero: folds
*** FLOP *** [4d Ts 2h]
4052bb6f: bets $0.23
9b1a3dd2: folds
188c8947: calls $0.23
*** TURN *** [4d Ts 2h] [4h]
4052bb6f: checks
188c8947: bets $0.46
4052bb6f: calls $0.46
*** RIVER *** [4d Ts 2h 4h] [5h]
4052bb6f: checks
188c8947: checks
4052bb6f: shows [Qd Td] (Pair of Tens and Pair of Fours)
188c8947: shows [5d 6d] (Pair of Fives and Pair of Fours)
*** SHOWDOWN ***
4052bb6f collected $1.69 from pot
*** SUMMARY ***
Total pot $1.84 | Rake $0.08 | Jackpot $0.07 | Bingo $0 | Fortune $0 | Tax $0
Board [4d Ts 2h 4h 5h]
Seat 1: 188c8947 (button) showed [5d 6d] and lost with Pair of Fives and Pair of Fours
Seat 2: c585480d (small blind) folded before Flop
Seat 3: Hero (big blind) folded before Flop
Seat 4: 4052bb6f showed [Qd Td] and won ($1.69) with Pair of Tens and Pair of Fours
Seat 5: ab8d5924 folded before Flop (didn't bet)
Seat 6: 9b1a3dd2 folded on the Flop


Poker Hand #RC3334372057: Hold'em No Limit ($0.02/$0.05) - 2025/02/17 20:21:44
Table 'RushAndCash597317' 6-max Seat #1 is the button
Seat 1: ac2aecf ($1.95 in chips)
Seat 2: 1063406 ($6.24 in chips)
Seat 3: e8e95c39 ($5.82 in chips)
Seat 4: f71f9fc0 ($4.93 in chips)
Seat 5: Hero ($5.12 in chips)
Seat 6: 491e0e63 ($5.33 in chips)
1063406: posts small blind $0.02
e8e95c39: posts big blind $0.05
*** HOLE CARDS ***
Dealt to ac2aecf 
Dealt to 1063406 
Dealt to e8e95c39 
Dealt to f71f9fc0 
Dealt to Hero [Tc 7s]
Dealt to 491e0e63 
f71f9fc0: folds
Hero: folds
491e0e63: folds
ac2aecf: folds
1063406: folds
Uncalled bet ($0.03) returned to e8e95c39
*** SHOWDOWN ***
e8e95c39 collected $0.04 from pot
*** SUMMARY ***
Total pot $0.04 | Rake $0 | Jackpot $0 | Bingo $0 | Fortune $0 | Tax $0
Seat 1: ac2aecf (button) folded before Flop (didn't bet)
Seat 2: 1063406 (small blind) folded before Flop
Seat 3: e8e95c39 (big blind) collected ($0.04)
Seat 4: f71f9fc0 folded before Flop (didn't bet)
Seat 5: Hero folded before Flop (didn't bet)
Seat 6: 491e0e63 folded before Flop (didn't bet)


Poker Hand #RC3334372037: Hold'em No Limit ($0.02/$0.05) - 2025/02/17 20:21:40
Table 'RushAndCash597297' 6-max Seat #1 is the button
Seat 1: 709ac205 ($10.45 in chips)
Seat 2: 42eefc11 ($4.8 in chips)
Seat 3: d58b99ca ($8.35 in chips)
Seat 4: 95fac4b9 ($10.49 in chips)
Seat 5: 93dfef8b ($5.07 in chips)
Seat 6: Hero ($5.12 in chips)
42eefc11: posts small blind $0.02
d58b99ca: posts big blind $0.05
*** HOLE CARDS ***
Dealt to 709ac205 
Dealt to 42eefc11 
Dealt to d58b99ca 
Dealt to 95fac4b9 
Dealt to 93dfef8b 
Dealt to Hero [Jh 8d]
95fac4b9: raises $0.25 to $0.3
93dfef8b: folds
Hero: folds
709ac205: folds
42eefc11: folds
d58b99ca: calls $0.25
*** FLOP *** [7c 4c Ks]
d58b99ca: checks
95fac4b9: checks
*** TURN *** [7c 4c Ks] [5d]
d58b99ca: bets $0.21
95fac4b9: folds
Uncalled bet ($0.21) returned to d58b99ca
*** SHOWDOWN ***
d58b99ca collected $0.59 from pot
*** SUMMARY ***
Total pot $0.62 | Rake $0.03 | Jackpot $0 | Bingo $0 | Fortune $0 | Tax $0
Board [7c 4c Ks 5d]
Seat 1: 709ac205 (button) folded before Flop (didn't bet)
Seat 2: 42eefc11 (small blind) folded before Flop
Seat 3: d58b99ca (big blind) won ($0.59)
Seat 4: 95fac4b9 folded on the Turn
Seat 5: 93dfef8b folded before Flop (didn't bet)
Seat 6: Hero folded before Flop (didn't bet)


Poker Hand #RC3334372007: Hold'em No Limit ($0.02/$0.05) - 2025/02/17 20:21:36
Table 'RushAndCash597267' 6-max Seat #1 is the button
Seat 1: ab8d5924 ($5.54 in chips)
Seat 2: 491e0e63 ($5.35 in chips)
Seat 3: 735c4afd ($5 in chips)
Seat 4: 130fc8d7 ($10.81 in chips)
Seat 5: Hero ($5.12 in chips)
Seat 6: 63499226 ($3.4 in chips)
491e0e63: posts small blind $0.02
735c4afd: posts big blind $0.05
*** HOLE CARDS ***
Dealt to ab8d5924 
Dealt to 491e0e63 
Dealt to 735c4afd 
Dealt to 130fc8d7 
Dealt to Hero [7h 2d]
Dealt to 63499226 
130fc8d7: folds
Hero: folds
63499226: folds
ab8d5924: raises $0.05 to $0.1
491e0e63: folds
735c4afd: folds
Uncalled bet ($0.05) returned to ab8d5924
*** SHOWDOWN ***
ab8d5924 collected $0.12 from pot
*** SUMMARY ***
Total pot $0.12 | Rake $0 | Jackpot $0 | Bingo $0 | Fortune $0 | Tax $0
Seat 1: ab8d5924 (button) collected ($0.12)
Seat 2: 491e0e63 (small blind) folded before Flop
Seat 3: 735c4afd (big blind) folded before Flop
Seat 4: 130fc8d7 folded before Flop (didn't bet)
Seat 5: Hero folded before Flop (didn't bet)
Seat 6: 63499226 folded before Flop (didn't bet)


Poker Hand #RC3334371901: Hold'em No Limit ($0.02/$0.05) - 2025/02/17 20:21:19
Table 'RushAndCash597161' 6-max Seat #1 is the button
Seat 1: d57e790f ($5.87 in chips)
Seat 2: 711af4a4 ($4.81 in chips)
Seat 3: 93dfef8b ($5.14 in chips)
Seat 4: Hero ($5.05 in chips)
Seat 5: f1f26d78 ($9.26 in chips)
Seat 6: 5cbe391a ($4.93 in chips)
711af4a4: posts small blind $0.02
93dfef8b: posts big blind $0.05
*** HOLE CARDS ***
Dealt to d57e790f 
Dealt to 711af4a4 
Dealt to 93dfef8b 
Dealt to Hero [Kc Qh]
Dealt to f1f26d78 
Dealt to 5cbe391a 
Hero: raises $0.05 to $0.1
f1f26d78: folds
5cbe391a: folds
d57e790f: folds
711af4a4: folds
93dfef8b: folds
Uncalled bet ($0.05) returned to Hero
*** SHOWDOWN ***
Hero collected $0.12 from pot
*** SUMMARY ***
Total pot $0.12 | Rake $0 | Jackpot $0 | Bingo $0 | Fortune $0 | Tax $0
Seat 1: d57e790f (button) folded before Flop (didn't bet)
Seat 2: 711af4a4 (small blind) folded before Flop
Seat 3: 93dfef8b (big blind) folded before Flop
Seat 4: Hero collected ($0.12)
Seat 5: f1f26d78 folded before Flop (didn't bet)
Seat 6: 5cbe391a folded before Flop (didn't bet)


Poker Hand #RC3334371881: Hold'em No Limit ($0.02/$0.05) - 2025/02/17 20:21:16
Table 'RushAndCash597141' 6-max Seat #1 is the button
Seat 1: 9e314792 ($4.61 in chips)
Seat 2: 1f187ba0 ($4.42 in chips)
Seat 3: Hero ($5.1 in chips)
Seat 4: 5db4cca ($4.9 in chips)
Seat 5: dc9e794c ($5.26 in chips)
Seat 6: cb6ce092 ($5.21 in chips)
1f187ba0: posts small blind $0.02
Hero: posts big blind $0.05
*** HOLE CARDS ***
Dealt to 9e314792 
Dealt to 1f187ba0 
Dealt to Hero [5h 7s]
Dealt to 5db4cca 
Dealt to dc9e794c 
Dealt to cb6ce092 
5db4cca: raises $0.12 to $0.17
dc9e794c: calls $0.17
cb6ce092: folds
9e314792: folds
1f187ba0: folds
Hero: folds
*** FLOP *** [3s Ks 6s]
5db4cca: bets $0.31
dc9e794c: folds
Uncalled bet ($0.31) returned to 5db4cca
*** SHOWDOWN ***
5db4cca collected $0.39 from pot
*** SUMMARY ***
Total pot $0.41 | Rake $0.02 | Jackpot $0 | Bingo $0 | Fortune $0 | Tax $0
Board [3s Ks 6s]
Seat 1: 9e314792 (button) folded before Flop (didn't bet)
Seat 2: 1f187ba0 (small blind) folded before Flop
Seat 3: Hero (big blind) folded before Flop
Seat 4: 5db4cca won ($0.39)
Seat 5: dc9e794c folded on the Flop
Seat 6: cb6ce092 folded before Flop (didn't bet)


Poker Hand #RC3334371555: Hold'em No Limit ($0.02/$0.05) - 2025/02/17 20:20:21
Table 'RushAndCash596815' 6-max Seat #1 is the button
Seat 1: 19bb03b5 ($6.74 in chips)
Seat 2: Hero ($5.37 in chips)
Seat 3: 5265b128 ($5 in chips)
Seat 4: 4190d158 ($5.02 in chips)
Seat 5: 5db4cca ($4.61 in chips)
Seat 6: f6655046 ($5.21 in chips)
Hero: posts small blind $0.02
5265b128: posts big blind $0.05
*** HOLE CARDS ***
Dealt to 19bb03b5 
Dealt to Hero [4d 5d]
Dealt to 5265b128 
Dealt to 4190d158 
Dealt to 5db4cca 
Dealt to f6655046 
4190d158: folds
5db4cca: raises $0.07 to $0.12
f6655046: folds
19bb03b5: folds
Hero: calls $0.1
5265b128: folds
*** FLOP *** [3c Kh Ac]
Hero: checks
5db4cca: bets $0.15
Hero: calls $0.15
*** TURN *** [3c Kh Ac] [Js]
Hero: checks
5db4cca: checks
*** RIVER *** [3c Kh Ac Js] [7c]
Hero: checks
5db4cca: checks
Hero: shows [4d 5d] (Ace-High)
5db4cca: shows [2h 3h] (Pair of Treys)
*** SHOWDOWN ***
5db4cca collected $0.56 from pot
*** SUMMARY ***
Total pot $0.59 | Rake $0.03 | Jackpot $0 | Bingo $0 | Fortune $0 | Tax $0
Board [3c Kh Ac Js 7c]
Seat 1: 19bb03b5 (button) folded before Flop (didn't bet)
Seat 2: Hero (small blind) showed [4d 5d] and lost with Ace-High
Seat 3: 5265b128 (big blind) folded before Flop
Seat 4: 4190d158 folded before Flop (didn't bet)
Seat 5: 5db4cca showed [2h 3h] and won ($0.56) with Pair of Treys
Seat 6: f6655046 folded before Flop (didn't bet)


Poker Hand #RC3334371534: Hold'em No Limit ($0.02/$0.05) - 2025/02/17 20:20:17
Table 'RushAndCash596794' 6-max Seat #1 is the button
Seat 1: Hero ($5.37 in chips)
Seat 2: 2ef61f09 ($5 in chips)
Seat 3: 1a54a2fc ($5 in chips)
Seat 4: f7a73a71 ($4.4 in chips)
Seat 5: 144ea2b0 ($5.05 in chips)
Seat 6: 2b8b2921 ($6.53 in chips)
2ef61f09: posts small blind $0.02
1a54a2fc: posts big blind $0.05
*** HOLE CARDS ***
Dealt to Hero [9d 8h]
Dealt to 2ef61f09 
Dealt to 1a54a2fc 
Dealt to f7a73a71 
Dealt to 144ea2b0 
Dealt to 2b8b2921 
f7a73a71: folds
144ea2b0: folds
2b8b2921: folds
Hero: folds
2ef61f09: folds
Uncalled bet ($0.03) returned to 1a54a2fc
*** SHOWDOWN ***
1a54a2fc collected $0.04 from pot
*** SUMMARY ***
Total pot $0.04 | Rake $0 | Jackpot $0 | Bingo $0 | Fortune $0 | Tax $0
Seat 1: Hero (button) folded before Flop (didn't bet)
Seat 2: 2ef61f09 (small blind) folded before Flop
Seat 3: 1a54a2fc (big blind) collected ($0.04)
Seat 4: f7a73a71 folded before Flop (didn't bet)
Seat 5: 144ea2b0 folded before Flop (didn't bet)
Seat 6: 2b8b2921 folded before Flop (didn't bet)


Poker Hand #RC3334371513: Hold'em No Limit ($0.02/$0.05) - 2025/02/17 20:20:14
Table 'RushAndCash596773' 6-max Seat #1 is the button
Seat 1: 4c5ef89 ($13.54 in chips)
Seat 2: 858b70a7 ($5.62 in chips)
Seat 3: 803e9f05 ($7.01 in chips)
Seat 4: 15e8a442 ($5.32 in chips)
Seat 5: Hero ($5.37 in chips)
Seat 6: 18af90c ($11.02 in chips)
858b70a7: posts small blind $0.02
803e9f05: posts big blind $0.05
*** HOLE CARDS ***
Dealt to 4c5ef89 
Dealt to 858b70a7 
Dealt to 803e9f05 
Dealt to 15e8a442 
Dealt to Hero [8s 7d]
Dealt to 18af90c 
15e8a442: folds
Hero: folds
18af90c: raises $0.05 to $0.1
4c5ef89: calls $0.1
858b70a7: folds
803e9f05: calls $0.05
*** FLOP *** [6c 5s 6s]
803e9f05: checks
18af90c: checks
4c5ef89: bets $0.11
803e9f05: calls $0.11
18af90c: folds
*** TURN *** [6c 5s 6s] [9d]
803e9f05: checks
4c5ef89: bets $0.41
803e9f05: folds
Uncalled bet ($0.41) returned to 4c5ef89
*** SHOWDOWN ***
4c5ef89 collected $0.52 from pot
*** SUMMARY ***
Total pot $0.54 | Rake $0.02 | Jackpot $0 | Bingo $0 | Fortune $0 | Tax $0
Board [6c 5s 6s 9d]
Seat 1: 4c5ef89 (button) won ($0.52)
Seat 2: 858b70a7 (small blind) folded before Flop
Seat 3: 803e9f05 (big blind) folded on the Turn
Seat 4: 15e8a442 folded before Flop (didn't bet)
Seat 5: Hero folded before Flop (didn't bet)
Seat 6: 18af90c folded on the Flop


Poker Hand #RC3334371490: Hold'em No Limit ($0.02/$0.05) - 2025/02/17 20:20:11
Table 'RushAndCash596750' 6-max Seat #1 is the button
Seat 1: 90fb5891 ($11.65 in chips)
Seat 2: d1cd1071 ($12.72 in chips)
Seat 3: fa499268 ($5 in chips)
Seat 4: Hero ($5.37 in chips)
Seat 5: 93cbff75 ($5.17 in chips)
Seat 6: cedf4726 ($5.05 in chips)
d1cd1071: posts small blind $0.02
fa499268: posts big blind $0.05
*** HOLE CARDS ***
Dealt to 90fb5891 
Dealt to d1cd1071 
Dealt to fa499268 
Dealt to Hero [5c 9d]
Dealt to 93cbff75 
Dealt to cedf4726 
Hero: folds
93cbff75: raises $0.06 to $0.11
cedf4726: folds
90fb5891: calls $0.11
d1cd1071: folds
fa499268: calls $0.06
*** FLOP *** [Qs 8s 7h]
fa499268: checks
93cbff75: bets $0.27
90fb5891: folds
fa499268: calls $0.27
*** TURN *** [Qs 8s 7h] [3c]
fa499268: bets $0.7
93cbff75: calls $0.7
*** RIVER *** [Qs 8s 7h 3c] [Kh]
fa499268: checks
93cbff75: checks
fa499268: shows [2s 5s] (King-High)
93cbff75: shows [Js Qh] (Pair of Queens)
*** SHOWDOWN ***
93cbff75 collected $2.11 from pot
*** SUMMARY ***
Total pot $2.29 | Rake $0.11 | Jackpot $0.07 | Bingo $0 | Fortune $0 | Tax $0
Board [Qs 8s 7h 3c Kh]
Seat 1: 90fb5891 (button) folded on the Flop
Seat 2: d1cd1071 (small blind) folded before Flop
Seat 3: fa499268 (big blind) showed [2s 5s] and lost with King-High
Seat 4: Hero folded before Flop (didn't bet)
Seat 5: 93cbff75 showed [Js Qh] and won ($2.11) with Pair of Queens
Seat 6: cedf4726 folded before Flop (didn't bet)


Poker Hand #RC3334371463: Hold'em No Limit ($0.02/$0.05) - 2025/02/17 20:20:06
Table 'RushAndCash596723' 6-max Seat #1 is the button
Seat 1: 16f2e5ce ($8.05 in chips)
Seat 2: Hero ($5.39 in chips)
Seat 3: 5381eb4c ($5 in chips)
Seat 4: a1fd9df7 ($5.17 in chips)
Seat 5: 6ebc3323 ($12.91 in chips)
Seat 6: d5283567 ($13.39 in chips)
Hero: posts small blind $0.02
5381eb4c: posts big blind $0.05
*** HOLE CARDS ***
Dealt to 16f2e5ce 
Dealt to Hero [4c 9c]
Dealt to 5381eb4c 
Dealt to a1fd9df7 
Dealt to 6ebc3323 
Dealt to d5283567 
a1fd9df7: folds
6ebc3323: folds
d5283567: folds
16f2e5ce: raises $0.05 to $0.1
Hero: folds
5381eb4c: folds
Uncalled bet ($0.05) returned to 16f2e5ce
*** SHOWDOWN ***
16f2e5ce collected $0.12 from pot
*** SUMMARY ***
Total pot $0.12 | Rake $0 | Jackpot $0 | Bingo $0 | Fortune $0 | Tax $0
Seat 1: 16f2e5ce (button) collected ($0.12)
Seat 2: Hero (small blind) folded before Flop
Seat 3: 5381eb4c (big blind) folded before Flop
Seat 4: a1fd9df7 folded before Flop (didn't bet)
Seat 5: 6ebc3323 folded before Flop (didn't bet)
Seat 6: d5283567 folded before Flop (didn't bet)


Poker Hand #RC3334371433: Hold'em No Limit ($0.02/$0.05) - 2025/02/17 20:20:01
Table 'RushAndCash596693' 6-max Seat #1 is the button
Seat 1: 491e0e63 ($5.07 in chips)
Seat 2: 157631a0 ($5.3 in chips)
Seat 3: Hero ($5.44 in chips)
Seat 4: c066ebc7 ($5.28 in chips)
Seat 5: e5903036 ($17.26 in chips)
Seat 6: bfc75c9 ($12.12 in chips)
157631a0: posts small blind $0.02
Hero: posts big blind $0.05
*** HOLE CARDS ***
Dealt to 491e0e63 
Dealt to 157631a0 
Dealt to Hero [7d Ts]
Dealt to c066ebc7 
Dealt to e5903036 
Dealt to bfc75c9 
c066ebc7: folds
e5903036: raises $0.1 to $0.15
bfc75c9: folds
491e0e63: folds
157631a0: raises $0.45 to $0.6
Hero: folds
e5903036: calls $0.45
*** FLOP *** [7s 8s 6s]
157631a0: checks
e5903036: checks
*** TURN *** [7s 8s 6s] [5c]
157631a0: checks
e5903036: checks
*** RIVER *** [7s 8s 6s 5c] [Ah]
157631a0: checks
e5903036: checks
157631a0: shows [Kh Kd] (Pair of Kings)
e5903036: shows [Qc Jc] (Ace-High)
*** SHOWDOWN ***
157631a0 collected $1.19 from pot
*** SUMMARY ***
Total pot $1.25 | Rake $0.06 | Jackpot $0 | Bingo $0 | Fortune $0 | Tax $0
Board [7s 8s 6s 5c Ah]
Seat 1: 491e0e63 (button) folded before Flop (didn't bet)
Seat 2: 157631a0 (small blind) showed [Kh Kd] and won ($1.19) with Pair of Kings
Seat 3: Hero (big blind) folded before Flop
Seat 4: c066ebc7 folded before Flop (didn't bet)
Seat 5: e5903036 showed [Qc Jc] and lost with Ace-High
Seat 6: bfc75c9 folded before Flop (didn't bet)


Poker Hand #RC3334371393: Hold'em No Limit ($0.02/$0.05) - 2025/02/17 20:19:54
Table 'RushAndCash596653' 6-max Seat #1 is the button
Seat 1: Hero ($5.44 in chips)
Seat 2: 6bc74d1d ($5 in chips)
Seat 3: f93eeed5 ($7.39 in chips)
Seat 4: 1a54a2fc ($5 in chips)
Seat 5: ab5e89b2 ($8.05 in chips)
Seat 6: f71f9fc0 ($4.93 in chips)
6bc74d1d: posts small blind $0.02
f93eeed5: posts big blind $0.05
*** HOLE CARDS ***
Dealt to Hero [Ks 9d]
Dealt to 6bc74d1d 
Dealt to f93eeed5 
Dealt to 1a54a2fc 
Dealt to ab5e89b2 
Dealt to f71f9fc0 
1a54a2fc: folds
ab5e89b2: folds
f71f9fc0: raises $0.05 to $0.1
Hero: folds
6bc74d1d: folds
f93eeed5: folds
Uncalled bet ($0.05) returned to f71f9fc0
*** SHOWDOWN ***
f71f9fc0 collected $0.12 from pot
*** SUMMARY ***
Total pot $0.12 | Rake $0 | Jackpot $0 | Bingo $0 | Fortune $0 | Tax $0
Seat 1: Hero (button) folded before Flop (didn't bet)
Seat 2: 6bc74d1d (small blind) folded before Flop
Seat 3: f93eeed5 (big blind) folded before Flop
Seat 4: 1a54a2fc folded before Flop (didn't bet)
Seat 5: ab5e89b2 folded before Flop (didn't bet)
Seat 6: f71f9fc0 collected ($0.12)


Poker Hand #RC3334371346: Hold'em No Limit ($0.02/$0.05) - 2025/02/17 20:19:45
Table 'RushAndCash596606' 6-max Seat #1 is the button
Seat 1: 63a77bff ($5.3 in chips)
Seat 2: 7cf45cbd ($7.42 in chips)
Seat 3: 84d78f72 ($8.78 in chips)
Seat 4: fa499268 ($5 in chips)
Seat 5: Hero ($5.44 in chips)
Seat 6: cfe19c20 ($5.71 in chips)
7cf45cbd: posts small blind $0.02
84d78f72: posts big blind $0.05
*** HOLE CARDS ***
Dealt to 63a77bff 
Dealt to 7cf45cbd 
Dealt to 84d78f72 
Dealt to fa499268 
Dealt to Hero [5d Td]
Dealt to cfe19c20 
fa499268: folds
Hero: folds
cfe19c20: folds
63a77bff: folds
7cf45cbd: folds
Uncalled bet ($0.03) returned to 84d78f72
*** SHOWDOWN ***
84d78f72 collected $0.04 from pot
*** SUMMARY ***
Total pot $0.04 | Rake $0 | Jackpot $0 | Bingo $0 | Fortune $0 | Tax $0
Seat 1: 63a77bff (button) folded before Flop (didn't bet)
Seat 2: 7cf45cbd (small blind) folded before Flop
Seat 3: 84d78f72 (big blind) collected ($0.04)
Seat 4: fa499268 folded before Flop (didn't bet)
Seat 5: Hero folded before Flop (didn't bet)
Seat 6: cfe19c20 folded before Flop (didn't bet)


Poker Hand #RC3334371328: Hold'em No Limit ($0.02/$0.05) - 2025/02/17 20:19:41
Table 'RushAndCash596588' 6-max Seat #1 is the button
Seat 1: bb702030 ($5 in chips)
Seat 2: 1e76a4d8 ($5.77 in chips)
Seat 3: dc9e794c ($5.28 in chips)
Seat 4: Hero ($5.44 in chips)
Seat 5: 7cf45cbd ($7.42 in chips)
Seat 6: 8c3789e ($7.22 in chips)
1e76a4d8: posts small blind $0.02
dc9e794c: posts big blind $0.05
*** HOLE CARDS ***
Dealt to bb702030 
Dealt to 1e76a4d8 
Dealt to dc9e794c 
Dealt to Hero [5s Js]
Dealt to 7cf45cbd 
Dealt to 8c3789e 
Hero: folds
7cf45cbd: folds
8c3789e: raises $0.08 to $0.13
bb702030: folds
1e76a4d8: folds
dc9e794c: folds
Uncalled bet ($0.08) returned to 8c3789e
*** SHOWDOWN ***
8c3789e collected $0.12 from pot
*** SUMMARY ***
Total pot $0.12 | Rake $0 | Jackpot $0 | Bingo $0 | Fortune $0 | Tax $0
Seat 1: bb702030 (button) folded before Flop (didn't bet)
Seat 2: 1e76a4d8 (small blind) folded before Flop
Seat 3: dc9e794c (big blind) folded before Flop
Seat 4: Hero folded before Flop (didn't bet)
Seat 5: 7cf45cbd folded before Flop (didn't bet)
Seat 6: 8c3789e collected ($0.12)


Poker Hand #RC3334371279: Hold'em No Limit ($0.02/$0.05) - 2025/02/17 20:19:32
Table 'RushAndCash596539' 6-max Seat #1 is the button
Seat 1: 3d2a56c8 ($5.33 in chips)
Seat 2: 1ed08fba ($12.54 in chips)
Seat 3: 7df4712d ($5.61 in chips)
Seat 4: 7381628 ($5 in chips)
Seat 5: cedf4726 ($5 in chips)
Seat 6: Hero ($5.44 in chips)
1ed08fba: posts small blind $0.02
7df4712d: posts big blind $0.05
*** HOLE CARDS ***
Dealt to 3d2a56c8 
Dealt to 1ed08fba 
Dealt to 7df4712d 
Dealt to 7381628 
Dealt to cedf4726 
Dealt to Hero [5h Kd]
7381628: folds
cedf4726: raises $0.08 to $0.13
Hero: folds
3d2a56c8: folds
1ed08fba: folds
7df4712d: folds
Uncalled bet ($0.08) returned to cedf4726
*** SHOWDOWN ***
cedf4726 collected $0.12 from pot
*** SUMMARY ***
Total pot $0.12 | Rake $0 | Jackpot $0 | Bingo $0 | Fortune $0 | Tax $0
Seat 1: 3d2a56c8 (button) folded before Flop (didn't bet)
Seat 2: 1ed08fba (small blind) folded before Flop
Seat 3: 7df4712d (big blind) folded before Flop
Seat 4: 7381628 folded before Flop (didn't bet)
Seat 5: cedf4726 collected ($0.12)
Seat 6: Hero folded before Flop (didn't bet)


Poker Hand #RC3334371120: Hold'em No Limit ($0.02/$0.05) - 2025/02/17 20:19:05
Table 'RushAndCash596380' 6-max Seat #1 is the button
Seat 1: Hero ($5.76 in chips)
Seat 2: 70d89e93 ($3.53 in chips)
Seat 3: c812cddb ($12.51 in chips)
Seat 4: 7aa85a40 ($3.76 in chips)
Seat 5: 8012317b ($5.52 in chips)
Seat 6: f93eeed5 ($7.22 in chips)
70d89e93: posts small blind $0.02
c812cddb: posts big blind $0.05
*** HOLE CARDS ***
Dealt to Hero [Qc Ah]
Dealt to 70d89e93 
Dealt to c812cddb 
Dealt to 7aa85a40 
Dealt to 8012317b 
Dealt to f93eeed5 
7aa85a40: raises $0.05 to $0.1
8012317b: folds
f93eeed5: folds
Hero: raises $0.22 to $0.32
70d89e93: folds
c812cddb: folds
7aa85a40: raises $0.54 to $0.86
Hero: folds
Uncalled bet ($0.54) returned to 7aa85a40
*** SHOWDOWN ***
7aa85a40 collected $0.68 from pot
*** SUMMARY ***
Total pot $0.71 | Rake $0.03 | Jackpot $0 | Bingo $0 | Fortune $0 | Tax $0
Seat 1: Hero (button) folded before Flop
Seat 2: 70d89e93 (small blind) folded before Flop
Seat 3: c812cddb (big blind) folded before Flop
Seat 4: 7aa85a40 collected ($0.68)
Seat 5: 8012317b folded before Flop (didn't bet)
Seat 6: f93eeed5 folded before Flop (didn't bet)


Poker Hand #RC3334370985: Hold'em No Limit ($0.02/$0.05) - 2025/02/17 20:18:43
Table 'RushAndCash596245' 6-max Seat #1 is the button
Seat 1: 6d5fa70b ($6.33 in chips)
Seat 2: Hero ($5.62 in chips)
Seat 3: c24b20b9 ($12.08 in chips)
Seat 4: 7aa85a40 ($3.86 in chips)
Seat 5: 2ae4e16 ($14.86 in chips)
Seat 6: 99af2b58 ($11.35 in chips)
Hero: posts small blind $0.02
c24b20b9: posts big blind $0.05
*** HOLE CARDS ***
Dealt to 6d5fa70b 
Dealt to Hero [Ks Kh]
Dealt to c24b20b9 
Dealt to 7aa85a40 
Dealt to 2ae4e16 
Dealt to 99af2b58 
7aa85a40: raises $0.05 to $0.1
2ae4e16: folds
99af2b58: folds
6d5fa70b: folds
Hero: raises $0.32 to $0.42
c24b20b9: folds
7aa85a40: folds
Uncalled bet ($0.32) returned to Hero
*** SHOWDOWN ***
Hero collected $0.24 from pot
*** SUMMARY ***
Total pot $0.25 | Rake $0.01 | Jackpot $0 | Bingo $0 | Fortune $0 | Tax $0
Seat 1: 6d5fa70b (button) folded before Flop (didn't bet)
Seat 2: Hero (small blind) collected ($0.24)
Seat 3: c24b20b9 (big blind) folded before Flop
Seat 4: 7aa85a40 folded before Flop
Seat 5: 2ae4e16 folded before Flop (didn't bet)
Seat 6: 99af2b58 folded before Flop (didn't bet)


Poker Hand #RC3334370946: Hold'em No Limit ($0.02/$0.05) - 2025/02/17 20:18:36
Table 'RushAndCash596206' 6-max Seat #1 is the button
Seat 1: 48dc6454 ($4.5 in chips)
Seat 2: 3b701823 ($5.17 in chips)
Seat 3: Hero ($5.67 in chips)
Seat 4: 2b6388ee ($5.13 in chips)
Seat 5: 6eae6bcb ($5.86 in chips)
Seat 6: ba18b75e ($8.34 in chips)
3b701823: posts small blind $0.02
Hero: posts big blind $0.05
*** HOLE CARDS ***
Dealt to 48dc6454 
Dealt to 3b701823 
Dealt to Hero [Td 5h]
Dealt to 2b6388ee 
Dealt to 6eae6bcb 
Dealt to ba18b75e 
2b6388ee: folds
6eae6bcb: raises $0.1 to $0.15
ba18b75e: folds
48dc6454: folds
3b701823: raises $0.35 to $0.5
Hero: folds
6eae6bcb: calls $0.35
*** FLOP *** [9s Kc 7c]
3b701823: bets $0.36
6eae6bcb: calls $0.36
*** TURN *** [9s Kc 7c] [4d]
3b701823: checks
6eae6bcb: bets $0.89
3b701823: folds
Uncalled bet ($0.89) returned to 6eae6bcb
*** SHOWDOWN ***
6eae6bcb collected $1.62 from pot
*** SUMMARY ***
Total pot $1.77 | Rake $0.08 | Jackpot $0.07 | Bingo $0 | Fortune $0 | Tax $0
Board [9s Kc 7c 4d]
Seat 1: 48dc6454 (button) folded before Flop (didn't bet)
Seat 2: 3b701823 (small blind) folded on the Turn
Seat 3: Hero (big blind) folded before Flop
Seat 4: 2b6388ee folded before Flop (didn't bet)
Seat 5: 6eae6bcb won ($1.62)
Seat 6: ba18b75e folded before Flop (didn't bet)


Poker Hand #RC3334370924: Hold'em No Limit ($0.02/$0.05) - 2025/02/17 20:18:32
Table 'RushAndCash596184' 6-max Seat #1 is the button
Seat 1: 9f09d482 ($5.41 in chips)
Seat 2: fb78508c ($5 in chips)
Seat 3: e26361cd ($5.2 in chips)
Seat 4: a6ca20e7 ($33.75 in chips)
Seat 5: 735c4afd ($5 in chips)
Seat 6: Hero ($5.67 in chips)
fb78508c: posts small blind $0.02
e26361cd: posts big blind $0.05
*** HOLE CARDS ***
Dealt to 9f09d482 
Dealt to fb78508c 
Dealt to e26361cd 
Dealt to a6ca20e7 
Dealt to 735c4afd 
Dealt to Hero [3c 5d]
a6ca20e7: raises $0.06 to $0.11
735c4afd: folds
Hero: folds
9f09d482: folds
fb78508c: folds
e26361cd: calls $0.06
*** FLOP *** [4d 5c Tc]
e26361cd: checks
a6ca20e7: bets $0.09
e26361cd: folds
Uncalled bet ($0.09) returned to a6ca20e7
*** SHOWDOWN ***
a6ca20e7 collected $0.23 from pot
*** SUMMARY ***
Total pot $0.24 | Rake $0.01 | Jackpot $0 | Bingo $0 | Fortune $0 | Tax $0
Board [4d 5c Tc]
Seat 1: 9f09d482 (button) folded before Flop (didn't bet)
Seat 2: fb78508c (small blind) folded before Flop
Seat 3: e26361cd (big blind) folded on the Flop
Seat 4: a6ca20e7 won ($0.23)
Seat 5: 735c4afd folded before Flop (didn't bet)
Seat 6: Hero folded before Flop (didn't bet)


Poker Hand #RC3334370905: Hold'em No Limit ($0.02/$0.05) - 2025/02/17 20:18:29
Table 'RushAndCash596165' 6-max Seat #1 is the button
Seat 1: ab13ccc6 ($8.25 in chips)
Seat 2: 9f09d482 ($5.43 in chips)
Seat 3: f71f9fc0 ($4.81 in chips)
Seat 4: a75233d9 ($5 in chips)
Seat 5: a6ca20e7 ($33.75 in chips)
Seat 6: Hero ($5.67 in chips)
9f09d482: posts small blind $0.02
f71f9fc0: posts big blind $0.05
*** HOLE CARDS ***
Dealt to ab13ccc6 
Dealt to 9f09d482 
Dealt to f71f9fc0 
Dealt to a75233d9 
Dealt to a6ca20e7 
Dealt to Hero [4h Qc]
a75233d9: folds
a6ca20e7: folds
Hero: folds
ab13ccc6: folds
9f09d482: folds
Uncalled bet ($0.03) returned to f71f9fc0
*** SHOWDOWN ***
f71f9fc0 collected $0.04 from pot
*** SUMMARY ***
Total pot $0.04 | Rake $0 | Jackpot $0 | Bingo $0 | Fortune $0 | Tax $0
Seat 1: ab13ccc6 (button) folded before Flop (didn't bet)
Seat 2: 9f09d482 (small blind) folded before Flop
Seat 3: f71f9fc0 (big blind) collected ($0.04)
Seat 4: a75233d9 folded before Flop (didn't bet)
Seat 5: a6ca20e7 folded before Flop (didn't bet)
Seat 6: Hero folded before Flop (didn't bet)


Poker Hand #RC3334370871: Hold'em No Limit ($0.02/$0.05) - 2025/02/17 20:18:23
Table 'RushAndCash596131' 6-max Seat #1 is the button
Seat 1: 9b4fbe63 ($12.37 in chips)
Seat 2: 882ed5dc ($5.14 in chips)
Seat 3: e92b360e ($11.45 in chips)
Seat 4: 6ebc3323 ($13.14 in chips)
Seat 5: Hero ($5.67 in chips)
Seat 6: 25f30dbe ($5.95 in chips)
882ed5dc: posts small blind $0.02
e92b360e: posts big blind $0.05
*** HOLE CARDS ***
Dealt to 9b4fbe63 
Dealt to 882ed5dc 
Dealt to e92b360e 
Dealt to 6ebc3323 
Dealt to Hero [9s As]
Dealt to 25f30dbe 
6ebc3323: folds
Hero: folds
25f30dbe: raises $0.05 to $0.1
9b4fbe63: folds
882ed5dc: calls $0.08
e92b360e: folds
*** FLOP *** [6h Kd Qc]
882ed5dc: checks
25f30dbe: bets $0.13
882ed5dc: raises $0.22 to $0.35
25f30dbe: calls $0.22
*** TURN *** [6h Kd Qc] [Ad]
882ed5dc: checks
25f30dbe: bets $0.32
882ed5dc: raises $0.67 to $0.99
25f30dbe: folds
Uncalled bet ($0.67) returned to 882ed5dc
*** SHOWDOWN ***
882ed5dc collected $1.45 from pot
*** SUMMARY ***
Total pot $1.59 | Rake $0.07 | Jackpot $0.07 | Bingo $0 | Fortune $0 | Tax $0
Board [6h Kd Qc Ad]
Seat 1: 9b4fbe63 (button) folded before Flop (didn't bet)
Seat 2: 882ed5dc (small blind) showed [Js] and won ($1.45)
Seat 3: e92b360e (big blind) folded before Flop
Seat 4: 6ebc3323 folded before Flop (didn't bet)
Seat 5: Hero folded before Flop (didn't bet)
Seat 6: 25f30dbe folded on the Turn


Poker Hand #RC3334370847: Hold'em No Limit ($0.02/$0.05) - 2025/02/17 20:18:19
Table 'RushAndCash596107' 6-max Seat #1 is the button
Seat 1: e632d40b ($5.69 in chips)
Seat 2: Hero ($5.69 in chips)
Seat 3: d0475ba7 ($5.69 in chips)
Seat 4: 26823915 ($5 in chips)
Seat 5: 6e73d15 ($5 in chips)
Seat 6: 825e110f ($5.41 in chips)
Hero: posts small blind $0.02
d0475ba7: posts big blind $0.05
*** HOLE CARDS ***
Dealt to e632d40b 
Dealt to Hero [Th 7d]
Dealt to d0475ba7 
Dealt to 26823915 
Dealt to 6e73d15 
Dealt to 825e110f 
26823915: folds
6e73d15: folds
825e110f: raises $0.08 to $0.13
e632d40b: folds
Hero: folds
d0475ba7: folds
Uncalled bet ($0.08) returned to 825e110f
*** SHOWDOWN ***
825e110f collected $0.12 from pot
*** SUMMARY ***
Total pot $0.12 | Rake $0 | Jackpot $0 | Bingo $0 | Fortune $0 | Tax $0
Seat 1: e632d40b (button) folded before Flop (didn't bet)
Seat 2: Hero (small blind) folded before Flop
Seat 3: d0475ba7 (big blind) folded before Flop
Seat 4: 26823915 folded before Flop (didn't bet)
Seat 5: 6e73d15 folded before Flop (didn't bet)
Seat 6: 825e110f collected ($0.12)


Poker Hand #RC3334370616: Hold'em No Limit ($0.02/$0.05) - 2025/02/17 20:17:39
Table 'RushAndCash595876' 6-max Seat #1 is the button
Seat 1: Hero ($5.58 in chips)
Seat 2: 59f12f9f ($5.02 in chips)
Seat 3: e632d40b ($5.79 in chips)
Seat 4: 8047b2ca ($4.34 in chips)
Seat 5: 9e314792 ($4.61 in chips)
Seat 6: 94a63b6c ($5 in chips)
59f12f9f: posts small blind $0.02
e632d40b: posts big blind $0.05
*** HOLE CARDS ***
Dealt to Hero [Jd 8d]
Dealt to 59f12f9f 
Dealt to e632d40b 
Dealt to 8047b2ca 
Dealt to 9e314792 
Dealt to 94a63b6c 
8047b2ca: folds
9e314792: folds
94a63b6c: folds
Hero: raises $0.05 to $0.1
59f12f9f: folds
e632d40b: calls $0.05
*** FLOP *** [2d 3c 4d]
e632d40b: checks
Hero: checks
*** TURN *** [2d 3c 4d] [9c]
e632d40b: checks
Hero: bets $0.12
e632d40b: folds
Uncalled bet ($0.12) returned to Hero
*** SHOWDOWN ***
Hero collected $0.21 from pot
*** SUMMARY ***
Total pot $0.22 | Rake $0.01 | Jackpot $0 | Bingo $0 | Fortune $0 | Tax $0
Board [2d 3c 4d 9c]
Seat 1: Hero (button) won ($0.21)
Seat 2: 59f12f9f (small blind) folded before Flop
Seat 3: e632d40b (big blind) folded on the Turn
Seat 4: 8047b2ca folded before Flop (didn't bet)
Seat 5: 9e314792 folded before Flop (didn't bet)
Seat 6: 94a63b6c folded before Flop (didn't bet)


Poker Hand #RC3334370601: Hold'em No Limit ($0.02/$0.05) - 2025/02/17 20:17:36
Table 'RushAndCash595861' 6-max Seat #1 is the button
Seat 1: d86379c5 ($6.71 in chips)
Seat 2: 9135e49d ($5.18 in chips)
Seat 3: Hero ($5.63 in chips)
Seat 4: 24d6dfa4 ($7.76 in chips)
Seat 5: f5592199 ($6.01 in chips)
Seat 6: 92099542 ($4.87 in chips)
9135e49d: posts small blind $0.02
Hero: posts big blind $0.05
*** HOLE CARDS ***
Dealt to d86379c5 
Dealt to 9135e49d 
Dealt to Hero [2d Th]
Dealt to 24d6dfa4 
Dealt to f5592199 
Dealt to 92099542 
24d6dfa4: folds
f5592199: folds
92099542: folds
d86379c5: folds
9135e49d: raises $0.1 to $0.15
Hero: folds
Uncalled bet ($0.1) returned to 9135e49d
*** SHOWDOWN ***
9135e49d collected $0.1 from pot
*** SUMMARY ***
Total pot $0.1 | Rake $0 | Jackpot $0 | Bingo $0 | Fortune $0 | Tax $0
Seat 1: d86379c5 (button) folded before Flop (didn't bet)
Seat 2: 9135e49d (small blind) collected ($0.1)
Seat 3: Hero (big blind) folded before Flop
Seat 4: 24d6dfa4 folded before Flop (didn't bet)
Seat 5: f5592199 folded before Flop (didn't bet)
Seat 6: 92099542 folded before Flop (didn't bet)


Poker Hand #RC3334370523: Hold'em No Limit ($0.02/$0.05) - 2025/02/17 20:17:21
Table 'RushAndCash595783' 6-max Seat #1 is the button
Seat 1: fb6c4072 ($5 in chips)
Seat 2: 1a54a2fc ($5 in chips)
Seat 3: d1cd1071 ($13.45 in chips)
Seat 4: Hero ($5.56 in chips)
Seat 5: 84f270f8 ($5.16 in chips)
Seat 6: fa84cc2d ($13.92 in chips)
1a54a2fc: posts small blind $0.02
d1cd1071: posts big blind $0.05
*** HOLE CARDS ***
Dealt to fb6c4072 
Dealt to 1a54a2fc 
Dealt to d1cd1071 
Dealt to Hero [Kc Qc]
Dealt to 84f270f8 
Dealt to fa84cc2d 
Hero: raises $0.05 to $0.1
84f270f8: folds
fa84cc2d: folds
fb6c4072: folds
1a54a2fc: folds
d1cd1071: folds
Uncalled bet ($0.05) returned to Hero
*** SHOWDOWN ***
Hero collected $0.12 from pot
*** SUMMARY ***
Total pot $0.12 | Rake $0 | Jackpot $0 | Bingo $0 | Fortune $0 | Tax $0
Seat 1: fb6c4072 (button) folded before Flop (didn't bet)
Seat 2: 1a54a2fc (small blind) folded before Flop
Seat 3: d1cd1071 (big blind) folded before Flop
Seat 4: Hero collected ($0.12)
Seat 5: 84f270f8 folded before Flop (didn't bet)
Seat 6: fa84cc2d folded before Flop (didn't bet)


Poker Hand #RC3334370500: Hold'em No Limit ($0.02/$0.05) - 2025/02/17 20:17:17
Table 'RushAndCash595760' 6-max Seat #1 is the button
Seat 1: 6c122cb5 ($6.77 in chips)
Seat 2: 48dc6454 ($5.02 in chips)
Seat 3: 7c99618c ($6.99 in chips)
Seat 4: Hero ($5.56 in chips)
Seat 5: d0475ba7 ($5.82 in chips)
Seat 6: 6008538 ($5.15 in chips)
48dc6454: posts small blind $0.02
7c99618c: posts big blind $0.05
*** HOLE CARDS ***
Dealt to 6c122cb5 
Dealt to 48dc6454 
Dealt to 7c99618c 
Dealt to Hero [Qc 7c]
Dealt to d0475ba7 
Dealt to 6008538 
Hero: folds
d0475ba7: folds
6008538: folds
6c122cb5: raises $0.08 to $0.13
48dc6454: folds
7c99618c: folds
Uncalled bet ($0.08) returned to 6c122cb5
*** SHOWDOWN ***
6c122cb5 collected $0.12 from pot
*** SUMMARY ***
Total pot $0.12 | Rake $0 | Jackpot $0 | Bingo $0 | Fortune $0 | Tax $0
Seat 1: 6c122cb5 (button) collected ($0.12)
Seat 2: 48dc6454 (small blind) folded before Flop
Seat 3: 7c99618c (big blind) folded before Flop
Seat 4: Hero folded before Flop (didn't bet)
Seat 5: d0475ba7 folded before Flop (didn't bet)
Seat 6: 6008538 folded before Flop (didn't bet)


Poker Hand #RC3334370357: Hold'em No Limit ($0.02/$0.05) - 2025/02/17 20:16:53
Table 'RushAndCash595617' 6-max Seat #1 is the button
Seat 1: eaafe260 ($5 in chips)
Seat 2: 5f8248c5 ($1.98 in chips)
Seat 3: deccd7eb ($5.5 in chips)
Seat 4: 9a633d8d ($7.51 in chips)
Seat 5: 4c7728b5 ($5.07 in chips)
Seat 6: Hero ($5.49 in chips)
5f8248c5: posts small blind $0.02
deccd7eb: posts big blind $0.05
*** HOLE CARDS ***
Dealt to eaafe260 
Dealt to 5f8248c5 
Dealt to deccd7eb 
Dealt to 9a633d8d 
Dealt to 4c7728b5 
Dealt to Hero [Tc Th]
9a633d8d: folds
4c7728b5: folds
Hero: raises $0.05 to $0.1
eaafe260: folds
5f8248c5: folds
deccd7eb: folds
Uncalled bet ($0.05) returned to Hero
*** SHOWDOWN ***
Hero collected $0.12 from pot
*** SUMMARY ***
Total pot $0.12 | Rake $0 | Jackpot $0 | Bingo $0 | Fortune $0 | Tax $0
Seat 1: eaafe260 (button) folded before Flop (didn't bet)
Seat 2: 5f8248c5 (small blind) folded before Flop
Seat 3: deccd7eb (big blind) folded before Flop
Seat 4: 9a633d8d folded before Flop (didn't bet)
Seat 5: 4c7728b5 folded before Flop (didn't bet)
Seat 6: Hero collected ($0.12)


Poker Hand #RC3334370338: Hold'em No Limit ($0.02/$0.05) - 2025/02/17 20:16:50
Table 'RushAndCash595598' 6-max Seat #1 is the button
Seat 1: Hero ($5.49 in chips)
Seat 2: ca93b3ea ($5.19 in chips)
Seat 3: 16081ce9 ($10.08 in chips)
Seat 4: 42fca4f9 ($4.88 in chips)
Seat 5: a1e98d09 ($3.79 in chips)
Seat 6: ab5e89b2 ($7.46 in chips)
ca93b3ea: posts small blind $0.02
16081ce9: posts big blind $0.05
*** HOLE CARDS ***
Dealt to Hero [Jc 4d]
Dealt to ca93b3ea 
Dealt to 16081ce9 
Dealt to 42fca4f9 
Dealt to a1e98d09 
Dealt to ab5e89b2 
42fca4f9: folds
a1e98d09: folds
ab5e89b2: raises $0.1 to $0.15
Hero: folds
ca93b3ea: raises $0.35 to $0.5
16081ce9: folds
ab5e89b2: calls $0.35
*** FLOP *** [5h Ac Ah]
ca93b3ea: bets $0.35
ab5e89b2: calls $0.35
*** TURN *** [5h Ac Ah] [3s]
ca93b3ea: checks
ab5e89b2: checks
*** RIVER *** [5h Ac Ah 3s] [Ad]
ca93b3ea: checks
ab5e89b2: checks
ca93b3ea: shows [7s 7h] (Aces Full over Sevens)
ab5e89b2: shows [Jh Qh] (Three Aces)
*** SHOWDOWN ***
ca93b3ea collected $1.6 from pot
*** SUMMARY ***
Total pot $1.75 | Rake $0.08 | Jackpot $0.07 | Bingo $0 | Fortune $0 | Tax $0
Board [5h Ac Ah 3s Ad]
Seat 1: Hero (button) folded before Flop (didn't bet)
Seat 2: ca93b3ea (small blind) showed [7s 7h] and won ($1.6) with Aces Full over Sevens
Seat 3: 16081ce9 (big blind) folded before Flop
Seat 4: 42fca4f9 folded before Flop (didn't bet)
Seat 5: a1e98d09 folded before Flop (didn't bet)
Seat 6: ab5e89b2 showed [Jh Qh] and lost with Three Aces


Poker Hand #RC3334370265: Hold'em No Limit ($0.02/$0.05) - 2025/02/17 20:16:36
Table 'RushAndCash595525' 6-max Seat #1 is the button
Seat 1: 2353ba72 ($10.1 in chips)
Seat 2: Hero ($5.51 in chips)
Seat 3: 4190d158 ($5.28 in chips)
Seat 4: 20e2d62 ($5.4 in chips)
Seat 5: 709ac205 ($11.14 in chips)
Seat 6: 64deaf18 ($5.39 in chips)
Hero: posts small blind $0.02
4190d158: posts big blind $0.05
*** HOLE CARDS ***
Dealt to 2353ba72 
Dealt to Hero [Th Qs]
Dealt to 4190d158 
Dealt to 20e2d62 
Dealt to 709ac205 
Dealt to 64deaf18 
20e2d62: folds
709ac205: folds
64deaf18: raises $0.1 to $0.15
2353ba72: folds
Hero: folds
4190d158: folds
Uncalled bet ($0.1) returned to 64deaf18
*** SHOWDOWN ***
64deaf18 collected $0.12 from pot
*** SUMMARY ***
Total pot $0.12 | Rake $0 | Jackpot $0 | Bingo $0 | Fortune $0 | Tax $0
Seat 1: 2353ba72 (button) folded before Flop (didn't bet)
Seat 2: Hero (small blind) folded before Flop
Seat 3: 4190d158 (big blind) folded before Flop
Seat 4: 20e2d62 folded before Flop (didn't bet)
Seat 5: 709ac205 folded before Flop (didn't bet)
Seat 6: 64deaf18 collected ($0.12)


Poker Hand #RC3334369980: Hold'em No Limit ($0.02/$0.05) - 2025/02/17 20:15:37
Table 'RushAndCash595240' 6-max Seat #1 is the button
Seat 1: 20e2d62 ($5.39 in chips)
Seat 2: 6d2abfa5 ($5 in chips)
Seat 3: Hero ($5.5 in chips)
Seat 4: d913286e ($6 in chips)
Seat 5: 80b2520f ($8.74 in chips)
Seat 6: 83c366a4 ($5 in chips)
6d2abfa5: posts small blind $0.02
Hero: posts big blind $0.05
*** HOLE CARDS ***
Dealt to 20e2d62 
Dealt to 6d2abfa5 
Dealt to Hero [Qs Ks]
Dealt to d913286e 
Dealt to 80b2520f 
Dealt to 83c366a4 
d913286e: folds
80b2520f: folds
83c366a4: folds
20e2d62: raises $0.08 to $0.13
6d2abfa5: folds
Hero: calls $0.08
*** FLOP *** [5h 8c 7c]
Hero: checks
20e2d62: checks
*** TURN *** [5h 8c 7c] [9c]
Hero: checks
20e2d62: checks
*** RIVER *** [5h 8c 7c 9c] [6d]
Hero: checks
20e2d62: checks
Hero: shows [Qs Ks] (Nines-High Straight)
20e2d62: shows [Js Ah] (Nines-High Straight)
*** SHOWDOWN ***
Hero collected $0.14 from pot
20e2d62 collected $0.14 from pot
*** SUMMARY ***
Total pot $0.28 | Rake $0 | Jackpot $0 | Bingo $0 | Fortune $0 | Tax $0
Board [5h 8c 7c 9c 6d]
Seat 1: 20e2d62 (button) showed [Js Ah] and won ($0.14) with Nines-High Straight
Seat 2: 6d2abfa5 (small blind) folded before Flop
Seat 3: Hero (big blind) showed [Qs Ks] and won ($0.14) with Nines-High Straight
Seat 4: d913286e folded before Flop (didn't bet)
Seat 5: 80b2520f folded before Flop (didn't bet)
Seat 6: 83c366a4 folded before Flop (didn't bet)


Poker Hand #RC3334369969: Hold'em No Limit ($0.02/$0.05) - 2025/02/17 20:15:34
Table 'RushAndCash595229' 6-max Seat #1 is the button
Seat 1: 8e39de43 ($5 in chips)
Seat 2: f45ac3d0 ($5.29 in chips)
Seat 3: b44ff266 ($5.72 in chips)
Seat 4: b4c33f6c ($5 in chips)
Seat 5: 488a283c ($3.42 in chips)
Seat 6: Hero ($5.5 in chips)
f45ac3d0: posts small blind $0.02
b44ff266: posts big blind $0.05
*** HOLE CARDS ***
Dealt to 8e39de43 
Dealt to f45ac3d0 
Dealt to b44ff266 
Dealt to b4c33f6c 
Dealt to 488a283c 
Dealt to Hero [7d Kh]
b4c33f6c: folds
488a283c: folds
Hero: folds
8e39de43: folds
f45ac3d0: folds
Uncalled bet ($0.03) returned to b44ff266
*** SHOWDOWN ***
b44ff266 collected $0.04 from pot
*** SUMMARY ***
Total pot $0.04 | Rake $0 | Jackpot $0 | Bingo $0 | Fortune $0 | Tax $0
Seat 1: 8e39de43 (button) folded before Flop (didn't bet)
Seat 2: f45ac3d0 (small blind) folded before Flop
Seat 3: b44ff266 (big blind) collected ($0.04)
Seat 4: b4c33f6c folded before Flop (didn't bet)
Seat 5: 488a283c folded before Flop (didn't bet)
Seat 6: Hero folded before Flop (didn't bet)


Poker Hand #RC3334369954: Hold'em No Limit ($0.02/$0.05) - 2025/02/17 20:15:31
Table 'RushAndCash595214' 6-max Seat #1 is the button
Seat 1: a6ca20e7 ($33.54 in chips)
Seat 2: 3d2a56c8 ($6.02 in chips)
Seat 3: c59158f3 ($5.14 in chips)
Seat 4: ab9949da ($4.69 in chips)
Seat 5: Hero ($5.5 in chips)
Seat 6: 742ccfee ($2.52 in chips)
3d2a56c8: posts small blind $0.02
c59158f3: posts big blind $0.05
*** HOLE CARDS ***
Dealt to a6ca20e7 
Dealt to 3d2a56c8 
Dealt to c59158f3 
Dealt to ab9949da 
Dealt to Hero [Ad 9s]
Dealt to 742ccfee 
ab9949da: folds
Hero: folds
742ccfee: folds
a6ca20e7: folds
3d2a56c8: folds
Uncalled bet ($0.03) returned to c59158f3
*** SHOWDOWN ***
c59158f3 collected $0.04 from pot
*** SUMMARY ***
Total pot $0.04 | Rake $0 | Jackpot $0 | Bingo $0 | Fortune $0 | Tax $0
Seat 1: a6ca20e7 (button) folded before Flop (didn't bet)
Seat 2: 3d2a56c8 (small blind) folded before Flop
Seat 3: c59158f3 (big blind) collected ($0.04)
Seat 4: ab9949da folded before Flop (didn't bet)
Seat 5: Hero folded before Flop (didn't bet)
Seat 6: 742ccfee folded before Flop (didn't bet)


Poker Hand #RC3334369906: Hold'em No Limit ($0.02/$0.05) - 2025/02/17 20:15:21
Table 'RushAndCash595166' 6-max Seat #1 is the button
Seat 1: 3a23fe14 ($3.15 in chips)
Seat 2: 93cbff75 ($5.45 in chips)
Seat 3: b167a4a5 ($15.42 in chips)
Seat 4: 16a87f9d ($8.35 in chips)
Seat 5: 7f832000 ($5.33 in chips)
Seat 6: Hero ($5.5 in chips)
93cbff75: posts small blind $0.02
b167a4a5: posts big blind $0.05
*** HOLE CARDS ***
Dealt to 3a23fe14 
Dealt to 93cbff75 
Dealt to b167a4a5 
Dealt to 16a87f9d 
Dealt to 7f832000 
Dealt to Hero [3d Qs]
16a87f9d: folds
7f832000: raises $0.05 to $0.1
Hero: folds
3a23fe14: folds
93cbff75: folds
b167a4a5: calls $0.05
*** FLOP *** [Tc 6c 9c]
b167a4a5: checks
7f832000: bets $0.15
b167a4a5: calls $0.15
*** TURN *** [Tc 6c 9c] [5s]
b167a4a5: checks
7f832000: bets $0.35
b167a4a5: calls $0.35
*** RIVER *** [Tc 6c 9c 5s] [4s]
b167a4a5: checks
7f832000: bets $0.85
b167a4a5: calls $0.85
7f832000: shows [Kd Js] (King-High)
b167a4a5: shows [Td Qh] (Pair of Tens)
*** SHOWDOWN ***
b167a4a5 collected $2.71 from pot
*** SUMMARY ***
Total pot $2.92 | Rake $0.14 | Jackpot $0.07 | Bingo $0 | Fortune $0 | Tax $0
Board [Tc 6c 9c 5s 4s]
Seat 1: 3a23fe14 (button) folded before Flop (didn't bet)
Seat 2: 93cbff75 (small blind) folded before Flop
Seat 3: b167a4a5 (big blind) showed [Td Qh] and won ($2.71) with Pair of Tens
Seat 4: 16a87f9d folded before Flop (didn't bet)
Seat 5: 7f832000 showed [Kd Js] and lost with King-High
Seat 6: Hero folded before Flop (didn't bet)


Poker Hand #RC3334369867: Hold'em No Limit ($0.02/$0.05) - 2025/02/17 20:15:14
Table 'RushAndCash595127' 6-max Seat #1 is the button
Seat 1: Hero ($5.5 in chips)
Seat 2: 8be10cd0 ($5.31 in chips)
Seat 3: a28ca95c ($11.93 in chips)
Seat 4: 5be1ddae ($4.27 in chips)
Seat 5: ed41f291 ($6.29 in chips)
Seat 6: c7d7e6aa ($6.11 in chips)
8be10cd0: posts small blind $0.02
a28ca95c: posts big blind $0.05
*** HOLE CARDS ***
Dealt to Hero [6d Kc]
Dealt to 8be10cd0 
Dealt to a28ca95c 
Dealt to 5be1ddae 
Dealt to ed41f291 
Dealt to c7d7e6aa 
5be1ddae: raises $0.08 to $0.13
ed41f291: folds
c7d7e6aa: folds
Hero: folds
8be10cd0: calls $0.11
a28ca95c: calls $0.08
*** FLOP *** [3s 8h 6s]
8be10cd0: checks
a28ca95c: bets $0.14
5be1ddae: folds
8be10cd0: folds
Uncalled bet ($0.14) returned to a28ca95c
*** SHOWDOWN ***
a28ca95c collected $0.37 from pot
*** SUMMARY ***
Total pot $0.39 | Rake $0.02 | Jackpot $0 | Bingo $0 | Fortune $0 | Tax $0
Board [3s 8h 6s]
Seat 1: Hero (button) folded before Flop (didn't bet)
Seat 2: 8be10cd0 (small blind) folded on the Flop
Seat 3: a28ca95c (big blind) won ($0.37)
Seat 4: 5be1ddae folded on the Flop
Seat 5: ed41f291 folded before Flop (didn't bet)
Seat 6: c7d7e6aa folded before Flop (didn't bet)


Poker Hand #RC3334369572: Hold'em No Limit ($0.02/$0.05) - 2025/02/17 20:14:24
Table 'RushAndCash594832' 6-max Seat #1 is the button
Seat 1: d32b2e06 ($10.62 in chips)
Seat 2: Hero ($5.6 in chips)
Seat 3: ed41f291 ($6.1 in chips)
Seat 4: cacae660 ($3.7 in chips)
Seat 5: 8be10cd0 ($5.41 in chips)
Seat 6: 32d40ce0 ($6.09 in chips)
Hero: posts small blind $0.02
ed41f291: posts big blind $0.05
*** HOLE CARDS ***
Dealt to d32b2e06 
Dealt to Hero [As Ts]
Dealt to ed41f291 
Dealt to cacae660 
Dealt to 8be10cd0 
Dealt to 32d40ce0 
cacae660: folds
8be10cd0: raises $0.05 to $0.1
32d40ce0: folds
d32b2e06: folds
Hero: calls $0.08
ed41f291: calls $0.05
*** FLOP *** [9h 7d 2s]
Hero: checks
ed41f291: checks
8be10cd0: checks
*** TURN *** [9h 7d 2s] [8s]
Hero: checks
ed41f291: checks
8be10cd0: checks
*** RIVER *** [9h 7d 2s 8s] [3d]
Hero: checks
ed41f291: checks
8be10cd0: checks
Hero: shows [As Ts] (Ace-High)
ed41f291: shows [7h 8h] (Pair of Eights and Pair of Sevens)
8be10cd0: shows [5c Ac] (Ace-High)
*** SHOWDOWN ***
ed41f291 collected $0.29 from pot
*** SUMMARY ***
Total pot $0.3 | Rake $0.01 | Jackpot $0 | Bingo $0 | Fortune $0 | Tax $0
Board [9h 7d 2s 8s 3d]
Seat 1: d32b2e06 (button) folded before Flop (didn't bet)
Seat 2: Hero (small blind) showed [As Ts] and lost with Ace-High
Seat 3: ed41f291 (big blind) showed [7h 8h] and won ($0.29) with Pair of Eights and Pair of Sevens
Seat 4: cacae660 folded before Flop (didn't bet)
Seat 5: 8be10cd0 showed [5c Ac] and lost with Ace-High
Seat 6: 32d40ce0 folded before Flop (didn't bet)


Poker Hand #RC3334369314: Hold'em No Limit ($0.02/$0.05) - 2025/02/17 20:13:41
Table 'RushAndCash594574' 6-max Seat #1 is the button
Seat 1: 8c6b70e4 ($5.07 in chips)
Seat 2: 4db54282 ($5.1 in chips)
Seat 3: Hero ($5.49 in chips)
Seat 4: 42fca4f9 ($5.11 in chips)
Seat 5: f5592199 ($6.02 in chips)
Seat 6: f93eeed5 ($6.62 in chips)
4db54282: posts small blind $0.02
Hero: posts big blind $0.05
*** HOLE CARDS ***
Dealt to 8c6b70e4 
Dealt to 4db54282 
Dealt to Hero [5c 3c]
Dealt to 42fca4f9 
Dealt to f5592199 
Dealt to f93eeed5 
42fca4f9: folds
f5592199: folds
f93eeed5: folds
8c6b70e4: raises $0.05 to $0.1
4db54282: folds
Hero: calls $0.05
*** FLOP *** [4c Qc 5d]
Hero: checks
8c6b70e4: checks
*** TURN *** [4c Qc 5d] [6s]
Hero: checks
8c6b70e4: checks
*** RIVER *** [4c Qc 5d 6s] [8h]
Hero: checks
8c6b70e4: checks
Hero: shows [5c 3c] (Pair of Fives)
8c6b70e4: shows [Jh Kd] (King-High)
*** SHOWDOWN ***
Hero collected $0.21 from pot
*** SUMMARY ***
Total pot $0.22 | Rake $0.01 | Jackpot $0 | Bingo $0 | Fortune $0 | Tax $0
Board [4c Qc 5d 6s 8h]
Seat 1: 8c6b70e4 (button) showed [Jh Kd] and lost with King-High
Seat 2: 4db54282 (small blind) folded before Flop
Seat 3: Hero (big blind) showed [5c 3c] and won ($0.21) with Pair of Fives
Seat 4: 42fca4f9 folded before Flop (didn't bet)
Seat 5: f5592199 folded before Flop (didn't bet)
Seat 6: f93eeed5 folded before Flop (didn't bet)


Poker Hand #RC3334369293: Hold'em No Limit ($0.02/$0.05) - 2025/02/17 20:13:37
Table 'RushAndCash594553' 6-max Seat #1 is the button
Seat 1: ab5e89b2 ($6.53 in chips)
Seat 2: f4988477 ($9.6 in chips)
Seat 3: a6ca20e7 ($33.84 in chips)
Seat 4: Hero ($5.49 in chips)
Seat 5: 99af2b58 ($11.71 in chips)
Seat 6: 16f2e5ce ($7.91 in chips)
f4988477: posts small blind $0.02
a6ca20e7: posts big blind $0.05
*** HOLE CARDS ***
Dealt to ab5e89b2 
Dealt to f4988477 
Dealt to a6ca20e7 
Dealt to Hero [9d 8c]
Dealt to 99af2b58 
Dealt to 16f2e5ce 
Hero: folds
99af2b58: folds
16f2e5ce: folds
ab5e89b2: raises $0.1 to $0.15
f4988477: raises $0.45 to $0.6
a6ca20e7: folds
ab5e89b2: calls $0.45
*** FLOP *** [7h 4d 8d]
f4988477: bets $0.27
ab5e89b2: raises $0.75 to $1.02
f4988477: folds
Uncalled bet ($0.75) returned to ab5e89b2
*** SHOWDOWN ***
ab5e89b2 collected $1.64 from pot
*** SUMMARY ***
Total pot $1.79 | Rake $0.08 | Jackpot $0.07 | Bingo $0 | Fortune $0 | Tax $0
Board [7h 4d 8d]
Seat 1: ab5e89b2 (button) won ($1.64)
Seat 2: f4988477 (small blind) folded on the Flop
Seat 3: a6ca20e7 (big blind) folded before Flop
Seat 4: Hero folded before Flop (didn't bet)
Seat 5: 99af2b58 folded before Flop (didn't bet)
Seat 6: 16f2e5ce folded before Flop (didn't bet)


Poker Hand #RC3334369278: Hold'em No Limit ($0.02/$0.05) - 2025/02/17 20:13:34
Table 'RushAndCash594538' 6-max Seat #1 is the button
Seat 1: 71e00d83 ($9.86 in chips)
Seat 2: 99af2b58 ($11.73 in chips)
Seat 3: 4c8dd192 ($9.8 in chips)
Seat 4: af9df96 ($5.49 in chips)
Seat 5: Hero ($5.49 in chips)
Seat 6: 97fe2676 ($9.67 in chips)
99af2b58: posts small blind $0.02
4c8dd192: posts big blind $0.05
*** HOLE CARDS ***
Dealt to 71e00d83 
Dealt to 99af2b58 
Dealt to 4c8dd192 
Dealt to af9df96 
Dealt to Hero [Qc 6c]
Dealt to 97fe2676 
af9df96: raises $0.05 to $0.1
Hero: folds
97fe2676: folds
71e00d83: folds
99af2b58: folds
4c8dd192: folds
Uncalled bet ($0.05) returned to af9df96
*** SHOWDOWN ***
af9df96 collected $0.12 from pot
*** SUMMARY ***
Total pot $0.12 | Rake $0 | Jackpot $0 | Bingo $0 | Fortune $0 | Tax $0
Seat 1: 71e00d83 (button) folded before Flop (didn't bet)
Seat 2: 99af2b58 (small blind) folded before Flop
Seat 3: 4c8dd192 (big blind) folded before Flop
Seat 4: af9df96 collected ($0.12)
Seat 5: Hero folded before Flop (didn't bet)
Seat 6: 97fe2676 folded before Flop (didn't bet)


Poker Hand #RC3334369260: Hold'em No Limit ($0.02/$0.05) - 2025/02/17 20:13:31
Table 'RushAndCash594520' 6-max Seat #1 is the button
Seat 1: ea485a4d ($6.11 in chips)
Seat 2: 8f8d8059 ($14.36 in chips)
Seat 3: 55d86a7e ($11.13 in chips)
Seat 4: Hero ($5.49 in chips)
Seat 5: 856cc88a ($4.69 in chips)
Seat 6: 5bf5cd50 ($5.07 in chips)
8f8d8059: posts small blind $0.02
55d86a7e: posts big blind $0.05
*** HOLE CARDS ***
Dealt to ea485a4d 
Dealt to 8f8d8059 
Dealt to 55d86a7e 
Dealt to Hero [4s Tc]
Dealt to 856cc88a 
Dealt to 5bf5cd50 
Hero: folds
856cc88a: calls $0.05
5bf5cd50: raises $0.1 to $0.15
ea485a4d: folds
8f8d8059: folds
55d86a7e: calls $0.1
856cc88a: calls $0.1
*** FLOP *** [8d 7s 9c]
55d86a7e: checks
856cc88a: checks
5bf5cd50: checks
*** TURN *** [8d 7s 9c] [2c]
55d86a7e: checks
856cc88a: checks
5bf5cd50: checks
*** RIVER *** [8d 7s 9c 2c] [9h]
55d86a7e: checks
856cc88a: checks
5bf5cd50: checks
55d86a7e: shows [5s Ts] (Pair of Nines)
856cc88a: shows [Qc Ad] (Pair of Nines)
5bf5cd50: shows [Kc Jd] (Pair of Nines)
*** SHOWDOWN ***
856cc88a collected $0.45 from pot
*** SUMMARY ***
Total pot $0.47 | Rake $0.02 | Jackpot $0 | Bingo $0 | Fortune $0 | Tax $0
Board [8d 7s 9c 2c 9h]
Seat 1: ea485a4d (button) folded before Flop (didn't bet)
Seat 2: 8f8d8059 (small blind) folded before Flop
Seat 3: 55d86a7e (big blind) showed [5s Ts] and lost with Pair of Nines
Seat 4: Hero folded before Flop (didn't bet)
Seat 5: 856cc88a showed [Qc Ad] and won ($0.45) with Pair of Nines
Seat 6: 5bf5cd50 showed [Kc Jd] and lost with Pair of Nines


Poker Hand #RC3334369111: Hold'em No Limit ($0.02/$0.05) - 2025/02/17 20:13:07
Table 'RushAndCash594371' 6-max Seat #1 is the button
Seat 1: f171b990 ($5 in chips)
Seat 2: 95fac4b9 ($10.26 in chips)
Seat 3: f93eeed5 ($6.67 in chips)
Seat 4: 2c0804e1 ($8.34 in chips)
Seat 5: Hero ($5.42 in chips)
Seat 6: b7bd1225 ($5.56 in chips)
95fac4b9: posts small blind $0.02
f93eeed5: posts big blind $0.05
*** HOLE CARDS ***
Dealt to f171b990 
Dealt to 95fac4b9 
Dealt to f93eeed5 
Dealt to 2c0804e1 
Dealt to Hero [Ah Ad]
Dealt to b7bd1225 
2c0804e1: folds
Hero: raises $0.05 to $0.1
b7bd1225: folds
f171b990: folds
95fac4b9: folds
f93eeed5: folds
Uncalled bet ($0.05) returned to Hero
*** SHOWDOWN ***
Hero collected $0.12 from pot
*** SUMMARY ***
Total pot $0.12 | Rake $0 | Jackpot $0 | Bingo $0 | Fortune $0 | Tax $0
Seat 1: f171b990 (button) folded before Flop (didn't bet)
Seat 2: 95fac4b9 (small blind) folded before Flop
Seat 3: f93eeed5 (big blind) folded before Flop
Seat 4: 2c0804e1 folded before Flop (didn't bet)
Seat 5: Hero collected ($0.12)
Seat 6: b7bd1225 folded before Flop (didn't bet)


Poker Hand #RC3334369047: Hold'em No Limit ($0.02/$0.05) - 2025/02/17 20:12:58
Table 'RushAndCash594307' 6-max Seat #1 is the button
Seat 1: b9ba5363 ($7.49 in chips)
Seat 2: Hero ($5.44 in chips)
Seat 3: 18af90c ($10.47 in chips)
Seat 4: 9ccadbb5 ($12.75 in chips)
Seat 5: 37558bf9 ($5 in chips)
Seat 6: 1bf2a40e ($5.09 in chips)
Hero: posts small blind $0.02
18af90c: posts big blind $0.05
*** HOLE CARDS ***
Dealt to b9ba5363 
Dealt to Hero [8s 4s]
Dealt to 18af90c 
Dealt to 9ccadbb5 
Dealt to 37558bf9 
Dealt to 1bf2a40e 
9ccadbb5: folds
37558bf9: raises $0.05 to $0.1
1bf2a40e: calls $0.1
b9ba5363: folds
Hero: folds
18af90c: folds
*** FLOP *** [6s Jh Jd]
37558bf9: bets $0.09
1bf2a40e: calls $0.09
*** TURN *** [6s Jh Jd] [5c]
37558bf9: bets $0.15
1bf2a40e: calls $0.15
*** RIVER *** [6s Jh Jd 5c] [2c]
37558bf9: checks
1bf2a40e: bets $0.57
37558bf9: folds
Uncalled bet ($0.57) returned to 1bf2a40e
*** SHOWDOWN ***
1bf2a40e collected $0.72 from pot
*** SUMMARY ***
Total pot $0.75 | Rake $0.03 | Jackpot $0 | Bingo $0 | Fortune $0 | Tax $0
Board [6s Jh Jd 5c 2c]
Seat 1: b9ba5363 (button) folded before Flop (didn't bet)
Seat 2: Hero (small blind) folded before Flop
Seat 3: 18af90c (big blind) folded before Flop
Seat 4: 9ccadbb5 folded before Flop (didn't bet)
Seat 5: 37558bf9 folded on the River
Seat 6: 1bf2a40e won ($0.72)


Poker Hand #RC3334368853: Hold'em No Limit ($0.02/$0.05) - 2025/02/17 20:12:27
Table 'RushAndCash594113' 6-max Seat #1 is the button
Seat 1: 18af90c ($10.6 in chips)
Seat 2: 936e1bce ($5.06 in chips)
Seat 3: Hero ($5.3 in chips)
Seat 4: 6ad9ee5e ($6.58 in chips)
Seat 5: 8bb740b8 ($4.92 in chips)
Seat 6: 27baaa05 ($5.09 in chips)
936e1bce: posts small blind $0.02
Hero: posts big blind $0.05
*** HOLE CARDS ***
Dealt to 18af90c 
Dealt to 936e1bce 
Dealt to Hero [8s Ah]
Dealt to 6ad9ee5e 
Dealt to 8bb740b8 
Dealt to 27baaa05 
6ad9ee5e: folds
8bb740b8: folds
27baaa05: folds
18af90c: raises $0.08 to $0.13
936e1bce: folds
Hero: calls $0.08
*** FLOP *** [Ad Th 5s]
Hero: checks
18af90c: checks
*** TURN *** [Ad Th 5s] [6s]
Hero: checks
18af90c: checks
*** RIVER *** [Ad Th 5s 6s] [9c]
Hero: bets $0.14
18af90c: folds
Uncalled bet ($0.14) returned to Hero
*** SHOWDOWN ***
Hero collected $0.27 from pot
*** SUMMARY ***
Total pot $0.28 | Rake $0.01 | Jackpot $0 | Bingo $0 | Fortune $0 | Tax $0
Board [Ad Th 5s 6s 9c]
Seat 1: 18af90c (button) folded on the River
Seat 2: 936e1bce (small blind) folded before Flop
Seat 3: Hero (big blind) won ($0.27)
Seat 4: 6ad9ee5e folded before Flop (didn't bet)
Seat 5: 8bb740b8 folded before Flop (didn't bet)
Seat 6: 27baaa05 folded before Flop (didn't bet)


Poker Hand #RC3334368497: Hold'em No Limit ($0.02/$0.05) - 2025/02/17 20:11:32
Table 'RushAndCash593757' 6-max Seat #1 is the button
Seat 1: Hero ($5 in chips)
Seat 2: a0a16222 ($7.07 in chips)
Seat 3: bddf8e1e ($11.86 in chips)
Seat 4: fb6c4072 ($5.02 in chips)
Seat 5: 1bf2a40e ($5.23 in chips)
Seat 6: 28e11496 ($10 in chips)
a0a16222: posts small blind $0.02
bddf8e1e: posts big blind $0.05
*** HOLE CARDS ***
Dealt to Hero [5h 5s]
Dealt to a0a16222 
Dealt to bddf8e1e 
Dealt to fb6c4072 
Dealt to 1bf2a40e 
Dealt to 28e11496 
fb6c4072: raises $0.08 to $0.13
1bf2a40e: folds
28e11496: folds
Hero: calls $0.13
a0a16222: folds
bddf8e1e: folds
*** FLOP *** [6d Qh 5c]
fb6c4072: checks
Hero: bets $0.12
fb6c4072: calls $0.12
*** TURN *** [6d Qh 5c] [Jc]
fb6c4072: checks
Hero: checks
*** RIVER *** [6d Qh 5c Jc] [8c]
fb6c4072: checks
Hero: bets $0.3
fb6c4072: folds
Uncalled bet ($0.3) returned to Hero
*** SHOWDOWN ***
Hero collected $0.55 from pot
*** SUMMARY ***
Total pot $0.57 | Rake $0.02 | Jackpot $0 | Bingo $0 | Fortune $0 | Tax $0
Board [6d Qh 5c Jc 8c]
Seat 1: Hero (button) won ($0.55)
Seat 2: a0a16222 (small blind) folded before Flop
Seat 3: bddf8e1e (big blind) folded before Flop
Seat 4: fb6c4072 folded on the River
Seat 5: 1bf2a40e folded before Flop (didn't bet)
Seat 6: 28e11496 folded before Flop (didn't bet)


Poker Hand #RC3334368457: Hold'em No Limit ($0.02/$0.05) - 2025/02/17 20:11:27
Table 'RushAndCash593717' 6-max Seat #1 is the button
Seat 1: 3b8ae104 ($5.07 in chips)
Seat 2: 9885e0a0 ($6.01 in chips)
Seat 3: 3cc4755 ($5.24 in chips)
Seat 4: 945593bf ($8.65 in chips)
Seat 5: 89025632 ($4.39 in chips)
Seat 6: Hero ($5 in chips)
9885e0a0: posts small blind $0.02
3cc4755: posts big blind $0.05
*** HOLE CARDS ***
Dealt to 3b8ae104 
Dealt to 9885e0a0 
Dealt to 3cc4755 
Dealt to 945593bf 
Dealt to 89025632 
Dealt to Hero [9c Kc]
945593bf: folds
89025632: raises $0.05 to $0.1
Hero: folds
3b8ae104: calls $0.1
9885e0a0: folds
3cc4755: calls $0.05
*** FLOP *** [Ad Kd Jd]
3cc4755: checks
89025632: checks
3b8ae104: checks
*** TURN *** [Ad Kd Jd] [Ah]
3cc4755: checks
89025632: bets $0.18
3b8ae104: folds
3cc4755: folds
Uncalled bet ($0.18) returned to 89025632
*** SHOWDOWN ***
89025632 collected $0.31 from pot
*** SUMMARY ***
Total pot $0.32 | Rake $0.01 | Jackpot $0 | Bingo $0 | Fortune $0 | Tax $0
Board [Ad Kd Jd Ah]
Seat 1: 3b8ae104 (button) folded on the Turn
Seat 2: 9885e0a0 (small blind) folded before Flop
Seat 3: 3cc4755 (big blind) folded on the Turn
Seat 4: 945593bf folded before Flop (didn't bet)
Seat 5: 89025632 won ($0.31)
Seat 6: Hero folded before Flop (didn't bet)


Poker Hand #RC3334368432: Hold'em No Limit ($0.02/$0.05) - 2025/02/17 20:11:23
Table 'RushAndCash593692' 6-max Seat #1 is the button
Seat 1: 9c9041e6 ($5 in chips)
Seat 2: ab9f01cc ($9.65 in chips)
Seat 3: 856cc88a ($4.88 in chips)
Seat 4: Hero ($5 in chips)
Seat 5: a22f05f1 ($5.68 in chips)
Seat 6: f553bfb4 ($5.76 in chips)
ab9f01cc: posts small blind $0.02
856cc88a: posts big blind $0.05
*** HOLE CARDS ***
Dealt to 9c9041e6 
Dealt to ab9f01cc 
Dealt to 856cc88a 
Dealt to Hero [4h Qh]
Dealt to a22f05f1 
Dealt to f553bfb4 
Hero: folds
a22f05f1: folds
f553bfb4: raises $0.08 to $0.13
9c9041e6: raises $2.72 to $2.85
ab9f01cc: folds
856cc88a: folds
f553bfb4: raises $2.91 to $5.76 and is all-in
9c9041e6: calls $2.15 and is all-in
Uncalled bet ($0.76) returned to f553bfb4
f553bfb4: shows [Kh Ks]
9c9041e6: shows [Ac Ad]
*** FLOP *** [Qc 9c 6d]
*** TURN *** [Qc 9c 6d] [4c]
*** RIVER *** [Qc 9c 6d 4c] [7d]
*** SHOWDOWN ***
9c9041e6 collected $9.85 from pot
*** SUMMARY ***
Total pot $10.07 | Rake $0.15 | Jackpot $0.07 | Bingo $0 | Fortune $0 | Tax $0
Board [Qc 9c 6d 4c 7d]
Seat 1: 9c9041e6 (button) showed [Ac Ad] and won ($9.85) with Pair of Aces
Seat 2: ab9f01cc (small blind) folded before Flop
Seat 3: 856cc88a (big blind) folded before Flop
Seat 4: Hero folded before Flop (didn't bet)
Seat 5: a22f05f1 folded before Flop (didn't bet)
Seat 6: f553bfb4 showed [Kh Ks] and lost with Pair of Kings


Poker Hand #RC3334368409: Hold'em No Limit ($0.02/$0.05) - 2025/02/17 20:11:20
Table 'RushAndCash593669' 6-max Seat #1 is the button
Seat 1: f3f5406e ($14.05 in chips)
Seat 2: Hero ($5 in chips)
Seat 3: c62b7a0b ($20.56 in chips)
Seat 4: 42140536 ($3.46 in chips)
Seat 5: c9ea832 ($6.63 in chips)
Seat 6: f0d238ad ($7.17 in chips)
Hero: posts small blind $0.02
c62b7a0b: posts big blind $0.05
*** HOLE CARDS ***
Dealt to f3f5406e 
Dealt to Hero [Kd 2d]
Dealt to c62b7a0b 
Dealt to 42140536 
Dealt to c9ea832 
Dealt to f0d238ad 
42140536: raises $0.05 to $0.1
c9ea832: folds
f0d238ad: folds
f3f5406e: folds
Hero: folds
c62b7a0b: calls $0.05
*** FLOP *** [9d 5d 3h]
c62b7a0b: checks
42140536: checks
*** TURN *** [9d 5d 3h] [2s]
c62b7a0b: checks
42140536: checks
*** RIVER *** [9d 5d 3h 2s] [Jh]
c62b7a0b: checks
42140536: bets $0.1
c62b7a0b: folds
Uncalled bet ($0.1) returned to 42140536
*** SHOWDOWN ***
42140536 collected $0.21 from pot
*** SUMMARY ***
Total pot $0.22 | Rake $0.01 | Jackpot $0 | Bingo $0 | Fortune $0 | Tax $0
Board [9d 5d 3h 2s Jh]
Seat 1: f3f5406e (button) folded before Flop (didn't bet)
Seat 2: Hero (small blind) folded before Flop
Seat 3: c62b7a0b (big blind) folded on the River
Seat 4: 42140536 won ($0.21)
Seat 5: c9ea832 folded before Flop (didn't bet)
Seat 6: f0d238ad folded before Flop (didn't bet)


Poker Hand #RC3334368375: Hold'em No Limit ($0.02/$0.05) - 2025/02/17 20:11:15
Table 'RushAndCash593635' 6-max Seat #1 is the button
Seat 1: f4c45632 ($10.36 in chips)
Seat 2: 6b62a9a6 ($5 in chips)
Seat 3: f3f5406e ($14.1 in chips)
Seat 4: cf7f09c2 ($5 in chips)
Seat 5: Hero ($5 in chips)
Seat 6: 6dcd0788 ($5.05 in chips)
6b62a9a6: posts small blind $0.02
f3f5406e: posts big blind $0.05
*** HOLE CARDS ***
Dealt to f4c45632 
Dealt to 6b62a9a6 
Dealt to f3f5406e 
Dealt to cf7f09c2 
Dealt to Hero [Qs Td]
Dealt to 6dcd0788 
cf7f09c2: folds
Hero: folds
6dcd0788: folds
f4c45632: folds
6b62a9a6: raises $0.07 to $0.12
f3f5406e: folds
Uncalled bet ($0.07) returned to 6b62a9a6
*** SHOWDOWN ***
6b62a9a6 collected $0.1 from pot
*** SUMMARY ***
Total pot $0.1 | Rake $0 | Jackpot $0 | Bingo $0 | Fortune $0 | Tax $0
Seat 1: f4c45632 (button) folded before Flop (didn't bet)
Seat 2: 6b62a9a6 (small blind) collected ($0.1)
Seat 3: f3f5406e (big blind) folded before Flop
Seat 4: cf7f09c2 folded before Flop (didn't bet)
Seat 5: Hero folded before Flop (didn't bet)
Seat 6: 6dcd0788 folded before Flop (didn't bet)


Poker Hand #RC3334368352: Hold'em No Limit ($0.02/$0.05) - 2025/02/17 20:11:11
Table 'RushAndCash593612' 6-max Seat #1 is the button
Seat 1: 1b085d29 ($5.29 in chips)
Seat 2: f4988477 ($9.62 in chips)
Seat 3: Hero ($5 in chips)
Seat 4: cf7f09c2 ($5 in chips)
Seat 5: 9a3fefc8 ($6.15 in chips)
Seat 6: 441bc86c ($5 in chips)
f4988477: posts small blind $0.02
Hero: posts big blind $0.05
*** HOLE CARDS ***
Dealt to 1b085d29 
Dealt to f4988477 
Dealt to Hero [4s 2h]
Dealt to cf7f09c2 
Dealt to 9a3fefc8 
Dealt to 441bc86c 
cf7f09c2: folds
9a3fefc8: raises $0.05 to $0.1
441bc86c: folds
1b085d29: folds
f4988477: calls $0.08
Hero: folds
*** FLOP *** [9h 3d 8d]
f4988477: checks
9a3fefc8: checks
*** TURN *** [9h 3d 8d] [4c]
f4988477: bets $0.13
9a3fefc8: folds
Uncalled bet ($0.13) returned to f4988477
*** SHOWDOWN ***
f4988477 collected $0.24 from pot
*** SUMMARY ***
Total pot $0.25 | Rake $0.01 | Jackpot $0 | Bingo $0 | Fortune $0 | Tax $0
Board [9h 3d 8d 4c]
Seat 1: 1b085d29 (button) folded before Flop (didn't bet)
Seat 2: f4988477 (small blind) won ($0.24)
Seat 3: Hero (big blind) folded before Flop
Seat 4: cf7f09c2 folded before Flop (didn't bet)
Seat 5: 9a3fefc8 folded on the Turn
Seat 6: 441bc86c folded before Flop (didn't bet)


Poker Hand #RC3334368254: Hold'em No Limit ($0.02/$0.05) - 2025/02/17 20:10:57
Table 'RushAndCash593514' 6-max Seat #1 is the button
Seat 1: Hero ($5 in chips)
Seat 2: 3469fa26 ($2.38 in chips)
Seat 3: 7af747dc ($7.21 in chips)
Seat 4: 6ad9ee5e ($6.47 in chips)
Seat 5: 35fb946f ($4.95 in chips)
Seat 6: 63499226 ($3.71 in chips)
3469fa26: posts small blind $0.02
7af747dc: posts big blind $0.05
*** HOLE CARDS ***
Dealt to Hero [Qs Jd]
Dealt to 3469fa26 
Dealt to 7af747dc 
Dealt to 6ad9ee5e 
Dealt to 35fb946f 
Dealt to 63499226 
6ad9ee5e: folds
35fb946f: folds
63499226: folds
Hero: raises $0.05 to $0.1
3469fa26: calls $0.08
7af747dc: raises $0.35 to $0.45
Hero: folds
3469fa26: calls $0.35
*** FLOP *** [7d 3c Qc]
3469fa26: checks
7af747dc: bets $0.38
3469fa26: calls $0.38
*** TURN *** [7d 3c Qc] [Ac]
3469fa26: checks
7af747dc: bets $0.59
3469fa26: raises $0.96 to $1.55 and is all-in
7af747dc: calls $0.96
3469fa26: shows [7h 8d] (Pair of Sevens)
7af747dc: shows [Ks Ah] (Pair of Aces)
*** RIVER *** [7d 3c Qc Ac] [4h]
*** SHOWDOWN ***
7af747dc collected $4.54 from pot
*** SUMMARY ***
Total pot $4.86 | Rake $0.25 | Jackpot $0.07 | Bingo $0 | Fortune $0 | Tax $0
Board [7d 3c Qc Ac 4h]
Seat 1: Hero (button) folded before Flop
Seat 2: 3469fa26 (small blind) showed [7h 8d] and lost with Pair of Sevens
Seat 3: 7af747dc (big blind) showed [Ks Ah] and won ($4.54) with Pair of Aces
Seat 4: 6ad9ee5e folded before Flop (didn't bet)
Seat 5: 35fb946f folded before Flop (didn't bet)
Seat 6: 63499226 folded before Flop (didn't bet)


Poker Hand #RC3334368230: Hold'em No Limit ($0.02/$0.05) - 2025/02/17 20:10:54
Table 'RushAndCash593490' 6-max Seat #1 is the button
Seat 1: 9438ae8e ($19.06 in chips)
Seat 2: 4190d158 ($5.02 in chips)
Seat 3: 30c2b6c7 ($5.26 in chips)
Seat 4: ac1a641a ($5.29 in chips)
Seat 5: Hero ($5 in chips)
Seat 6: fc8b0177 ($8.32 in chips)
4190d158: posts small blind $0.02
30c2b6c7: posts big blind $0.05
*** HOLE CARDS ***
Dealt to 9438ae8e 
Dealt to 4190d158 
Dealt to 30c2b6c7 
Dealt to ac1a641a 
Dealt to Hero [Js 6d]
Dealt to fc8b0177 
ac1a641a: folds
Hero: folds
fc8b0177: folds
9438ae8e: raises $0.08 to $0.13
4190d158: folds
30c2b6c7: folds
Uncalled bet ($0.08) returned to 9438ae8e
*** SHOWDOWN ***
9438ae8e collected $0.12 from pot
*** SUMMARY ***
Total pot $0.12 | Rake $0 | Jackpot $0 | Bingo $0 | Fortune $0 | Tax $0
Seat 1: 9438ae8e (button) collected ($0.12)
Seat 2: 4190d158 (small blind) folded before Flop
Seat 3: 30c2b6c7 (big blind) folded before Flop
Seat 4: ac1a641a folded before Flop (didn't bet)
Seat 5: Hero folded before Flop (didn't bet)
Seat 6: fc8b0177 folded before Flop (didn't bet)


Poker Hand #RC3334368207: Hold'em No Limit ($0.02/$0.05) - 2025/02/17 20:10:50
Table 'RushAndCash593467' 6-max Seat #1 is the button
Seat 1: 7b286ce1 ($5 in chips)
Seat 2: 37558bf9 ($5 in chips)
Seat 3: a1e98d09 ($1.38 in chips)
Seat 4: 742ccfee ($2.57 in chips)
Seat 5: Hero ($5 in chips)
Seat 6: d58b99ca ($9.82 in chips)
37558bf9: posts small blind $0.02
a1e98d09: posts big blind $0.05
*** HOLE CARDS ***
Dealt to 7b286ce1 
Dealt to 37558bf9 
Dealt to a1e98d09 
Dealt to 742ccfee 
Dealt to Hero [8s Jd]
Dealt to d58b99ca 
742ccfee: raises $0.05 to $0.1
Hero: folds
d58b99ca: raises $0.28 to $0.38
7b286ce1: folds
37558bf9: folds
a1e98d09: calls $0.33
742ccfee: folds
*** FLOP *** [9h Qc 3c]
a1e98d09: checks
d58b99ca: checks
*** TURN *** [9h Qc 3c] [5d]
a1e98d09: checks
d58b99ca: bets $0.3
a1e98d09: folds
Uncalled bet ($0.3) returned to d58b99ca
*** SHOWDOWN ***
d58b99ca collected $0.84 from pot
*** SUMMARY ***
Total pot $0.88 | Rake $0.04 | Jackpot $0 | Bingo $0 | Fortune $0 | Tax $0
Board [9h Qc 3c 5d]
Seat 1: 7b286ce1 (button) folded before Flop (didn't bet)
Seat 2: 37558bf9 (small blind) folded before Flop
Seat 3: a1e98d09 (big blind) folded on the Turn
Seat 4: 742ccfee folded before Flop
Seat 5: Hero folded before Flop (didn't bet)
Seat 6: d58b99ca won ($0.84)


Poker Hand #RC3334368184: Hold'em No Limit ($0.02/$0.05) - 2025/02/17 20:10:47
Table 'RushAndCash593444' 6-max Seat #1 is the button
Seat 1: Hero ($5 in chips)
Seat 2: 8ec32764 ($5.42 in chips)
Seat 3: 42140536 ($3.37 in chips)
Seat 4: 55d86a7e ($11.6 in chips)
Seat 5: 742ccfee ($2.57 in chips)
Seat 6: 90b5d23c ($5.21 in chips)
8ec32764: posts small blind $0.02
42140536: posts big blind $0.05
*** HOLE CARDS ***
Dealt to Hero [Ah 8d]
Dealt to 8ec32764 
Dealt to 42140536 
Dealt to 55d86a7e 
Dealt to 742ccfee 
Dealt to 90b5d23c 
55d86a7e: folds
742ccfee: folds
90b5d23c: folds
Hero: folds
8ec32764: raises $0.07 to $0.12
42140536: calls $0.07
*** FLOP *** [2c 9c Kd]
8ec32764: checks
42140536: bets $0.1
8ec32764: folds
Uncalled bet ($0.1) returned to 42140536
*** SHOWDOWN ***
42140536 collected $0.23 from pot
*** SUMMARY ***
Total pot $0.24 | Rake $0.01 | Jackpot $0 | Bingo $0 | Fortune $0 | Tax $0
Board [2c 9c Kd]
Seat 1: Hero (button) folded before Flop (didn't bet)
Seat 2: 8ec32764 (small blind) folded on the Flop
Seat 3: 42140536 (big blind) won ($0.23)
Seat 4: 55d86a7e folded before Flop (didn't bet)
Seat 5: 742ccfee folded before Flop (didn't bet)
Seat 6: 90b5d23c folded before Flop (didn't bet)


Poker Hand #RC3334368160: Hold'em No Limit ($0.02/$0.05) - 2025/02/17 20:10:43
Table 'RushAndCash593420' 6-max Seat #1 is the button
Seat 1: 2136c68 ($5 in chips)
Seat 2: Hero ($5.02 in chips)
Seat 3: 9013f95e ($11.04 in chips)
Seat 4: 1063406 ($5.34 in chips)
Seat 5: 3b2a8270 ($13.69 in chips)
Seat 6: 436ecab0 ($4.59 in chips)
Hero: posts small blind $0.02
9013f95e: posts big blind $0.05
*** HOLE CARDS ***
Dealt to 2136c68 
Dealt to Hero [4d 8c]
Dealt to 9013f95e 
Dealt to 1063406 
Dealt to 3b2a8270 
Dealt to 436ecab0 
1063406: folds
3b2a8270: folds
436ecab0: folds
2136c68: raises $0.05 to $0.1
Hero: folds
9013f95e: calls $0.05
*** FLOP *** [Th 5h 7c]
9013f95e: checks
2136c68: checks
*** TURN *** [Th 5h 7c] [3h]
9013f95e: checks
2136c68: bets $0.14
9013f95e: calls $0.14
*** RIVER *** [Th 5h 7c 3h] [5c]
9013f95e: checks
2136c68: checks
9013f95e: shows [8h 8d] (Pair of Eights and Pair of Fives)
2136c68: shows [9h Ad] (Pair of Fives)
*** SHOWDOWN ***
9013f95e collected $0.48 from pot
*** SUMMARY ***
Total pot $0.5 | Rake $0.02 | Jackpot $0 | Bingo $0 | Fortune $0 | Tax $0
Board [Th 5h 7c 3h 5c]
Seat 1: 2136c68 (button) showed [9h Ad] and lost with Pair of Fives
Seat 2: Hero (small blind) folded before Flop
Seat 3: 9013f95e (big blind) showed [8h 8d] and won ($0.48) with Pair of Eights and Pair of Fives
Seat 4: 1063406 folded before Flop (didn't bet)
Seat 5: 3b2a8270 folded before Flop (didn't bet)
Seat 6: 436ecab0 folded before Flop (didn't bet)


Poker Hand #RC3334368049: Hold'em No Limit ($0.02/$0.05) - 2025/02/17 20:10:26
Table 'RushAndCash593309' 6-max Seat #1 is the button
Seat 1: 82010c93 ($4.93 in chips)
Seat 2: 436ecab0 ($4.61 in chips)
Seat 3: Hero ($5.07 in chips)
Seat 4: 18767060 ($13.49 in chips)
Seat 5: b0ee20aa ($14.01 in chips)
Seat 6: 2a494316 ($5.8 in chips)
436ecab0: posts small blind $0.02
Hero: posts big blind $0.05
*** HOLE CARDS ***
Dealt to 82010c93 
Dealt to 436ecab0 
Dealt to Hero [6c Kd]
Dealt to 18767060 
Dealt to b0ee20aa 
Dealt to 2a494316 
18767060: folds
b0ee20aa: raises $0.08 to $0.13
2a494316: folds
82010c93: folds
436ecab0: folds
Hero: folds
Uncalled bet ($0.08) returned to b0ee20aa
*** SHOWDOWN ***
b0ee20aa collected $0.12 from pot
*** SUMMARY ***
Total pot $0.12 | Rake $0 | Jackpot $0 | Bingo $0 | Fortune $0 | Tax $0
Seat 1: 82010c93 (button) folded before Flop (didn't bet)
Seat 2: 436ecab0 (small blind) folded before Flop
Seat 3: Hero (big blind) folded before Flop
Seat 4: 18767060 folded before Flop (didn't bet)
Seat 5: b0ee20aa collected ($0.12)
Seat 6: 2a494316 folded before Flop (didn't bet)


Poker Hand #RC3334367971: Hold'em No Limit ($0.02/$0.05) - 2025/02/17 20:10:14
Table 'RushAndCash593231' 6-max Seat #1 is the button
Seat 1: b50c086 ($5.04 in chips)
Seat 2: 6b62a9a6 ($5 in chips)
Seat 3: 6c122cb5 ($5 in chips)
Seat 4: 87d9de00 ($4.71 in chips)
Seat 5: Hero ($5 in chips)
Seat 6: 6ad9ee5e ($6.54 in chips)
6b62a9a6: posts small blind $0.02
6c122cb5: posts big blind $0.05
*** HOLE CARDS ***
Dealt to b50c086 
Dealt to 6b62a9a6 
Dealt to 6c122cb5 
Dealt to 87d9de00 
Dealt to Hero [7d 7s]
Dealt to 6ad9ee5e 
87d9de00: folds
Hero: raises $0.05 to $0.1
6ad9ee5e: folds
b50c086: folds
6b62a9a6: folds
6c122cb5: folds
Uncalled bet ($0.05) returned to Hero
*** SHOWDOWN ***
Hero collected $0.12 from pot
*** SUMMARY ***
Total pot $0.12 | Rake $0 | Jackpot $0 | Bingo $0 | Fortune $0 | Tax $0
Seat 1: b50c086 (button) folded before Flop (didn't bet)
Seat 2: 6b62a9a6 (small blind) folded before Flop
Seat 3: 6c122cb5 (big blind) folded before Flop
Seat 4: 87d9de00 folded before Flop (didn't bet)
Seat 5: Hero collected ($0.12)
Seat 6: 6ad9ee5e folded before Flop (didn't bet)


Poker Hand #RC3334367647: Hold'em No Limit ($0.02/$0.05) - 2025/02/17 20:09:24
Table 'RushAndCash592907' 6-max Seat #1 is the button
Seat 1: 936e1bce ($5.11 in chips)
Seat 2: 7f832000 ($5.02 in chips)
Seat 3: 7a5bf293 ($5.07 in chips)
Seat 4: 63ec769d ($1.67 in chips)
Seat 5: Hero ($5 in chips)
Seat 6: 6f96f8db ($4.87 in chips)
7f832000: posts small blind $0.02
7a5bf293: posts big blind $0.05
*** HOLE CARDS ***
Dealt to 936e1bce 
Dealt to 7f832000 
Dealt to 7a5bf293 
Dealt to 63ec769d 
Dealt to Hero [Th Ac]
Dealt to 6f96f8db 
63ec769d: folds
Hero: raises $0.05 to $0.1
6f96f8db: folds
936e1bce: folds
7f832000: folds
7a5bf293: calls $0.05
*** FLOP *** [Jh Tc 6d]
7a5bf293: checks
Hero: checks
*** TURN *** [Jh Tc 6d] [5c]
7a5bf293: checks
Hero: bets $0.12
7a5bf293: calls $0.12
*** RIVER *** [Jh Tc 6d 5c] [Js]
7a5bf293: checks
Hero: bets $0.24
7a5bf293: calls $0.24
Hero: shows [Th Ac] (Pair of Jacks and Pair of Tens)
7a5bf293: shows [Ts As] (Pair of Jacks and Pair of Tens)
*** SHOWDOWN ***
7a5bf293 collected $0.45 from pot
Hero collected $0.45 from pot
*** SUMMARY ***
Total pot $0.94 | Rake $0.04 | Jackpot $0 | Bingo $0 | Fortune $0 | Tax $0
Board [Jh Tc 6d 5c Js]
Seat 1: 936e1bce (button) folded before Flop (didn't bet)
Seat 2: 7f832000 (small blind) folded before Flop
Seat 3: 7a5bf293 (big blind) showed [Ts As] and won ($0.45) with Pair of Jacks and Pair of Tens
Seat 4: 63ec769d folded before Flop (didn't bet)
Seat 5: Hero showed [Th Ac] and won ($0.45) with Pair of Jacks and Pair of Tens
Seat 6: 6f96f8db folded before Flop (didn't bet)


Poker Hand #RC3334367544: Hold'em No Limit ($0.02/$0.05) - 2025/02/17 20:09:06
Table 'RushAndCash592804' 6-max Seat #1 is the button
Seat 1: Hero ($5 in chips)
Seat 2: 5871193e ($5 in chips)
Seat 3: 50bd9a93 ($5.35 in chips)
Seat 4: c7e9103c ($20.25 in chips)
Seat 5: a31061c ($2.71 in chips)
Seat 6: ccddedff ($14.14 in chips)
5871193e: posts small blind $0.02
50bd9a93: posts big blind $0.05
*** HOLE CARDS ***
Dealt to Hero [4h Ad]
Dealt to 5871193e 
Dealt to 50bd9a93 
Dealt to c7e9103c 
Dealt to a31061c 
Dealt to ccddedff 
c7e9103c: folds
a31061c: folds
ccddedff: folds
Hero: folds
5871193e: raises $0.1 to $0.15
50bd9a93: folds
Uncalled bet ($0.1) returned to 5871193e
*** SHOWDOWN ***
5871193e collected $0.1 from pot
*** SUMMARY ***
Total pot $0.1 | Rake $0 | Jackpot $0 | Bingo $0 | Fortune $0 | Tax $0
Seat 1: Hero (button) folded before Flop (didn't bet)
Seat 2: 5871193e (small blind) collected ($0.1)
Seat 3: 50bd9a93 (big blind) folded before Flop
Seat 4: c7e9103c folded before Flop (didn't bet)
Seat 5: a31061c folded before Flop (didn't bet)
Seat 6: ccddedff folded before Flop (didn't bet)


Poker Hand #RC3334367499: Hold'em No Limit ($0.02/$0.05) - 2025/02/17 20:09:00
Table 'RushAndCash592759' 6-max Seat #1 is the button
Seat 1: b0d0d63c ($5 in chips)
Seat 2: 933857a6 ($5.27 in chips)
Seat 3: f0deee96 ($3.77 in chips)
Seat 4: b66d20fa ($15.38 in chips)
Seat 5: dbf5f543 ($9.01 in chips)
Seat 6: Hero ($5 in chips)
933857a6: posts small blind $0.02
f0deee96: posts big blind $0.05
*** HOLE CARDS ***
Dealt to b0d0d63c 
Dealt to 933857a6 
Dealt to f0deee96 
Dealt to b66d20fa 
Dealt to dbf5f543 
Dealt to Hero [6d 8s]
b66d20fa: folds
dbf5f543: folds
Hero: folds
b0d0d63c: raises $0.07 to $0.12
933857a6: folds
f0deee96: calls $0.07
*** FLOP *** [As 7c 9c]
f0deee96: checks
b0d0d63c: checks
*** TURN *** [As 7c 9c] [9d]
f0deee96: checks
b0d0d63c: bets $0.09
f0deee96: calls $0.09
*** RIVER *** [As 7c 9c 9d] [9h]
f0deee96: checks
b0d0d63c: checks
f0deee96: shows [8c 8d] (Nines Full over Eights)
b0d0d63c: shows [3d Js] (Three Nines)
*** SHOWDOWN ***
f0deee96 collected $0.42 from pot
*** SUMMARY ***
Total pot $0.44 | Rake $0.02 | Jackpot $0 | Bingo $0 | Fortune $0 | Tax $0
Board [As 7c 9c 9d 9h]
Seat 1: b0d0d63c (button) showed [3d Js] and lost with Three Nines
Seat 2: 933857a6 (small blind) folded before Flop
Seat 3: f0deee96 (big blind) showed [8c 8d] and won ($0.42) with Nines Full over Eights
Seat 4: b66d20fa folded before Flop (didn't bet)
Seat 5: dbf5f543 folded before Flop (didn't bet)
Seat 6: Hero folded before Flop (didn't bet)


Poker Hand #RC3334367348: Hold'em No Limit ($0.02/$0.05) - 2025/02/17 20:08:37
Table 'RushAndCash592608' 6-max Seat #1 is the button
Seat 1: 5fe62400 ($6.38 in chips)
Seat 2: 16081ce9 ($10.66 in chips)
Seat 3: Hero ($5 in chips)
Seat 4: 936e1bce ($5 in chips)
Seat 5: f110529a ($10.14 in chips)
Seat 6: cff3c4c8 ($2.55 in chips)
16081ce9: posts small blind $0.02
Hero: posts big blind $0.05
*** HOLE CARDS ***
Dealt to 5fe62400 
Dealt to 16081ce9 
Dealt to Hero [4s As]
Dealt to 936e1bce 
Dealt to f110529a 
Dealt to cff3c4c8 
936e1bce: raises $0.05 to $0.1
f110529a: folds
cff3c4c8: folds
5fe62400: folds
16081ce9: folds
Hero: calls $0.05
*** FLOP *** [Jh 4h 5h]
Hero: checks
936e1bce: bets $0.17
Hero: folds
Uncalled bet ($0.17) returned to 936e1bce
*** SHOWDOWN ***
936e1bce collected $0.21 from pot
*** SUMMARY ***
Total pot $0.22 | Rake $0.01 | Jackpot $0 | Bingo $0 | Fortune $0 | Tax $0
Board [Jh 4h 5h]
Seat 1: 5fe62400 (button) folded before Flop (didn't bet)
Seat 2: 16081ce9 (small blind) folded before Flop
Seat 3: Hero (big blind) folded on the Flop
Seat 4: 936e1bce won ($0.21)
Seat 5: f110529a folded before Flop (didn't bet)
Seat 6: cff3c4c8 folded before Flop (didn't bet)


Poker Hand #RC3334367320: Hold'em No Limit ($0.02/$0.05) - 2025/02/17 20:08:33
Table 'RushAndCash592580' 6-max Seat #1 is the button
Seat 1: 84aea2bd ($6.85 in chips)
Seat 2: Hero ($5 in chips)
Seat 3: b0d0d63c ($5 in chips)
Seat 4: 5f1cdd27 ($5.02 in chips)
Seat 5: fb6c4072 ($5 in chips)
Seat 6: 9f008576 ($3.93 in chips)
Hero: posts small blind $0.02
b0d0d63c: posts big blind $0.05
*** HOLE CARDS ***
Dealt to 84aea2bd 
Dealt to Hero [Qd 3h]
Dealt to b0d0d63c 
Dealt to 5f1cdd27 
Dealt to fb6c4072 
Dealt to 9f008576 
5f1cdd27: folds
fb6c4072: folds
9f008576: folds
84aea2bd: raises $0.1 to $0.15
Hero: folds
b0d0d63c: folds
Uncalled bet ($0.1) returned to 84aea2bd
*** SHOWDOWN ***
84aea2bd collected $0.12 from pot
*** SUMMARY ***
Total pot $0.12 | Rake $0 | Jackpot $0 | Bingo $0 | Fortune $0 | Tax $0
Seat 1: 84aea2bd (button) collected ($0.12)
Seat 2: Hero (small blind) folded before Flop
Seat 3: b0d0d63c (big blind) folded before Flop
Seat 4: 5f1cdd27 folded before Flop (didn't bet)
Seat 5: fb6c4072 folded before Flop (didn't bet)
Seat 6: 9f008576 folded before Flop (didn't bet)


Poker Hand #RC3334367272: Hold'em No Limit ($0.02/$0.05) - 2025/02/17 20:08:27
Table 'RushAndCash592532' 6-max Seat #1 is the button
Seat 1: 918d412c ($4.74 in chips)
Seat 2: 4e3c3196 ($23.85 in chips)
Seat 3: e80ee414 ($2.18 in chips)
Seat 4: ef82d036 ($22.67 in chips)
Seat 5: Hero ($5 in chips)
Seat 6: 675a7b76 ($6.43 in chips)
4e3c3196: posts small blind $0.02
e80ee414: posts big blind $0.05
*** HOLE CARDS ***
Dealt to 918d412c 
Dealt to 4e3c3196 
Dealt to e80ee414 
Dealt to ef82d036 
Dealt to Hero [7c 4c]
Dealt to 675a7b76 
ef82d036: folds
Hero: folds
675a7b76: raises $0.05 to $0.1
918d412c: folds
4e3c3196: folds
e80ee414: calls $0.05
*** FLOP *** [Ac 8s 2c]
e80ee414: checks
675a7b76: checks
*** TURN *** [Ac 8s 2c] [Ts]
e80ee414: checks
675a7b76: checks
*** RIVER *** [Ac 8s 2c Ts] [7d]
e80ee414: checks
675a7b76: bets $0.17
e80ee414: calls $0.17
675a7b76: shows [6d 9d] (Tens-High Straight)
e80ee414: shows [Td Qc] (Pair of Tens)
*** SHOWDOWN ***
675a7b76 collected $0.54 from pot
*** SUMMARY ***
Total pot $0.56 | Rake $0.02 | Jackpot $0 | Bingo $0 | Fortune $0 | Tax $0
Board [Ac 8s 2c Ts 7d]
Seat 1: 918d412c (button) folded before Flop (didn't bet)
Seat 2: 4e3c3196 (small blind) folded before Flop
Seat 3: e80ee414 (big blind) showed [Td Qc] and lost with Pair of Tens
Seat 4: ef82d036 folded before Flop (didn't bet)
Seat 5: Hero folded before Flop (didn't bet)
Seat 6: 675a7b76 showed [6d 9d] and won ($0.54) with Tens-High Straight


Poker Hand #RC3334367139: Hold'em No Limit ($0.02/$0.05) - 2025/02/17 20:08:05
Table 'RushAndCash592399' 6-max Seat #1 is the button
Seat 1: 94b22b92 ($5 in chips)
Seat 2: cf593991 ($5.63 in chips)
Seat 3: e80ee414 ($2.25 in chips)
Seat 4: 5f1cdd27 ($5 in chips)
Seat 5: 6d2abfa5 ($5.73 in chips)
Seat 6: Hero ($5 in chips)
cf593991: posts small blind $0.02
e80ee414: posts big blind $0.05
*** HOLE CARDS ***
Dealt to 94b22b92 
Dealt to cf593991 
Dealt to e80ee414 
Dealt to 5f1cdd27 
Dealt to 6d2abfa5 
Dealt to Hero [8s Ah]
5f1cdd27: folds
6d2abfa5: folds
Hero: raises $0.05 to $0.1
94b22b92: raises $0.2 to $0.3
cf593991: folds
e80ee414: folds
Hero: folds
Uncalled bet ($0.2) returned to 94b22b92
*** SHOWDOWN ***
94b22b92 collected $0.26 from pot
*** SUMMARY ***
Total pot $0.27 | Rake $0.01 | Jackpot $0 | Bingo $0 | Fortune $0 | Tax $0
Seat 1: 94b22b92 (button) collected ($0.26)
Seat 2: cf593991 (small blind) folded before Flop
Seat 3: e80ee414 (big blind) folded before Flop
Seat 4: 5f1cdd27 folded before Flop (didn't bet)
Seat 5: 6d2abfa5 folded before Flop (didn't bet)
Seat 6: Hero folded before Flop


Poker Hand #RC3334366967: Hold'em No Limit ($0.02/$0.05) - 2025/02/17 20:07:37
Table 'RushAndCash592227' 6-max Seat #1 is the button
Seat 1: 7f832000 ($5 in chips)
Seat 2: 9864109b ($5 in chips)
Seat 3: f4c45632 ($5 in chips)
Seat 4: 7c13e490 ($5.55 in chips)
Seat 5: 742ccfee ($2.6 in chips)
Seat 6: Hero ($5 in chips)
9864109b: posts small blind $0.02
f4c45632: posts big blind $0.05
*** HOLE CARDS ***
Dealt to 7f832000 
Dealt to 9864109b 
Dealt to f4c45632 
Dealt to 7c13e490 
Dealt to 742ccfee 
Dealt to Hero [Tc Qc]
7c13e490: folds
742ccfee: folds
Hero: raises $0.05 to $0.1
7f832000: folds
9864109b: folds
f4c45632: calls $0.05
*** FLOP *** [Td 5d 9c]
f4c45632: checks
Hero: bets $0.08
f4c45632: raises $0.34 to $0.42
Hero: folds
Uncalled bet ($0.34) returned to f4c45632
*** SHOWDOWN ***
f4c45632 collected $0.37 from pot
*** SUMMARY ***
Total pot $0.38 | Rake $0.01 | Jackpot $0 | Bingo $0 | Fortune $0 | Tax $0
Board [Td 5d 9c]
Seat 1: 7f832000 (button) folded before Flop (didn't bet)
Seat 2: 9864109b (small blind) folded before Flop
Seat 3: f4c45632 (big blind) won ($0.37)
Seat 4: 7c13e490 folded before Flop (didn't bet)
Seat 5: 742ccfee folded before Flop (didn't bet)
Seat 6: Hero folded on the Flop


Poker Hand #RC3334366810: Hold'em No Limit ($0.02/$0.05) - 2025/02/17 20:07:12
Table 'RushAndCash592070' 6-max Seat #1 is the button
Seat 1: Hero ($5 in chips)
Seat 2: 735c4afd ($5 in chips)
Seat 3: f5592199 ($5 in chips)
Seat 4: 6a477bbc ($5.22 in chips)
Seat 5: c1e6dd66 ($5.8 in chips)
Seat 6: 1a2d8f33 ($5.16 in chips)
735c4afd: posts small blind $0.02
f5592199: posts big blind $0.05
*** HOLE CARDS ***
Dealt to Hero [6s 5s]
Dealt to 735c4afd 
Dealt to f5592199 
Dealt to 6a477bbc 
Dealt to c1e6dd66 
Dealt to 1a2d8f33 
6a477bbc: folds
c1e6dd66: folds
1a2d8f33: folds
Hero: raises $0.05 to $0.1
735c4afd: folds
f5592199: raises $0.3 to $0.4
Hero: folds
Uncalled bet ($0.3) returned to f5592199
*** SHOWDOWN ***
f5592199 collected $0.21 from pot
*** SUMMARY ***
Total pot $0.22 | Rake $0.01 | Jackpot $0 | Bingo $0 | Fortune $0 | Tax $0
Seat 1: Hero (button) folded before Flop
Seat 2: 735c4afd (small blind) folded before Flop
Seat 3: f5592199 (big blind) collected ($0.21)
Seat 4: 6a477bbc folded before Flop (didn't bet)
Seat 5: c1e6dd66 folded before Flop (didn't bet)
Seat 6: 1a2d8f33 folded before Flop (didn't bet)


Poker Hand #RC3334366788: Hold'em No Limit ($0.02/$0.05) - 2025/02/17 20:07:08
Table 'RushAndCash592048' 6-max Seat #1 is the button
Seat 1: 766a71b7 ($6.77 in chips)
Seat 2: Hero ($5 in chips)
Seat 3: 3c1ddc3a ($5.26 in chips)
Seat 4: bf15fd4d ($3.88 in chips)
Seat 5: 25b4d6e7 ($11.6 in chips)
Seat 6: b8f2bc48 ($7.15 in chips)
Hero: posts small blind $0.02
3c1ddc3a: posts big blind $0.05
*** HOLE CARDS ***
Dealt to 766a71b7 
Dealt to Hero [5s 3c]
Dealt to 3c1ddc3a 
Dealt to bf15fd4d 
Dealt to 25b4d6e7 
Dealt to b8f2bc48 
bf15fd4d: folds
25b4d6e7: folds
b8f2bc48: folds
766a71b7: folds
Hero: folds
Uncalled bet ($0.03) returned to 3c1ddc3a
*** SHOWDOWN ***
3c1ddc3a collected $0.04 from pot
*** SUMMARY ***
Total pot $0.04 | Rake $0 | Jackpot $0 | Bingo $0 | Fortune $0 | Tax $0
Seat 1: 766a71b7 (button) folded before Flop (didn't bet)
Seat 2: Hero (small blind) folded before Flop
Seat 3: 3c1ddc3a (big blind) collected ($0.04)
Seat 4: bf15fd4d folded before Flop (didn't bet)
Seat 5: 25b4d6e7 folded before Flop (didn't bet)
Seat 6: b8f2bc48 folded before Flop (didn't bet)


Poker Hand #RC3334366670: Hold'em No Limit ($0.02/$0.05) - 2025/02/17 20:06:51
Table 'RushAndCash591930' 6-max Seat #1 is the button
Seat 1: e5f214e5 ($7.93 in chips)
Seat 2: b0ee20aa ($7.08 in chips)
Seat 3: Hero ($5 in chips)
Seat 4: 7a5bf293 ($5 in chips)
Seat 5: 9b63101d ($14.3 in chips)
Seat 6: 90f78eaa ($9.85 in chips)
b0ee20aa: posts small blind $0.02
Hero: posts big blind $0.05
*** HOLE CARDS ***
Dealt to e5f214e5 
Dealt to b0ee20aa 
Dealt to Hero [4s Ac]
Dealt to 7a5bf293 
Dealt to 9b63101d 
Dealt to 90f78eaa 
7a5bf293: folds
9b63101d: folds
90f78eaa: folds
e5f214e5: raises $0.1 to $0.15
b0ee20aa: folds
Hero: folds
Uncalled bet ($0.1) returned to e5f214e5
*** SHOWDOWN ***
e5f214e5 collected $0.12 from pot
*** SUMMARY ***
Total pot $0.12 | Rake $0 | Jackpot $0 | Bingo $0 | Fortune $0 | Tax $0
Seat 1: e5f214e5 (button) collected ($0.12)
Seat 2: b0ee20aa (small blind) folded before Flop
Seat 3: Hero (big blind) folded before Flop
Seat 4: 7a5bf293 folded before Flop (didn't bet)
Seat 5: 9b63101d folded before Flop (didn't bet)
Seat 6: 90f78eaa folded before Flop (didn't bet)


Poker Hand #RC3334366485: Hold'em No Limit ($0.02/$0.05) - 2025/02/17 20:06:21
Table 'RushAndCash591745' 6-max Seat #1 is the button
Seat 1: 9864109b ($5 in chips)
Seat 2: 6c122cb5 ($5.85 in chips)
Seat 3: 3cc4755 ($6.64 in chips)
Seat 4: c182b1a3 ($5 in chips)
Seat 5: 94706c35 ($17.31 in chips)
Seat 6: Hero ($5 in chips)
6c122cb5: posts small blind $0.02
3cc4755: posts big blind $0.05
*** HOLE CARDS ***
Dealt to 9864109b 
Dealt to 6c122cb5 
Dealt to 3cc4755 
Dealt to c182b1a3 
Dealt to 94706c35 
Dealt to Hero [5c 5h]
c182b1a3: folds
94706c35: folds
Hero: raises $0.05 to $0.1
9864109b: folds
6c122cb5: folds
3cc4755: raises $0.22 to $0.32
Hero: folds
Uncalled bet ($0.22) returned to 3cc4755
*** SHOWDOWN ***
3cc4755 collected $0.21 from pot
*** SUMMARY ***
Total pot $0.22 | Rake $0.01 | Jackpot $0 | Bingo $0 | Fortune $0 | Tax $0
Seat 1: 9864109b (button) folded before Flop (didn't bet)
Seat 2: 6c122cb5 (small blind) folded before Flop
Seat 3: 3cc4755 (big blind) collected ($0.21)
Seat 4: c182b1a3 folded before Flop (didn't bet)
Seat 5: 94706c35 folded before Flop (didn't bet)
Seat 6: Hero folded before Flop


Poker Hand #RC3334366463: Hold'em No Limit ($0.02/$0.05) - 2025/02/17 20:06:18
Table 'RushAndCash591723' 6-max Seat #1 is the button
Seat 1: 9b2bd2a6 ($8.69 in chips)
Seat 2: a0ca1705 ($13.18 in chips)
Seat 3: b8f2bc48 ($7.06 in chips)
Seat 4: Hero ($5 in chips)
Seat 5: c9ea832 ($6.44 in chips)
Seat 6: ed38df5e ($6.41 in chips)
a0ca1705: posts small blind $0.02
b8f2bc48: posts big blind $0.05
*** HOLE CARDS ***
Dealt to 9b2bd2a6 
Dealt to a0ca1705 
Dealt to b8f2bc48 
Dealt to Hero [2s Js]
Dealt to c9ea832 
Dealt to ed38df5e 
Hero: folds
c9ea832: raises $0.05 to $0.1
ed38df5e: folds
9b2bd2a6: folds
a0ca1705: folds
b8f2bc48: folds
Uncalled bet ($0.05) returned to c9ea832
*** SHOWDOWN ***
c9ea832 collected $0.12 from pot
*** SUMMARY ***
Total pot $0.12 | Rake $0 | Jackpot $0 | Bingo $0 | Fortune $0 | Tax $0
Seat 1: 9b2bd2a6 (button) folded before Flop (didn't bet)
Seat 2: a0ca1705 (small blind) folded before Flop
Seat 3: b8f2bc48 (big blind) folded before Flop
Seat 4: Hero folded before Flop (didn't bet)
Seat 5: c9ea832 collected ($0.12)
Seat 6: ed38df5e folded before Flop (didn't bet)


Poker Hand #RC3334366439: Hold'em No Limit ($0.02/$0.05) - 2025/02/17 20:06:15
Table 'RushAndCash591699' 6-max Seat #1 is the button
Seat 1: 84fb210c ($9.77 in chips)
Seat 2: 8f8d8059 ($17.04 in chips)
Seat 3: 275443dc ($4.78 in chips)
Seat 4: Hero ($5 in chips)
Seat 5: 8e39de43 ($5 in chips)
Seat 6: 10a7b2c7 ($7.06 in chips)
8f8d8059: posts small blind $0.02
275443dc: posts big blind $0.05
*** HOLE CARDS ***
Dealt to 84fb210c 
Dealt to 8f8d8059 
Dealt to 275443dc 
Dealt to Hero [7s 5c]
Dealt to 8e39de43 
Dealt to 10a7b2c7 
Hero: folds
8e39de43: raises $0.06 to $0.11
10a7b2c7: folds
84fb210c: folds
8f8d8059: calls $0.09
275443dc: folds
*** FLOP *** [7h Ad 8s]
8f8d8059: checks
8e39de43: bets $0.09
8f8d8059: calls $0.09
*** TURN *** [7h Ad 8s] [3s]
8f8d8059: checks
8e39de43: checks
*** RIVER *** [7h Ad 8s 3s] [6s]
8f8d8059: bets $0.23
8e39de43: folds
Uncalled bet ($0.23) returned to 8f8d8059
*** SHOWDOWN ***
8f8d8059 collected $0.43 from pot
*** SUMMARY ***
Total pot $0.45 | Rake $0.02 | Jackpot $0 | Bingo $0 | Fortune $0 | Tax $0
Board [7h Ad 8s 3s 6s]
Seat 1: 84fb210c (button) folded before Flop (didn't bet)
Seat 2: 8f8d8059 (small blind) won ($0.43)
Seat 3: 275443dc (big blind) folded before Flop
Seat 4: Hero folded before Flop (didn't bet)
Seat 5: 8e39de43 folded on the River
Seat 6: 10a7b2c7 folded before Flop (didn't bet)


Poker Hand #RC3334366418: Hold'em No Limit ($0.02/$0.05) - 2025/02/17 20:06:11
Table 'RushAndCash591678' 6-max Seat #1 is the button
Seat 1: 650bf952 ($14.28 in chips)
Seat 2: 9babc997 ($4.65 in chips)
Seat 3: 904f2b1b ($4.21 in chips)
Seat 4: 275443dc ($4.78 in chips)
Seat 5: 9885e0a0 ($5.85 in chips)
Seat 6: Hero ($5 in chips)
9babc997: posts small blind $0.02
904f2b1b: posts big blind $0.05
*** HOLE CARDS ***
Dealt to 650bf952 
Dealt to 9babc997 
Dealt to 904f2b1b 
Dealt to 275443dc 
Dealt to 9885e0a0 
Dealt to Hero [7d 9c]
275443dc: folds
9885e0a0: raises $0.06 to $0.11
Hero: folds
650bf952: folds
9babc997: folds
904f2b1b: folds
Uncalled bet ($0.06) returned to 9885e0a0
*** SHOWDOWN ***
9885e0a0 collected $0.12 from pot
*** SUMMARY ***
Total pot $0.12 | Rake $0 | Jackpot $0 | Bingo $0 | Fortune $0 | Tax $0
Seat 1: 650bf952 (button) folded before Flop (didn't bet)
Seat 2: 9babc997 (small blind) folded before Flop
Seat 3: 904f2b1b (big blind) folded before Flop
Seat 4: 275443dc folded before Flop (didn't bet)
Seat 5: 9885e0a0 collected ($0.12)
Seat 6: Hero folded before Flop (didn't bet)


Poker Hand #RC3334366395: Hold'em No Limit ($0.02/$0.05) - 2025/02/17 20:06:08
Table 'RushAndCash591655' 6-max Seat #1 is the button
Seat 1: Hero ($5 in chips)
Seat 2: 16a87f9d ($8.17 in chips)
Seat 3: a28ca95c ($8.3 in chips)
Seat 4: bb6278d8 ($5 in chips)
Seat 5: 2678c032 ($7.11 in chips)
Seat 6: 63a77bff ($3.88 in chips)
16a87f9d: posts small blind $0.02
a28ca95c: posts big blind $0.05
*** HOLE CARDS ***
Dealt to Hero [3c 8h]
Dealt to 16a87f9d 
Dealt to a28ca95c 
Dealt to bb6278d8 
Dealt to 2678c032 
Dealt to 63a77bff 
bb6278d8: raises $0.05 to $0.1
2678c032: folds
63a77bff: folds
Hero: folds
16a87f9d: folds
a28ca95c: folds
Uncalled bet ($0.05) returned to bb6278d8
*** SHOWDOWN ***
bb6278d8 collected $0.12 from pot
*** SUMMARY ***
Total pot $0.12 | Rake $0 | Jackpot $0 | Bingo $0 | Fortune $0 | Tax $0
Seat 1: Hero (button) folded before Flop (didn't bet)
Seat 2: 16a87f9d (small blind) folded before Flop
Seat 3: a28ca95c (big blind) folded before Flop
Seat 4: bb6278d8 collected ($0.12)
Seat 5: 2678c032 folded before Flop (didn't bet)
Seat 6: 63a77bff folded before Flop (didn't bet)


Poker Hand #RC3334366364: Hold'em No Limit ($0.02/$0.05) - 2025/02/17 20:06:03
Table 'RushAndCash591624' 6-max Seat #1 is the button
Seat 1: 4190d158 ($5.21 in chips)
Seat 2: Hero ($5 in chips)
Seat 3: 187f2194 ($6.08 in chips)
Seat 4: 86d9f390 ($5.35 in chips)
Seat 5: 8a4e5bd6 ($6.51 in chips)
Seat 6: a28ca95c ($8.3 in chips)
Hero: posts small blind $0.02
187f2194: posts big blind $0.05
*** HOLE CARDS ***
Dealt to 4190d158 
Dealt to Hero [4s Qs]
Dealt to 187f2194 
Dealt to 86d9f390 
Dealt to 8a4e5bd6 
Dealt to a28ca95c 
86d9f390: folds
8a4e5bd6: folds
a28ca95c: folds
4190d158: raises $0.08 to $0.13
Hero: folds
187f2194: folds
Uncalled bet ($0.08) returned to 4190d158
*** SHOWDOWN ***
4190d158 collected $0.12 from pot
*** SUMMARY ***
Total pot $0.12 | Rake $0 | Jackpot $0 | Bingo $0 | Fortune $0 | Tax $0
Seat 1: 4190d158 (button) collected ($0.12)
Seat 2: Hero (small blind) folded before Flop
Seat 3: 187f2194 (big blind) folded before Flop
Seat 4: 86d9f390 folded before Flop (didn't bet)
Seat 5: 8a4e5bd6 folded before Flop (didn't bet)
Seat 6: a28ca95c folded before Flop (didn't bet)


Poker Hand #RC3334366259: Hold'em No Limit ($0.02/$0.05) - 2025/02/17 20:05:48
Table 'RushAndCash591519' 6-max Seat #1 is the button
Seat 1: 459728f6 ($5.07 in chips)
Seat 2: f0d238ad ($5.75 in chips)
Seat 3: Hero ($5 in chips)
Seat 4: 2f7629a8 ($4.37 in chips)
Seat 5: d64896fd ($11.47 in chips)
Seat 6: 84f270f8 ($5 in chips)
f0d238ad: posts small blind $0.02
Hero: posts big blind $0.05
*** HOLE CARDS ***
Dealt to 459728f6 
Dealt to f0d238ad 
Dealt to Hero [4c Jd]
Dealt to 2f7629a8 
Dealt to d64896fd 
Dealt to 84f270f8 
2f7629a8: folds
d64896fd: folds
84f270f8: folds
459728f6: folds
f0d238ad: raises $0.08 to $0.13
Hero: folds
Uncalled bet ($0.08) returned to f0d238ad
*** SHOWDOWN ***
f0d238ad collected $0.1 from pot
*** SUMMARY ***
Total pot $0.1 | Rake $0 | Jackpot $0 | Bingo $0 | Fortune $0 | Tax $0
Seat 1: 459728f6 (button) folded before Flop (didn't bet)
Seat 2: f0d238ad (small blind) collected ($0.1)
Seat 3: Hero (big blind) folded before Flop
Seat 4: 2f7629a8 folded before Flop (didn't bet)
Seat 5: d64896fd folded before Flop (didn't bet)
Seat 6: 84f270f8 folded before Flop (didn't bet)


