Poker Hand #RC3334603619: Hold'em No Limit ($0.02/$0.05) - 2025/02/17 21:51:23
Table 'RushAndCash638879' 6-max Seat #1 is the button
Seat 1: ec2814be ($5.51 in chips)
Seat 2: 687fd17d ($4.09 in chips)
Seat 3: c565c977 ($5.05 in chips)
Seat 4: 529120ac ($4.05 in chips)
Seat 5: a9bca211 ($5.09 in chips)
Seat 6: Hero ($5 in chips)
687fd17d: posts small blind $0.02
c565c977: posts big blind $0.05
*** HOLE CARDS ***
Dealt to ec2814be 
Dealt to 687fd17d 
Dealt to c565c977 
Dealt to 529120ac 
Dealt to a9bca211 
Dealt to Hero [9c Ac]
529120ac: folds
a9bca211: folds
Hero: raises $0.05 to $0.1
ec2814be: folds
687fd17d: folds
c565c977: calls $0.05
*** FLOP *** [7s 3h Tc]
c565c977: checks
Hero: checks
*** TURN *** [7s 3h Tc] [8s]
c565c977: bets $0.08
Hero: calls $0.08
*** RIVER *** [7s 3h Tc 8s] [3d]
c565c977: bets $0.29
Hero: folds
Uncalled bet ($0.29) returned to c565c977
*** SHOWDOWN ***
c565c977 collected $0.37 from pot
*** SUMMARY ***
Total pot $0.38 | Rake $0.01 | Jackpot $0 | Bingo $0 | Fortune $0 | Tax $0
Board [7s 3h Tc 8s 3d]
Seat 1: ec2814be (button) folded before Flop (didn't bet)
Seat 2: 687fd17d (small blind) folded before Flop
Seat 3: c565c977 (big blind) won ($0.37)
Seat 4: 529120ac folded before Flop (didn't bet)
Seat 5: a9bca211 folded before Flop (didn't bet)
Seat 6: Hero folded on the River


Poker Hand #RC3334603565: Hold'em No Limit ($0.02/$0.05) - 2025/02/17 21:51:16
Table 'RushAndCash638825' 6-max Seat #1 is the button
Seat 1: 8d0bc73f ($8.59 in chips)
Seat 2: d7a16be3 ($4.89 in chips)
Seat 3: 83b423c8 ($5 in chips)
Seat 4: 82c6ccfb ($12.16 in chips)
Seat 5: c3c40ffa ($6.42 in chips)
Seat 6: Hero ($5 in chips)
d7a16be3: posts small blind $0.02
83b423c8: posts big blind $0.05
*** HOLE CARDS ***
Dealt to 8d0bc73f 
Dealt to d7a16be3 
Dealt to 83b423c8 
Dealt to 82c6ccfb 
Dealt to c3c40ffa 
Dealt to Hero [Qh 4c]
82c6ccfb: folds
c3c40ffa: folds
Hero: folds
8d0bc73f: folds
d7a16be3: folds
Uncalled bet ($0.03) returned to 83b423c8
*** SHOWDOWN ***
83b423c8 collected $0.04 from pot
*** SUMMARY ***
Total pot $0.04 | Rake $0 | Jackpot $0 | Bingo $0 | Fortune $0 | Tax $0
Seat 1: 8d0bc73f (button) folded before Flop (didn't bet)
Seat 2: d7a16be3 (small blind) folded before Flop
Seat 3: 83b423c8 (big blind) collected ($0.04)
Seat 4: 82c6ccfb folded before Flop (didn't bet)
Seat 5: c3c40ffa folded before Flop (didn't bet)
Seat 6: Hero folded before Flop (didn't bet)


Poker Hand #RC3334603458: Hold'em No Limit ($0.02/$0.05) - 2025/02/17 21:51:03
Table 'RushAndCash638718' 6-max Seat #1 is the button
Seat 1: ba72b338 ($5 in chips)
Seat 2: a91946aa ($2.55 in chips)
Seat 3: Hero ($5 in chips)
Seat 4: 1dd0b66b ($6.38 in chips)
Seat 5: 692417ff ($13.21 in chips)
Seat 6: b02447b8 ($7.32 in chips)
a91946aa: posts small blind $0.02
Hero: posts big blind $0.05
*** HOLE CARDS ***
Dealt to ba72b338 
Dealt to a91946aa 
Dealt to Hero [6s 7s]
Dealt to 1dd0b66b 
Dealt to 692417ff 
Dealt to b02447b8 
1dd0b66b: raises $0.05 to $0.1
692417ff: folds
b02447b8: folds
ba72b338: raises $0.21 to $0.31
a91946aa: folds
Hero: folds
1dd0b66b: calls $0.21
*** FLOP *** [Qh 9s Kd]
1dd0b66b: checks
ba72b338: bets $0.24
1dd0b66b: folds
Uncalled bet ($0.24) returned to ba72b338
*** SHOWDOWN ***
ba72b338 collected $0.66 from pot
*** SUMMARY ***
Total pot $0.69 | Rake $0.03 | Jackpot $0 | Bingo $0 | Fortune $0 | Tax $0
Board [Qh 9s Kd]
Seat 1: ba72b338 (button) won ($0.66)
Seat 2: a91946aa (small blind) folded before Flop
Seat 3: Hero (big blind) folded before Flop
Seat 4: 1dd0b66b folded on the Flop
Seat 5: 692417ff folded before Flop (didn't bet)
Seat 6: b02447b8 folded before Flop (didn't bet)


Poker Hand #RC3334603430: Hold'em No Limit ($0.02/$0.05) - 2025/02/17 21:51:00
Table 'RushAndCash638690' 6-max Seat #1 is the button
Seat 1: Hero ($5 in chips)
Seat 2: b9039b9 ($2.33 in chips)
Seat 3: 719071b8 ($7.04 in chips)
Seat 4: a91946aa ($2.55 in chips)
Seat 5: 811c7448 ($7.24 in chips)
Seat 6: a0ed5617 ($10 in chips)
b9039b9: posts small blind $0.02
719071b8: posts big blind $0.05
*** HOLE CARDS ***
Dealt to Hero [3s Ts]
Dealt to b9039b9 
Dealt to 719071b8 
Dealt to a91946aa 
Dealt to 811c7448 
Dealt to a0ed5617 
a91946aa: folds
811c7448: folds
a0ed5617: raises $0.1 to $0.15
Hero: folds
b9039b9: calls $0.13
719071b8: calls $0.1
*** FLOP *** [Ad 3d 8s]
b9039b9: checks
719071b8: checks
a0ed5617: checks
*** TURN *** [Ad 3d 8s] [3c]
b9039b9: bets $0.15
719071b8: folds
a0ed5617: folds
Uncalled bet ($0.15) returned to b9039b9
*** SHOWDOWN ***
b9039b9 collected $0.43 from pot
*** SUMMARY ***
Total pot $0.45 | Rake $0.02 | Jackpot $0 | Bingo $0 | Fortune $0 | Tax $0
Board [Ad 3d 8s 3c]
Seat 1: Hero (button) folded before Flop (didn't bet)
Seat 2: b9039b9 (small blind) won ($0.43)
Seat 3: 719071b8 (big blind) folded on the Turn
Seat 4: a91946aa folded before Flop (didn't bet)
Seat 5: 811c7448 folded before Flop (didn't bet)
Seat 6: a0ed5617 folded on the Turn


Poker Hand #RC3334603399: Hold'em No Limit ($0.02/$0.05) - 2025/02/17 21:50:57
Table 'RushAndCash638659' 6-max Seat #1 is the button
Seat 1: 9e226e3b ($5.54 in chips)
Seat 2: Hero ($5 in chips)
Seat 3: 7b1424ef ($5 in chips)
Seat 4: 3455b228 ($1.72 in chips)
Seat 5: edbb0bb6 ($5.07 in chips)
Seat 6: b66c51bb ($5.04 in chips)
Hero: posts small blind $0.02
7b1424ef: posts big blind $0.05
*** HOLE CARDS ***
Dealt to 9e226e3b 
Dealt to Hero [9d Qs]
Dealt to 7b1424ef 
Dealt to 3455b228 
Dealt to edbb0bb6 
Dealt to b66c51bb 
3455b228: folds
edbb0bb6: folds
b66c51bb: folds
9e226e3b: raises $0.07 to $0.12
Hero: folds
7b1424ef: folds
Uncalled bet ($0.07) returned to 9e226e3b
*** SHOWDOWN ***
9e226e3b collected $0.12 from pot
*** SUMMARY ***
Total pot $0.12 | Rake $0 | Jackpot $0 | Bingo $0 | Fortune $0 | Tax $0
Seat 1: 9e226e3b (button) collected ($0.12)
Seat 2: Hero (small blind) folded before Flop
Seat 3: 7b1424ef (big blind) folded before Flop
Seat 4: 3455b228 folded before Flop (didn't bet)
Seat 5: edbb0bb6 folded before Flop (didn't bet)
Seat 6: b66c51bb folded before Flop (didn't bet)


Poker Hand #RC3334603366: Hold'em No Limit ($0.02/$0.05) - 2025/02/17 21:50:53
Table 'RushAndCash638626' 6-max Seat #1 is the button
Seat 1: af130c3f ($5 in chips)
Seat 2: 8ea92302 ($5.11 in chips)
Seat 3: 50d79ef5 ($5.7 in chips)
Seat 4: 3455b228 ($1.72 in chips)
Seat 5: Hero ($5 in chips)
Seat 6: b9f66756 ($5.07 in chips)
8ea92302: posts small blind $0.02
50d79ef5: posts big blind $0.05
*** HOLE CARDS ***
Dealt to af130c3f 
Dealt to 8ea92302 
Dealt to 50d79ef5 
Dealt to 3455b228 
Dealt to Hero [Qs 5c]
Dealt to b9f66756 
3455b228: folds
Hero: folds
b9f66756: raises $0.05 to $0.1
af130c3f: raises $0.28 to $0.38
8ea92302: folds
50d79ef5: folds
b9f66756: folds
Uncalled bet ($0.28) returned to af130c3f
*** SHOWDOWN ***
af130c3f collected $0.26 from pot
*** SUMMARY ***
Total pot $0.27 | Rake $0.01 | Jackpot $0 | Bingo $0 | Fortune $0 | Tax $0
Seat 1: af130c3f (button) collected ($0.26)
Seat 2: 8ea92302 (small blind) folded before Flop
Seat 3: 50d79ef5 (big blind) folded before Flop
Seat 4: 3455b228 folded before Flop (didn't bet)
Seat 5: Hero folded before Flop (didn't bet)
Seat 6: b9f66756 folded before Flop


Poker Hand #RC3334603330: Hold'em No Limit ($0.02/$0.05) - 2025/02/17 21:50:50
Table 'RushAndCash638590' 6-max Seat #1 is the button
Seat 1: 6ab3ea38 ($5.79 in chips)
Seat 2: 1f78e1eb ($5.22 in chips)
Seat 3: 9babc997 ($6.26 in chips)
Seat 4: a223d3ca ($5.14 in chips)
Seat 5: 53a8c2fd ($7.56 in chips)
Seat 6: Hero ($5 in chips)
1f78e1eb: posts small blind $0.02
9babc997: posts big blind $0.05
*** HOLE CARDS ***
Dealt to 6ab3ea38 
Dealt to 1f78e1eb 
Dealt to 9babc997 
Dealt to a223d3ca 
Dealt to 53a8c2fd 
Dealt to Hero [3c 2s]
a223d3ca: folds
53a8c2fd: raises $0.06 to $0.11
Hero: folds
6ab3ea38: folds
1f78e1eb: raises $0.44 to $0.55
9babc997: folds
53a8c2fd: folds
Uncalled bet ($0.44) returned to 1f78e1eb
*** SHOWDOWN ***
1f78e1eb collected $0.26 from pot
*** SUMMARY ***
Total pot $0.27 | Rake $0.01 | Jackpot $0 | Bingo $0 | Fortune $0 | Tax $0
Seat 1: 6ab3ea38 (button) folded before Flop (didn't bet)
Seat 2: 1f78e1eb (small blind) collected ($0.26)
Seat 3: 9babc997 (big blind) folded before Flop
Seat 4: a223d3ca folded before Flop (didn't bet)
Seat 5: 53a8c2fd folded before Flop
Seat 6: Hero folded before Flop (didn't bet)


Poker Hand #RC3334603292: Hold'em No Limit ($0.02/$0.05) - 2025/02/17 21:50:46
Table 'RushAndCash638552' 6-max Seat #1 is the button
Seat 1: d916afa1 ($30.55 in chips)
Seat 2: 70a68a0b ($5 in chips)
Seat 3: 951a45c3 ($5.12 in chips)
Seat 4: 7eb5dbb3 ($11.96 in chips)
Seat 5: 75a97e80 ($8.01 in chips)
Seat 6: Hero ($5 in chips)
70a68a0b: posts small blind $0.02
951a45c3: posts big blind $0.05
*** HOLE CARDS ***
Dealt to d916afa1 
Dealt to 70a68a0b 
Dealt to 951a45c3 
Dealt to 7eb5dbb3 
Dealt to 75a97e80 
Dealt to Hero [2h 7h]
7eb5dbb3: folds
75a97e80: raises $0.1 to $0.15
Hero: folds
d916afa1: folds
70a68a0b: folds
951a45c3: folds
Uncalled bet ($0.1) returned to 75a97e80
*** SHOWDOWN ***
75a97e80 collected $0.12 from pot
*** SUMMARY ***
Total pot $0.12 | Rake $0 | Jackpot $0 | Bingo $0 | Fortune $0 | Tax $0
Seat 1: d916afa1 (button) folded before Flop (didn't bet)
Seat 2: 70a68a0b (small blind) folded before Flop
Seat 3: 951a45c3 (big blind) folded before Flop
Seat 4: 7eb5dbb3 folded before Flop (didn't bet)
Seat 5: 75a97e80 collected ($0.12)
Seat 6: Hero folded before Flop (didn't bet)


Poker Hand #RC3334603245: Hold'em No Limit ($0.02/$0.05) - 2025/02/17 21:50:41
Table 'RushAndCash638505' 6-max Seat #1 is the button
Seat 1: b4cd57cf ($8.04 in chips)
Seat 2: 4e3c3196 ($31.13 in chips)
Seat 3: e21d7555 ($0.6 in chips)
Seat 4: 4ce7d5f4 ($6.52 in chips)
Seat 5: Hero ($5 in chips)
Seat 6: 99df5763 ($2.17 in chips)
4e3c3196: posts small blind $0.02
e21d7555: posts big blind $0.05
*** HOLE CARDS ***
Dealt to b4cd57cf 
Dealt to 4e3c3196 
Dealt to e21d7555 
Dealt to 4ce7d5f4 
Dealt to Hero [2h Ks]
Dealt to 99df5763 
4ce7d5f4: folds
Hero: folds
99df5763: folds
b4cd57cf: folds
4e3c3196: folds
Uncalled bet ($0.03) returned to e21d7555
*** SHOWDOWN ***
e21d7555 collected $0.04 from pot
*** SUMMARY ***
Total pot $0.04 | Rake $0 | Jackpot $0 | Bingo $0 | Fortune $0 | Tax $0
Seat 1: b4cd57cf (button) folded before Flop (didn't bet)
Seat 2: 4e3c3196 (small blind) folded before Flop
Seat 3: e21d7555 (big blind) collected ($0.04)
Seat 4: 4ce7d5f4 folded before Flop (didn't bet)
Seat 5: Hero folded before Flop (didn't bet)
Seat 6: 99df5763 folded before Flop (didn't bet)


Poker Hand #RC3334603213: Hold'em No Limit ($0.02/$0.05) - 2025/02/17 21:50:38
Table 'RushAndCash638473' 6-max Seat #1 is the button
Seat 1: 5c08f408 ($4.68 in chips)
Seat 2: 7c8b3964 ($9.62 in chips)
Seat 3: 256d985c ($5.17 in chips)
Seat 4: 97d67e86 ($6.61 in chips)
Seat 5: Hero ($5 in chips)
Seat 6: 32f34df2 ($6.64 in chips)
7c8b3964: posts small blind $0.02
256d985c: posts big blind $0.05
*** HOLE CARDS ***
Dealt to 5c08f408 
Dealt to 7c8b3964 
Dealt to 256d985c 
Dealt to 97d67e86 
Dealt to Hero [2h Ah]
Dealt to 32f34df2 
97d67e86: folds
Hero: folds
32f34df2: folds
5c08f408: raises $0.08 to $0.13
7c8b3964: folds
256d985c: calls $0.08
*** FLOP *** [3s Jc 7s]
256d985c: checks
5c08f408: bets $0.14
256d985c: raises $0.42 to $0.56
5c08f408: folds
Uncalled bet ($0.42) returned to 256d985c
*** SHOWDOWN ***
256d985c collected $0.54 from pot
*** SUMMARY ***
Total pot $0.56 | Rake $0.02 | Jackpot $0 | Bingo $0 | Fortune $0 | Tax $0
Board [3s Jc 7s]
Seat 1: 5c08f408 (button) folded on the Flop
Seat 2: 7c8b3964 (small blind) folded before Flop
Seat 3: 256d985c (big blind) won ($0.54)
Seat 4: 97d67e86 folded before Flop (didn't bet)
Seat 5: Hero folded before Flop (didn't bet)
Seat 6: 32f34df2 folded before Flop (didn't bet)


Poker Hand #RC3334603179: Hold'em No Limit ($0.02/$0.05) - 2025/02/17 21:50:35
Table 'RushAndCash638439' 6-max Seat #1 is the button
Seat 1: d037279c ($5.14 in chips)
Seat 2: 14d03752 ($6.82 in chips)
Seat 3: bd5d2bb7 ($5.76 in chips)
Seat 4: Hero ($5 in chips)
Seat 5: 443f46a7 ($5.11 in chips)
Seat 6: da5282f0 ($5.17 in chips)
14d03752: posts small blind $0.02
bd5d2bb7: posts big blind $0.05
*** HOLE CARDS ***
Dealt to d037279c 
Dealt to 14d03752 
Dealt to bd5d2bb7 
Dealt to Hero [Td 5d]
Dealt to 443f46a7 
Dealt to da5282f0 
Hero: folds
443f46a7: folds
da5282f0: folds
d037279c: raises $0.12 to $0.17
14d03752: folds
bd5d2bb7: folds
Uncalled bet ($0.12) returned to d037279c
*** SHOWDOWN ***
d037279c collected $0.12 from pot
*** SUMMARY ***
Total pot $0.12 | Rake $0 | Jackpot $0 | Bingo $0 | Fortune $0 | Tax $0
Seat 1: d037279c (button) collected ($0.12)
Seat 2: 14d03752 (small blind) folded before Flop
Seat 3: bd5d2bb7 (big blind) folded before Flop
Seat 4: Hero folded before Flop (didn't bet)
Seat 5: 443f46a7 folded before Flop (didn't bet)
Seat 6: da5282f0 folded before Flop (didn't bet)


Poker Hand #RC3334603138: Hold'em No Limit ($0.02/$0.05) - 2025/02/17 21:50:30
Table 'RushAndCash638398' 6-max Seat #1 is the button
Seat 1: 3ecb9f22 ($5.3 in chips)
Seat 2: 92fa3d91 ($5.38 in chips)
Seat 3: c9e4cf57 ($7.92 in chips)
Seat 4: 545ae247 ($9.05 in chips)
Seat 5: Hero ($5 in chips)
Seat 6: 7d310fdd ($5.23 in chips)
92fa3d91: posts small blind $0.02
c9e4cf57: posts big blind $0.05
*** HOLE CARDS ***
Dealt to 3ecb9f22 
Dealt to 92fa3d91 
Dealt to c9e4cf57 
Dealt to 545ae247 
Dealt to Hero [4d As]
Dealt to 7d310fdd 
545ae247: folds
Hero: folds
7d310fdd: folds
3ecb9f22: folds
92fa3d91: raises $0.08 to $0.13
c9e4cf57: folds
Uncalled bet ($0.08) returned to 92fa3d91
*** SHOWDOWN ***
92fa3d91 collected $0.1 from pot
*** SUMMARY ***
Total pot $0.1 | Rake $0 | Jackpot $0 | Bingo $0 | Fortune $0 | Tax $0
Seat 1: 3ecb9f22 (button) folded before Flop (didn't bet)
Seat 2: 92fa3d91 (small blind) collected ($0.1)
Seat 3: c9e4cf57 (big blind) folded before Flop
Seat 4: 545ae247 folded before Flop (didn't bet)
Seat 5: Hero folded before Flop (didn't bet)
Seat 6: 7d310fdd folded before Flop (didn't bet)


Poker Hand #RC3334603034: Hold'em No Limit ($0.02/$0.05) - 2025/02/17 21:50:20
Table 'RushAndCash638294' 6-max Seat #1 is the button
Seat 1: 18491af ($7.68 in chips)
Seat 2: f737c730 ($5.09 in chips)
Seat 3: Hero ($5 in chips)
Seat 4: b9f66756 ($5.02 in chips)
Seat 5: 40df0724 ($4.25 in chips)
Seat 6: 22a3f0e8 ($9.56 in chips)
f737c730: posts small blind $0.02
Hero: posts big blind $0.05
*** HOLE CARDS ***
Dealt to 18491af 
Dealt to f737c730 
Dealt to Hero [5s 7h]
Dealt to b9f66756 
Dealt to 40df0724 
Dealt to 22a3f0e8 
b9f66756: raises $0.05 to $0.1
40df0724: folds
22a3f0e8: folds
18491af: folds
f737c730: folds
Hero: folds
Uncalled bet ($0.05) returned to b9f66756
*** SHOWDOWN ***
b9f66756 collected $0.12 from pot
*** SUMMARY ***
Total pot $0.12 | Rake $0 | Jackpot $0 | Bingo $0 | Fortune $0 | Tax $0
Seat 1: 18491af (button) folded before Flop (didn't bet)
Seat 2: f737c730 (small blind) folded before Flop
Seat 3: Hero (big blind) folded before Flop
Seat 4: b9f66756 collected ($0.12)
Seat 5: 40df0724 folded before Flop (didn't bet)
Seat 6: 22a3f0e8 folded before Flop (didn't bet)


Poker Hand #RC3334603002: Hold'em No Limit ($0.02/$0.05) - 2025/02/17 21:50:16
Table 'RushAndCash638262' 6-max Seat #1 is the button
Seat 1: f737c730 ($5.09 in chips)
Seat 2: a041e358 ($5 in chips)
Seat 3: cea9730b ($7.44 in chips)
Seat 4: 8c8bf19e ($6.01 in chips)
Seat 5: 3e6e7b99 ($6.47 in chips)
Seat 6: Hero ($5 in chips)
a041e358: posts small blind $0.02
cea9730b: posts big blind $0.05
*** HOLE CARDS ***
Dealt to f737c730 
Dealt to a041e358 
Dealt to cea9730b 
Dealt to 8c8bf19e 
Dealt to 3e6e7b99 
Dealt to Hero [6d 3c]
8c8bf19e: folds
3e6e7b99: folds
Hero: folds
f737c730: folds
a041e358: folds
Uncalled bet ($0.03) returned to cea9730b
*** SHOWDOWN ***
cea9730b collected $0.04 from pot
*** SUMMARY ***
Total pot $0.04 | Rake $0 | Jackpot $0 | Bingo $0 | Fortune $0 | Tax $0
Seat 1: f737c730 (button) folded before Flop (didn't bet)
Seat 2: a041e358 (small blind) folded before Flop
Seat 3: cea9730b (big blind) collected ($0.04)
Seat 4: 8c8bf19e folded before Flop (didn't bet)
Seat 5: 3e6e7b99 folded before Flop (didn't bet)
Seat 6: Hero folded before Flop (didn't bet)


Poker Hand #RC3334602934: Hold'em No Limit ($0.02/$0.05) - 2025/02/17 21:50:10
Table 'RushAndCash638194' 6-max Seat #1 is the button
Seat 1: 9babc997 ($6.38 in chips)
Seat 2: Hero ($5 in chips)
Seat 3: df9e409d ($4.36 in chips)
Seat 4: dd9aa252 ($5.35 in chips)
Seat 5: d47282a4 ($6.5 in chips)
Seat 6: 3ffd6491 ($9.85 in chips)
Hero: posts small blind $0.02
df9e409d: posts big blind $0.05
*** HOLE CARDS ***
Dealt to 9babc997 
Dealt to Hero [7d 5c]
Dealt to df9e409d 
Dealt to dd9aa252 
Dealt to d47282a4 
Dealt to 3ffd6491 
dd9aa252: raises $0.1 to $0.15
d47282a4: folds
3ffd6491: folds
9babc997: folds
Hero: folds
df9e409d: folds
Uncalled bet ($0.1) returned to dd9aa252
*** SHOWDOWN ***
dd9aa252 collected $0.12 from pot
*** SUMMARY ***
Total pot $0.12 | Rake $0 | Jackpot $0 | Bingo $0 | Fortune $0 | Tax $0
Seat 1: 9babc997 (button) folded before Flop (didn't bet)
Seat 2: Hero (small blind) folded before Flop
Seat 3: df9e409d (big blind) folded before Flop
Seat 4: dd9aa252 collected ($0.12)
Seat 5: d47282a4 folded before Flop (didn't bet)
Seat 6: 3ffd6491 folded before Flop (didn't bet)


Poker Hand #RC3334602902: Hold'em No Limit ($0.02/$0.05) - 2025/02/17 21:50:06
Table 'RushAndCash638162' 6-max Seat #1 is the button
Seat 1: Hero ($5 in chips)
Seat 2: 7725a7cb ($5 in chips)
Seat 3: 319021b1 ($8.13 in chips)
Seat 4: d47282a4 ($6.5 in chips)
Seat 5: 3ffd6491 ($9.85 in chips)
Seat 6: fcfd355a ($6.31 in chips)
7725a7cb: posts small blind $0.02
319021b1: posts big blind $0.05
*** HOLE CARDS ***
Dealt to Hero [Qd 7c]
Dealt to 7725a7cb 
Dealt to 319021b1 
Dealt to d47282a4 
Dealt to 3ffd6491 
Dealt to fcfd355a 
d47282a4: folds
3ffd6491: folds
fcfd355a: raises $0.08 to $0.13
Hero: folds
7725a7cb: folds
319021b1: calls $0.08
*** FLOP *** [8s 5s 5d]
319021b1: checks
fcfd355a: bets $0.1
319021b1: folds
Uncalled bet ($0.1) returned to fcfd355a
*** SHOWDOWN ***
fcfd355a collected $0.27 from pot
*** SUMMARY ***
Total pot $0.28 | Rake $0.01 | Jackpot $0 | Bingo $0 | Fortune $0 | Tax $0
Board [8s 5s 5d]
Seat 1: Hero (button) folded before Flop (didn't bet)
Seat 2: 7725a7cb (small blind) folded before Flop
Seat 3: 319021b1 (big blind) folded on the Flop
Seat 4: d47282a4 folded before Flop (didn't bet)
Seat 5: 3ffd6491 folded before Flop (didn't bet)
Seat 6: fcfd355a won ($0.27)


Poker Hand #RC3334602867: Hold'em No Limit ($0.02/$0.05) - 2025/02/17 21:50:03
Table 'RushAndCash638127' 6-max Seat #1 is the button
Seat 1: Hero ($5 in chips)
Seat 2: 3ecb9f22 ($5.39 in chips)
Seat 3: 5ac336e3 ($5.21 in chips)
Seat 4: e16b78a9 ($4.75 in chips)
Seat 5: b2069524 ($6.18 in chips)
Seat 6: 5947e28d ($6.08 in chips)
3ecb9f22: posts small blind $0.02
5ac336e3: posts big blind $0.05
*** HOLE CARDS ***
Dealt to Hero [4d 6h]
Dealt to 3ecb9f22 
Dealt to 5ac336e3 
Dealt to e16b78a9 
Dealt to b2069524 
Dealt to 5947e28d 
e16b78a9: folds
b2069524: folds
5947e28d: raises $0.08 to $0.13
Hero: folds
3ecb9f22: folds
5ac336e3: folds
Uncalled bet ($0.08) returned to 5947e28d
*** SHOWDOWN ***
5947e28d collected $0.12 from pot
*** SUMMARY ***
Total pot $0.12 | Rake $0 | Jackpot $0 | Bingo $0 | Fortune $0 | Tax $0
Seat 1: Hero (button) folded before Flop (didn't bet)
Seat 2: 3ecb9f22 (small blind) folded before Flop
Seat 3: 5ac336e3 (big blind) folded before Flop
Seat 4: e16b78a9 folded before Flop (didn't bet)
Seat 5: b2069524 folded before Flop (didn't bet)
Seat 6: 5947e28d collected ($0.12)


Poker Hand #RC3334602838: Hold'em No Limit ($0.02/$0.05) - 2025/02/17 21:50:00
Table 'RushAndCash638098' 6-max Seat #1 is the button
Seat 1: dd9aa252 ($5.35 in chips)
Seat 2: b2e12d09 ($5.41 in chips)
Seat 3: 56b9b8a5 ($5.16 in chips)
Seat 4: 1095926a ($9.18 in chips)
Seat 5: 2d4e8369 ($5.07 in chips)
Seat 6: Hero ($5 in chips)
b2e12d09: posts small blind $0.02
56b9b8a5: posts big blind $0.05
*** HOLE CARDS ***
Dealt to dd9aa252 
Dealt to b2e12d09 
Dealt to 56b9b8a5 
Dealt to 1095926a 
Dealt to 2d4e8369 
Dealt to Hero [8d Qs]
1095926a: folds
2d4e8369: folds
Hero: folds
dd9aa252: folds
b2e12d09: folds
Uncalled bet ($0.03) returned to 56b9b8a5
*** SHOWDOWN ***
56b9b8a5 collected $0.04 from pot
*** SUMMARY ***
Total pot $0.04 | Rake $0 | Jackpot $0 | Bingo $0 | Fortune $0 | Tax $0
Seat 1: dd9aa252 (button) folded before Flop (didn't bet)
Seat 2: b2e12d09 (small blind) folded before Flop
Seat 3: 56b9b8a5 (big blind) collected ($0.04)
Seat 4: 1095926a folded before Flop (didn't bet)
Seat 5: 2d4e8369 folded before Flop (didn't bet)
Seat 6: Hero folded before Flop (didn't bet)


Poker Hand #RC3334602807: Hold'em No Limit ($0.02/$0.05) - 2025/02/17 21:49:57
Table 'RushAndCash638067' 6-max Seat #1 is the button
Seat 1: 9acb7e4c ($6.85 in chips)
Seat 2: 91b10922 ($2.97 in chips)
Seat 3: b386a385 ($5 in chips)
Seat 4: 7cf365ea ($11.34 in chips)
Seat 5: 56b9b8a5 ($5.16 in chips)
Seat 6: Hero ($5 in chips)
91b10922: posts small blind $0.02
b386a385: posts big blind $0.05
*** HOLE CARDS ***
Dealt to 9acb7e4c 
Dealt to 91b10922 
Dealt to b386a385 
Dealt to 7cf365ea 
Dealt to 56b9b8a5 
Dealt to Hero [7c 9c]
7cf365ea: folds
56b9b8a5: folds
Hero: folds
9acb7e4c: folds
91b10922: folds
Uncalled bet ($0.03) returned to b386a385
*** SHOWDOWN ***
b386a385 collected $0.04 from pot
*** SUMMARY ***
Total pot $0.04 | Rake $0 | Jackpot $0 | Bingo $0 | Fortune $0 | Tax $0
Seat 1: 9acb7e4c (button) folded before Flop (didn't bet)
Seat 2: 91b10922 (small blind) folded before Flop
Seat 3: b386a385 (big blind) collected ($0.04)
Seat 4: 7cf365ea folded before Flop (didn't bet)
Seat 5: 56b9b8a5 folded before Flop (didn't bet)
Seat 6: Hero folded before Flop (didn't bet)


Poker Hand #RC3334602322: Hold'em No Limit ($0.02/$0.05) - 2025/02/17 21:49:02
Table 'RushAndCash637582' 6-max Seat #1 is the button
Seat 1: df79f8b0 ($5.12 in chips)
Seat 2: 656af102 ($6.89 in chips)
Seat 3: Hero ($5 in chips)
Seat 4: a730170a ($5.32 in chips)
Seat 5: aadfce52 ($6.86 in chips)
Seat 6: 51719807 ($4.63 in chips)
656af102: posts small blind $0.02
Hero: posts big blind $0.05
*** HOLE CARDS ***
Dealt to df79f8b0 
Dealt to 656af102 
Dealt to Hero [Ac Ts]
Dealt to a730170a 
Dealt to aadfce52 
Dealt to 51719807 
a730170a: folds
aadfce52: folds
51719807: folds
df79f8b0: raises $0.06 to $0.11
656af102: folds
Hero: calls $0.06
*** FLOP *** [Jd 2s Ah]
Hero: checks
df79f8b0: bets $0.13
Hero: calls $0.13
*** TURN *** [Jd 2s Ah] [8s]
Hero: checks
df79f8b0: bets $0.38
Hero: folds
Uncalled bet ($0.38) returned to df79f8b0
*** SHOWDOWN ***
df79f8b0 collected $0.48 from pot
*** SUMMARY ***
Total pot $0.5 | Rake $0.02 | Jackpot $0 | Bingo $0 | Fortune $0 | Tax $0
Board [Jd 2s Ah 8s]
Seat 1: df79f8b0 (button) won ($0.48)
Seat 2: 656af102 (small blind) folded before Flop
Seat 3: Hero (big blind) folded on the Turn
Seat 4: a730170a folded before Flop (didn't bet)
Seat 5: aadfce52 folded before Flop (didn't bet)
Seat 6: 51719807 folded before Flop (didn't bet)


Poker Hand #RC3334602256: Hold'em No Limit ($0.02/$0.05) - 2025/02/17 21:48:55
Table 'RushAndCash637516' 6-max Seat #1 is the button
Seat 1: 81f29d91 ($6.49 in chips)
Seat 2: Hero ($5 in chips)
Seat 3: 55e0d4fe ($9.1 in chips)
Seat 4: c28bd986 ($5.07 in chips)
Seat 5: 32972137 ($5.1 in chips)
Seat 6: 395482a9 ($9.93 in chips)
Hero: posts small blind $0.02
55e0d4fe: posts big blind $0.05
*** HOLE CARDS ***
Dealt to 81f29d91 
Dealt to Hero [7s 3c]
Dealt to 55e0d4fe 
Dealt to c28bd986 
Dealt to 32972137 
Dealt to 395482a9 
c28bd986: folds
32972137: folds
395482a9: raises $0.05 to $0.1
81f29d91: folds
Hero: folds
55e0d4fe: calls $0.05
*** FLOP *** [7d Js Jd]
55e0d4fe: checks
395482a9: checks
*** TURN *** [7d Js Jd] [Qh]
55e0d4fe: checks
395482a9: checks
*** RIVER *** [7d Js Jd Qh] [Tc]
55e0d4fe: checks
395482a9: bets $0.08
55e0d4fe: calls $0.08
395482a9: shows [7h Qc] (Pair of Queens and Pair of Jacks)
55e0d4fe: shows [8s Th] (Pair of Jacks and Pair of Tens)
*** SHOWDOWN ***
395482a9 collected $0.37 from pot
*** SUMMARY ***
Total pot $0.38 | Rake $0.01 | Jackpot $0 | Bingo $0 | Fortune $0 | Tax $0
Board [7d Js Jd Qh Tc]
Seat 1: 81f29d91 (button) folded before Flop (didn't bet)
Seat 2: Hero (small blind) folded before Flop
Seat 3: 55e0d4fe (big blind) showed [8s Th] and lost with Pair of Jacks and Pair of Tens
Seat 4: c28bd986 folded before Flop (didn't bet)
Seat 5: 32972137 folded before Flop (didn't bet)
Seat 6: 395482a9 showed [7h Qc] and won ($0.37) with Pair of Queens and Pair of Jacks


Poker Hand #RC3334602205: Hold'em No Limit ($0.02/$0.05) - 2025/02/17 21:48:50
Table 'RushAndCash637465' 6-max Seat #1 is the button
Seat 1: d7a83a17 ($8.34 in chips)
Seat 2: 81f29d91 ($6.51 in chips)
Seat 3: c27051e0 ($5 in chips)
Seat 4: c6e11d19 ($5 in chips)
Seat 5: Hero ($5 in chips)
Seat 6: f53325ff ($5.05 in chips)
81f29d91: posts small blind $0.02
c27051e0: posts big blind $0.05
*** HOLE CARDS ***
Dealt to d7a83a17 
Dealt to 81f29d91 
Dealt to c27051e0 
Dealt to c6e11d19 
Dealt to Hero [Qc 2d]
Dealt to f53325ff 
c6e11d19: raises $0.05 to $0.1
Hero: folds
f53325ff: folds
d7a83a17: folds
81f29d91: folds
c27051e0: folds
Uncalled bet ($0.05) returned to c6e11d19
*** SHOWDOWN ***
c6e11d19 collected $0.12 from pot
*** SUMMARY ***
Total pot $0.12 | Rake $0 | Jackpot $0 | Bingo $0 | Fortune $0 | Tax $0
Seat 1: d7a83a17 (button) folded before Flop (didn't bet)
Seat 2: 81f29d91 (small blind) folded before Flop
Seat 3: c27051e0 (big blind) folded before Flop
Seat 4: c6e11d19 collected ($0.12)
Seat 5: Hero folded before Flop (didn't bet)
Seat 6: f53325ff folded before Flop (didn't bet)


Poker Hand #RC3334602022: Hold'em No Limit ($0.02/$0.05) - 2025/02/17 21:48:28
Table 'RushAndCash637282' 6-max Seat #1 is the button
Seat 1: 18fbcc2b ($1.45 in chips)
Seat 2: ddd8fec4 ($5.13 in chips)
Seat 3: Hero ($5.07 in chips)
Seat 4: d870506c ($5.48 in chips)
Seat 5: 8671b051 ($4.92 in chips)
Seat 6: b87651f7 ($5.59 in chips)
ddd8fec4: posts small blind $0.02
Hero: posts big blind $0.05
*** HOLE CARDS ***
Dealt to 18fbcc2b 
Dealt to ddd8fec4 
Dealt to Hero [9c Kc]
Dealt to d870506c 
Dealt to 8671b051 
Dealt to b87651f7 
d870506c: folds
8671b051: folds
b87651f7: folds
18fbcc2b: raises $0.05 to $0.1
ddd8fec4: folds
Hero: calls $0.05
*** FLOP *** [Jd 5d 2h]
Hero: checks
18fbcc2b: bets $0.11
Hero: folds
Uncalled bet ($0.11) returned to 18fbcc2b
*** SHOWDOWN ***
18fbcc2b collected $0.21 from pot
*** SUMMARY ***
Total pot $0.22 | Rake $0.01 | Jackpot $0 | Bingo $0 | Fortune $0 | Tax $0
Board [Jd 5d 2h]
Seat 1: 18fbcc2b (button) won ($0.21)
Seat 2: ddd8fec4 (small blind) folded before Flop
Seat 3: Hero (big blind) folded on the Flop
Seat 4: d870506c folded before Flop (didn't bet)
Seat 5: 8671b051 folded before Flop (didn't bet)
Seat 6: b87651f7 folded before Flop (didn't bet)


Poker Hand #RC3334601994: Hold'em No Limit ($0.02/$0.05) - 2025/02/17 21:48:25
Table 'RushAndCash637254' 6-max Seat #1 is the button
Seat 1: 47b2c33d ($6.12 in chips)
Seat 2: 719071b8 ($7.23 in chips)
Seat 3: e7d8e6cc ($0.61 in chips)
Seat 4: 5abb6a6d ($5 in chips)
Seat 5: 38005dc9 ($2.56 in chips)
Seat 6: Hero ($5.07 in chips)
719071b8: posts small blind $0.02
e7d8e6cc: posts big blind $0.05
*** HOLE CARDS ***
Dealt to 47b2c33d 
Dealt to 719071b8 
Dealt to e7d8e6cc 
Dealt to 5abb6a6d 
Dealt to 38005dc9 
Dealt to Hero [3d 2c]
5abb6a6d: folds
38005dc9: folds
Hero: folds
47b2c33d: raises $0.08 to $0.13
719071b8: folds
e7d8e6cc: calls $0.08
*** FLOP *** [7h 9s 9c]
e7d8e6cc: bets $0.28
47b2c33d: raises $0.28 to $0.56
e7d8e6cc: calls $0.2 and is all-in
Uncalled bet ($0.08) returned to 47b2c33d
47b2c33d: shows [7d Ac] (Pair of Nines and Pair of Sevens)
e7d8e6cc: shows [9h Th] (Three Nines)
*** TURN *** [7h 9s 9c] [Ah]
*** RIVER *** [7h 9s 9c Ah] [Td]
*** SHOWDOWN ***
e7d8e6cc collected $1.18 from pot
*** SUMMARY ***
Total pot $1.24 | Rake $0.06 | Jackpot $0 | Bingo $0 | Fortune $0 | Tax $0
Board [7h 9s 9c Ah Td]
Seat 1: 47b2c33d (button) showed [7d Ac] and lost with Pair of Aces and Pair of Nines
Seat 2: 719071b8 (small blind) folded before Flop
Seat 3: e7d8e6cc (big blind) showed [9h Th] and won ($1.18) with Nines Full over Tens
Seat 4: 5abb6a6d folded before Flop (didn't bet)
Seat 5: 38005dc9 folded before Flop (didn't bet)
Seat 6: Hero folded before Flop (didn't bet)


Poker Hand #RC3334601964: Hold'em No Limit ($0.02/$0.05) - 2025/02/17 21:48:22
Table 'RushAndCash637224' 6-max Seat #1 is the button
Seat 1: 62fdcc3c ($9.86 in chips)
Seat 2: b74983a1 ($5.31 in chips)
Seat 3: Hero ($5.12 in chips)
Seat 4: 62156df3 ($7.67 in chips)
Seat 5: ff65d17f ($7.24 in chips)
Seat 6: 719071b8 ($7.23 in chips)
b74983a1: posts small blind $0.02
Hero: posts big blind $0.05
*** HOLE CARDS ***
Dealt to 62fdcc3c 
Dealt to b74983a1 
Dealt to Hero [5s 7h]
Dealt to 62156df3 
Dealt to ff65d17f 
Dealt to 719071b8 
62156df3: folds
ff65d17f: raises $0.08 to $0.13
719071b8: folds
62fdcc3c: folds
b74983a1: calls $0.11
Hero: folds
*** FLOP *** [5h Jc 8c]
b74983a1: checks
ff65d17f: checks
*** TURN *** [5h Jc 8c] [6s]
b74983a1: checks
ff65d17f: bets $0.15
b74983a1: folds
Uncalled bet ($0.15) returned to ff65d17f
*** SHOWDOWN ***
ff65d17f collected $0.3 from pot
*** SUMMARY ***
Total pot $0.31 | Rake $0.01 | Jackpot $0 | Bingo $0 | Fortune $0 | Tax $0
Board [5h Jc 8c 6s]
Seat 1: 62fdcc3c (button) folded before Flop (didn't bet)
Seat 2: b74983a1 (small blind) folded on the Turn
Seat 3: Hero (big blind) folded before Flop
Seat 4: 62156df3 folded before Flop (didn't bet)
Seat 5: ff65d17f won ($0.3)
Seat 6: 719071b8 folded before Flop (didn't bet)


Poker Hand #RC3334601905: Hold'em No Limit ($0.02/$0.05) - 2025/02/17 21:48:15
Table 'RushAndCash637165' 6-max Seat #1 is the button
Seat 1: Hero ($5.12 in chips)
Seat 2: 2aa9c26c ($4.19 in chips)
Seat 3: f53325ff ($4.98 in chips)
Seat 4: 76092425 ($5.04 in chips)
Seat 5: 55e0d4fe ($8.98 in chips)
Seat 6: 610144dc ($4.64 in chips)
2aa9c26c: posts small blind $0.02
f53325ff: posts big blind $0.05
*** HOLE CARDS ***
Dealt to Hero [Kc Tc]
Dealt to 2aa9c26c 
Dealt to f53325ff 
Dealt to 76092425 
Dealt to 55e0d4fe 
Dealt to 610144dc 
76092425: folds
55e0d4fe: raises $0.07 to $0.12
610144dc: folds
Hero: folds
2aa9c26c: folds
f53325ff: folds
Uncalled bet ($0.07) returned to 55e0d4fe
*** SHOWDOWN ***
55e0d4fe collected $0.12 from pot
*** SUMMARY ***
Total pot $0.12 | Rake $0 | Jackpot $0 | Bingo $0 | Fortune $0 | Tax $0
Seat 1: Hero (button) folded before Flop (didn't bet)
Seat 2: 2aa9c26c (small blind) folded before Flop
Seat 3: f53325ff (big blind) folded before Flop
Seat 4: 76092425 folded before Flop (didn't bet)
Seat 5: 55e0d4fe collected ($0.12)
Seat 6: 610144dc folded before Flop (didn't bet)


Poker Hand #RC3334601876: Hold'em No Limit ($0.02/$0.05) - 2025/02/17 21:48:12
Table 'RushAndCash637136' 6-max Seat #1 is the button
Seat 1: c24b20b9 ($17.27 in chips)
Seat 2: Hero ($5.14 in chips)
Seat 3: 31f44d74 ($7.17 in chips)
Seat 4: 88aa3863 ($5 in chips)
Seat 5: 14d966a6 ($8.36 in chips)
Seat 6: 1a2d8f33 ($8.18 in chips)
Hero: posts small blind $0.02
31f44d74: posts big blind $0.05
*** HOLE CARDS ***
Dealt to c24b20b9 
Dealt to Hero [7s Js]
Dealt to 31f44d74 
Dealt to 88aa3863 
Dealt to 14d966a6 
Dealt to 1a2d8f33 
88aa3863: raises $0.08 to $0.13
14d966a6: folds
1a2d8f33: folds
c24b20b9: raises $0.25 to $0.38
Hero: folds
31f44d74: folds
88aa3863: folds
Uncalled bet ($0.25) returned to c24b20b9
*** SHOWDOWN ***
c24b20b9 collected $0.32 from pot
*** SUMMARY ***
Total pot $0.33 | Rake $0.01 | Jackpot $0 | Bingo $0 | Fortune $0 | Tax $0
Seat 1: c24b20b9 (button) collected ($0.32)
Seat 2: Hero (small blind) folded before Flop
Seat 3: 31f44d74 (big blind) folded before Flop
Seat 4: 88aa3863 folded before Flop
Seat 5: 14d966a6 folded before Flop (didn't bet)
Seat 6: 1a2d8f33 folded before Flop (didn't bet)


Poker Hand #RC3334601846: Hold'em No Limit ($0.02/$0.05) - 2025/02/17 21:48:08
Table 'RushAndCash637106' 6-max Seat #1 is the button
Seat 1: c6e11d19 ($5 in chips)
Seat 2: b9f66756 ($5.21 in chips)
Seat 3: 869f5988 ($5.5 in chips)
Seat 4: Hero ($5.14 in chips)
Seat 5: 7d556318 ($5 in chips)
Seat 6: 72b3f81 ($5.88 in chips)
b9f66756: posts small blind $0.02
869f5988: posts big blind $0.05
*** HOLE CARDS ***
Dealt to c6e11d19 
Dealt to b9f66756 
Dealt to 869f5988 
Dealt to Hero [Jc 8d]
Dealt to 7d556318 
Dealt to 72b3f81 
Hero: folds
7d556318: folds
72b3f81: folds
c6e11d19: raises $0.05 to $0.1
b9f66756: folds
869f5988: calls $0.05
*** FLOP *** [3d 6s 6d]
869f5988: checks
c6e11d19: bets $0.08
869f5988: calls $0.08
*** TURN *** [3d 6s 6d] [As]
869f5988: checks
c6e11d19: bets $0.2
869f5988: calls $0.2
*** RIVER *** [3d 6s 6d As] [4d]
869f5988: bets $0.26
c6e11d19: folds
Uncalled bet ($0.26) returned to 869f5988
*** SHOWDOWN ***
869f5988 collected $0.75 from pot
*** SUMMARY ***
Total pot $0.78 | Rake $0.03 | Jackpot $0 | Bingo $0 | Fortune $0 | Tax $0
Board [3d 6s 6d As 4d]
Seat 1: c6e11d19 (button) folded on the River
Seat 2: b9f66756 (small blind) folded before Flop
Seat 3: 869f5988 (big blind) won ($0.75)
Seat 4: Hero folded before Flop (didn't bet)
Seat 5: 7d556318 folded before Flop (didn't bet)
Seat 6: 72b3f81 folded before Flop (didn't bet)


Poker Hand #RC3334601614: Hold'em No Limit ($0.02/$0.05) - 2025/02/17 21:47:43
Table 'RushAndCash636874' 6-max Seat #1 is the button
Seat 1: Hero ($5 in chips)
Seat 2: 72b3f81 ($5.98 in chips)
Seat 3: c501a5b2 ($4.93 in chips)
Seat 4: 96707874 ($5.25 in chips)
Seat 5: 45f47d64 ($5 in chips)
Seat 6: 1f960832 ($5.71 in chips)
72b3f81: posts small blind $0.02
c501a5b2: posts big blind $0.05
*** HOLE CARDS ***
Dealt to Hero [Jd Js]
Dealt to 72b3f81 
Dealt to c501a5b2 
Dealt to 96707874 
Dealt to 45f47d64 
Dealt to 1f960832 
96707874: folds
45f47d64: folds
1f960832: folds
Hero: raises $0.05 to $0.1
72b3f81: calls $0.08
c501a5b2: folds
*** FLOP *** [9d 3h 3s]
72b3f81: checks
Hero: bets $0.14
72b3f81: folds
Uncalled bet ($0.14) returned to Hero
*** SHOWDOWN ***
Hero collected $0.24 from pot
*** SUMMARY ***
Total pot $0.25 | Rake $0.01 | Jackpot $0 | Bingo $0 | Fortune $0 | Tax $0
Board [9d 3h 3s]
Seat 1: Hero (button) won ($0.24)
Seat 2: 72b3f81 (small blind) folded on the Flop
Seat 3: c501a5b2 (big blind) folded before Flop
Seat 4: 96707874 folded before Flop (didn't bet)
Seat 5: 45f47d64 folded before Flop (didn't bet)
Seat 6: 1f960832 folded before Flop (didn't bet)


Poker Hand #RC3334601319: Hold'em No Limit ($0.02/$0.05) - 2025/02/17 21:47:08
Table 'RushAndCash636579' 6-max Seat #1 is the button
Seat 1: 3e301744 ($10.33 in chips)
Seat 2: a19fb924 ($7.04 in chips)
Seat 3: f7759ba6 ($5.55 in chips)
Seat 4: Hero ($5.02 in chips)
Seat 5: 191b60c1 ($9.79 in chips)
Seat 6: 4a2c171f ($5.66 in chips)
a19fb924: posts small blind $0.02
f7759ba6: posts big blind $0.05
*** HOLE CARDS ***
Dealt to 3e301744 
Dealt to a19fb924 
Dealt to f7759ba6 
Dealt to Hero [Jh Ks]
Dealt to 191b60c1 
Dealt to 4a2c171f 
Hero: raises $0.05 to $0.1
191b60c1: folds
4a2c171f: folds
3e301744: folds
a19fb924: calls $0.08
f7759ba6: calls $0.05
*** FLOP *** [5s Ac 2s]
a19fb924: checks
f7759ba6: checks
Hero: checks
*** TURN *** [5s Ac 2s] [Ah]
a19fb924: bets $0.1
f7759ba6: folds
Hero: folds
Uncalled bet ($0.1) returned to a19fb924
*** SHOWDOWN ***
a19fb924 collected $0.29 from pot
*** SUMMARY ***
Total pot $0.3 | Rake $0.01 | Jackpot $0 | Bingo $0 | Fortune $0 | Tax $0
Board [5s Ac 2s Ah]
Seat 1: 3e301744 (button) folded before Flop (didn't bet)
Seat 2: a19fb924 (small blind) won ($0.29)
Seat 3: f7759ba6 (big blind) folded on the Turn
Seat 4: Hero folded on the Turn
Seat 5: 191b60c1 folded before Flop (didn't bet)
Seat 6: 4a2c171f folded before Flop (didn't bet)


Poker Hand #RC3334601236: Hold'em No Limit ($0.02/$0.05) - 2025/02/17 21:47:00
Table 'RushAndCash636496' 6-max Seat #1 is the button
Seat 1: Hero ($5.02 in chips)
Seat 2: 198a1e4 ($7.98 in chips)
Seat 3: 820e1571 ($5.07 in chips)
Seat 4: f53325ff ($5.03 in chips)
Seat 5: a730170a ($5.14 in chips)
Seat 6: e4aeeb30 ($5.61 in chips)
198a1e4: posts small blind $0.02
820e1571: posts big blind $0.05
*** HOLE CARDS ***
Dealt to Hero [Qd 3h]
Dealt to 198a1e4 
Dealt to 820e1571 
Dealt to f53325ff 
Dealt to a730170a 
Dealt to e4aeeb30 
f53325ff: raises $0.08 to $0.13
a730170a: folds
e4aeeb30: folds
Hero: folds
198a1e4: folds
820e1571: raises $0.47 to $0.6
f53325ff: calls $0.47
*** FLOP *** [Ad 4h Jh]
820e1571: bets $0.5
f53325ff: folds
Uncalled bet ($0.5) returned to 820e1571
*** SHOWDOWN ***
820e1571 collected $1.16 from pot
*** SUMMARY ***
Total pot $1.22 | Rake $0.06 | Jackpot $0 | Bingo $0 | Fortune $0 | Tax $0
Board [Ad 4h Jh]
Seat 1: Hero (button) folded before Flop (didn't bet)
Seat 2: 198a1e4 (small blind) folded before Flop
Seat 3: 820e1571 (big blind) won ($1.16)
Seat 4: f53325ff folded on the Flop
Seat 5: a730170a folded before Flop (didn't bet)
Seat 6: e4aeeb30 folded before Flop (didn't bet)


Poker Hand #RC3334601201: Hold'em No Limit ($0.02/$0.05) - 2025/02/17 21:46:57
Table 'RushAndCash636461' 6-max Seat #1 is the button
Seat 1: 89c4e71b ($5.1 in chips)
Seat 2: 717e9861 ($10.59 in chips)
Seat 3: 1dd0b66b ($6.31 in chips)
Seat 4: Hero ($5.02 in chips)
Seat 5: d0c5fe0e ($5.03 in chips)
Seat 6: 53a8c2fd ($8.28 in chips)
717e9861: posts small blind $0.02
1dd0b66b: posts big blind $0.05
*** HOLE CARDS ***
Dealt to 89c4e71b 
Dealt to 717e9861 
Dealt to 1dd0b66b 
Dealt to Hero [2s Ad]
Dealt to d0c5fe0e 
Dealt to 53a8c2fd 
Hero: folds
d0c5fe0e: folds
53a8c2fd: raises $0.07 to $0.12
89c4e71b: folds
717e9861: folds
1dd0b66b: folds
Uncalled bet ($0.07) returned to 53a8c2fd
*** SHOWDOWN ***
53a8c2fd collected $0.12 from pot
*** SUMMARY ***
Total pot $0.12 | Rake $0 | Jackpot $0 | Bingo $0 | Fortune $0 | Tax $0
Seat 1: 89c4e71b (button) folded before Flop (didn't bet)
Seat 2: 717e9861 (small blind) folded before Flop
Seat 3: 1dd0b66b (big blind) folded before Flop
Seat 4: Hero folded before Flop (didn't bet)
Seat 5: d0c5fe0e folded before Flop (didn't bet)
Seat 6: 53a8c2fd collected ($0.12)


Poker Hand #RC3334601145: Hold'em No Limit ($0.02/$0.05) - 2025/02/17 21:46:51
Table 'RushAndCash636405' 6-max Seat #1 is the button
Seat 1: c3ca6759 ($5.61 in chips)
Seat 2: 3b2a8270 ($10.57 in chips)
Seat 3: aeb50acd ($11.64 in chips)
Seat 4: Hero ($5.02 in chips)
Seat 5: 1b6c31ec ($11.42 in chips)
Seat 6: 677c4b25 ($11.58 in chips)
3b2a8270: posts small blind $0.02
aeb50acd: posts big blind $0.05
*** HOLE CARDS ***
Dealt to c3ca6759 
Dealt to 3b2a8270 
Dealt to aeb50acd 
Dealt to Hero [Ts Jd]
Dealt to 1b6c31ec 
Dealt to 677c4b25 
Hero: folds
1b6c31ec: folds
677c4b25: raises $0.06 to $0.11
c3ca6759: folds
3b2a8270: folds
aeb50acd: folds
Uncalled bet ($0.06) returned to 677c4b25
*** SHOWDOWN ***
677c4b25 collected $0.12 from pot
*** SUMMARY ***
Total pot $0.12 | Rake $0 | Jackpot $0 | Bingo $0 | Fortune $0 | Tax $0
Seat 1: c3ca6759 (button) folded before Flop (didn't bet)
Seat 2: 3b2a8270 (small blind) folded before Flop
Seat 3: aeb50acd (big blind) folded before Flop
Seat 4: Hero folded before Flop (didn't bet)
Seat 5: 1b6c31ec folded before Flop (didn't bet)
Seat 6: 677c4b25 collected ($0.12)


Poker Hand #RC3334601103: Hold'em No Limit ($0.02/$0.05) - 2025/02/17 21:46:46
Table 'RushAndCash636363' 6-max Seat #1 is the button
Seat 1: c27051e0 ($5.43 in chips)
Seat 2: 218dd9df ($10.05 in chips)
Seat 3: 4e53b23f ($5.24 in chips)
Seat 4: 3db4c32a ($5.77 in chips)
Seat 5: Hero ($5.02 in chips)
Seat 6: 9f70f94d ($7.53 in chips)
218dd9df: posts small blind $0.02
4e53b23f: posts big blind $0.05
*** HOLE CARDS ***
Dealt to c27051e0 
Dealt to 218dd9df 
Dealt to 4e53b23f 
Dealt to 3db4c32a 
Dealt to Hero [6h 6d]
Dealt to 9f70f94d 
3db4c32a: folds
Hero: folds
9f70f94d: folds
c27051e0: folds
218dd9df: folds
Uncalled bet ($0.03) returned to 4e53b23f
*** SHOWDOWN ***
4e53b23f collected $0.04 from pot
*** SUMMARY ***
Total pot $0.04 | Rake $0 | Jackpot $0 | Bingo $0 | Fortune $0 | Tax $0
Seat 1: c27051e0 (button) folded before Flop (didn't bet)
Seat 2: 218dd9df (small blind) folded before Flop
Seat 3: 4e53b23f (big blind) collected ($0.04)
Seat 4: 3db4c32a folded before Flop (didn't bet)
Seat 5: Hero folded before Flop (didn't bet)
Seat 6: 9f70f94d folded before Flop (didn't bet)


Poker Hand #RC3334601029: Hold'em No Limit ($0.02/$0.05) - 2025/02/17 21:46:38
Table 'RushAndCash636289' 6-max Seat #1 is the button
Seat 1: 32d40ce0 ($5.78 in chips)
Seat 2: cf7f09c2 ($11.23 in chips)
Seat 3: Hero ($5 in chips)
Seat 4: 381c6d82 ($23.42 in chips)
Seat 5: c349b3b1 ($5 in chips)
Seat 6: 38005dc9 ($2.54 in chips)
cf7f09c2: posts small blind $0.02
Hero: posts big blind $0.05
*** HOLE CARDS ***
Dealt to 32d40ce0 
Dealt to cf7f09c2 
Dealt to Hero [8c 8s]
Dealt to 381c6d82 
Dealt to c349b3b1 
Dealt to 38005dc9 
381c6d82: folds
c349b3b1: folds
38005dc9: folds
32d40ce0: folds
cf7f09c2: folds
Uncalled bet ($0.03) returned to Hero
*** SHOWDOWN ***
Hero collected $0.04 from pot
*** SUMMARY ***
Total pot $0.04 | Rake $0 | Jackpot $0 | Bingo $0 | Fortune $0 | Tax $0
Seat 1: 32d40ce0 (button) folded before Flop (didn't bet)
Seat 2: cf7f09c2 (small blind) folded before Flop
Seat 3: Hero (big blind) collected ($0.04)
Seat 4: 381c6d82 folded before Flop (didn't bet)
Seat 5: c349b3b1 folded before Flop (didn't bet)
Seat 6: 38005dc9 folded before Flop (didn't bet)


Poker Hand #RC3334600976: Hold'em No Limit ($0.02/$0.05) - 2025/02/17 21:46:31
Table 'RushAndCash636236' 6-max Seat #1 is the button
Seat 1: 345ce3dc ($5.16 in chips)
Seat 2: Hero ($5 in chips)
Seat 3: 915fe0fb ($5.63 in chips)
Seat 4: 1095926a ($5.12 in chips)
Seat 5: d75cab93 ($14.61 in chips)
Seat 6: f691c1c2 ($5.09 in chips)
Hero: posts small blind $0.02
915fe0fb: posts big blind $0.05
*** HOLE CARDS ***
Dealt to 345ce3dc 
Dealt to Hero [3c Kd]
Dealt to 915fe0fb 
Dealt to 1095926a 
Dealt to d75cab93 
Dealt to f691c1c2 
1095926a: folds
d75cab93: folds
f691c1c2: folds
345ce3dc: folds
Hero: folds
Uncalled bet ($0.03) returned to 915fe0fb
*** SHOWDOWN ***
915fe0fb collected $0.04 from pot
*** SUMMARY ***
Total pot $0.04 | Rake $0 | Jackpot $0 | Bingo $0 | Fortune $0 | Tax $0
Seat 1: 345ce3dc (button) folded before Flop (didn't bet)
Seat 2: Hero (small blind) folded before Flop
Seat 3: 915fe0fb (big blind) collected ($0.04)
Seat 4: 1095926a folded before Flop (didn't bet)
Seat 5: d75cab93 folded before Flop (didn't bet)
Seat 6: f691c1c2 folded before Flop (didn't bet)


Poker Hand #RC3334600779: Hold'em No Limit ($0.02/$0.05) - 2025/02/17 21:46:09
Table 'RushAndCash636039' 6-max Seat #1 is the button
Seat 1: 52f54c69 ($5.26 in chips)
Seat 2: fdbac393 ($14.64 in chips)
Seat 3: bcb971d3 ($8.01 in chips)
Seat 4: Hero ($5 in chips)
Seat 5: ac6c5037 ($7.54 in chips)
Seat 6: e79aba5a ($5 in chips)
fdbac393: posts small blind $0.02
bcb971d3: posts big blind $0.05
*** HOLE CARDS ***
Dealt to 52f54c69 
Dealt to fdbac393 
Dealt to bcb971d3 
Dealt to Hero [8s 8h]
Dealt to ac6c5037 
Dealt to e79aba5a 
Hero: raises $0.05 to $0.1
ac6c5037: raises $0.2 to $0.3
e79aba5a: folds
52f54c69: calls $0.3
fdbac393: folds
bcb971d3: folds
Hero: calls $0.2
*** FLOP *** [5c Kh As]
Hero: checks
ac6c5037: bets $0.25
52f54c69: calls $0.25
Hero: folds
*** TURN *** [5c Kh As] [2c]
ac6c5037: checks
52f54c69: bets $0.9
ac6c5037: raises $1.1 to $2
52f54c69: raises $2.71 to $4.71 and is all-in
ac6c5037: calls $2.71
52f54c69: shows [2s 5s] (Pair of Fives and Pair of Twos)
ac6c5037: shows [3d 4d] (Fives-High Straight)
*** RIVER *** [5c Kh As 2c] [5h]
*** SHOWDOWN ***
52f54c69 collected $10.67 from pot
*** SUMMARY ***
Total pot $10.89 | Rake $0.15 | Jackpot $0.07 | Bingo $0 | Fortune $0 | Tax $0
Board [5c Kh As 2c 5h]
Seat 1: 52f54c69 (button) showed [2s 5s] and won ($10.67) with Fives Full over Twos
Seat 2: fdbac393 (small blind) folded before Flop
Seat 3: bcb971d3 (big blind) folded before Flop
Seat 4: Hero folded on the Flop
Seat 5: ac6c5037 showed [3d 4d] and lost with Fives-High Straight
Seat 6: e79aba5a folded before Flop (didn't bet)


Poker Hand #RC3334600748: Hold'em No Limit ($0.02/$0.05) - 2025/02/17 21:46:05
Table 'RushAndCash636008' 6-max Seat #1 is the button
Seat 1: c3ae0b9c ($5.07 in chips)
Seat 2: bc9f4180 ($5.43 in chips)
Seat 3: 381c6d82 ($23.33 in chips)
Seat 4: Hero ($5 in chips)
Seat 5: 62fdcc3c ($10.26 in chips)
Seat 6: 4f63019a ($4.63 in chips)
bc9f4180: posts small blind $0.02
381c6d82: posts big blind $0.05
*** HOLE CARDS ***
Dealt to c3ae0b9c 
Dealt to bc9f4180 
Dealt to 381c6d82 
Dealt to Hero [9d 3d]
Dealt to 62fdcc3c 
Dealt to 4f63019a 
Hero: folds
62fdcc3c: folds
4f63019a: folds
c3ae0b9c: folds
bc9f4180: folds
Uncalled bet ($0.03) returned to 381c6d82
*** SHOWDOWN ***
381c6d82 collected $0.04 from pot
*** SUMMARY ***
Total pot $0.04 | Rake $0 | Jackpot $0 | Bingo $0 | Fortune $0 | Tax $0
Seat 1: c3ae0b9c (button) folded before Flop (didn't bet)
Seat 2: bc9f4180 (small blind) folded before Flop
Seat 3: 381c6d82 (big blind) collected ($0.04)
Seat 4: Hero folded before Flop (didn't bet)
Seat 5: 62fdcc3c folded before Flop (didn't bet)
Seat 6: 4f63019a folded before Flop (didn't bet)


Poker Hand #RC3334600716: Hold'em No Limit ($0.02/$0.05) - 2025/02/17 21:46:01
Table 'RushAndCash635976' 6-max Seat #1 is the button
Seat 1: 5a37a767 ($7.79 in chips)
Seat 2: Hero ($5 in chips)
Seat 3: 427e0150 ($5 in chips)
Seat 4: 8e07c53 ($11.13 in chips)
Seat 5: c59158f3 ($5.86 in chips)
Seat 6: 4038bf09 ($5.07 in chips)
Hero: posts small blind $0.02
427e0150: posts big blind $0.05
*** HOLE CARDS ***
Dealt to 5a37a767 
Dealt to Hero [6c Jd]
Dealt to 427e0150 
Dealt to 8e07c53 
Dealt to c59158f3 
Dealt to 4038bf09 
8e07c53: folds
c59158f3: raises $0.05 to $0.1
4038bf09: folds
5a37a767: folds
Hero: folds
427e0150: folds
Uncalled bet ($0.05) returned to c59158f3
*** SHOWDOWN ***
c59158f3 collected $0.12 from pot
*** SUMMARY ***
Total pot $0.12 | Rake $0 | Jackpot $0 | Bingo $0 | Fortune $0 | Tax $0
Seat 1: 5a37a767 (button) folded before Flop (didn't bet)
Seat 2: Hero (small blind) folded before Flop
Seat 3: 427e0150 (big blind) folded before Flop
Seat 4: 8e07c53 folded before Flop (didn't bet)
Seat 5: c59158f3 collected ($0.12)
Seat 6: 4038bf09 folded before Flop (didn't bet)


Poker Hand #RC3334600687: Hold'em No Limit ($0.02/$0.05) - 2025/02/17 21:45:58
Table 'RushAndCash635947' 6-max Seat #1 is the button
Seat 1: 49b4f33a ($21.68 in chips)
Seat 2: b56b513d ($1.95 in chips)
Seat 3: 5ea9f27c ($4.94 in chips)
Seat 4: cd69b3e5 ($9.59 in chips)
Seat 5: Hero ($5 in chips)
Seat 6: f0600331 ($7.48 in chips)
b56b513d: posts small blind $0.02
5ea9f27c: posts big blind $0.05
*** HOLE CARDS ***
Dealt to 49b4f33a 
Dealt to b56b513d 
Dealt to 5ea9f27c 
Dealt to cd69b3e5 
Dealt to Hero [6h Jd]
Dealt to f0600331 
cd69b3e5: folds
Hero: folds
f0600331: folds
49b4f33a: raises $0.06 to $0.11
b56b513d: calls $0.09
5ea9f27c: folds
*** FLOP *** [8c 9h 6d]
b56b513d: checks
49b4f33a: checks
*** TURN *** [8c 9h 6d] [2h]
b56b513d: bets $0.21
49b4f33a: folds
Uncalled bet ($0.21) returned to b56b513d
*** SHOWDOWN ***
b56b513d collected $0.26 from pot
*** SUMMARY ***
Total pot $0.27 | Rake $0.01 | Jackpot $0 | Bingo $0 | Fortune $0 | Tax $0
Board [8c 9h 6d 2h]
Seat 1: 49b4f33a (button) folded on the Turn
Seat 2: b56b513d (small blind) won ($0.26)
Seat 3: 5ea9f27c (big blind) folded before Flop
Seat 4: cd69b3e5 folded before Flop (didn't bet)
Seat 5: Hero folded before Flop (didn't bet)
Seat 6: f0600331 folded before Flop (didn't bet)


Poker Hand #RC3334600370: Hold'em No Limit ($0.02/$0.05) - 2025/02/17 21:45:21
Table 'RushAndCash635630' 6-max Seat #1 is the button
Seat 1: 12cda2e0 ($20.68 in chips)
Seat 2: Hero ($5 in chips)
Seat 3: 23c23672 ($5.29 in chips)
Seat 4: 32d40ce0 ($5.9 in chips)
Seat 5: 59238e48 ($5.38 in chips)
Seat 6: a0af0a81 ($5.74 in chips)
Hero: posts small blind $0.02
23c23672: posts big blind $0.05
*** HOLE CARDS ***
Dealt to 12cda2e0 
Dealt to Hero [9h Ah]
Dealt to 23c23672 
Dealt to 32d40ce0 
Dealt to 59238e48 
Dealt to a0af0a81 
32d40ce0: folds
59238e48: folds
a0af0a81: folds
12cda2e0: folds
Hero: calls $0.03
23c23672: checks
*** FLOP *** [4d 3h 7d]
Hero: checks
23c23672: checks
*** TURN *** [4d 3h 7d] [Js]
Hero: checks
23c23672: checks
*** RIVER *** [4d 3h 7d Js] [Td]
Hero: checks
23c23672: checks
Hero: shows [9h Ah] (Ace-High)
23c23672: shows [4c Jh] (Pair of Jacks and Pair of Fours)
*** SHOWDOWN ***
23c23672 collected $0.1 from pot
*** SUMMARY ***
Total pot $0.1 | Rake $0 | Jackpot $0 | Bingo $0 | Fortune $0 | Tax $0
Board [4d 3h 7d Js Td]
Seat 1: 12cda2e0 (button) folded before Flop (didn't bet)
Seat 2: Hero (small blind) showed [9h Ah] and lost with Ace-High
Seat 3: 23c23672 (big blind) showed [4c Jh] and won ($0.1) with Pair of Jacks and Pair of Fours
Seat 4: 32d40ce0 folded before Flop (didn't bet)
Seat 5: 59238e48 folded before Flop (didn't bet)
Seat 6: a0af0a81 folded before Flop (didn't bet)


Poker Hand #RC3334600341: Hold'em No Limit ($0.02/$0.05) - 2025/02/17 21:45:18
Table 'RushAndCash635601' 6-max Seat #1 is the button
Seat 1: Hero ($5 in chips)
Seat 2: efee9c46 ($5.17 in chips)
Seat 3: 86fb354d ($17.45 in chips)
Seat 4: 32d40ce0 ($5.9 in chips)
Seat 5: db6b60a1 ($5.34 in chips)
Seat 6: 3f6d99d0 ($4.11 in chips)
efee9c46: posts small blind $0.02
86fb354d: posts big blind $0.05
*** HOLE CARDS ***
Dealt to Hero [7h 2d]
Dealt to efee9c46 
Dealt to 86fb354d 
Dealt to 32d40ce0 
Dealt to db6b60a1 
Dealt to 3f6d99d0 
32d40ce0: folds
db6b60a1: folds
3f6d99d0: raises $0.05 to $0.1
Hero: folds
efee9c46: folds
86fb354d: folds
Uncalled bet ($0.05) returned to 3f6d99d0
*** SHOWDOWN ***
3f6d99d0 collected $0.12 from pot
*** SUMMARY ***
Total pot $0.12 | Rake $0 | Jackpot $0 | Bingo $0 | Fortune $0 | Tax $0
Seat 1: Hero (button) folded before Flop (didn't bet)
Seat 2: efee9c46 (small blind) folded before Flop
Seat 3: 86fb354d (big blind) folded before Flop
Seat 4: 32d40ce0 folded before Flop (didn't bet)
Seat 5: db6b60a1 folded before Flop (didn't bet)
Seat 6: 3f6d99d0 collected ($0.12)


Poker Hand #RC3334600316: Hold'em No Limit ($0.02/$0.05) - 2025/02/17 21:45:15
Table 'RushAndCash635576' 6-max Seat #1 is the button
Seat 1: 62156df3 ($7.87 in chips)
Seat 2: 37bc5b77 ($5 in chips)
Seat 3: ac56502f ($3.7 in chips)
Seat 4: e59e5895 ($5.19 in chips)
Seat 5: 510f8c9f ($10.89 in chips)
Seat 6: Hero ($5 in chips)
37bc5b77: posts small blind $0.02
ac56502f: posts big blind $0.05
*** HOLE CARDS ***
Dealt to 62156df3 
Dealt to 37bc5b77 
Dealt to ac56502f 
Dealt to e59e5895 
Dealt to 510f8c9f 
Dealt to Hero [3d Qh]
e59e5895: folds
510f8c9f: folds
Hero: folds
62156df3: raises $0.06 to $0.11
37bc5b77: folds
ac56502f: folds
Uncalled bet ($0.06) returned to 62156df3
*** SHOWDOWN ***
62156df3 collected $0.12 from pot
*** SUMMARY ***
Total pot $0.12 | Rake $0 | Jackpot $0 | Bingo $0 | Fortune $0 | Tax $0
Seat 1: 62156df3 (button) collected ($0.12)
Seat 2: 37bc5b77 (small blind) folded before Flop
Seat 3: ac56502f (big blind) folded before Flop
Seat 4: e59e5895 folded before Flop (didn't bet)
Seat 5: 510f8c9f folded before Flop (didn't bet)
Seat 6: Hero folded before Flop (didn't bet)


Poker Hand #RC3334600172: Hold'em No Limit ($0.02/$0.05) - 2025/02/17 21:44:58
Table 'RushAndCash635432' 6-max Seat #1 is the button
Seat 1: 697412e ($11.1 in chips)
Seat 2: 6ad786fd ($6.33 in chips)
Seat 3: Hero ($5 in chips)
Seat 4: ca7c2b72 ($5.11 in chips)
Seat 5: 2d47d29d ($5.11 in chips)
Seat 6: e331f6bb ($4.57 in chips)
6ad786fd: posts small blind $0.02
Hero: posts big blind $0.05
*** HOLE CARDS ***
Dealt to 697412e 
Dealt to 6ad786fd 
Dealt to Hero [Ks 8h]
Dealt to ca7c2b72 
Dealt to 2d47d29d 
Dealt to e331f6bb 
ca7c2b72: raises $0.05 to $0.1
2d47d29d: folds
e331f6bb: folds
697412e: folds
6ad786fd: folds
Hero: folds
Uncalled bet ($0.05) returned to ca7c2b72
*** SHOWDOWN ***
ca7c2b72 collected $0.12 from pot
*** SUMMARY ***
Total pot $0.12 | Rake $0 | Jackpot $0 | Bingo $0 | Fortune $0 | Tax $0
Seat 1: 697412e (button) folded before Flop (didn't bet)
Seat 2: 6ad786fd (small blind) folded before Flop
Seat 3: Hero (big blind) folded before Flop
Seat 4: ca7c2b72 collected ($0.12)
Seat 5: 2d47d29d folded before Flop (didn't bet)
Seat 6: e331f6bb folded before Flop (didn't bet)


Poker Hand #RC3334600145: Hold'em No Limit ($0.02/$0.05) - 2025/02/17 21:44:55
Table 'RushAndCash635405' 6-max Seat #1 is the button
Seat 1: a16d60b6 ($5 in chips)
Seat 2: da5282f0 ($5.02 in chips)
Seat 3: ceaf3b1d ($7.1 in chips)
Seat 4: eae3d655 ($5.46 in chips)
Seat 5: Hero ($5 in chips)
Seat 6: 802a8ffb ($8.55 in chips)
da5282f0: posts small blind $0.02
ceaf3b1d: posts big blind $0.05
*** HOLE CARDS ***
Dealt to a16d60b6 
Dealt to da5282f0 
Dealt to ceaf3b1d 
Dealt to eae3d655 
Dealt to Hero [6h Qs]
Dealt to 802a8ffb 
eae3d655: folds
Hero: folds
802a8ffb: folds
a16d60b6: raises $0.05 to $0.1
da5282f0: folds
ceaf3b1d: folds
Uncalled bet ($0.05) returned to a16d60b6
*** SHOWDOWN ***
a16d60b6 collected $0.12 from pot
*** SUMMARY ***
Total pot $0.12 | Rake $0 | Jackpot $0 | Bingo $0 | Fortune $0 | Tax $0
Seat 1: a16d60b6 (button) collected ($0.12)
Seat 2: da5282f0 (small blind) folded before Flop
Seat 3: ceaf3b1d (big blind) folded before Flop
Seat 4: eae3d655 folded before Flop (didn't bet)
Seat 5: Hero folded before Flop (didn't bet)
Seat 6: 802a8ffb folded before Flop (didn't bet)


Poker Hand #RC3334600116: Hold'em No Limit ($0.02/$0.05) - 2025/02/17 21:44:52
Table 'RushAndCash635376' 6-max Seat #1 is the button
Seat 1: e7d8e6cc ($1.9 in chips)
Seat 2: edbb0bb6 ($5 in chips)
Seat 3: f9d64f1a ($5.38 in chips)
Seat 4: 62156df3 ($7.99 in chips)
Seat 5: ab43c8b8 ($8.92 in chips)
Seat 6: Hero ($5 in chips)
edbb0bb6: posts small blind $0.02
f9d64f1a: posts big blind $0.05
*** HOLE CARDS ***
Dealt to e7d8e6cc 
Dealt to edbb0bb6 
Dealt to f9d64f1a 
Dealt to 62156df3 
Dealt to ab43c8b8 
Dealt to Hero [7d 9c]
62156df3: folds
ab43c8b8: folds
Hero: folds
e7d8e6cc: folds
edbb0bb6: raises $0.05 to $0.1
f9d64f1a: folds
Uncalled bet ($0.05) returned to edbb0bb6
*** SHOWDOWN ***
edbb0bb6 collected $0.1 from pot
*** SUMMARY ***
Total pot $0.1 | Rake $0 | Jackpot $0 | Bingo $0 | Fortune $0 | Tax $0
Seat 1: e7d8e6cc (button) folded before Flop (didn't bet)
Seat 2: edbb0bb6 (small blind) collected ($0.1)
Seat 3: f9d64f1a (big blind) folded before Flop
Seat 4: 62156df3 folded before Flop (didn't bet)
Seat 5: ab43c8b8 folded before Flop (didn't bet)
Seat 6: Hero folded before Flop (didn't bet)


Poker Hand #RC3334600062: Hold'em No Limit ($0.02/$0.05) - 2025/02/17 21:44:46
Table 'RushAndCash635322' 6-max Seat #1 is the button
Seat 1: 5e4e4a51 ($1 in chips)
Seat 2: d75cab93 ($13.07 in chips)
Seat 3: a9d8ced4 ($5.68 in chips)
Seat 4: 42fdd5b8 ($5.03 in chips)
Seat 5: Hero ($5 in chips)
Seat 6: 7c8b3964 ($10.75 in chips)
d75cab93: posts small blind $0.02
a9d8ced4: posts big blind $0.05
*** HOLE CARDS ***
Dealt to 5e4e4a51 
Dealt to d75cab93 
Dealt to a9d8ced4 
Dealt to 42fdd5b8 
Dealt to Hero [4d Jd]
Dealt to 7c8b3964 
42fdd5b8: folds
Hero: folds
7c8b3964: raises $0.05 to $0.1
5e4e4a51: folds
d75cab93: folds
a9d8ced4: folds
Uncalled bet ($0.05) returned to 7c8b3964
*** SHOWDOWN ***
7c8b3964 collected $0.12 from pot
*** SUMMARY ***
Total pot $0.12 | Rake $0 | Jackpot $0 | Bingo $0 | Fortune $0 | Tax $0
Seat 1: 5e4e4a51 (button) folded before Flop (didn't bet)
Seat 2: d75cab93 (small blind) folded before Flop
Seat 3: a9d8ced4 (big blind) folded before Flop
Seat 4: 42fdd5b8 folded before Flop (didn't bet)
Seat 5: Hero folded before Flop (didn't bet)
Seat 6: 7c8b3964 collected ($0.12)


Poker Hand #RC3334600023: Hold'em No Limit ($0.02/$0.05) - 2025/02/17 21:44:42
Table 'RushAndCash635283' 6-max Seat #1 is the button
Seat 1: 9f09d482 ($12.22 in chips)
Seat 2: 9c00bca7 ($5.37 in chips)
Seat 3: 38005dc9 ($3.3 in chips)
Seat 4: da5282f0 ($5.07 in chips)
Seat 5: Hero ($5 in chips)
Seat 6: 2b6ba85b ($4.51 in chips)
9c00bca7: posts small blind $0.02
38005dc9: posts big blind $0.05
*** HOLE CARDS ***
Dealt to 9f09d482 
Dealt to 9c00bca7 
Dealt to 38005dc9 
Dealt to da5282f0 
Dealt to Hero [Tc 2c]
Dealt to 2b6ba85b 
da5282f0: folds
Hero: folds
2b6ba85b: folds
9f09d482: folds
9c00bca7: folds
Uncalled bet ($0.03) returned to 38005dc9
*** SHOWDOWN ***
38005dc9 collected $0.04 from pot
*** SUMMARY ***
Total pot $0.04 | Rake $0 | Jackpot $0 | Bingo $0 | Fortune $0 | Tax $0
Seat 1: 9f09d482 (button) folded before Flop (didn't bet)
Seat 2: 9c00bca7 (small blind) folded before Flop
Seat 3: 38005dc9 (big blind) collected ($0.04)
Seat 4: da5282f0 folded before Flop (didn't bet)
Seat 5: Hero folded before Flop (didn't bet)
Seat 6: 2b6ba85b folded before Flop (didn't bet)


Poker Hand #RC3334599998: Hold'em No Limit ($0.02/$0.05) - 2025/02/17 21:44:39
Table 'RushAndCash635258' 6-max Seat #1 is the button
Seat 1: 787e1958 ($5 in chips)
Seat 2: da5282f0 ($5.02 in chips)
Seat 3: 4a2c171f ($5.37 in chips)
Seat 4: 8c8bf19e ($5.34 in chips)
Seat 5: dfc02c40 ($6.23 in chips)
Seat 6: Hero ($5 in chips)
da5282f0: posts small blind $0.02
4a2c171f: posts big blind $0.05
*** HOLE CARDS ***
Dealt to 787e1958 
Dealt to da5282f0 
Dealt to 4a2c171f 
Dealt to 8c8bf19e 
Dealt to dfc02c40 
Dealt to Hero [5d 9s]
8c8bf19e: folds
dfc02c40: folds
Hero: folds
787e1958: folds
da5282f0: folds
Uncalled bet ($0.03) returned to 4a2c171f
*** SHOWDOWN ***
4a2c171f collected $0.04 from pot
*** SUMMARY ***
Total pot $0.04 | Rake $0 | Jackpot $0 | Bingo $0 | Fortune $0 | Tax $0
Seat 1: 787e1958 (button) folded before Flop (didn't bet)
Seat 2: da5282f0 (small blind) folded before Flop
Seat 3: 4a2c171f (big blind) collected ($0.04)
Seat 4: 8c8bf19e folded before Flop (didn't bet)
Seat 5: dfc02c40 folded before Flop (didn't bet)
Seat 6: Hero folded before Flop (didn't bet)


Poker Hand #RC3334599969: Hold'em No Limit ($0.02/$0.05) - 2025/02/17 21:44:36
Table 'RushAndCash635229' 6-max Seat #1 is the button
Seat 1: b28541cc ($4.86 in chips)
Seat 2: Hero ($5 in chips)
Seat 3: b2966865 ($12.03 in chips)
Seat 4: f9d64f1a ($5.4 in chips)
Seat 5: dfc02c40 ($6.23 in chips)
Seat 6: a19fb924 ($7.06 in chips)
Hero: posts small blind $0.02
b2966865: posts big blind $0.05
*** HOLE CARDS ***
Dealt to b28541cc 
Dealt to Hero [2d Jd]
Dealt to b2966865 
Dealt to f9d64f1a 
Dealt to dfc02c40 
Dealt to a19fb924 
f9d64f1a: folds
dfc02c40: folds
a19fb924: folds
b28541cc: folds
Hero: folds
Uncalled bet ($0.03) returned to b2966865
*** SHOWDOWN ***
b2966865 collected $0.04 from pot
*** SUMMARY ***
Total pot $0.04 | Rake $0 | Jackpot $0 | Bingo $0 | Fortune $0 | Tax $0
Seat 1: b28541cc (button) folded before Flop (didn't bet)
Seat 2: Hero (small blind) folded before Flop
Seat 3: b2966865 (big blind) collected ($0.04)
Seat 4: f9d64f1a folded before Flop (didn't bet)
Seat 5: dfc02c40 folded before Flop (didn't bet)
Seat 6: a19fb924 folded before Flop (didn't bet)


Poker Hand #RC3334599912: Hold'em No Limit ($0.02/$0.05) - 2025/02/17 21:44:29
Table 'RushAndCash635172' 6-max Seat #1 is the button
Seat 1: Hero ($5 in chips)
Seat 2: 2f016cc4 ($10.14 in chips)
Seat 3: d9558276 ($14.76 in chips)
Seat 4: 292d1602 ($5.26 in chips)
Seat 5: 50d79ef5 ($6.42 in chips)
Seat 6: b4cd57cf ($10.85 in chips)
2f016cc4: posts small blind $0.02
d9558276: posts big blind $0.05
*** HOLE CARDS ***
Dealt to Hero [Td 2h]
Dealt to 2f016cc4 
Dealt to d9558276 
Dealt to 292d1602 
Dealt to 50d79ef5 
Dealt to b4cd57cf 
292d1602: folds
50d79ef5: folds
b4cd57cf: folds
Hero: folds
2f016cc4: raises $0.1 to $0.15
d9558276: folds
Uncalled bet ($0.1) returned to 2f016cc4
*** SHOWDOWN ***
2f016cc4 collected $0.1 from pot
*** SUMMARY ***
Total pot $0.1 | Rake $0 | Jackpot $0 | Bingo $0 | Fortune $0 | Tax $0
Seat 1: Hero (button) folded before Flop (didn't bet)
Seat 2: 2f016cc4 (small blind) collected ($0.1)
Seat 3: d9558276 (big blind) folded before Flop
Seat 4: 292d1602 folded before Flop (didn't bet)
Seat 5: 50d79ef5 folded before Flop (didn't bet)
Seat 6: b4cd57cf folded before Flop (didn't bet)


Poker Hand #RC3334599884: Hold'em No Limit ($0.02/$0.05) - 2025/02/17 21:44:26
Table 'RushAndCash635144' 6-max Seat #1 is the button
Seat 1: 598d859f ($15.22 in chips)
Seat 2: Hero ($5 in chips)
Seat 3: 2da06ab0 ($5.61 in chips)
Seat 4: 3a228f55 ($5.55 in chips)
Seat 5: bacb67c8 ($5.78 in chips)
Seat 6: 116bb053 ($3.25 in chips)
Hero: posts small blind $0.02
2da06ab0: posts big blind $0.05
*** HOLE CARDS ***
Dealt to 598d859f 
Dealt to Hero [8d Jh]
Dealt to 2da06ab0 
Dealt to 3a228f55 
Dealt to bacb67c8 
Dealt to 116bb053 
3a228f55: folds
bacb67c8: folds
116bb053: folds
598d859f: folds
Hero: folds
Uncalled bet ($0.03) returned to 2da06ab0
*** SHOWDOWN ***
2da06ab0 collected $0.04 from pot
*** SUMMARY ***
Total pot $0.04 | Rake $0 | Jackpot $0 | Bingo $0 | Fortune $0 | Tax $0
Seat 1: 598d859f (button) folded before Flop (didn't bet)
Seat 2: Hero (small blind) folded before Flop
Seat 3: 2da06ab0 (big blind) collected ($0.04)
Seat 4: 3a228f55 folded before Flop (didn't bet)
Seat 5: bacb67c8 folded before Flop (didn't bet)
Seat 6: 116bb053 folded before Flop (didn't bet)


Poker Hand #RC3334599701: Hold'em No Limit ($0.02/$0.05) - 2025/02/17 21:44:06
Table 'RushAndCash634961' 6-max Seat #1 is the button
Seat 1: 8a026fe3 ($10.26 in chips)
Seat 2: 8d2df76c ($4.87 in chips)
Seat 3: Hero ($5 in chips)
Seat 4: 2642904 ($5 in chips)
Seat 5: 853dbdb5 ($4.38 in chips)
Seat 6: fb8cc108 ($5.79 in chips)
8d2df76c: posts small blind $0.02
Hero: posts big blind $0.05
*** HOLE CARDS ***
Dealt to 8a026fe3 
Dealt to 8d2df76c 
Dealt to Hero [7c 5c]
Dealt to 2642904 
Dealt to 853dbdb5 
Dealt to fb8cc108 
2642904: folds
853dbdb5: raises $0.05 to $0.1
fb8cc108: folds
8a026fe3: folds
8d2df76c: folds
Hero: calls $0.05
*** FLOP *** [Ac Qd Js]
Hero: checks
853dbdb5: bets $0.08
Hero: folds
Uncalled bet ($0.08) returned to 853dbdb5
*** SHOWDOWN ***
853dbdb5 collected $0.21 from pot
*** SUMMARY ***
Total pot $0.22 | Rake $0.01 | Jackpot $0 | Bingo $0 | Fortune $0 | Tax $0
Board [Ac Qd Js]
Seat 1: 8a026fe3 (button) folded before Flop (didn't bet)
Seat 2: 8d2df76c (small blind) folded before Flop
Seat 3: Hero (big blind) folded on the Flop
Seat 4: 2642904 folded before Flop (didn't bet)
Seat 5: 853dbdb5 won ($0.21)
Seat 6: fb8cc108 folded before Flop (didn't bet)


Poker Hand #RC3334599672: Hold'em No Limit ($0.02/$0.05) - 2025/02/17 21:44:03
Table 'RushAndCash634932' 6-max Seat #1 is the button
Seat 1: 5f6b984b ($8.78 in chips)
Seat 2: 719071b8 ($6.48 in chips)
Seat 3: Hero ($5.02 in chips)
Seat 4: 12ef643d ($5.09 in chips)
Seat 5: b2966865 ($11.98 in chips)
Seat 6: 9fa2589a ($4.32 in chips)
719071b8: posts small blind $0.02
Hero: posts big blind $0.05
*** HOLE CARDS ***
Dealt to 5f6b984b 
Dealt to 719071b8 
Dealt to Hero [4h Ts]
Dealt to 12ef643d 
Dealt to b2966865 
Dealt to 9fa2589a 
12ef643d: folds
b2966865: raises $0.05 to $0.1
9fa2589a: folds
5f6b984b: folds
719071b8: folds
Hero: folds
Uncalled bet ($0.05) returned to b2966865
*** SHOWDOWN ***
b2966865 collected $0.12 from pot
*** SUMMARY ***
Total pot $0.12 | Rake $0 | Jackpot $0 | Bingo $0 | Fortune $0 | Tax $0
Seat 1: 5f6b984b (button) folded before Flop (didn't bet)
Seat 2: 719071b8 (small blind) folded before Flop
Seat 3: Hero (big blind) folded before Flop
Seat 4: 12ef643d folded before Flop (didn't bet)
Seat 5: b2966865 collected ($0.12)
Seat 6: 9fa2589a folded before Flop (didn't bet)


Poker Hand #RC3334599645: Hold'em No Limit ($0.02/$0.05) - 2025/02/17 21:44:00
Table 'RushAndCash634905' 6-max Seat #1 is the button
Seat 1: Hero ($5.02 in chips)
Seat 2: cc91d9ca ($9.44 in chips)
Seat 3: b28541cc ($4.93 in chips)
Seat 4: 9436c62d ($4.93 in chips)
Seat 5: 50d79ef5 ($6.42 in chips)
Seat 6: 1fa8537 ($7.7 in chips)
cc91d9ca: posts small blind $0.02
b28541cc: posts big blind $0.05
*** HOLE CARDS ***
Dealt to Hero [Kd 3h]
Dealt to cc91d9ca 
Dealt to b28541cc 
Dealt to 9436c62d 
Dealt to 50d79ef5 
Dealt to 1fa8537 
9436c62d: raises $0.06 to $0.11
50d79ef5: folds
1fa8537: folds
Hero: folds
cc91d9ca: folds
b28541cc: folds
Uncalled bet ($0.06) returned to 9436c62d
*** SHOWDOWN ***
9436c62d collected $0.12 from pot
*** SUMMARY ***
Total pot $0.12 | Rake $0 | Jackpot $0 | Bingo $0 | Fortune $0 | Tax $0
Seat 1: Hero (button) folded before Flop (didn't bet)
Seat 2: cc91d9ca (small blind) folded before Flop
Seat 3: b28541cc (big blind) folded before Flop
Seat 4: 9436c62d collected ($0.12)
Seat 5: 50d79ef5 folded before Flop (didn't bet)
Seat 6: 1fa8537 folded before Flop (didn't bet)


Poker Hand #RC3334599621: Hold'em No Limit ($0.02/$0.05) - 2025/02/17 21:43:57
Table 'RushAndCash634881' 6-max Seat #1 is the button
Seat 1: b182414a ($4.61 in chips)
Seat 2: 40816bf9 ($5 in chips)
Seat 3: cea9730b ($8.79 in chips)
Seat 4: Hero ($5.02 in chips)
Seat 5: 493727d2 ($10.33 in chips)
Seat 6: 2f016cc4 ($10.19 in chips)
40816bf9: posts small blind $0.02
cea9730b: posts big blind $0.05
*** HOLE CARDS ***
Dealt to b182414a 
Dealt to 40816bf9 
Dealt to cea9730b 
Dealt to Hero [4h 2d]
Dealt to 493727d2 
Dealt to 2f016cc4 
Hero: folds
493727d2: folds
2f016cc4: folds
b182414a: folds
40816bf9: raises $0.1 to $0.15
cea9730b: folds
Uncalled bet ($0.1) returned to 40816bf9
*** SHOWDOWN ***
40816bf9 collected $0.1 from pot
*** SUMMARY ***
Total pot $0.1 | Rake $0 | Jackpot $0 | Bingo $0 | Fortune $0 | Tax $0
Seat 1: b182414a (button) folded before Flop (didn't bet)
Seat 2: 40816bf9 (small blind) collected ($0.1)
Seat 3: cea9730b (big blind) folded before Flop
Seat 4: Hero folded before Flop (didn't bet)
Seat 5: 493727d2 folded before Flop (didn't bet)
Seat 6: 2f016cc4 folded before Flop (didn't bet)


Poker Hand #RC3334599433: Hold'em No Limit ($0.02/$0.05) - 2025/02/17 21:43:34
Table 'RushAndCash634693' 6-max Seat #1 is the button
Seat 1: Hero ($5.12 in chips)
Seat 2: dd9aa252 ($5.07 in chips)
Seat 3: 89bcbb95 ($9.79 in chips)
Seat 4: f56d4922 ($5 in chips)
Seat 5: 55630016 ($10.13 in chips)
Seat 6: e32dc6f0 ($5.56 in chips)
dd9aa252: posts small blind $0.02
89bcbb95: posts big blind $0.05
*** HOLE CARDS ***
Dealt to Hero [Kh Jc]
Dealt to dd9aa252 
Dealt to 89bcbb95 
Dealt to f56d4922 
Dealt to 55630016 
Dealt to e32dc6f0 
f56d4922: raises $0.05 to $0.1
55630016: folds
e32dc6f0: folds
Hero: calls $0.1
dd9aa252: folds
89bcbb95: raises $0.6 to $0.7
f56d4922: folds
Hero: folds
Uncalled bet ($0.6) returned to 89bcbb95
*** SHOWDOWN ***
89bcbb95 collected $0.31 from pot
*** SUMMARY ***
Total pot $0.32 | Rake $0.01 | Jackpot $0 | Bingo $0 | Fortune $0 | Tax $0
Seat 1: Hero (button) folded before Flop
Seat 2: dd9aa252 (small blind) folded before Flop
Seat 3: 89bcbb95 (big blind) collected ($0.31)
Seat 4: f56d4922 folded before Flop
Seat 5: 55630016 folded before Flop (didn't bet)
Seat 6: e32dc6f0 folded before Flop (didn't bet)


Poker Hand #RC3334599394: Hold'em No Limit ($0.02/$0.05) - 2025/02/17 21:43:30
Table 'RushAndCash634654' 6-max Seat #1 is the button
Seat 1: b9b43bc0 ($5.19 in chips)
Seat 2: Hero ($5.07 in chips)
Seat 3: b5e885d5 ($5 in chips)
Seat 4: 510f8c9f ($5.52 in chips)
Seat 5: 167e28c4 ($8.52 in chips)
Seat 6: c4c3cf85 ($5 in chips)
Hero: posts small blind $0.02
b5e885d5: posts big blind $0.05
*** HOLE CARDS ***
Dealt to b9b43bc0 
Dealt to Hero [5h 8d]
Dealt to b5e885d5 
Dealt to 510f8c9f 
Dealt to 167e28c4 
Dealt to c4c3cf85 
510f8c9f: raises $0.1 to $0.15
167e28c4: folds
c4c3cf85: folds
b9b43bc0: folds
Hero: folds
b5e885d5: folds
Uncalled bet ($0.1) returned to 510f8c9f
*** SHOWDOWN ***
510f8c9f collected $0.12 from pot
*** SUMMARY ***
Total pot $0.12 | Rake $0 | Jackpot $0 | Bingo $0 | Fortune $0 | Tax $0
Seat 1: b9b43bc0 (button) folded before Flop (didn't bet)
Seat 2: Hero (small blind) folded before Flop
Seat 3: b5e885d5 (big blind) folded before Flop
Seat 4: 510f8c9f collected ($0.12)
Seat 5: 167e28c4 folded before Flop (didn't bet)
Seat 6: c4c3cf85 folded before Flop (didn't bet)


Poker Hand #RC3334599366: Hold'em No Limit ($0.02/$0.05) - 2025/02/17 21:43:27
Table 'RushAndCash634626' 6-max Seat #1 is the button
Seat 1: 93a6c244 ($15.61 in chips)
Seat 2: e59e5895 ($5.22 in chips)
Seat 3: Hero ($5.12 in chips)
Seat 4: a664c86a ($6.96 in chips)
Seat 5: 381c6d82 ($22.61 in chips)
Seat 6: 21bff972 ($6.8 in chips)
e59e5895: posts small blind $0.02
Hero: posts big blind $0.05
*** HOLE CARDS ***
Dealt to 93a6c244 
Dealt to e59e5895 
Dealt to Hero [7s Jh]
Dealt to a664c86a 
Dealt to 381c6d82 
Dealt to 21bff972 
a664c86a: folds
381c6d82: folds
21bff972: folds
93a6c244: folds
e59e5895: folds
Uncalled bet ($0.03) returned to Hero
*** SHOWDOWN ***
Hero collected $0.04 from pot
*** SUMMARY ***
Total pot $0.04 | Rake $0 | Jackpot $0 | Bingo $0 | Fortune $0 | Tax $0
Seat 1: 93a6c244 (button) folded before Flop (didn't bet)
Seat 2: e59e5895 (small blind) folded before Flop
Seat 3: Hero (big blind) collected ($0.04)
Seat 4: a664c86a folded before Flop (didn't bet)
Seat 5: 381c6d82 folded before Flop (didn't bet)
Seat 6: 21bff972 folded before Flop (didn't bet)


Poker Hand #RC3334599327: Hold'em No Limit ($0.02/$0.05) - 2025/02/17 21:43:22
Table 'RushAndCash634587' 6-max Seat #1 is the button
Seat 1: 545ae247 ($7.77 in chips)
Seat 2: f0a8dabb ($4.66 in chips)
Seat 3: 42fca4f9 ($14.66 in chips)
Seat 4: 20045c1 ($8.78 in chips)
Seat 5: Hero ($5.12 in chips)
Seat 6: 21be8833 ($5.8 in chips)
f0a8dabb: posts small blind $0.02
42fca4f9: posts big blind $0.05
*** HOLE CARDS ***
Dealt to 545ae247 
Dealt to f0a8dabb 
Dealt to 42fca4f9 
Dealt to 20045c1 
Dealt to Hero [4h Ah]
Dealt to 21be8833 
20045c1: folds
Hero: folds
21be8833: folds
545ae247: folds
f0a8dabb: raises $0.05 to $0.1
42fca4f9: folds
Uncalled bet ($0.05) returned to f0a8dabb
*** SHOWDOWN ***
f0a8dabb collected $0.1 from pot
*** SUMMARY ***
Total pot $0.1 | Rake $0 | Jackpot $0 | Bingo $0 | Fortune $0 | Tax $0
Seat 1: 545ae247 (button) folded before Flop (didn't bet)
Seat 2: f0a8dabb (small blind) collected ($0.1)
Seat 3: 42fca4f9 (big blind) folded before Flop
Seat 4: 20045c1 folded before Flop (didn't bet)
Seat 5: Hero folded before Flop (didn't bet)
Seat 6: 21be8833 folded before Flop (didn't bet)


Poker Hand #RC3334599303: Hold'em No Limit ($0.02/$0.05) - 2025/02/17 21:43:19
Table 'RushAndCash634563' 6-max Seat #1 is the button
Seat 1: 9b2eb25 ($5.72 in chips)
Seat 2: bc9f4180 ($5 in chips)
Seat 3: d49c6b7d ($5 in chips)
Seat 4: 421a6d95 ($6.09 in chips)
Seat 5: f0d238ad ($16.54 in chips)
Seat 6: Hero ($5.12 in chips)
bc9f4180: posts small blind $0.02
d49c6b7d: posts big blind $0.05
*** HOLE CARDS ***
Dealt to 9b2eb25 
Dealt to bc9f4180 
Dealt to d49c6b7d 
Dealt to 421a6d95 
Dealt to f0d238ad 
Dealt to Hero [Ac 4s]
421a6d95: folds
f0d238ad: raises $0.05 to $0.1
Hero: folds
9b2eb25: folds
bc9f4180: folds
d49c6b7d: folds
Uncalled bet ($0.05) returned to f0d238ad
*** SHOWDOWN ***
f0d238ad collected $0.12 from pot
*** SUMMARY ***
Total pot $0.12 | Rake $0 | Jackpot $0 | Bingo $0 | Fortune $0 | Tax $0
Seat 1: 9b2eb25 (button) folded before Flop (didn't bet)
Seat 2: bc9f4180 (small blind) folded before Flop
Seat 3: d49c6b7d (big blind) folded before Flop
Seat 4: 421a6d95 folded before Flop (didn't bet)
Seat 5: f0d238ad collected ($0.12)
Seat 6: Hero folded before Flop (didn't bet)


Poker Hand #RC3334599281: Hold'em No Limit ($0.02/$0.05) - 2025/02/17 21:43:16
Table 'RushAndCash634541' 6-max Seat #1 is the button
Seat 1: 1b6c31ec ($10.02 in chips)
Seat 2: 90bbba9f ($11.02 in chips)
Seat 3: 8862e1e9 ($7.03 in chips)
Seat 4: Hero ($5.12 in chips)
Seat 5: 49ccafb4 ($5 in chips)
Seat 6: 189fa0ee ($3.46 in chips)
90bbba9f: posts small blind $0.02
8862e1e9: posts big blind $0.05
*** HOLE CARDS ***
Dealt to 1b6c31ec 
Dealt to 90bbba9f 
Dealt to 8862e1e9 
Dealt to Hero [4h 5s]
Dealt to 49ccafb4 
Dealt to 189fa0ee 
Hero: folds
49ccafb4: folds
189fa0ee: folds
1b6c31ec: raises $0.05 to $0.1
90bbba9f: folds
8862e1e9: raises $0.35 to $0.45
1b6c31ec: folds
Uncalled bet ($0.35) returned to 8862e1e9
*** SHOWDOWN ***
8862e1e9 collected $0.21 from pot
*** SUMMARY ***
Total pot $0.22 | Rake $0.01 | Jackpot $0 | Bingo $0 | Fortune $0 | Tax $0
Seat 1: 1b6c31ec (button) folded before Flop
Seat 2: 90bbba9f (small blind) folded before Flop
Seat 3: 8862e1e9 (big blind) collected ($0.21)
Seat 4: Hero folded before Flop (didn't bet)
Seat 5: 49ccafb4 folded before Flop (didn't bet)
Seat 6: 189fa0ee folded before Flop (didn't bet)


Poker Hand #RC3334599247: Hold'em No Limit ($0.02/$0.05) - 2025/02/17 21:43:12
Table 'RushAndCash634507' 6-max Seat #1 is the button
Seat 1: Hero ($5.12 in chips)
Seat 2: cbfc1dd3 ($5.35 in chips)
Seat 3: a8fd1cce ($5.1 in chips)
Seat 4: 81f29d91 ($5.03 in chips)
Seat 5: 44b5c3bb ($5.14 in chips)
Seat 6: 49ccafb4 ($5 in chips)
cbfc1dd3: posts small blind $0.02
a8fd1cce: posts big blind $0.05
*** HOLE CARDS ***
Dealt to Hero [Kd 6h]
Dealt to cbfc1dd3 
Dealt to a8fd1cce 
Dealt to 81f29d91 
Dealt to 44b5c3bb 
Dealt to 49ccafb4 
81f29d91: folds
44b5c3bb: raises $0.08 to $0.13
49ccafb4: folds
Hero: folds
cbfc1dd3: raises $0.28 to $0.41
a8fd1cce: folds
44b5c3bb: calls $0.28
*** FLOP *** [Th Qd 7s]
cbfc1dd3: bets $0.2
44b5c3bb: calls $0.2
*** TURN *** [Th Qd 7s] [5c]
cbfc1dd3: checks
44b5c3bb: checks
*** RIVER *** [Th Qd 7s 5c] [Kc]
cbfc1dd3: checks
44b5c3bb: checks
cbfc1dd3: shows [Ad 6d] (Ace-High)
44b5c3bb: shows [6c 6s] (Pair of Sixes)
*** SHOWDOWN ***
44b5c3bb collected $1.21 from pot
*** SUMMARY ***
Total pot $1.27 | Rake $0.06 | Jackpot $0 | Bingo $0 | Fortune $0 | Tax $0
Board [Th Qd 7s 5c Kc]
Seat 1: Hero (button) folded before Flop (didn't bet)
Seat 2: cbfc1dd3 (small blind) showed [Ad 6d] and lost with Ace-High
Seat 3: a8fd1cce (big blind) folded before Flop
Seat 4: 81f29d91 folded before Flop (didn't bet)
Seat 5: 44b5c3bb showed [6c 6s] and won ($1.21) with Pair of Sixes
Seat 6: 49ccafb4 folded before Flop (didn't bet)


Poker Hand #RC3334599220: Hold'em No Limit ($0.02/$0.05) - 2025/02/17 21:43:09
Table 'RushAndCash634480' 6-max Seat #1 is the button
Seat 1: 21bff972 ($6.73 in chips)
Seat 2: Hero ($5.14 in chips)
Seat 3: a730170a ($5.88 in chips)
Seat 4: 3bfcd529 ($9.44 in chips)
Seat 5: 8d0bc73f ($8.32 in chips)
Seat 6: 5abb6a6d ($4.82 in chips)
Hero: posts small blind $0.02
a730170a: posts big blind $0.05
*** HOLE CARDS ***
Dealt to 21bff972 
Dealt to Hero [As 5h]
Dealt to a730170a 
Dealt to 3bfcd529 
Dealt to 8d0bc73f 
Dealt to 5abb6a6d 
3bfcd529: folds
8d0bc73f: folds
5abb6a6d: folds
21bff972: raises $0.08 to $0.13
Hero: folds
a730170a: folds
Uncalled bet ($0.08) returned to 21bff972
*** SHOWDOWN ***
21bff972 collected $0.12 from pot
*** SUMMARY ***
Total pot $0.12 | Rake $0 | Jackpot $0 | Bingo $0 | Fortune $0 | Tax $0
Seat 1: 21bff972 (button) collected ($0.12)
Seat 2: Hero (small blind) folded before Flop
Seat 3: a730170a (big blind) folded before Flop
Seat 4: 3bfcd529 folded before Flop (didn't bet)
Seat 5: 8d0bc73f folded before Flop (didn't bet)
Seat 6: 5abb6a6d folded before Flop (didn't bet)


Poker Hand #RC3334599166: Hold'em No Limit ($0.02/$0.05) - 2025/02/17 21:43:03
Table 'RushAndCash634426' 6-max Seat #1 is the button
Seat 1: 19259657 ($5 in chips)
Seat 2: Hero ($5.16 in chips)
Seat 3: 18767060 ($8.25 in chips)
Seat 4: 7fc44808 ($11.18 in chips)
Seat 5: 3be0e562 ($5 in chips)
Seat 6: b9b43bc0 ($5.19 in chips)
Hero: posts small blind $0.02
18767060: posts big blind $0.05
*** HOLE CARDS ***
Dealt to 19259657 
Dealt to Hero [4d Tc]
Dealt to 18767060 
Dealt to 7fc44808 
Dealt to 3be0e562 
Dealt to b9b43bc0 
7fc44808: folds
3be0e562: raises $0.1 to $0.15
b9b43bc0: folds
19259657: folds
Hero: folds
18767060: folds
Uncalled bet ($0.1) returned to 3be0e562
*** SHOWDOWN ***
3be0e562 collected $0.12 from pot
*** SUMMARY ***
Total pot $0.12 | Rake $0 | Jackpot $0 | Bingo $0 | Fortune $0 | Tax $0
Seat 1: 19259657 (button) folded before Flop (didn't bet)
Seat 2: Hero (small blind) folded before Flop
Seat 3: 18767060 (big blind) folded before Flop
Seat 4: 7fc44808 folded before Flop (didn't bet)
Seat 5: 3be0e562 collected ($0.12)
Seat 6: b9b43bc0 folded before Flop (didn't bet)


Poker Hand #RC3334599087: Hold'em No Limit ($0.02/$0.05) - 2025/02/17 21:42:53
Table 'RushAndCash634347' 6-max Seat #1 is the button
Seat 1: 6b09dc81 ($5.04 in chips)
Seat 2: 39a65b3b ($5.18 in chips)
Seat 3: 14d966a6 ($8.25 in chips)
Seat 4: Hero ($5.09 in chips)
Seat 5: 43bc6b67 ($1.93 in chips)
Seat 6: 9c3abcbf ($23.89 in chips)
39a65b3b: posts small blind $0.02
14d966a6: posts big blind $0.05
*** HOLE CARDS ***
Dealt to 6b09dc81 
Dealt to 39a65b3b 
Dealt to 14d966a6 
Dealt to Hero [Qc Ad]
Dealt to 43bc6b67 
Dealt to 9c3abcbf 
Hero: raises $0.05 to $0.1
43bc6b67: folds
9c3abcbf: folds
6b09dc81: folds
39a65b3b: folds
14d966a6: folds
Uncalled bet ($0.05) returned to Hero
*** SHOWDOWN ***
Hero collected $0.12 from pot
*** SUMMARY ***
Total pot $0.12 | Rake $0 | Jackpot $0 | Bingo $0 | Fortune $0 | Tax $0
Seat 1: 6b09dc81 (button) folded before Flop (didn't bet)
Seat 2: 39a65b3b (small blind) folded before Flop
Seat 3: 14d966a6 (big blind) folded before Flop
Seat 4: Hero collected ($0.12)
Seat 5: 43bc6b67 folded before Flop (didn't bet)
Seat 6: 9c3abcbf folded before Flop (didn't bet)


Poker Hand #RC3334599060: Hold'em No Limit ($0.02/$0.05) - 2025/02/17 21:42:50
Table 'RushAndCash634320' 6-max Seat #1 is the button
Seat 1: d917dee0 ($5 in chips)
Seat 2: dc99401b ($5.04 in chips)
Seat 3: 73ccb7bc ($5 in chips)
Seat 4: 657ee1fc ($7.46 in chips)
Seat 5: Hero ($5.09 in chips)
Seat 6: 198a1e4 ($8.15 in chips)
dc99401b: posts small blind $0.02
73ccb7bc: posts big blind $0.05
*** HOLE CARDS ***
Dealt to d917dee0 
Dealt to dc99401b 
Dealt to 73ccb7bc 
Dealt to 657ee1fc 
Dealt to Hero [3c As]
Dealt to 198a1e4 
657ee1fc: folds
Hero: folds
198a1e4: raises $0.07 to $0.12
d917dee0: folds
dc99401b: folds
73ccb7bc: calls $0.07
*** FLOP *** [Ah 7c 3s]
73ccb7bc: checks
198a1e4: bets $0.09
73ccb7bc: calls $0.09
*** TURN *** [Ah 7c 3s] [5s]
73ccb7bc: checks
198a1e4: checks
*** RIVER *** [Ah 7c 3s 5s] [Ad]
73ccb7bc: bets $0.15
198a1e4: folds
Uncalled bet ($0.15) returned to 73ccb7bc
*** SHOWDOWN ***
73ccb7bc collected $0.42 from pot
*** SUMMARY ***
Total pot $0.44 | Rake $0.02 | Jackpot $0 | Bingo $0 | Fortune $0 | Tax $0
Board [Ah 7c 3s 5s Ad]
Seat 1: d917dee0 (button) folded before Flop (didn't bet)
Seat 2: dc99401b (small blind) folded before Flop
Seat 3: 73ccb7bc (big blind) won ($0.42)
Seat 4: 657ee1fc folded before Flop (didn't bet)
Seat 5: Hero folded before Flop (didn't bet)
Seat 6: 198a1e4 folded on the River


Poker Hand #RC3334598706: Hold'em No Limit ($0.02/$0.05) - 2025/02/17 21:42:08
Table 'RushAndCash633966' 6-max Seat #1 is the button
Seat 1: 8858e1f1 ($7.36 in chips)
Seat 2: 4262311b ($8.61 in chips)
Seat 3: Hero ($5.2 in chips)
Seat 4: 82c6ccfb ($12.09 in chips)
Seat 5: 10b5ea2f ($11.4 in chips)
Seat 6: d870506c ($5.25 in chips)
4262311b: posts small blind $0.02
Hero: posts big blind $0.05
*** HOLE CARDS ***
Dealt to 8858e1f1 
Dealt to 4262311b 
Dealt to Hero [As 9s]
Dealt to 82c6ccfb 
Dealt to 10b5ea2f 
Dealt to d870506c 
82c6ccfb: folds
10b5ea2f: folds
d870506c: folds
8858e1f1: raises $0.06 to $0.11
4262311b: folds
Hero: calls $0.06
*** FLOP *** [6c 6s 5c]
Hero: checks
8858e1f1: bets $0.07
Hero: folds
Uncalled bet ($0.07) returned to 8858e1f1
*** SHOWDOWN ***
8858e1f1 collected $0.23 from pot
*** SUMMARY ***
Total pot $0.24 | Rake $0.01 | Jackpot $0 | Bingo $0 | Fortune $0 | Tax $0
Board [6c 6s 5c]
Seat 1: 8858e1f1 (button) won ($0.23)
Seat 2: 4262311b (small blind) folded before Flop
Seat 3: Hero (big blind) folded on the Flop
Seat 4: 82c6ccfb folded before Flop (didn't bet)
Seat 5: 10b5ea2f folded before Flop (didn't bet)
Seat 6: d870506c folded before Flop (didn't bet)


Poker Hand #RC3334598640: Hold'em No Limit ($0.02/$0.05) - 2025/02/17 21:42:00
Table 'RushAndCash633900' 6-max Seat #1 is the button
Seat 1: a664c86a ($6.65 in chips)
Seat 2: 40df0724 ($4.72 in chips)
Seat 3: 99df5763 ($3.25 in chips)
Seat 4: Hero ($5.2 in chips)
Seat 5: 577aa3d3 ($9.48 in chips)
Seat 6: f7759ba6 ($5 in chips)
40df0724: posts small blind $0.02
99df5763: posts big blind $0.05
*** HOLE CARDS ***
Dealt to a664c86a 
Dealt to 40df0724 
Dealt to 99df5763 
Dealt to Hero [As 3d]
Dealt to 577aa3d3 
Dealt to f7759ba6 
Hero: folds
577aa3d3: folds
f7759ba6: folds
a664c86a: folds
40df0724: folds
Uncalled bet ($0.03) returned to 99df5763
*** SHOWDOWN ***
99df5763 collected $0.04 from pot
*** SUMMARY ***
Total pot $0.04 | Rake $0 | Jackpot $0 | Bingo $0 | Fortune $0 | Tax $0
Seat 1: a664c86a (button) folded before Flop (didn't bet)
Seat 2: 40df0724 (small blind) folded before Flop
Seat 3: 99df5763 (big blind) collected ($0.04)
Seat 4: Hero folded before Flop (didn't bet)
Seat 5: 577aa3d3 folded before Flop (didn't bet)
Seat 6: f7759ba6 folded before Flop (didn't bet)


Poker Hand #RC3334598536: Hold'em No Limit ($0.02/$0.05) - 2025/02/17 21:41:48
Table 'RushAndCash633796' 6-max Seat #1 is the button
Seat 1: a223d3ca ($5.1 in chips)
Seat 2: 8f77797e ($5.02 in chips)
Seat 3: fd055f75 ($5.61 in chips)
Seat 4: 3a46e390 ($6.32 in chips)
Seat 5: ff01bdba ($10.67 in chips)
Seat 6: Hero ($5.13 in chips)
8f77797e: posts small blind $0.02
fd055f75: posts big blind $0.05
*** HOLE CARDS ***
Dealt to a223d3ca 
Dealt to 8f77797e 
Dealt to fd055f75 
Dealt to 3a46e390 
Dealt to ff01bdba 
Dealt to Hero [9h 9c]
3a46e390: folds
ff01bdba: folds
Hero: raises $0.05 to $0.1
a223d3ca: folds
8f77797e: folds
fd055f75: folds
Uncalled bet ($0.05) returned to Hero
*** SHOWDOWN ***
Hero collected $0.12 from pot
*** SUMMARY ***
Total pot $0.12 | Rake $0 | Jackpot $0 | Bingo $0 | Fortune $0 | Tax $0
Seat 1: a223d3ca (button) folded before Flop (didn't bet)
Seat 2: 8f77797e (small blind) folded before Flop
Seat 3: fd055f75 (big blind) folded before Flop
Seat 4: 3a46e390 folded before Flop (didn't bet)
Seat 5: ff01bdba folded before Flop (didn't bet)
Seat 6: Hero collected ($0.12)


Poker Hand #RC3334598503: Hold'em No Limit ($0.02/$0.05) - 2025/02/17 21:41:44
Table 'RushAndCash633763' 6-max Seat #1 is the button
Seat 1: 38005dc9 ($3.1 in chips)
Seat 2: 720edd8b ($2.67 in chips)
Seat 3: 626359de ($17.16 in chips)
Seat 4: 7c8b3964 ($10.25 in chips)
Seat 5: c3c40ffa ($5.07 in chips)
Seat 6: Hero ($5.13 in chips)
720edd8b: posts small blind $0.02
626359de: posts big blind $0.05
*** HOLE CARDS ***
Dealt to 38005dc9 
Dealt to 720edd8b 
Dealt to 626359de 
Dealt to 7c8b3964 
Dealt to c3c40ffa 
Dealt to Hero [Ac 7d]
7c8b3964: raises $0.05 to $0.1
c3c40ffa: folds
Hero: folds
38005dc9: folds
720edd8b: folds
626359de: calls $0.05
*** FLOP *** [8s Qc 4s]
626359de: checks
7c8b3964: bets $0.22
626359de: folds
Uncalled bet ($0.22) returned to 7c8b3964
*** SHOWDOWN ***
7c8b3964 collected $0.21 from pot
*** SUMMARY ***
Total pot $0.22 | Rake $0.01 | Jackpot $0 | Bingo $0 | Fortune $0 | Tax $0
Board [8s Qc 4s]
Seat 1: 38005dc9 (button) folded before Flop (didn't bet)
Seat 2: 720edd8b (small blind) folded before Flop
Seat 3: 626359de (big blind) folded on the Flop
Seat 4: 7c8b3964 won ($0.21)
Seat 5: c3c40ffa folded before Flop (didn't bet)
Seat 6: Hero folded before Flop (didn't bet)


Poker Hand #RC3334598474: Hold'em No Limit ($0.02/$0.05) - 2025/02/17 21:41:41
Table 'RushAndCash633734' 6-max Seat #1 is the button
Seat 1: 15fafcaa ($5.59 in chips)
Seat 2: d11ba472 ($5 in chips)
Seat 3: 292d1602 ($5.12 in chips)
Seat 4: Hero ($5.13 in chips)
Seat 5: 719071b8 ($5 in chips)
Seat 6: 6a5a3ab6 ($4.76 in chips)
d11ba472: posts small blind $0.02
292d1602: posts big blind $0.05
*** HOLE CARDS ***
Dealt to 15fafcaa 
Dealt to d11ba472 
Dealt to 292d1602 
Dealt to Hero [8h 7d]
Dealt to 719071b8 
Dealt to 6a5a3ab6 
Hero: folds
719071b8: folds
6a5a3ab6: raises $0.06 to $0.11
15fafcaa: folds
d11ba472: folds
292d1602: calls $0.06
*** FLOP *** [Qh 4h Qc]
292d1602: checks
6a5a3ab6: bets $0.12
292d1602: folds
Uncalled bet ($0.12) returned to 6a5a3ab6
*** SHOWDOWN ***
6a5a3ab6 collected $0.23 from pot
*** SUMMARY ***
Total pot $0.24 | Rake $0.01 | Jackpot $0 | Bingo $0 | Fortune $0 | Tax $0
Board [Qh 4h Qc]
Seat 1: 15fafcaa (button) folded before Flop (didn't bet)
Seat 2: d11ba472 (small blind) folded before Flop
Seat 3: 292d1602 (big blind) folded on the Flop
Seat 4: Hero folded before Flop (didn't bet)
Seat 5: 719071b8 folded before Flop (didn't bet)
Seat 6: 6a5a3ab6 won ($0.23)


Poker Hand #RC3334598447: Hold'em No Limit ($0.02/$0.05) - 2025/02/17 21:41:37
Table 'RushAndCash633707' 6-max Seat #1 is the button
Seat 1: 50254767 ($5.71 in chips)
Seat 2: 8e93231a ($5.09 in chips)
Seat 3: Hero ($5.18 in chips)
Seat 4: a75d2a3b ($4.76 in chips)
Seat 5: 486aa946 ($4.71 in chips)
Seat 6: ccf5b50f ($6.12 in chips)
8e93231a: posts small blind $0.02
Hero: posts big blind $0.05
*** HOLE CARDS ***
Dealt to 50254767 
Dealt to 8e93231a 
Dealt to Hero [5s Ts]
Dealt to a75d2a3b 
Dealt to 486aa946 
Dealt to ccf5b50f 
a75d2a3b: folds
486aa946: folds
ccf5b50f: folds
50254767: folds
8e93231a: raises $0.08 to $0.13
Hero: folds
Uncalled bet ($0.08) returned to 8e93231a
*** SHOWDOWN ***
8e93231a collected $0.1 from pot
*** SUMMARY ***
Total pot $0.1 | Rake $0 | Jackpot $0 | Bingo $0 | Fortune $0 | Tax $0
Seat 1: 50254767 (button) folded before Flop (didn't bet)
Seat 2: 8e93231a (small blind) collected ($0.1)
Seat 3: Hero (big blind) folded before Flop
Seat 4: a75d2a3b folded before Flop (didn't bet)
Seat 5: 486aa946 folded before Flop (didn't bet)
Seat 6: ccf5b50f folded before Flop (didn't bet)


Poker Hand #RC3334598417: Hold'em No Limit ($0.02/$0.05) - 2025/02/17 21:41:34
Table 'RushAndCash633677' 6-max Seat #1 is the button
Seat 1: aeb50acd ($10.68 in chips)
Seat 2: 3c76a91d ($10.26 in chips)
Seat 3: add6668e ($6.88 in chips)
Seat 4: 6e22a6c1 ($5.68 in chips)
Seat 5: 20045c1 ($9.16 in chips)
Seat 6: Hero ($5.18 in chips)
3c76a91d: posts small blind $0.02
add6668e: posts big blind $0.05
*** HOLE CARDS ***
Dealt to aeb50acd 
Dealt to 3c76a91d 
Dealt to add6668e 
Dealt to 6e22a6c1 
Dealt to 20045c1 
Dealt to Hero [As 4c]
6e22a6c1: folds
20045c1: folds
Hero: folds
aeb50acd: folds
3c76a91d: raises $0.11 to $0.16
add6668e: folds
Uncalled bet ($0.11) returned to 3c76a91d
*** SHOWDOWN ***
3c76a91d collected $0.1 from pot
*** SUMMARY ***
Total pot $0.1 | Rake $0 | Jackpot $0 | Bingo $0 | Fortune $0 | Tax $0
Seat 1: aeb50acd (button) folded before Flop (didn't bet)
Seat 2: 3c76a91d (small blind) collected ($0.1)
Seat 3: add6668e (big blind) folded before Flop
Seat 4: 6e22a6c1 folded before Flop (didn't bet)
Seat 5: 20045c1 folded before Flop (didn't bet)
Seat 6: Hero folded before Flop (didn't bet)


Poker Hand #RC3334598389: Hold'em No Limit ($0.02/$0.05) - 2025/02/17 21:41:31
Table 'RushAndCash633649' 6-max Seat #1 is the button
Seat 1: 89bcbb95 ($9.67 in chips)
Seat 2: Hero ($5.2 in chips)
Seat 3: 6b09dc81 ($4.86 in chips)
Seat 4: 421a6d95 ($6.02 in chips)
Seat 5: 22643080 ($8.23 in chips)
Seat 6: 9b1a3dd2 ($14.93 in chips)
Hero: posts small blind $0.02
6b09dc81: posts big blind $0.05
*** HOLE CARDS ***
Dealt to 89bcbb95 
Dealt to Hero [7s Qs]
Dealt to 6b09dc81 
Dealt to 421a6d95 
Dealt to 22643080 
Dealt to 9b1a3dd2 
421a6d95: folds
22643080: raises $0.08 to $0.13
9b1a3dd2: folds
89bcbb95: folds
Hero: folds
6b09dc81: folds
Uncalled bet ($0.08) returned to 22643080
*** SHOWDOWN ***
22643080 collected $0.12 from pot
*** SUMMARY ***
Total pot $0.12 | Rake $0 | Jackpot $0 | Bingo $0 | Fortune $0 | Tax $0
Seat 1: 89bcbb95 (button) folded before Flop (didn't bet)
Seat 2: Hero (small blind) folded before Flop
Seat 3: 6b09dc81 (big blind) folded before Flop
Seat 4: 421a6d95 folded before Flop (didn't bet)
Seat 5: 22643080 collected ($0.12)
Seat 6: 9b1a3dd2 folded before Flop (didn't bet)


Poker Hand #RC3334598362: Hold'em No Limit ($0.02/$0.05) - 2025/02/17 21:41:28
Table 'RushAndCash633622' 6-max Seat #1 is the button
Seat 1: 73ccb7bc ($5.42 in chips)
Seat 2: b70bdf37 ($5.26 in chips)
Seat 3: Hero ($5.25 in chips)
Seat 4: a32bdeef ($5 in chips)
Seat 5: 32d40ce0 ($5.53 in chips)
Seat 6: a4461af6 ($5.36 in chips)
b70bdf37: posts small blind $0.02
Hero: posts big blind $0.05
*** HOLE CARDS ***
Dealt to 73ccb7bc 
Dealt to b70bdf37 
Dealt to Hero [2d Kh]
Dealt to a32bdeef 
Dealt to 32d40ce0 
Dealt to a4461af6 
a32bdeef: folds
32d40ce0: folds
a4461af6: raises $0.05 to $0.1
73ccb7bc: calls $0.1
b70bdf37: raises $0.27 to $0.37
Hero: folds
a4461af6: calls $0.27
73ccb7bc: raises $1.16 to $1.53
b70bdf37: folds
a4461af6: raises $3.83 to $5.36 and is all-in
73ccb7bc: calls $3.83
a4461af6: shows [9h 9d]
73ccb7bc: shows [8s 8h]
*** FLOP *** [Ks Qd Ad]
*** TURN *** [Ks Qd Ad] [Th]
*** RIVER *** [Ks Qd Ad Th] [Qh]
*** SHOWDOWN ***
a4461af6 collected $10.92 from pot
*** SUMMARY ***
Total pot $11.14 | Rake $0.15 | Jackpot $0.07 | Bingo $0 | Fortune $0 | Tax $0
Board [Ks Qd Ad Th Qh]
Seat 1: 73ccb7bc (button) showed [8s 8h] and lost with Pair of Queens and Pair of Eights
Seat 2: b70bdf37 (small blind) folded before Flop
Seat 3: Hero (big blind) folded before Flop
Seat 4: a32bdeef folded before Flop (didn't bet)
Seat 5: 32d40ce0 folded before Flop (didn't bet)
Seat 6: a4461af6 showed [9h 9d] and won ($10.92) with Pair of Queens and Pair of Nines


Poker Hand #RC3334598334: Hold'em No Limit ($0.02/$0.05) - 2025/02/17 21:41:24
Table 'RushAndCash633594' 6-max Seat #1 is the button
Seat 1: Hero ($5.25 in chips)
Seat 2: fcfd355a ($5 in chips)
Seat 3: e2d5acdf ($5.73 in chips)
Seat 4: 73ccb7bc ($5.42 in chips)
Seat 5: a86de18f ($2.85 in chips)
Seat 6: f21cbd70 ($5.23 in chips)
fcfd355a: posts small blind $0.02
e2d5acdf: posts big blind $0.05
*** HOLE CARDS ***
Dealt to Hero [4s 6d]
Dealt to fcfd355a 
Dealt to e2d5acdf 
Dealt to 73ccb7bc 
Dealt to a86de18f 
Dealt to f21cbd70 
73ccb7bc: folds
a86de18f: folds
f21cbd70: folds
Hero: folds
fcfd355a: raises $0.1 to $0.15
e2d5acdf: folds
Uncalled bet ($0.1) returned to fcfd355a
*** SHOWDOWN ***
fcfd355a collected $0.1 from pot
*** SUMMARY ***
Total pot $0.1 | Rake $0 | Jackpot $0 | Bingo $0 | Fortune $0 | Tax $0
Seat 1: Hero (button) folded before Flop (didn't bet)
Seat 2: fcfd355a (small blind) collected ($0.1)
Seat 3: e2d5acdf (big blind) folded before Flop
Seat 4: 73ccb7bc folded before Flop (didn't bet)
Seat 5: a86de18f folded before Flop (didn't bet)
Seat 6: f21cbd70 folded before Flop (didn't bet)


Poker Hand #RC3334598301: Hold'em No Limit ($0.02/$0.05) - 2025/02/17 21:41:20
Table 'RushAndCash633561' 6-max Seat #1 is the button
Seat 1: 2e8ab509 ($12.79 in chips)
Seat 2: bd7b1be4 ($5.02 in chips)
Seat 3: 4577a98c ($5.51 in chips)
Seat 4: a4461af6 ($5.36 in chips)
Seat 5: 9de4e6c3 ($5.16 in chips)
Seat 6: Hero ($5.25 in chips)
bd7b1be4: posts small blind $0.02
4577a98c: posts big blind $0.05
*** HOLE CARDS ***
Dealt to 2e8ab509 
Dealt to bd7b1be4 
Dealt to 4577a98c 
Dealt to a4461af6 
Dealt to 9de4e6c3 
Dealt to Hero [Ad 2h]
a4461af6: folds
9de4e6c3: folds
Hero: folds
2e8ab509: folds
bd7b1be4: raises $0.07 to $0.12
4577a98c: raises $0.23 to $0.35
bd7b1be4: folds
Uncalled bet ($0.23) returned to 4577a98c
*** SHOWDOWN ***
4577a98c collected $0.23 from pot
*** SUMMARY ***
Total pot $0.24 | Rake $0.01 | Jackpot $0 | Bingo $0 | Fortune $0 | Tax $0
Seat 1: 2e8ab509 (button) folded before Flop (didn't bet)
Seat 2: bd7b1be4 (small blind) folded before Flop
Seat 3: 4577a98c (big blind) collected ($0.23)
Seat 4: a4461af6 folded before Flop (didn't bet)
Seat 5: 9de4e6c3 folded before Flop (didn't bet)
Seat 6: Hero folded before Flop (didn't bet)


Poker Hand #RC3334598269: Hold'em No Limit ($0.02/$0.05) - 2025/02/17 21:41:16
Table 'RushAndCash633529' 6-max Seat #1 is the button
Seat 1: Hero ($5.25 in chips)
Seat 2: 9b1a3dd2 ($14.95 in chips)
Seat 3: d8f38484 ($6.06 in chips)
Seat 4: 69373e56 ($7.58 in chips)
Seat 5: 229ec9a7 ($9.97 in chips)
Seat 6: 827649ff ($5.05 in chips)
9b1a3dd2: posts small blind $0.02
d8f38484: posts big blind $0.05
*** HOLE CARDS ***
Dealt to Hero [9h 6c]
Dealt to 9b1a3dd2 
Dealt to d8f38484 
Dealt to 69373e56 
Dealt to 229ec9a7 
Dealt to 827649ff 
69373e56: folds
229ec9a7: folds
827649ff: raises $0.05 to $0.1
Hero: folds
9b1a3dd2: folds
d8f38484: folds
Uncalled bet ($0.05) returned to 827649ff
*** SHOWDOWN ***
827649ff collected $0.12 from pot
*** SUMMARY ***
Total pot $0.12 | Rake $0 | Jackpot $0 | Bingo $0 | Fortune $0 | Tax $0
Seat 1: Hero (button) folded before Flop (didn't bet)
Seat 2: 9b1a3dd2 (small blind) folded before Flop
Seat 3: d8f38484 (big blind) folded before Flop
Seat 4: 69373e56 folded before Flop (didn't bet)
Seat 5: 229ec9a7 folded before Flop (didn't bet)
Seat 6: 827649ff collected ($0.12)


Poker Hand #RC3334598239: Hold'em No Limit ($0.02/$0.05) - 2025/02/17 21:41:13
Table 'RushAndCash633499' 6-max Seat #1 is the button
Seat 1: 802a8ffb ($8.8 in chips)
Seat 2: 697412e ($10.13 in chips)
Seat 3: 50254767 ($5.71 in chips)
Seat 4: Hero ($5.25 in chips)
Seat 5: a730170a ($5.49 in chips)
Seat 6: 2ec306f3 ($5.34 in chips)
697412e: posts small blind $0.02
50254767: posts big blind $0.05
*** HOLE CARDS ***
Dealt to 802a8ffb 
Dealt to 697412e 
Dealt to 50254767 
Dealt to Hero [9c 8h]
Dealt to a730170a 
Dealt to 2ec306f3 
Hero: folds
a730170a: folds
2ec306f3: folds
802a8ffb: folds
697412e: folds
Uncalled bet ($0.03) returned to 50254767
*** SHOWDOWN ***
50254767 collected $0.04 from pot
*** SUMMARY ***
Total pot $0.04 | Rake $0 | Jackpot $0 | Bingo $0 | Fortune $0 | Tax $0
Seat 1: 802a8ffb (button) folded before Flop (didn't bet)
Seat 2: 697412e (small blind) folded before Flop
Seat 3: 50254767 (big blind) collected ($0.04)
Seat 4: Hero folded before Flop (didn't bet)
Seat 5: a730170a folded before Flop (didn't bet)
Seat 6: 2ec306f3 folded before Flop (didn't bet)


Poker Hand #RC3334598177: Hold'em No Limit ($0.02/$0.05) - 2025/02/17 21:41:06
Table 'RushAndCash633437' 6-max Seat #1 is the button
Seat 1: ba806aaa ($1.67 in chips)
Seat 2: 8b825942 ($2.81 in chips)
Seat 3: 5bf5cd50 ($5.01 in chips)
Seat 4: e59e5895 ($5.07 in chips)
Seat 5: 53a8c2fd ($9.69 in chips)
Seat 6: Hero ($5.25 in chips)
8b825942: posts small blind $0.02
5bf5cd50: posts big blind $0.05
*** HOLE CARDS ***
Dealt to ba806aaa 
Dealt to 8b825942 
Dealt to 5bf5cd50 
Dealt to e59e5895 
Dealt to 53a8c2fd 
Dealt to Hero [8s Ks]
e59e5895: folds
53a8c2fd: raises $0.06 to $0.11
Hero: folds
ba806aaa: folds
8b825942: folds
5bf5cd50: calls $0.06
*** FLOP *** [7h 3d Tc]
5bf5cd50: checks
53a8c2fd: bets $0.06
5bf5cd50: folds
Uncalled bet ($0.06) returned to 53a8c2fd
*** SHOWDOWN ***
53a8c2fd collected $0.23 from pot
*** SUMMARY ***
Total pot $0.24 | Rake $0.01 | Jackpot $0 | Bingo $0 | Fortune $0 | Tax $0
Board [7h 3d Tc]
Seat 1: ba806aaa (button) folded before Flop (didn't bet)
Seat 2: 8b825942 (small blind) folded before Flop
Seat 3: 5bf5cd50 (big blind) folded on the Flop
Seat 4: e59e5895 folded before Flop (didn't bet)
Seat 5: 53a8c2fd won ($0.23)
Seat 6: Hero folded before Flop (didn't bet)


Poker Hand #RC3334598124: Hold'em No Limit ($0.02/$0.05) - 2025/02/17 21:41:01
Table 'RushAndCash633384' 6-max Seat #1 is the button
Seat 1: Hero ($5.25 in chips)
Seat 2: 52f54c69 ($5.24 in chips)
Seat 3: 8507bdad ($9.38 in chips)
Seat 4: 12cda2e0 ($21.29 in chips)
Seat 5: 1e300ec0 ($5.18 in chips)
Seat 6: ab43c8b8 ($8.9 in chips)
52f54c69: posts small blind $0.02
8507bdad: posts big blind $0.05
*** HOLE CARDS ***
Dealt to Hero [Ks 3c]
Dealt to 52f54c69 
Dealt to 8507bdad 
Dealt to 12cda2e0 
Dealt to 1e300ec0 
Dealt to ab43c8b8 
12cda2e0: folds
1e300ec0: folds
ab43c8b8: folds
Hero: folds
52f54c69: folds
Uncalled bet ($0.03) returned to 8507bdad
*** SHOWDOWN ***
8507bdad collected $0.04 from pot
*** SUMMARY ***
Total pot $0.04 | Rake $0 | Jackpot $0 | Bingo $0 | Fortune $0 | Tax $0
Seat 1: Hero (button) folded before Flop (didn't bet)
Seat 2: 52f54c69 (small blind) folded before Flop
Seat 3: 8507bdad (big blind) collected ($0.04)
Seat 4: 12cda2e0 folded before Flop (didn't bet)
Seat 5: 1e300ec0 folded before Flop (didn't bet)
Seat 6: ab43c8b8 folded before Flop (didn't bet)


Poker Hand #RC3334597796: Hold'em No Limit ($0.02/$0.05) - 2025/02/17 21:40:24
Table 'RushAndCash633056' 6-max Seat #1 is the button
Seat 1: f0a8dabb ($4.95 in chips)
Seat 2: 9da6ba55 ($6.32 in chips)
Seat 3: Hero ($5.35 in chips)
Seat 4: 493e7626 ($10.07 in chips)
Seat 5: 8507bdad ($9.27 in chips)
Seat 6: 51b01079 ($5 in chips)
9da6ba55: posts small blind $0.02
Hero: posts big blind $0.05
*** HOLE CARDS ***
Dealt to f0a8dabb 
Dealt to 9da6ba55 
Dealt to Hero [Kc Jh]
Dealt to 493e7626 
Dealt to 8507bdad 
Dealt to 51b01079 
493e7626: folds
8507bdad: raises $0.05 to $0.1
51b01079: folds
f0a8dabb: folds
9da6ba55: folds
Hero: calls $0.05
*** FLOP *** [7d 6d Ts]
Hero: checks
8507bdad: checks
*** TURN *** [7d 6d Ts] [4d]
Hero: checks
8507bdad: checks
*** RIVER *** [7d 6d Ts 4d] [9s]
Hero: checks
8507bdad: checks
Hero: shows [Kc Jh] (King-High)
8507bdad: shows [Ah 6h] (Pair of Sixes)
*** SHOWDOWN ***
8507bdad collected $0.21 from pot
*** SUMMARY ***
Total pot $0.22 | Rake $0.01 | Jackpot $0 | Bingo $0 | Fortune $0 | Tax $0
Board [7d 6d Ts 4d 9s]
Seat 1: f0a8dabb (button) folded before Flop (didn't bet)
Seat 2: 9da6ba55 (small blind) folded before Flop
Seat 3: Hero (big blind) showed [Kc Jh] and lost with King-High
Seat 4: 493e7626 folded before Flop (didn't bet)
Seat 5: 8507bdad showed [Ah 6h] and won ($0.21) with Pair of Sixes
Seat 6: 51b01079 folded before Flop (didn't bet)


Poker Hand #RC3334597767: Hold'em No Limit ($0.02/$0.05) - 2025/02/17 21:40:21
Table 'RushAndCash633027' 6-max Seat #1 is the button
Seat 1: Hero ($5.35 in chips)
Seat 2: d6280cb6 ($5 in chips)
Seat 3: 44b5c3bb ($5.22 in chips)
Seat 4: 656af102 ($7 in chips)
Seat 5: 2a10169c ($10.11 in chips)
Seat 6: fa7bb2c5 ($8.26 in chips)
d6280cb6: posts small blind $0.02
44b5c3bb: posts big blind $0.05
*** HOLE CARDS ***
Dealt to Hero [Qd 6h]
Dealt to d6280cb6 
Dealt to 44b5c3bb 
Dealt to 656af102 
Dealt to 2a10169c 
Dealt to fa7bb2c5 
656af102: folds
2a10169c: folds
fa7bb2c5: folds
Hero: folds
d6280cb6: raises $0.05 to $0.1
44b5c3bb: folds
Uncalled bet ($0.05) returned to d6280cb6
*** SHOWDOWN ***
d6280cb6 collected $0.1 from pot
*** SUMMARY ***
Total pot $0.1 | Rake $0 | Jackpot $0 | Bingo $0 | Fortune $0 | Tax $0
Seat 1: Hero (button) folded before Flop (didn't bet)
Seat 2: d6280cb6 (small blind) collected ($0.1)
Seat 3: 44b5c3bb (big blind) folded before Flop
Seat 4: 656af102 folded before Flop (didn't bet)
Seat 5: 2a10169c folded before Flop (didn't bet)
Seat 6: fa7bb2c5 folded before Flop (didn't bet)


Poker Hand #RC3334597577: Hold'em No Limit ($0.02/$0.05) - 2025/02/17 21:40:00
Table 'RushAndCash632837' 6-max Seat #1 is the button
Seat 1: 27b4c2a6 ($9.31 in chips)
Seat 2: 53a8c2fd ($9.7 in chips)
Seat 3: a664c86a ($6.96 in chips)
Seat 4: b72def64 ($5 in chips)
Seat 5: 702c0f17 ($4.48 in chips)
Seat 6: Hero ($5.45 in chips)
53a8c2fd: posts small blind $0.02
a664c86a: posts big blind $0.05
*** HOLE CARDS ***
Dealt to 27b4c2a6 
Dealt to 53a8c2fd 
Dealt to a664c86a 
Dealt to b72def64 
Dealt to 702c0f17 
Dealt to Hero [9h 9d]
b72def64: folds
702c0f17: folds
Hero: raises $0.05 to $0.1
27b4c2a6: raises $0.3 to $0.4
53a8c2fd: folds
a664c86a: folds
Hero: folds
Uncalled bet ($0.3) returned to 27b4c2a6
*** SHOWDOWN ***
27b4c2a6 collected $0.26 from pot
*** SUMMARY ***
Total pot $0.27 | Rake $0.01 | Jackpot $0 | Bingo $0 | Fortune $0 | Tax $0
Seat 1: 27b4c2a6 (button) collected ($0.26)
Seat 2: 53a8c2fd (small blind) folded before Flop
Seat 3: a664c86a (big blind) folded before Flop
Seat 4: b72def64 folded before Flop (didn't bet)
Seat 5: 702c0f17 folded before Flop (didn't bet)
Seat 6: Hero folded before Flop


Poker Hand #RC3334597128: Hold'em No Limit ($0.02/$0.05) - 2025/02/17 21:39:05
Table 'RushAndCash632388' 6-max Seat #1 is the button
Seat 1: 5ea9f27c ($3.82 in chips)
Seat 2: a0cb6644 ($5.56 in chips)
Seat 3: 4c7728b5 ($5 in chips)
Seat 4: 4506a4f6 ($5.07 in chips)
Seat 5: 9c00bca7 ($5.18 in chips)
Seat 6: Hero ($5.27 in chips)
a0cb6644: posts small blind $0.02
4c7728b5: posts big blind $0.05
*** HOLE CARDS ***
Dealt to 5ea9f27c 
Dealt to a0cb6644 
Dealt to 4c7728b5 
Dealt to 4506a4f6 
Dealt to 9c00bca7 
Dealt to Hero [9c 9h]
4506a4f6: folds
9c00bca7: folds
Hero: raises $0.05 to $0.1
5ea9f27c: folds
a0cb6644: folds
4c7728b5: calls $0.05
*** FLOP *** [3d Kd 5d]
4c7728b5: checks
Hero: checks
*** TURN *** [3d Kd 5d] [Kc]
4c7728b5: checks
Hero: bets $0.12
4c7728b5: folds
Uncalled bet ($0.12) returned to Hero
*** SHOWDOWN ***
Hero collected $0.21 from pot
*** SUMMARY ***
Total pot $0.22 | Rake $0.01 | Jackpot $0 | Bingo $0 | Fortune $0 | Tax $0
Board [3d Kd 5d Kc]
Seat 1: 5ea9f27c (button) folded before Flop (didn't bet)
Seat 2: a0cb6644 (small blind) folded before Flop
Seat 3: 4c7728b5 (big blind) folded on the Turn
Seat 4: 4506a4f6 folded before Flop (didn't bet)
Seat 5: 9c00bca7 folded before Flop (didn't bet)
Seat 6: Hero won ($0.21)


Poker Hand #RC3334597093: Hold'em No Limit ($0.02/$0.05) - 2025/02/17 21:39:01
Table 'RushAndCash632353' 6-max Seat #1 is the button
Seat 1: beffcf8a ($5.07 in chips)
Seat 2: 4c265d8a ($5.02 in chips)
Seat 3: Hero ($5.32 in chips)
Seat 4: 6c641898 ($6.01 in chips)
Seat 5: cf7f09c2 ($15.4 in chips)
Seat 6: fd5b33a8 ($7.61 in chips)
4c265d8a: posts small blind $0.02
Hero: posts big blind $0.05
*** HOLE CARDS ***
Dealt to beffcf8a 
Dealt to 4c265d8a 
Dealt to Hero [Qc 5h]
Dealt to 6c641898 
Dealt to cf7f09c2 
Dealt to fd5b33a8 
6c641898: folds
cf7f09c2: folds
fd5b33a8: folds
beffcf8a: folds
4c265d8a: folds
Uncalled bet ($0.03) returned to Hero
*** SHOWDOWN ***
Hero collected $0.04 from pot
*** SUMMARY ***
Total pot $0.04 | Rake $0 | Jackpot $0 | Bingo $0 | Fortune $0 | Tax $0
Seat 1: beffcf8a (button) folded before Flop (didn't bet)
Seat 2: 4c265d8a (small blind) folded before Flop
Seat 3: Hero (big blind) collected ($0.04)
Seat 4: 6c641898 folded before Flop (didn't bet)
Seat 5: cf7f09c2 folded before Flop (didn't bet)
Seat 6: fd5b33a8 folded before Flop (didn't bet)


Poker Hand #RC3334597065: Hold'em No Limit ($0.02/$0.05) - 2025/02/17 21:38:58
Table 'RushAndCash632325' 6-max Seat #1 is the button
Seat 1: 3f6d99d0 ($4.44 in chips)
Seat 2: dbf5f543 ($14.51 in chips)
Seat 3: 2808c418 ($5.21 in chips)
Seat 4: 5b79005a ($5.76 in chips)
Seat 5: 8012317b ($10.77 in chips)
Seat 6: Hero ($5.32 in chips)
dbf5f543: posts small blind $0.02
2808c418: posts big blind $0.05
*** HOLE CARDS ***
Dealt to 3f6d99d0 
Dealt to dbf5f543 
Dealt to 2808c418 
Dealt to 5b79005a 
Dealt to 8012317b 
Dealt to Hero [6s Td]
5b79005a: folds
8012317b: folds
Hero: folds
3f6d99d0: folds
dbf5f543: folds
Uncalled bet ($0.03) returned to 2808c418
*** SHOWDOWN ***
2808c418 collected $0.04 from pot
*** SUMMARY ***
Total pot $0.04 | Rake $0 | Jackpot $0 | Bingo $0 | Fortune $0 | Tax $0
Seat 1: 3f6d99d0 (button) folded before Flop (didn't bet)
Seat 2: dbf5f543 (small blind) folded before Flop
Seat 3: 2808c418 (big blind) collected ($0.04)
Seat 4: 5b79005a folded before Flop (didn't bet)
Seat 5: 8012317b folded before Flop (didn't bet)
Seat 6: Hero folded before Flop (didn't bet)


Poker Hand #RC3334597033: Hold'em No Limit ($0.02/$0.05) - 2025/02/17 21:38:55
Table 'RushAndCash632293' 6-max Seat #1 is the button
Seat 1: 719071b8 ($5.14 in chips)
Seat 2: Hero ($5.34 in chips)
Seat 3: 33caafa3 ($5.05 in chips)
Seat 4: a25931dc ($5.56 in chips)
Seat 5: 2a10169c ($5.07 in chips)
Seat 6: 8f6b4935 ($5.59 in chips)
Hero: posts small blind $0.02
33caafa3: posts big blind $0.05
*** HOLE CARDS ***
Dealt to 719071b8 
Dealt to Hero [4d 5c]
Dealt to 33caafa3 
Dealt to a25931dc 
Dealt to 2a10169c 
Dealt to 8f6b4935 
a25931dc: folds
2a10169c: raises $0.05 to $0.1
8f6b4935: folds
719071b8: folds
Hero: folds
33caafa3: folds
Uncalled bet ($0.05) returned to 2a10169c
*** SHOWDOWN ***
2a10169c collected $0.12 from pot
*** SUMMARY ***
Total pot $0.12 | Rake $0 | Jackpot $0 | Bingo $0 | Fortune $0 | Tax $0
Seat 1: 719071b8 (button) folded before Flop (didn't bet)
Seat 2: Hero (small blind) folded before Flop
Seat 3: 33caafa3 (big blind) folded before Flop
Seat 4: a25931dc folded before Flop (didn't bet)
Seat 5: 2a10169c collected ($0.12)
Seat 6: 8f6b4935 folded before Flop (didn't bet)


Poker Hand #RC3334597006: Hold'em No Limit ($0.02/$0.05) - 2025/02/17 21:38:52
Table 'RushAndCash632266' 6-max Seat #1 is the button
Seat 1: 9013f95e ($10.32 in chips)
Seat 2: 47d6aff8 ($5.46 in chips)
Seat 3: 218dd9df ($6.79 in chips)
Seat 4: 7cf365ea ($6.31 in chips)
Seat 5: d606d9 ($8.9 in chips)
Seat 6: Hero ($5.34 in chips)
47d6aff8: posts small blind $0.02
218dd9df: posts big blind $0.05
*** HOLE CARDS ***
Dealt to 9013f95e 
Dealt to 47d6aff8 
Dealt to 218dd9df 
Dealt to 7cf365ea 
Dealt to d606d9 
Dealt to Hero [9h Ac]
7cf365ea: raises $0.05 to $0.1
d606d9: folds
Hero: folds
9013f95e: folds
47d6aff8: folds
218dd9df: calls $0.05
*** FLOP *** [7c 9c 3c]
218dd9df: checks
7cf365ea: checks
*** TURN *** [7c 9c 3c] [3s]
218dd9df: bets $0.11
7cf365ea: calls $0.11
*** RIVER *** [7c 9c 3c 3s] [Kc]
218dd9df: checks
7cf365ea: checks
218dd9df: shows [4s 5h] (Pair of Treys)
7cf365ea: shows [Tc Ad] (King High Flush)
*** SHOWDOWN ***
7cf365ea collected $0.42 from pot
*** SUMMARY ***
Total pot $0.44 | Rake $0.02 | Jackpot $0 | Bingo $0 | Fortune $0 | Tax $0
Board [7c 9c 3c 3s Kc]
Seat 1: 9013f95e (button) folded before Flop (didn't bet)
Seat 2: 47d6aff8 (small blind) folded before Flop
Seat 3: 218dd9df (big blind) showed [4s 5h] and lost with Pair of Treys
Seat 4: 7cf365ea showed [Tc Ad] and won ($0.42) with King High Flush
Seat 5: d606d9 folded before Flop (didn't bet)
Seat 6: Hero folded before Flop (didn't bet)


Poker Hand #RC3334596978: Hold'em No Limit ($0.02/$0.05) - 2025/02/17 21:38:48
Table 'RushAndCash632238' 6-max Seat #1 is the button
Seat 1: c607d475 ($8.91 in chips)
Seat 2: Hero ($5.36 in chips)
Seat 3: 5c8b20e0 ($7.16 in chips)
Seat 4: 7b9ea1f3 ($8 in chips)
Seat 5: fa499268 ($8.85 in chips)
Seat 6: 6d5fa70b ($5.54 in chips)
Hero: posts small blind $0.02
5c8b20e0: posts big blind $0.05
*** HOLE CARDS ***
Dealt to c607d475 
Dealt to Hero [3s 5s]
Dealt to 5c8b20e0 
Dealt to 7b9ea1f3 
Dealt to fa499268 
Dealt to 6d5fa70b 
7b9ea1f3: folds
fa499268: folds
6d5fa70b: folds
c607d475: folds
Hero: folds
Uncalled bet ($0.03) returned to 5c8b20e0
*** SHOWDOWN ***
5c8b20e0 collected $0.04 from pot
*** SUMMARY ***
Total pot $0.04 | Rake $0 | Jackpot $0 | Bingo $0 | Fortune $0 | Tax $0
Seat 1: c607d475 (button) folded before Flop (didn't bet)
Seat 2: Hero (small blind) folded before Flop
Seat 3: 5c8b20e0 (big blind) collected ($0.04)
Seat 4: 7b9ea1f3 folded before Flop (didn't bet)
Seat 5: fa499268 folded before Flop (didn't bet)
Seat 6: 6d5fa70b folded before Flop (didn't bet)


Poker Hand #RC3334596936: Hold'em No Limit ($0.02/$0.05) - 2025/02/17 21:38:44
Table 'RushAndCash632196' 6-max Seat #1 is the button
Seat 1: 229ec9a7 ($9.73 in chips)
Seat 2: 82c6ccfb ($10.49 in chips)
Seat 3: 4b71998b ($11.74 in chips)
Seat 4: 8d7c8253 ($6.71 in chips)
Seat 5: a25931dc ($5.58 in chips)
Seat 6: Hero ($5.36 in chips)
82c6ccfb: posts small blind $0.02
4b71998b: posts big blind $0.05
*** HOLE CARDS ***
Dealt to 229ec9a7 
Dealt to 82c6ccfb 
Dealt to 4b71998b 
Dealt to 8d7c8253 
Dealt to a25931dc 
Dealt to Hero [Qs 8s]
8d7c8253: raises $0.05 to $0.1
a25931dc: folds
Hero: folds
229ec9a7: folds
82c6ccfb: folds
4b71998b: calls $0.05
*** FLOP *** [7s Qc Qd]
4b71998b: checks
8d7c8253: bets $0.16
4b71998b: folds
Uncalled bet ($0.16) returned to 8d7c8253
*** SHOWDOWN ***
8d7c8253 collected $0.21 from pot
*** SUMMARY ***
Total pot $0.22 | Rake $0.01 | Jackpot $0 | Bingo $0 | Fortune $0 | Tax $0
Board [7s Qc Qd]
Seat 1: 229ec9a7 (button) folded before Flop (didn't bet)
Seat 2: 82c6ccfb (small blind) folded before Flop
Seat 3: 4b71998b (big blind) folded on the Flop
Seat 4: 8d7c8253 won ($0.21)
Seat 5: a25931dc folded before Flop (didn't bet)
Seat 6: Hero folded before Flop (didn't bet)


Poker Hand #RC3334596901: Hold'em No Limit ($0.02/$0.05) - 2025/02/17 21:38:40
Table 'RushAndCash632161' 6-max Seat #1 is the button
Seat 1: 76135c78 ($13.31 in chips)
Seat 2: b244c9b2 ($4.95 in chips)
Seat 3: 12ef643d ($4.65 in chips)
Seat 4: 97d67e86 ($5.51 in chips)
Seat 5: c607d475 ($8.91 in chips)
Seat 6: Hero ($5.36 in chips)
b244c9b2: posts small blind $0.02
12ef643d: posts big blind $0.05
*** HOLE CARDS ***
Dealt to 76135c78 
Dealt to b244c9b2 
Dealt to 12ef643d 
Dealt to 97d67e86 
Dealt to c607d475 
Dealt to Hero [2h Ad]
97d67e86: folds
c607d475: folds
Hero: folds
76135c78: folds
b244c9b2: raises $0.05 to $0.1
12ef643d: calls $0.05
*** FLOP *** [3d Ah Jc]
b244c9b2: bets $0.1
12ef643d: raises $0.16 to $0.26
b244c9b2: calls $0.16
*** TURN *** [3d Ah Jc] [Jh]
b244c9b2: checks
12ef643d: checks
*** RIVER *** [3d Ah Jc Jh] [8c]
b244c9b2: checks
12ef643d: bets $0.36
b244c9b2: calls $0.36
12ef643d: shows [6h 9h] (Pair of Jacks)
b244c9b2: shows [As 7c] (Pair of Aces and Pair of Jacks)
*** SHOWDOWN ***
b244c9b2 collected $1.37 from pot
*** SUMMARY ***
Total pot $1.44 | Rake $0.07 | Jackpot $0 | Bingo $0 | Fortune $0 | Tax $0
Board [3d Ah Jc Jh 8c]
Seat 1: 76135c78 (button) folded before Flop (didn't bet)
Seat 2: b244c9b2 (small blind) showed [As 7c] and won ($1.37) with Pair of Aces and Pair of Jacks
Seat 3: 12ef643d (big blind) showed [6h 9h] and lost with Pair of Jacks
Seat 4: 97d67e86 folded before Flop (didn't bet)
Seat 5: c607d475 folded before Flop (didn't bet)
Seat 6: Hero folded before Flop (didn't bet)


Poker Hand #RC3334596874: Hold'em No Limit ($0.02/$0.05) - 2025/02/17 21:38:37
Table 'RushAndCash632134' 6-max Seat #1 is the button
Seat 1: fb6c913 ($8.97 in chips)
Seat 2: f994138c ($9.31 in chips)
Seat 3: 8d7c8253 ($6.69 in chips)
Seat 4: bcb971d3 ($5.68 in chips)
Seat 5: Hero ($5.36 in chips)
Seat 6: f0600331 ($8.03 in chips)
f994138c: posts small blind $0.02
8d7c8253: posts big blind $0.05
*** HOLE CARDS ***
Dealt to fb6c913 
Dealt to f994138c 
Dealt to 8d7c8253 
Dealt to bcb971d3 
Dealt to Hero [6c 2s]
Dealt to f0600331 
bcb971d3: folds
Hero: folds
f0600331: folds
fb6c913: folds
f994138c: folds
Uncalled bet ($0.03) returned to 8d7c8253
*** SHOWDOWN ***
8d7c8253 collected $0.04 from pot
*** SUMMARY ***
Total pot $0.04 | Rake $0 | Jackpot $0 | Bingo $0 | Fortune $0 | Tax $0
Seat 1: fb6c913 (button) folded before Flop (didn't bet)
Seat 2: f994138c (small blind) folded before Flop
Seat 3: 8d7c8253 (big blind) collected ($0.04)
Seat 4: bcb971d3 folded before Flop (didn't bet)
Seat 5: Hero folded before Flop (didn't bet)
Seat 6: f0600331 folded before Flop (didn't bet)


Poker Hand #RC3334596844: Hold'em No Limit ($0.02/$0.05) - 2025/02/17 21:38:33
Table 'RushAndCash632104' 6-max Seat #1 is the button
Seat 1: fc77b046 ($9.51 in chips)
Seat 2: 86fb354d ($10.04 in chips)
Seat 3: Hero ($5.41 in chips)
Seat 4: cc8de981 ($9.22 in chips)
Seat 5: 87205baf ($11.41 in chips)
Seat 6: 34498263 ($5.78 in chips)
86fb354d: posts small blind $0.02
Hero: posts big blind $0.05
*** HOLE CARDS ***
Dealt to fc77b046 
Dealt to 86fb354d 
Dealt to Hero [7d 3c]
Dealt to cc8de981 
Dealt to 87205baf 
Dealt to 34498263 
cc8de981: folds
87205baf: raises $0.07 to $0.12
34498263: folds
fc77b046: folds
86fb354d: folds
Hero: folds
Uncalled bet ($0.07) returned to 87205baf
*** SHOWDOWN ***
87205baf collected $0.12 from pot
*** SUMMARY ***
Total pot $0.12 | Rake $0 | Jackpot $0 | Bingo $0 | Fortune $0 | Tax $0
Seat 1: fc77b046 (button) folded before Flop (didn't bet)
Seat 2: 86fb354d (small blind) folded before Flop
Seat 3: Hero (big blind) folded before Flop
Seat 4: cc8de981 folded before Flop (didn't bet)
Seat 5: 87205baf collected ($0.12)
Seat 6: 34498263 folded before Flop (didn't bet)


Poker Hand #RC3334596817: Hold'em No Limit ($0.02/$0.05) - 2025/02/17 21:38:30
Table 'RushAndCash632077' 6-max Seat #1 is the button
Seat 1: 55fce4b5 ($4.86 in chips)
Seat 2: e6ee1d7f ($5.39 in chips)
Seat 3: 71e00d83 ($7.85 in chips)
Seat 4: 8072ab30 ($5.07 in chips)
Seat 5: Hero ($5.41 in chips)
Seat 6: 94cb065d ($7.42 in chips)
e6ee1d7f: posts small blind $0.02
71e00d83: posts big blind $0.05
*** HOLE CARDS ***
Dealt to 55fce4b5 
Dealt to e6ee1d7f 
Dealt to 71e00d83 
Dealt to 8072ab30 
Dealt to Hero [8d 2d]
Dealt to 94cb065d 
8072ab30: folds
Hero: folds
94cb065d: folds
55fce4b5: folds
e6ee1d7f: folds
Uncalled bet ($0.03) returned to 71e00d83
*** SHOWDOWN ***
71e00d83 collected $0.04 from pot
*** SUMMARY ***
Total pot $0.04 | Rake $0 | Jackpot $0 | Bingo $0 | Fortune $0 | Tax $0
Seat 1: 55fce4b5 (button) folded before Flop (didn't bet)
Seat 2: e6ee1d7f (small blind) folded before Flop
Seat 3: 71e00d83 (big blind) collected ($0.04)
Seat 4: 8072ab30 folded before Flop (didn't bet)
Seat 5: Hero folded before Flop (didn't bet)
Seat 6: 94cb065d folded before Flop (didn't bet)


Poker Hand #RC3334596784: Hold'em No Limit ($0.02/$0.05) - 2025/02/17 21:38:26
Table 'RushAndCash632044' 6-max Seat #1 is the button
Seat 1: 65ca9276 ($8.79 in chips)
Seat 2: 911dbc6d ($2.62 in chips)
Seat 3: 2596103a ($2.11 in chips)
Seat 4: Hero ($5.41 in chips)
Seat 5: a81aa4e3 ($6.37 in chips)
Seat 6: c0a90b1a ($6.23 in chips)
911dbc6d: posts small blind $0.02
2596103a: posts big blind $0.05
*** HOLE CARDS ***
Dealt to 65ca9276 
Dealt to 911dbc6d 
Dealt to 2596103a 
Dealt to Hero [Th Qc]
Dealt to a81aa4e3 
Dealt to c0a90b1a 
Hero: folds
a81aa4e3: folds
c0a90b1a: raises $0.08 to $0.13
65ca9276: folds
911dbc6d: folds
2596103a: raises $0.14 to $0.27
c0a90b1a: raises $5.96 to $6.23 and is all-in
2596103a: folds
Uncalled bet ($5.96) returned to c0a90b1a
*** SHOWDOWN ***
c0a90b1a collected $0.54 from pot
*** SUMMARY ***
Total pot $0.56 | Rake $0.02 | Jackpot $0 | Bingo $0 | Fortune $0 | Tax $0
Seat 1: 65ca9276 (button) folded before Flop (didn't bet)
Seat 2: 911dbc6d (small blind) folded before Flop
Seat 3: 2596103a (big blind) folded before Flop
Seat 4: Hero folded before Flop (didn't bet)
Seat 5: a81aa4e3 folded before Flop (didn't bet)
Seat 6: c0a90b1a collected ($0.54)


Poker Hand #RC3334596757: Hold'em No Limit ($0.02/$0.05) - 2025/02/17 21:38:23
Table 'RushAndCash632017' 6-max Seat #1 is the button
Seat 1: d60e3ce5 ($6.13 in chips)
Seat 2: Hero ($5.43 in chips)
Seat 3: 8012317b ($10.82 in chips)
Seat 4: f994138c ($9.31 in chips)
Seat 5: 5466aa49 ($5.43 in chips)
Seat 6: f9ae1394 ($5 in chips)
Hero: posts small blind $0.02
8012317b: posts big blind $0.05
*** HOLE CARDS ***
Dealt to d60e3ce5 
Dealt to Hero [Td 6d]
Dealt to 8012317b 
Dealt to f994138c 
Dealt to 5466aa49 
Dealt to f9ae1394 
f994138c: folds
5466aa49: raises $0.06 to $0.11
f9ae1394: folds
d60e3ce5: folds
Hero: folds
8012317b: folds
Uncalled bet ($0.06) returned to 5466aa49
*** SHOWDOWN ***
5466aa49 collected $0.12 from pot
*** SUMMARY ***
Total pot $0.12 | Rake $0 | Jackpot $0 | Bingo $0 | Fortune $0 | Tax $0
Seat 1: d60e3ce5 (button) folded before Flop (didn't bet)
Seat 2: Hero (small blind) folded before Flop
Seat 3: 8012317b (big blind) folded before Flop
Seat 4: f994138c folded before Flop (didn't bet)
Seat 5: 5466aa49 collected ($0.12)
Seat 6: f9ae1394 folded before Flop (didn't bet)


Poker Hand #RC3334596729: Hold'em No Limit ($0.02/$0.05) - 2025/02/17 21:38:20
Table 'RushAndCash631989' 6-max Seat #1 is the button
Seat 1: Hero ($5.43 in chips)
Seat 2: 577aa3d3 ($9.68 in chips)
Seat 3: 8b7080d0 ($6.25 in chips)
Seat 4: 421a6d95 ($5.72 in chips)
Seat 5: e97b3270 ($22.69 in chips)
Seat 6: 2642904 ($5.02 in chips)
577aa3d3: posts small blind $0.02
8b7080d0: posts big blind $0.05
*** HOLE CARDS ***
Dealt to Hero [4s 6c]
Dealt to 577aa3d3 
Dealt to 8b7080d0 
Dealt to 421a6d95 
Dealt to e97b3270 
Dealt to 2642904 
421a6d95: folds
e97b3270: folds
2642904: raises $0.05 to $0.1
Hero: folds
577aa3d3: folds
8b7080d0: folds
Uncalled bet ($0.05) returned to 2642904
*** SHOWDOWN ***
2642904 collected $0.12 from pot
*** SUMMARY ***
Total pot $0.12 | Rake $0 | Jackpot $0 | Bingo $0 | Fortune $0 | Tax $0
Seat 1: Hero (button) folded before Flop (didn't bet)
Seat 2: 577aa3d3 (small blind) folded before Flop
Seat 3: 8b7080d0 (big blind) folded before Flop
Seat 4: 421a6d95 folded before Flop (didn't bet)
Seat 5: e97b3270 folded before Flop (didn't bet)
Seat 6: 2642904 collected ($0.12)


Poker Hand #RC3334596703: Hold'em No Limit ($0.02/$0.05) - 2025/02/17 21:38:17
Table 'RushAndCash631963' 6-max Seat #1 is the button
Seat 1: e97b3270 ($22.69 in chips)
Seat 2: c24b20b9 ($16.65 in chips)
Seat 3: 6ac4af54 ($12.68 in chips)
Seat 4: b258f9f9 ($5.59 in chips)
Seat 5: 9d687e0 ($4.1 in chips)
Seat 6: Hero ($5.43 in chips)
c24b20b9: posts small blind $0.02
6ac4af54: posts big blind $0.05
*** HOLE CARDS ***
Dealt to e97b3270 
Dealt to c24b20b9 
Dealt to 6ac4af54 
Dealt to b258f9f9 
Dealt to 9d687e0 
Dealt to Hero [Qs 2c]
b258f9f9: folds
9d687e0: folds
Hero: folds
e97b3270: folds
c24b20b9: folds
Uncalled bet ($0.03) returned to 6ac4af54
*** SHOWDOWN ***
6ac4af54 collected $0.04 from pot
*** SUMMARY ***
Total pot $0.04 | Rake $0 | Jackpot $0 | Bingo $0 | Fortune $0 | Tax $0
Seat 1: e97b3270 (button) folded before Flop (didn't bet)
Seat 2: c24b20b9 (small blind) folded before Flop
Seat 3: 6ac4af54 (big blind) collected ($0.04)
Seat 4: b258f9f9 folded before Flop (didn't bet)
Seat 5: 9d687e0 folded before Flop (didn't bet)
Seat 6: Hero folded before Flop (didn't bet)


Poker Hand #RC3334596676: Hold'em No Limit ($0.02/$0.05) - 2025/02/17 21:38:13
Table 'RushAndCash631936' 6-max Seat #1 is the button
Seat 1: b9ae439d ($5.92 in chips)
Seat 2: 14d966a6 ($5.02 in chips)
Seat 3: 4238ab48 ($7.84 in chips)
Seat 4: Hero ($5.43 in chips)
Seat 5: ebb43f9 ($3.34 in chips)
Seat 6: b10195a2 ($5.07 in chips)
14d966a6: posts small blind $0.02
4238ab48: posts big blind $0.05
*** HOLE CARDS ***
Dealt to b9ae439d 
Dealt to 14d966a6 
Dealt to 4238ab48 
Dealt to Hero [7s Qs]
Dealt to ebb43f9 
Dealt to b10195a2 
Hero: folds
ebb43f9: folds
b10195a2: folds
b9ae439d: folds
14d966a6: raises $0.05 to $0.1
4238ab48: folds
Uncalled bet ($0.05) returned to 14d966a6
*** SHOWDOWN ***
14d966a6 collected $0.1 from pot
*** SUMMARY ***
Total pot $0.1 | Rake $0 | Jackpot $0 | Bingo $0 | Fortune $0 | Tax $0
Seat 1: b9ae439d (button) folded before Flop (didn't bet)
Seat 2: 14d966a6 (small blind) collected ($0.1)
Seat 3: 4238ab48 (big blind) folded before Flop
Seat 4: Hero folded before Flop (didn't bet)
Seat 5: ebb43f9 folded before Flop (didn't bet)
Seat 6: b10195a2 folded before Flop (didn't bet)


Poker Hand #RC3334596499: Hold'em No Limit ($0.02/$0.05) - 2025/02/17 21:37:51
Table 'RushAndCash631759' 6-max Seat #1 is the button
Seat 1: ee3fdfd8 ($5.05 in chips)
Seat 2: e97b3270 ($22.76 in chips)
Seat 3: 58623097 ($5 in chips)
Seat 4: 56b9b8a5 ($5 in chips)
Seat 5: 5b79005a ($5.88 in chips)
Seat 6: Hero ($5.53 in chips)
e97b3270: posts small blind $0.02
58623097: posts big blind $0.05
*** HOLE CARDS ***
Dealt to ee3fdfd8 
Dealt to e97b3270 
Dealt to 58623097 
Dealt to 56b9b8a5 
Dealt to 5b79005a 
Dealt to Hero [Jh Ad]
56b9b8a5: folds
5b79005a: folds
Hero: raises $0.05 to $0.1
ee3fdfd8: raises $0.21 to $0.31
e97b3270: folds
58623097: calls $0.26
Hero: folds
*** FLOP *** [4d Ts 2s]
58623097: checks
ee3fdfd8: checks
*** TURN *** [4d Ts 2s] [5s]
58623097: checks
ee3fdfd8: checks
*** RIVER *** [4d Ts 2s 5s] [2d]
58623097: checks
ee3fdfd8: checks
58623097: shows [9c 9d] (Pair of Nines and Pair of Twos)
ee3fdfd8: shows [Jc Kc] (Pair of Twos)
*** SHOWDOWN ***
58623097 collected $0.71 from pot
*** SUMMARY ***
Total pot $0.74 | Rake $0.03 | Jackpot $0 | Bingo $0 | Fortune $0 | Tax $0
Board [4d Ts 2s 5s 2d]
Seat 1: ee3fdfd8 (button) showed [Jc Kc] and lost with Pair of Twos
Seat 2: e97b3270 (small blind) folded before Flop
Seat 3: 58623097 (big blind) showed [9c 9d] and won ($0.71) with Pair of Nines and Pair of Twos
Seat 4: 56b9b8a5 folded before Flop (didn't bet)
Seat 5: 5b79005a folded before Flop (didn't bet)
Seat 6: Hero folded before Flop


Poker Hand #RC3334596407: Hold'em No Limit ($0.02/$0.05) - 2025/02/17 21:37:41
Table 'RushAndCash631667' 6-max Seat #1 is the button
Seat 1: a664c86a ($6.96 in chips)
Seat 2: 56b9b8a5 ($5.07 in chips)
Seat 3: Hero ($5.58 in chips)
Seat 4: 1640de52 ($23.6 in chips)
Seat 5: 33554b00 ($5 in chips)
Seat 6: bd5d2bb7 ($5.13 in chips)
56b9b8a5: posts small blind $0.02
Hero: posts big blind $0.05
*** HOLE CARDS ***
Dealt to a664c86a 
Dealt to 56b9b8a5 
Dealt to Hero [2c 9d]
Dealt to 1640de52 
Dealt to 33554b00 
Dealt to bd5d2bb7 
1640de52: folds
33554b00: folds
bd5d2bb7: raises $0.05 to $0.1
a664c86a: folds
56b9b8a5: folds
Hero: folds
Uncalled bet ($0.05) returned to bd5d2bb7
*** SHOWDOWN ***
bd5d2bb7 collected $0.12 from pot
*** SUMMARY ***
Total pot $0.12 | Rake $0 | Jackpot $0 | Bingo $0 | Fortune $0 | Tax $0
Seat 1: a664c86a (button) folded before Flop (didn't bet)
Seat 2: 56b9b8a5 (small blind) folded before Flop
Seat 3: Hero (big blind) folded before Flop
Seat 4: 1640de52 folded before Flop (didn't bet)
Seat 5: 33554b00 folded before Flop (didn't bet)
Seat 6: bd5d2bb7 collected ($0.12)


Poker Hand #RC3334596382: Hold'em No Limit ($0.02/$0.05) - 2025/02/17 21:37:38
Table 'RushAndCash631642' 6-max Seat #1 is the button
Seat 1: 8e93231a ($6.3 in chips)
Seat 2: 66be2112 ($7.29 in chips)
Seat 3: 8c8bf19e ($5.6 in chips)
Seat 4: a19fb924 ($8.47 in chips)
Seat 5: Hero ($5.58 in chips)
Seat 6: 9b6d78be ($5.17 in chips)
66be2112: posts small blind $0.02
8c8bf19e: posts big blind $0.05
*** HOLE CARDS ***
Dealt to 8e93231a 
Dealt to 66be2112 
Dealt to 8c8bf19e 
Dealt to a19fb924 
Dealt to Hero [9h 4d]
Dealt to 9b6d78be 
a19fb924: raises $0.05 to $0.1
Hero: folds
9b6d78be: folds
8e93231a: folds
66be2112: folds
8c8bf19e: folds
Uncalled bet ($0.05) returned to a19fb924
*** SHOWDOWN ***
a19fb924 collected $0.12 from pot
*** SUMMARY ***
Total pot $0.12 | Rake $0 | Jackpot $0 | Bingo $0 | Fortune $0 | Tax $0
Seat 1: 8e93231a (button) folded before Flop (didn't bet)
Seat 2: 66be2112 (small blind) folded before Flop
Seat 3: 8c8bf19e (big blind) folded before Flop
Seat 4: a19fb924 collected ($0.12)
Seat 5: Hero folded before Flop (didn't bet)
Seat 6: 9b6d78be folded before Flop (didn't bet)


Poker Hand #RC3334596348: Hold'em No Limit ($0.02/$0.05) - 2025/02/17 21:37:34
Table 'RushAndCash631608' 6-max Seat #1 is the button
Seat 1: Hero ($5.58 in chips)
Seat 2: d8d5b4d7 ($5.21 in chips)
Seat 3: c4483bd8 ($5 in chips)
Seat 4: c83a952b ($5.7 in chips)
Seat 5: 1e2c3e8b ($5.4 in chips)
Seat 6: ba806aaa ($2.53 in chips)
d8d5b4d7: posts small blind $0.02
c4483bd8: posts big blind $0.05
*** HOLE CARDS ***
Dealt to Hero [3h Qh]
Dealt to d8d5b4d7 
Dealt to c4483bd8 
Dealt to c83a952b 
Dealt to 1e2c3e8b 
Dealt to ba806aaa 
c83a952b: folds
1e2c3e8b: folds
ba806aaa: raises $0.05 to $0.1
Hero: folds
d8d5b4d7: folds
c4483bd8: folds
Uncalled bet ($0.05) returned to ba806aaa
*** SHOWDOWN ***
ba806aaa collected $0.12 from pot
*** SUMMARY ***
Total pot $0.12 | Rake $0 | Jackpot $0 | Bingo $0 | Fortune $0 | Tax $0
Seat 1: Hero (button) folded before Flop (didn't bet)
Seat 2: d8d5b4d7 (small blind) folded before Flop
Seat 3: c4483bd8 (big blind) folded before Flop
Seat 4: c83a952b folded before Flop (didn't bet)
Seat 5: 1e2c3e8b folded before Flop (didn't bet)
Seat 6: ba806aaa collected ($0.12)


Poker Hand #RC3334596324: Hold'em No Limit ($0.02/$0.05) - 2025/02/17 21:37:31
Table 'RushAndCash631584' 6-max Seat #1 is the button
Seat 1: c2080d6e ($5.83 in chips)
Seat 2: d870506c ($4.86 in chips)
Seat 3: 38005dc9 ($4.12 in chips)
Seat 4: Hero ($5.58 in chips)
Seat 5: 4c7728b5 ($5.2 in chips)
Seat 6: 3a46e390 ($5.81 in chips)
d870506c: posts small blind $0.02
38005dc9: posts big blind $0.05
*** HOLE CARDS ***
Dealt to c2080d6e 
Dealt to d870506c 
Dealt to 38005dc9 
Dealt to Hero [3d Js]
Dealt to 4c7728b5 
Dealt to 3a46e390 
Hero: folds
4c7728b5: folds
3a46e390: folds
c2080d6e: raises $0.07 to $0.12
d870506c: folds
38005dc9: folds
Uncalled bet ($0.07) returned to c2080d6e
*** SHOWDOWN ***
c2080d6e collected $0.12 from pot
*** SUMMARY ***
Total pot $0.12 | Rake $0 | Jackpot $0 | Bingo $0 | Fortune $0 | Tax $0
Seat 1: c2080d6e (button) collected ($0.12)
Seat 2: d870506c (small blind) folded before Flop
Seat 3: 38005dc9 (big blind) folded before Flop
Seat 4: Hero folded before Flop (didn't bet)
Seat 5: 4c7728b5 folded before Flop (didn't bet)
Seat 6: 3a46e390 folded before Flop (didn't bet)


Poker Hand #RC3334596295: Hold'em No Limit ($0.02/$0.05) - 2025/02/17 21:37:27
Table 'RushAndCash631555' 6-max Seat #1 is the button
Seat 1: ca7c2b72 ($5.74 in chips)
Seat 2: Hero ($5.6 in chips)
Seat 3: 95096c6a ($10.39 in chips)
Seat 4: 4b71998b ($11.5 in chips)
Seat 5: 5337265e ($19.54 in chips)
Seat 6: a664c86a ($7.03 in chips)
Hero: posts small blind $0.02
95096c6a: posts big blind $0.05
*** HOLE CARDS ***
Dealt to ca7c2b72 
Dealt to Hero [Kd 3c]
Dealt to 95096c6a 
Dealt to 4b71998b 
Dealt to 5337265e 
Dealt to a664c86a 
4b71998b: folds
5337265e: folds
a664c86a: folds
ca7c2b72: folds
Hero: folds
Uncalled bet ($0.03) returned to 95096c6a
*** SHOWDOWN ***
95096c6a collected $0.04 from pot
*** SUMMARY ***
Total pot $0.04 | Rake $0 | Jackpot $0 | Bingo $0 | Fortune $0 | Tax $0
Seat 1: ca7c2b72 (button) folded before Flop (didn't bet)
Seat 2: Hero (small blind) folded before Flop
Seat 3: 95096c6a (big blind) collected ($0.04)
Seat 4: 4b71998b folded before Flop (didn't bet)
Seat 5: 5337265e folded before Flop (didn't bet)
Seat 6: a664c86a folded before Flop (didn't bet)


Poker Hand #RC3334596268: Hold'em No Limit ($0.02/$0.05) - 2025/02/17 21:37:24
Table 'RushAndCash631528' 6-max Seat #1 is the button
Seat 1: b74983a1 ($6.07 in chips)
Seat 2: 9b1a3dd2 ($15.08 in chips)
Seat 3: ee6eaae7 ($4.51 in chips)
Seat 4: Hero ($5.6 in chips)
Seat 5: b8c09f2 ($6.51 in chips)
Seat 6: 802a8ffb ($9.13 in chips)
9b1a3dd2: posts small blind $0.02
ee6eaae7: posts big blind $0.05
*** HOLE CARDS ***
Dealt to b74983a1 
Dealt to 9b1a3dd2 
Dealt to ee6eaae7 
Dealt to Hero [9h Kc]
Dealt to b8c09f2 
Dealt to 802a8ffb 
Hero: folds
b8c09f2: folds
802a8ffb: folds
b74983a1: raises $0.08 to $0.13
9b1a3dd2: folds
ee6eaae7: folds
Uncalled bet ($0.08) returned to b74983a1
*** SHOWDOWN ***
b74983a1 collected $0.12 from pot
*** SUMMARY ***
Total pot $0.12 | Rake $0 | Jackpot $0 | Bingo $0 | Fortune $0 | Tax $0
Seat 1: b74983a1 (button) collected ($0.12)
Seat 2: 9b1a3dd2 (small blind) folded before Flop
Seat 3: ee6eaae7 (big blind) folded before Flop
Seat 4: Hero folded before Flop (didn't bet)
Seat 5: b8c09f2 folded before Flop (didn't bet)
Seat 6: 802a8ffb folded before Flop (didn't bet)


Poker Hand #RC3334595962: Hold'em No Limit ($0.02/$0.05) - 2025/02/17 21:36:47
Table 'RushAndCash631222' 6-max Seat #1 is the button
Seat 1: Hero ($5.49 in chips)
Seat 2: 2ec306f3 ($5.18 in chips)
Seat 3: c585480d ($10.7 in chips)
Seat 4: 3b98b9ec ($18.29 in chips)
Seat 5: 44527b96 ($5.48 in chips)
Seat 6: 12ef643d ($4.65 in chips)
2ec306f3: posts small blind $0.02
c585480d: posts big blind $0.05
*** HOLE CARDS ***
Dealt to Hero [4h 4d]
Dealt to 2ec306f3 
Dealt to c585480d 
Dealt to 3b98b9ec 
Dealt to 44527b96 
Dealt to 12ef643d 
3b98b9ec: folds
44527b96: folds
12ef643d: folds
Hero: raises $0.05 to $0.1
2ec306f3: folds
c585480d: calls $0.05
*** FLOP *** [6d 4c 9s]
c585480d: checks
Hero: bets $0.18
c585480d: folds
Uncalled bet ($0.18) returned to Hero
*** SHOWDOWN ***
Hero collected $0.21 from pot
*** SUMMARY ***
Total pot $0.22 | Rake $0.01 | Jackpot $0 | Bingo $0 | Fortune $0 | Tax $0
Board [6d 4c 9s]
Seat 1: Hero (button) won ($0.21)
Seat 2: 2ec306f3 (small blind) folded before Flop
Seat 3: c585480d (big blind) folded on the Flop
Seat 4: 3b98b9ec folded before Flop (didn't bet)
Seat 5: 44527b96 folded before Flop (didn't bet)
Seat 6: 12ef643d folded before Flop (didn't bet)


Poker Hand #RC3334595935: Hold'em No Limit ($0.02/$0.05) - 2025/02/17 21:36:43
Table 'RushAndCash631195' 6-max Seat #1 is the button
Seat 1: bebd931c ($4.43 in chips)
Seat 2: Hero ($5.51 in chips)
Seat 3: 8c3789e ($5.84 in chips)
Seat 4: d0d9ce45 ($8.01 in chips)
Seat 5: 87395f7a ($5.6 in chips)
Seat 6: 27754ad8 ($5 in chips)
Hero: posts small blind $0.02
8c3789e: posts big blind $0.05
*** HOLE CARDS ***
Dealt to bebd931c 
Dealt to Hero [2s Td]
Dealt to 8c3789e 
Dealt to d0d9ce45 
Dealt to 87395f7a 
Dealt to 27754ad8 
d0d9ce45: raises $0.06 to $0.11
87395f7a: folds
27754ad8: folds
bebd931c: folds
Hero: folds
8c3789e: folds
Uncalled bet ($0.06) returned to d0d9ce45
*** SHOWDOWN ***
d0d9ce45 collected $0.12 from pot
*** SUMMARY ***
Total pot $0.12 | Rake $0 | Jackpot $0 | Bingo $0 | Fortune $0 | Tax $0
Seat 1: bebd931c (button) folded before Flop (didn't bet)
Seat 2: Hero (small blind) folded before Flop
Seat 3: 8c3789e (big blind) folded before Flop
Seat 4: d0d9ce45 collected ($0.12)
Seat 5: 87395f7a folded before Flop (didn't bet)
Seat 6: 27754ad8 folded before Flop (didn't bet)


Poker Hand #RC3334595800: Hold'em No Limit ($0.02/$0.05) - 2025/02/17 21:36:28
Table 'RushAndCash631060' 6-max Seat #1 is the button
Seat 1: e3559a7e ($4.56 in chips)
Seat 2: 9fa2589a ($3.94 in chips)
Seat 3: Hero ($5.49 in chips)
Seat 4: a0cb6644 ($5.6 in chips)
Seat 5: d2fb1cd9 ($10.19 in chips)
Seat 6: a9d8ced4 ($6.15 in chips)
9fa2589a: posts small blind $0.02
Hero: posts big blind $0.05
*** HOLE CARDS ***
Dealt to e3559a7e 
Dealt to 9fa2589a 
Dealt to Hero [8c 6c]
Dealt to a0cb6644 
Dealt to d2fb1cd9 
Dealt to a9d8ced4 
a0cb6644: folds
d2fb1cd9: folds
a9d8ced4: folds
e3559a7e: folds
9fa2589a: folds
Uncalled bet ($0.03) returned to Hero
*** SHOWDOWN ***
Hero collected $0.04 from pot
*** SUMMARY ***
Total pot $0.04 | Rake $0 | Jackpot $0 | Bingo $0 | Fortune $0 | Tax $0
Seat 1: e3559a7e (button) folded before Flop (didn't bet)
Seat 2: 9fa2589a (small blind) folded before Flop
Seat 3: Hero (big blind) collected ($0.04)
Seat 4: a0cb6644 folded before Flop (didn't bet)
Seat 5: d2fb1cd9 folded before Flop (didn't bet)
Seat 6: a9d8ced4 folded before Flop (didn't bet)


Poker Hand #RC3334595776: Hold'em No Limit ($0.02/$0.05) - 2025/02/17 21:36:25
Table 'RushAndCash631036' 6-max Seat #1 is the button
Seat 1: 8023de0f ($8.65 in chips)
Seat 2: fa499268 ($8.1 in chips)
Seat 3: 7cf365ea ($5.93 in chips)
Seat 4: fea7bb48 ($8.87 in chips)
Seat 5: Hero ($5.49 in chips)
Seat 6: f84a49f0 ($5 in chips)
fa499268: posts small blind $0.02
7cf365ea: posts big blind $0.05
*** HOLE CARDS ***
Dealt to 8023de0f 
Dealt to fa499268 
Dealt to 7cf365ea 
Dealt to fea7bb48 
Dealt to Hero [5h Kh]
Dealt to f84a49f0 
fea7bb48: folds
Hero: folds
f84a49f0: raises $0.05 to $0.1
8023de0f: folds
fa499268: folds
7cf365ea: folds
Uncalled bet ($0.05) returned to f84a49f0
*** SHOWDOWN ***
f84a49f0 collected $0.12 from pot
*** SUMMARY ***
Total pot $0.12 | Rake $0 | Jackpot $0 | Bingo $0 | Fortune $0 | Tax $0
Seat 1: 8023de0f (button) folded before Flop (didn't bet)
Seat 2: fa499268 (small blind) folded before Flop
Seat 3: 7cf365ea (big blind) folded before Flop
Seat 4: fea7bb48 folded before Flop (didn't bet)
Seat 5: Hero folded before Flop (didn't bet)
Seat 6: f84a49f0 collected ($0.12)


Poker Hand #RC3334595718: Hold'em No Limit ($0.02/$0.05) - 2025/02/17 21:36:19
Table 'RushAndCash630978' 6-max Seat #1 is the button
Seat 1: e76863c8 ($6.46 in chips)
Seat 2: e8a5680c ($6.27 in chips)
Seat 3: 14d966a6 ($5.31 in chips)
Seat 4: Hero ($5.49 in chips)
Seat 5: 650e9dc7 ($11.18 in chips)
Seat 6: 5381eb4c ($6.82 in chips)
e8a5680c: posts small blind $0.02
14d966a6: posts big blind $0.05
*** HOLE CARDS ***
Dealt to e76863c8 
Dealt to e8a5680c 
Dealt to 14d966a6 
Dealt to Hero [5h 9h]
Dealt to 650e9dc7 
Dealt to 5381eb4c 
Hero: folds
650e9dc7: raises $0.08 to $0.13
5381eb4c: folds
e76863c8: calls $0.13
e8a5680c: folds
14d966a6: folds
*** FLOP *** [Kc 2h Js]
650e9dc7: checks
e76863c8: checks
*** TURN *** [Kc 2h Js] [Qc]
650e9dc7: bets $0.25
e76863c8: folds
Uncalled bet ($0.25) returned to 650e9dc7
*** SHOWDOWN ***
650e9dc7 collected $0.32 from pot
*** SUMMARY ***
Total pot $0.33 | Rake $0.01 | Jackpot $0 | Bingo $0 | Fortune $0 | Tax $0
Board [Kc 2h Js Qc]
Seat 1: e76863c8 (button) folded on the Turn
Seat 2: e8a5680c (small blind) folded before Flop
Seat 3: 14d966a6 (big blind) folded before Flop
Seat 4: Hero folded before Flop (didn't bet)
Seat 5: 650e9dc7 won ($0.32)
Seat 6: 5381eb4c folded before Flop (didn't bet)


Poker Hand #RC3334595603: Hold'em No Limit ($0.02/$0.05) - 2025/02/17 21:36:05
Table 'RushAndCash630863' 6-max Seat #1 is the button
Seat 1: 5c8c19b7 ($12.89 in chips)
Seat 2: edbb0bb6 ($5 in chips)
Seat 3: Hero ($5.54 in chips)
Seat 4: 4812f5c8 ($5.07 in chips)
Seat 5: 12ef643d ($4.72 in chips)
Seat 6: 2bfd1d0c ($10.57 in chips)
edbb0bb6: posts small blind $0.02
Hero: posts big blind $0.05
*** HOLE CARDS ***
Dealt to 5c8c19b7 
Dealt to edbb0bb6 
Dealt to Hero [8s 8c]
Dealt to 4812f5c8 
Dealt to 12ef643d 
Dealt to 2bfd1d0c 
4812f5c8: folds
12ef643d: folds
2bfd1d0c: folds
5c8c19b7: raises $0.08 to $0.13
edbb0bb6: raises $0.35 to $0.48
Hero: folds
5c8c19b7: calls $0.35
*** FLOP *** [7h 2c 7d]
edbb0bb6: bets $0.68
5c8c19b7: folds
Uncalled bet ($0.68) returned to edbb0bb6
*** SHOWDOWN ***
edbb0bb6 collected $0.96 from pot
*** SUMMARY ***
Total pot $1.01 | Rake $0.05 | Jackpot $0 | Bingo $0 | Fortune $0 | Tax $0
Board [7h 2c 7d]
Seat 1: 5c8c19b7 (button) folded on the Flop
Seat 2: edbb0bb6 (small blind) won ($0.96)
Seat 3: Hero (big blind) folded before Flop
Seat 4: 4812f5c8 folded before Flop (didn't bet)
Seat 5: 12ef643d folded before Flop (didn't bet)
Seat 6: 2bfd1d0c folded before Flop (didn't bet)


Poker Hand #RC3334595558: Hold'em No Limit ($0.02/$0.05) - 2025/02/17 21:36:00
Table 'RushAndCash630818' 6-max Seat #1 is the button
Seat 1: Hero ($5.54 in chips)
Seat 2: ced76793 ($5.78 in chips)
Seat 3: 826a79b4 ($6.28 in chips)
Seat 4: ba806aaa ($2.66 in chips)
Seat 5: 167e28c4 ($8.75 in chips)
Seat 6: 7b0814a4 ($4.61 in chips)
ced76793: posts small blind $0.02
826a79b4: posts big blind $0.05
*** HOLE CARDS ***
Dealt to Hero [6h Jc]
Dealt to ced76793 
Dealt to 826a79b4 
Dealt to ba806aaa 
Dealt to 167e28c4 
Dealt to 7b0814a4 
ba806aaa: raises $0.05 to $0.1
167e28c4: folds
7b0814a4: calls $0.1
Hero: folds
ced76793: folds
826a79b4: folds
*** FLOP *** [3h 9d Kc]
ba806aaa: checks
7b0814a4: checks
*** TURN *** [3h 9d Kc] [6c]
ba806aaa: checks
7b0814a4: checks
*** RIVER *** [3h 9d Kc 6c] [2s]
ba806aaa: checks
7b0814a4: checks
ba806aaa: shows [Ac Th] (Ace-High)
7b0814a4: shows [Tc Ad] (Ace-High)
*** SHOWDOWN ***
ba806aaa collected $0.14 from pot
7b0814a4 collected $0.13 from pot
*** SUMMARY ***
Total pot $0.27 | Rake $0 | Jackpot $0 | Bingo $0 | Fortune $0 | Tax $0
Board [3h 9d Kc 6c 2s]
Seat 1: Hero (button) folded before Flop (didn't bet)
Seat 2: ced76793 (small blind) folded before Flop
Seat 3: 826a79b4 (big blind) folded before Flop
Seat 4: ba806aaa showed [Ac Th] and won ($0.14) with Ace-High
Seat 5: 167e28c4 folded before Flop (didn't bet)
Seat 6: 7b0814a4 showed [Tc Ad] and won ($0.13) with Ace-High


Poker Hand #RC3334595315: Hold'em No Limit ($0.02/$0.05) - 2025/02/17 21:35:30
Table 'RushAndCash630575' 6-max Seat #1 is the button
Seat 1: 577bd292 ($5.79 in chips)
Seat 2: Hero ($5.64 in chips)
Seat 3: ced76793 ($5.69 in chips)
Seat 4: 5e2a2694 ($5.19 in chips)
Seat 5: 76135c78 ($12.8 in chips)
Seat 6: 3e3946b0 ($6.28 in chips)
Hero: posts small blind $0.02
ced76793: posts big blind $0.05
*** HOLE CARDS ***
Dealt to 577bd292 
Dealt to Hero [Kc Ts]
Dealt to ced76793 
Dealt to 5e2a2694 
Dealt to 76135c78 
Dealt to 3e3946b0 
5e2a2694: folds
76135c78: folds
3e3946b0: folds
577bd292: folds
Hero: calls $0.03
ced76793: checks
*** FLOP *** [Tc Qd 9d]
Hero: checks
ced76793: bets $0.05
Hero: calls $0.05
*** TURN *** [Tc Qd 9d] [3d]
Hero: checks
ced76793: checks
*** RIVER *** [Tc Qd 9d 3d] [Ah]
Hero: checks
ced76793: checks
Hero: shows [Kc Ts] (Pair of Tens)
ced76793: shows [Qs 8h] (Pair of Queens)
*** SHOWDOWN ***
ced76793 collected $0.19 from pot
*** SUMMARY ***
Total pot $0.2 | Rake $0.01 | Jackpot $0 | Bingo $0 | Fortune $0 | Tax $0
Board [Tc Qd 9d 3d Ah]
Seat 1: 577bd292 (button) folded before Flop (didn't bet)
Seat 2: Hero (small blind) showed [Kc Ts] and lost with Pair of Tens
Seat 3: ced76793 (big blind) showed [Qs 8h] and won ($0.19) with Pair of Queens
Seat 4: 5e2a2694 folded before Flop (didn't bet)
Seat 5: 76135c78 folded before Flop (didn't bet)
Seat 6: 3e3946b0 folded before Flop (didn't bet)


Poker Hand #RC3334595291: Hold'em No Limit ($0.02/$0.05) - 2025/02/17 21:35:27
Table 'RushAndCash630551' 6-max Seat #1 is the button
Seat 1: 96707874 ($5 in chips)
Seat 2: Hero ($5.66 in chips)
Seat 3: 5b79005a ($5.56 in chips)
Seat 4: 8c8bf19e ($5 in chips)
Seat 5: fd236f26 ($6.02 in chips)
Seat 6: 5c8b20e0 ($5.9 in chips)
Hero: posts small blind $0.02
5b79005a: posts big blind $0.05
*** HOLE CARDS ***
Dealt to 96707874 
Dealt to Hero [9c Qd]
Dealt to 5b79005a 
Dealt to 8c8bf19e 
Dealt to fd236f26 
Dealt to 5c8b20e0 
8c8bf19e: folds
fd236f26: folds
5c8b20e0: folds
96707874: raises $0.06 to $0.11
Hero: folds
5b79005a: folds
Uncalled bet ($0.06) returned to 96707874
*** SHOWDOWN ***
96707874 collected $0.12 from pot
*** SUMMARY ***
Total pot $0.12 | Rake $0 | Jackpot $0 | Bingo $0 | Fortune $0 | Tax $0
Seat 1: 96707874 (button) collected ($0.12)
Seat 2: Hero (small blind) folded before Flop
Seat 3: 5b79005a (big blind) folded before Flop
Seat 4: 8c8bf19e folded before Flop (didn't bet)
Seat 5: fd236f26 folded before Flop (didn't bet)
Seat 6: 5c8b20e0 folded before Flop (didn't bet)


Poker Hand #RC3334595254: Hold'em No Limit ($0.02/$0.05) - 2025/02/17 21:35:22
Table 'RushAndCash630514' 6-max Seat #1 is the button
Seat 1: Hero ($5.66 in chips)
Seat 2: 9604af2 ($6.21 in chips)
Seat 3: 577aa3d3 ($9.59 in chips)
Seat 4: c7197736 ($8.85 in chips)
Seat 5: 23c23672 ($6.74 in chips)
Seat 6: 54fe77bd ($15.39 in chips)
9604af2: posts small blind $0.02
577aa3d3: posts big blind $0.05
*** HOLE CARDS ***
Dealt to Hero [6c Ad]
Dealt to 9604af2 
Dealt to 577aa3d3 
Dealt to c7197736 
Dealt to 23c23672 
Dealt to 54fe77bd 
c7197736: folds
23c23672: folds
54fe77bd: folds
Hero: folds
9604af2: raises $0.08 to $0.13
577aa3d3: folds
Uncalled bet ($0.08) returned to 9604af2
*** SHOWDOWN ***
9604af2 collected $0.1 from pot
*** SUMMARY ***
Total pot $0.1 | Rake $0 | Jackpot $0 | Bingo $0 | Fortune $0 | Tax $0
Seat 1: Hero (button) folded before Flop (didn't bet)
Seat 2: 9604af2 (small blind) collected ($0.1)
Seat 3: 577aa3d3 (big blind) folded before Flop
Seat 4: c7197736 folded before Flop (didn't bet)
Seat 5: 23c23672 folded before Flop (didn't bet)
Seat 6: 54fe77bd folded before Flop (didn't bet)


Poker Hand #RC3334595216: Hold'em No Limit ($0.02/$0.05) - 2025/02/17 21:35:17
Table 'RushAndCash630476' 6-max Seat #1 is the button
Seat 1: c3883bcf ($7.34 in chips)
Seat 2: 64542a04 ($5.13 in chips)
Seat 3: 4e3c3196 ($31.06 in chips)
Seat 4: 67b2dab9 ($8.79 in chips)
Seat 5: Hero ($5.66 in chips)
Seat 6: 419eb9fb ($5.27 in chips)
64542a04: posts small blind $0.02
4e3c3196: posts big blind $0.05
*** HOLE CARDS ***
Dealt to c3883bcf 
Dealt to 64542a04 
Dealt to 4e3c3196 
Dealt to 67b2dab9 
Dealt to Hero [Ks 8c]
Dealt to 419eb9fb 
67b2dab9: folds
Hero: folds
419eb9fb: folds
c3883bcf: folds
64542a04: raises $0.07 to $0.12
4e3c3196: calls $0.07
*** FLOP *** [Tc 2d Qs]
64542a04: checks
4e3c3196: checks
*** TURN *** [Tc 2d Qs] [9h]
64542a04: bets $0.14
4e3c3196: calls $0.14
*** RIVER *** [Tc 2d Qs 9h] [6s]
64542a04: bets $0.19
4e3c3196: raises $0.45 to $0.64
64542a04: folds
Uncalled bet ($0.45) returned to 4e3c3196
*** SHOWDOWN ***
4e3c3196 collected $0.86 from pot
*** SUMMARY ***
Total pot $0.9 | Rake $0.04 | Jackpot $0 | Bingo $0 | Fortune $0 | Tax $0
Board [Tc 2d Qs 9h 6s]
Seat 1: c3883bcf (button) folded before Flop (didn't bet)
Seat 2: 64542a04 (small blind) folded on the River
Seat 3: 4e3c3196 (big blind) won ($0.86)
Seat 4: 67b2dab9 folded before Flop (didn't bet)
Seat 5: Hero folded before Flop (didn't bet)
Seat 6: 419eb9fb folded before Flop (didn't bet)


Poker Hand #RC3334595191: Hold'em No Limit ($0.02/$0.05) - 2025/02/17 21:35:14
Table 'RushAndCash630451' 6-max Seat #1 is the button
Seat 1: d0d9ce45 ($7.95 in chips)
Seat 2: 4ec50768 ($5.62 in chips)
Seat 3: 21be8833 ($5.36 in chips)
Seat 4: 59238e48 ($5 in chips)
Seat 5: d0a192cb ($2.23 in chips)
Seat 6: Hero ($5.66 in chips)
4ec50768: posts small blind $0.02
21be8833: posts big blind $0.05
*** HOLE CARDS ***
Dealt to d0d9ce45 
Dealt to 4ec50768 
Dealt to 21be8833 
Dealt to 59238e48 
Dealt to d0a192cb 
Dealt to Hero [6h 2h]
59238e48: raises $0.05 to $0.1
d0a192cb: calls $0.1
Hero: folds
d0d9ce45: folds
4ec50768: folds
21be8833: folds
*** FLOP *** [As Qd 2c]
59238e48: checks
d0a192cb: checks
*** TURN *** [As Qd 2c] [Ad]
59238e48: checks
d0a192cb: checks
*** RIVER *** [As Qd 2c Ad] [6s]
59238e48: checks
d0a192cb: bets $0.27
59238e48: folds
Uncalled bet ($0.27) returned to d0a192cb
*** SHOWDOWN ***
d0a192cb collected $0.26 from pot
*** SUMMARY ***
Total pot $0.27 | Rake $0.01 | Jackpot $0 | Bingo $0 | Fortune $0 | Tax $0
Board [As Qd 2c Ad 6s]
Seat 1: d0d9ce45 (button) folded before Flop (didn't bet)
Seat 2: 4ec50768 (small blind) folded before Flop
Seat 3: 21be8833 (big blind) folded before Flop
Seat 4: 59238e48 folded on the River
Seat 5: d0a192cb won ($0.26)
Seat 6: Hero folded before Flop (didn't bet)


Poker Hand #RC3334595163: Hold'em No Limit ($0.02/$0.05) - 2025/02/17 21:35:11
Table 'RushAndCash630423' 6-max Seat #1 is the button
Seat 1: 9b6d78be ($5 in chips)
Seat 2: c9f8ff1c ($5.17 in chips)
Seat 3: a5be70d9 ($13.48 in chips)
Seat 4: 9f70f94d ($8.81 in chips)
Seat 5: e5fa3450 ($5.99 in chips)
Seat 6: Hero ($5.66 in chips)
c9f8ff1c: posts small blind $0.02
a5be70d9: posts big blind $0.05
*** HOLE CARDS ***
Dealt to 9b6d78be 
Dealt to c9f8ff1c 
Dealt to a5be70d9 
Dealt to 9f70f94d 
Dealt to e5fa3450 
Dealt to Hero [6c Th]
9f70f94d: folds
e5fa3450: folds
Hero: folds
9b6d78be: folds
c9f8ff1c: folds
Uncalled bet ($0.03) returned to a5be70d9
*** SHOWDOWN ***
a5be70d9 collected $0.04 from pot
*** SUMMARY ***
Total pot $0.04 | Rake $0 | Jackpot $0 | Bingo $0 | Fortune $0 | Tax $0
Seat 1: 9b6d78be (button) folded before Flop (didn't bet)
Seat 2: c9f8ff1c (small blind) folded before Flop
Seat 3: a5be70d9 (big blind) collected ($0.04)
Seat 4: 9f70f94d folded before Flop (didn't bet)
Seat 5: e5fa3450 folded before Flop (didn't bet)
Seat 6: Hero folded before Flop (didn't bet)


Poker Hand #RC3334595136: Hold'em No Limit ($0.02/$0.05) - 2025/02/17 21:35:08
Table 'RushAndCash630396' 6-max Seat #1 is the button
Seat 1: b2f44cb6 ($10.97 in chips)
Seat 2: ad31dea3 ($5.32 in chips)
Seat 3: Hero ($5.71 in chips)
Seat 4: 719071b8 ($5.23 in chips)
Seat 5: a32bdeef ($5 in chips)
Seat 6: fad7078a ($6.81 in chips)
ad31dea3: posts small blind $0.02
Hero: posts big blind $0.05
*** HOLE CARDS ***
Dealt to b2f44cb6 
Dealt to ad31dea3 
Dealt to Hero [9d 6d]
Dealt to 719071b8 
Dealt to a32bdeef 
Dealt to fad7078a 
719071b8: raises $0.06 to $0.11
a32bdeef: folds
fad7078a: calls $0.11
b2f44cb6: folds
ad31dea3: folds
Hero: folds
*** FLOP *** [8s Jc 5s]
719071b8: checks
fad7078a: bets $0.16
719071b8: raises $0.21 to $0.37
fad7078a: calls $0.21
*** TURN *** [8s Jc 5s] [Ah]
719071b8: bets $0.34
fad7078a: calls $0.34
*** RIVER *** [8s Jc 5s Ah] [Jd]
719071b8: checks
fad7078a: checks
719071b8: shows [6c 5c] (Pair of Jacks and Pair of Fives)
fad7078a: shows [9s Ts] (Pair of Jacks)
*** SHOWDOWN ***
719071b8 collected $1.56 from pot
*** SUMMARY ***
Total pot $1.71 | Rake $0.08 | Jackpot $0.07 | Bingo $0 | Fortune $0 | Tax $0
Board [8s Jc 5s Ah Jd]
Seat 1: b2f44cb6 (button) folded before Flop (didn't bet)
Seat 2: ad31dea3 (small blind) folded before Flop
Seat 3: Hero (big blind) folded before Flop
Seat 4: 719071b8 showed [6c 5c] and won ($1.56) with Pair of Jacks and Pair of Fives
Seat 5: a32bdeef folded before Flop (didn't bet)
Seat 6: fad7078a showed [9s Ts] and lost with Pair of Jacks


Poker Hand #RC3334595102: Hold'em No Limit ($0.02/$0.05) - 2025/02/17 21:35:04
Table 'RushAndCash630362' 6-max Seat #1 is the button
Seat 1: f3614ba1 ($9.63 in chips)
Seat 2: 3b98b9ec ($18.54 in chips)
Seat 3: 381c6d82 ($15.87 in chips)
Seat 4: e0a9129e ($3 in chips)
Seat 5: 3e301744 ($11.62 in chips)
Seat 6: Hero ($5.71 in chips)
3b98b9ec: posts small blind $0.02
381c6d82: posts big blind $0.05
*** HOLE CARDS ***
Dealt to f3614ba1 
Dealt to 3b98b9ec 
Dealt to 381c6d82 
Dealt to e0a9129e 
Dealt to 3e301744 
Dealt to Hero [9d 7c]
e0a9129e: folds
3e301744: raises $0.06 to $0.11
Hero: folds
f3614ba1: calls $0.11
3b98b9ec: folds
381c6d82: folds
*** FLOP *** [Ts Qc As]
3e301744: bets $0.1
f3614ba1: calls $0.1
*** TURN *** [Ts Qc As] [9h]
3e301744: checks
f3614ba1: checks
*** RIVER *** [Ts Qc As 9h] [3h]
3e301744: checks
f3614ba1: checks
3e301744: shows [Jd Qh] (Pair of Queens)
f3614ba1: shows [Kc 8c] (Ace-High)
*** SHOWDOWN ***
3e301744 collected $0.47 from pot
*** SUMMARY ***
Total pot $0.49 | Rake $0.02 | Jackpot $0 | Bingo $0 | Fortune $0 | Tax $0
Board [Ts Qc As 9h 3h]
Seat 1: f3614ba1 (button) showed [Kc 8c] and lost with Ace-High
Seat 2: 3b98b9ec (small blind) folded before Flop
Seat 3: 381c6d82 (big blind) folded before Flop
Seat 4: e0a9129e folded before Flop (didn't bet)
Seat 5: 3e301744 showed [Jd Qh] and won ($0.47) with Pair of Queens
Seat 6: Hero folded before Flop (didn't bet)


Poker Hand #RC3334564738: Hold'em No Limit ($0.02/$0.05) - 2025/02/17 21:34:20
Table 'RushAndCash629998' 6-max Seat #1 is the button
Seat 1: Hero ($6.37 in chips)
Seat 2: cc8de981 ($10.7 in chips)
Seat 3: bc8371cb ($5.94 in chips)
Seat 4: dad15618 ($1.95 in chips)
Seat 5: 55630016 ($8.33 in chips)
Seat 6: 42fca4f9 ($9.88 in chips)
cc8de981: posts small blind $0.02
bc8371cb: posts big blind $0.05
*** HOLE CARDS ***
Dealt to Hero [Kd Kc]
Dealt to cc8de981 
Dealt to bc8371cb 
Dealt to dad15618 
Dealt to 55630016 
Dealt to 42fca4f9 
dad15618: folds
55630016: raises $0.08 to $0.13
42fca4f9: folds
Hero: raises $0.25 to $0.38
cc8de981: folds
bc8371cb: folds
55630016: calls $0.25
*** FLOP *** [4h Qh Th]
55630016: checks
Hero: bets $0.28
55630016: calls $0.28
*** TURN *** [4h Qh Th] [Jd]
55630016: checks
Hero: checks
*** RIVER *** [4h Qh Th Jd] [5s]
55630016: bets $1.39
Hero: folds
Uncalled bet ($1.39) returned to 55630016
*** SHOWDOWN ***
55630016 collected $1.32 from pot
*** SUMMARY ***
Total pot $1.39 | Rake $0.07 | Jackpot $0 | Bingo $0 | Fortune $0 | Tax $0
Board [4h Qh Th Jd 5s]
Seat 1: Hero (button) folded on the River
Seat 2: cc8de981 (small blind) folded before Flop
Seat 3: bc8371cb (big blind) folded before Flop
Seat 4: dad15618 folded before Flop (didn't bet)
Seat 5: 55630016 won ($1.32)
Seat 6: 42fca4f9 folded before Flop (didn't bet)


Poker Hand #RC3334564709: Hold'em No Limit ($0.02/$0.05) - 2025/02/17 21:34:17
Table 'RushAndCash629969' 6-max Seat #1 is the button
Seat 1: 1606744a ($6.26 in chips)
Seat 2: 97d67e86 ($5.6 in chips)
Seat 3: 4262311b ($7.74 in chips)
Seat 4: 80c22e34 ($5.23 in chips)
Seat 5: Hero ($6.37 in chips)
Seat 6: c9baa38a ($5.41 in chips)
97d67e86: posts small blind $0.02
4262311b: posts big blind $0.05
*** HOLE CARDS ***
Dealt to 1606744a 
Dealt to 97d67e86 
Dealt to 4262311b 
Dealt to 80c22e34 
Dealt to Hero [7s Ac]
Dealt to c9baa38a 
80c22e34: folds
Hero: folds
c9baa38a: folds
1606744a: folds
97d67e86: raises $0.06 to $0.11
4262311b: folds
Uncalled bet ($0.06) returned to 97d67e86
*** SHOWDOWN ***
97d67e86 collected $0.1 from pot
*** SUMMARY ***
Total pot $0.1 | Rake $0 | Jackpot $0 | Bingo $0 | Fortune $0 | Tax $0
Seat 1: 1606744a (button) folded before Flop (didn't bet)
Seat 2: 97d67e86 (small blind) collected ($0.1)
Seat 3: 4262311b (big blind) folded before Flop
Seat 4: 80c22e34 folded before Flop (didn't bet)
Seat 5: Hero folded before Flop (didn't bet)
Seat 6: c9baa38a folded before Flop (didn't bet)


Poker Hand #RC3334564678: Hold'em No Limit ($0.02/$0.05) - 2025/02/17 21:34:13
Table 'RushAndCash629938' 6-max Seat #1 is the button
Seat 1: ae4e82ab ($5.99 in chips)
Seat 2: d037279c ($6.76 in chips)
Seat 3: 38a4c833 ($10.85 in chips)
Seat 4: 9b2eb25 ($5.07 in chips)
Seat 5: Hero ($6.37 in chips)
Seat 6: d897e841 ($5.44 in chips)
d037279c: posts small blind $0.02
38a4c833: posts big blind $0.05
*** HOLE CARDS ***
Dealt to ae4e82ab 
Dealt to d037279c 
Dealt to 38a4c833 
Dealt to 9b2eb25 
Dealt to Hero [5s 8s]
Dealt to d897e841 
9b2eb25: folds
Hero: folds
d897e841: folds
ae4e82ab: folds
d037279c: folds
Uncalled bet ($0.03) returned to 38a4c833
*** SHOWDOWN ***
38a4c833 collected $0.04 from pot
*** SUMMARY ***
Total pot $0.04 | Rake $0 | Jackpot $0 | Bingo $0 | Fortune $0 | Tax $0
Seat 1: ae4e82ab (button) folded before Flop (didn't bet)
Seat 2: d037279c (small blind) folded before Flop
Seat 3: 38a4c833 (big blind) collected ($0.04)
Seat 4: 9b2eb25 folded before Flop (didn't bet)
Seat 5: Hero folded before Flop (didn't bet)
Seat 6: d897e841 folded before Flop (didn't bet)


Poker Hand #RC3334564480: Hold'em No Limit ($0.02/$0.05) - 2025/02/17 21:33:49
Table 'RushAndCash629740' 6-max Seat #1 is the button
Seat 1: 6608ec00 ($5 in chips)
Seat 2: b59fc0b9 ($5.11 in chips)
Seat 3: f9d64f1a ($5.56 in chips)
Seat 4: 9da6ba55 ($5.42 in chips)
Seat 5: 38a4c833 ($10.49 in chips)
Seat 6: Hero ($6.69 in chips)
b59fc0b9: posts small blind $0.02
f9d64f1a: posts big blind $0.05
*** HOLE CARDS ***
Dealt to 6608ec00 
Dealt to b59fc0b9 
Dealt to f9d64f1a 
Dealt to 9da6ba55 
Dealt to 38a4c833 
Dealt to Hero [As Js]
9da6ba55: folds
38a4c833: raises $0.05 to $0.1
Hero: raises $0.22 to $0.32
6608ec00: folds
b59fc0b9: folds
f9d64f1a: folds
38a4c833: calls $0.22
*** FLOP *** [3s 6h Kd]
38a4c833: bets $0.36
Hero: folds
Uncalled bet ($0.36) returned to 38a4c833
*** SHOWDOWN ***
38a4c833 collected $0.68 from pot
*** SUMMARY ***
Total pot $0.71 | Rake $0.03 | Jackpot $0 | Bingo $0 | Fortune $0 | Tax $0
Board [3s 6h Kd]
Seat 1: 6608ec00 (button) folded before Flop (didn't bet)
Seat 2: b59fc0b9 (small blind) folded before Flop
Seat 3: f9d64f1a (big blind) folded before Flop
Seat 4: 9da6ba55 folded before Flop (didn't bet)
Seat 5: 38a4c833 won ($0.68)
Seat 6: Hero folded on the Flop


Poker Hand #RC3334564453: Hold'em No Limit ($0.02/$0.05) - 2025/02/17 21:33:45
Table 'RushAndCash629713' 6-max Seat #1 is the button
Seat 1: 8f3a3c0a ($14 in chips)
Seat 2: Hero ($6.71 in chips)
Seat 3: beffcf8a ($5.54 in chips)
Seat 4: 9da6ba55 ($5.42 in chips)
Seat 5: ae4e82ab ($6.04 in chips)
Seat 6: ccabd9d2 ($5.21 in chips)
Hero: posts small blind $0.02
beffcf8a: posts big blind $0.05
*** HOLE CARDS ***
Dealt to 8f3a3c0a 
Dealt to Hero [2h 3d]
Dealt to beffcf8a 
Dealt to 9da6ba55 
Dealt to ae4e82ab 
Dealt to ccabd9d2 
9da6ba55: folds
ae4e82ab: folds
ccabd9d2: folds
8f3a3c0a: folds
Hero: folds
Uncalled bet ($0.03) returned to beffcf8a
*** SHOWDOWN ***
beffcf8a collected $0.04 from pot
*** SUMMARY ***
Total pot $0.04 | Rake $0 | Jackpot $0 | Bingo $0 | Fortune $0 | Tax $0
Seat 1: 8f3a3c0a (button) folded before Flop (didn't bet)
Seat 2: Hero (small blind) folded before Flop
Seat 3: beffcf8a (big blind) collected ($0.04)
Seat 4: 9da6ba55 folded before Flop (didn't bet)
Seat 5: ae4e82ab folded before Flop (didn't bet)
Seat 6: ccabd9d2 folded before Flop (didn't bet)


Poker Hand #RC3334564420: Hold'em No Limit ($0.02/$0.05) - 2025/02/17 21:33:41
Table 'RushAndCash629680' 6-max Seat #1 is the button
Seat 1: 4d8ae83 ($7.62 in chips)
Seat 2: d5bfb52 ($2.61 in chips)
Seat 3: e297f049 ($5.71 in chips)
Seat 4: Hero ($6.71 in chips)
Seat 5: 33554b00 ($5 in chips)
Seat 6: 86b969db ($5.22 in chips)
d5bfb52: posts small blind $0.02
e297f049: posts big blind $0.05
*** HOLE CARDS ***
Dealt to 4d8ae83 
Dealt to d5bfb52 
Dealt to e297f049 
Dealt to Hero [5h 2d]
Dealt to 33554b00 
Dealt to 86b969db 
Hero: folds
33554b00: folds
86b969db: folds
4d8ae83: raises $0.1 to $0.15
d5bfb52: folds
e297f049: folds
Uncalled bet ($0.1) returned to 4d8ae83
*** SHOWDOWN ***
4d8ae83 collected $0.12 from pot
*** SUMMARY ***
Total pot $0.12 | Rake $0 | Jackpot $0 | Bingo $0 | Fortune $0 | Tax $0
Seat 1: 4d8ae83 (button) collected ($0.12)
Seat 2: d5bfb52 (small blind) folded before Flop
Seat 3: e297f049 (big blind) folded before Flop
Seat 4: Hero folded before Flop (didn't bet)
Seat 5: 33554b00 folded before Flop (didn't bet)
Seat 6: 86b969db folded before Flop (didn't bet)


Poker Hand #RC3334564392: Hold'em No Limit ($0.02/$0.05) - 2025/02/17 21:33:38
Table 'RushAndCash629652' 6-max Seat #1 is the button
Seat 1: 3ae3072b ($4.92 in chips)
Seat 2: bcb971d3 ($5 in chips)
Seat 3: 96564827 ($5.58 in chips)
Seat 4: a39b5beb ($6.27 in chips)
Seat 5: d47282a4 ($3.77 in chips)
Seat 6: Hero ($6.71 in chips)
bcb971d3: posts small blind $0.02
96564827: posts big blind $0.05
*** HOLE CARDS ***
Dealt to 3ae3072b 
Dealt to bcb971d3 
Dealt to 96564827 
Dealt to a39b5beb 
Dealt to d47282a4 
Dealt to Hero [Th 7h]
a39b5beb: folds
d47282a4: folds
Hero: folds
3ae3072b: raises $0.1 to $0.15
bcb971d3: folds
96564827: folds
Uncalled bet ($0.1) returned to 3ae3072b
*** SHOWDOWN ***
3ae3072b collected $0.12 from pot
*** SUMMARY ***
Total pot $0.12 | Rake $0 | Jackpot $0 | Bingo $0 | Fortune $0 | Tax $0
Seat 1: 3ae3072b (button) collected ($0.12)
Seat 2: bcb971d3 (small blind) folded before Flop
Seat 3: 96564827 (big blind) folded before Flop
Seat 4: a39b5beb folded before Flop (didn't bet)
Seat 5: d47282a4 folded before Flop (didn't bet)
Seat 6: Hero folded before Flop (didn't bet)


Poker Hand #RC3334564359: Hold'em No Limit ($0.02/$0.05) - 2025/02/17 21:33:35
Table 'RushAndCash629619' 6-max Seat #1 is the button
Seat 1: aa2d17c0 ($8.47 in chips)
Seat 2: 57a66aa7 ($7.88 in chips)
Seat 3: Hero ($6.76 in chips)
Seat 4: a39b5beb ($6.27 in chips)
Seat 5: 9e226e3b ($5.59 in chips)
Seat 6: 5381eb4c ($7.09 in chips)
57a66aa7: posts small blind $0.02
Hero: posts big blind $0.05
*** HOLE CARDS ***
Dealt to aa2d17c0 
Dealt to 57a66aa7 
Dealt to Hero [3s Tc]
Dealt to a39b5beb 
Dealt to 9e226e3b 
Dealt to 5381eb4c 
a39b5beb: folds
9e226e3b: raises $0.07 to $0.12
5381eb4c: folds
aa2d17c0: folds
57a66aa7: folds
Hero: folds
Uncalled bet ($0.07) returned to 9e226e3b
*** SHOWDOWN ***
9e226e3b collected $0.12 from pot
*** SUMMARY ***
Total pot $0.12 | Rake $0 | Jackpot $0 | Bingo $0 | Fortune $0 | Tax $0
Seat 1: aa2d17c0 (button) folded before Flop (didn't bet)
Seat 2: 57a66aa7 (small blind) folded before Flop
Seat 3: Hero (big blind) folded before Flop
Seat 4: a39b5beb folded before Flop (didn't bet)
Seat 5: 9e226e3b collected ($0.12)
Seat 6: 5381eb4c folded before Flop (didn't bet)


Poker Hand #RC3334564329: Hold'em No Limit ($0.02/$0.05) - 2025/02/17 21:33:31
Table 'RushAndCash629589' 6-max Seat #1 is the button
Seat 1: f0600331 ($9.36 in chips)
Seat 2: c582715a ($5.09 in chips)
Seat 3: Hero ($6.81 in chips)
Seat 4: 5b015cd4 ($2.21 in chips)
Seat 5: 9604af2 ($6.35 in chips)
Seat 6: 6e5afa4f ($2.72 in chips)
c582715a: posts small blind $0.02
Hero: posts big blind $0.05
*** HOLE CARDS ***
Dealt to f0600331 
Dealt to c582715a 
Dealt to Hero [Kd 7s]
Dealt to 5b015cd4 
Dealt to 9604af2 
Dealt to 6e5afa4f 
5b015cd4: calls $0.05
9604af2: folds
6e5afa4f: raises $0.05 to $0.1
f0600331: folds
c582715a: folds
Hero: folds
5b015cd4: raises $2.11 to $2.21 and is all-in
6e5afa4f: folds
Uncalled bet ($2.11) returned to 5b015cd4
*** SHOWDOWN ***
5b015cd4 collected $0.26 from pot
*** SUMMARY ***
Total pot $0.27 | Rake $0.01 | Jackpot $0 | Bingo $0 | Fortune $0 | Tax $0
Seat 1: f0600331 (button) folded before Flop (didn't bet)
Seat 2: c582715a (small blind) folded before Flop
Seat 3: Hero (big blind) folded before Flop
Seat 4: 5b015cd4 collected ($0.26)
Seat 5: 9604af2 folded before Flop (didn't bet)
Seat 6: 6e5afa4f folded before Flop


Poker Hand #RC3334564298: Hold'em No Limit ($0.02/$0.05) - 2025/02/17 21:33:28
Table 'RushAndCash629558' 6-max Seat #1 is the button
Seat 1: Hero ($6.81 in chips)
Seat 2: f6efd55a ($9.2 in chips)
Seat 3: a61c94e4 ($7.13 in chips)
Seat 4: f1be594d ($5.06 in chips)
Seat 5: a0f1665c ($5 in chips)
Seat 6: e352a329 ($5 in chips)
f6efd55a: posts small blind $0.02
a61c94e4: posts big blind $0.05
*** HOLE CARDS ***
Dealt to Hero [6s Th]
Dealt to f6efd55a 
Dealt to a61c94e4 
Dealt to f1be594d 
Dealt to a0f1665c 
Dealt to e352a329 
f1be594d: folds
a0f1665c: raises $0.08 to $0.13
e352a329: folds
Hero: folds
f6efd55a: folds
a61c94e4: folds
Uncalled bet ($0.08) returned to a0f1665c
*** SHOWDOWN ***
a0f1665c collected $0.12 from pot
*** SUMMARY ***
Total pot $0.12 | Rake $0 | Jackpot $0 | Bingo $0 | Fortune $0 | Tax $0
Seat 1: Hero (button) folded before Flop (didn't bet)
Seat 2: f6efd55a (small blind) folded before Flop
Seat 3: a61c94e4 (big blind) folded before Flop
Seat 4: f1be594d folded before Flop (didn't bet)
Seat 5: a0f1665c collected ($0.12)
Seat 6: e352a329 folded before Flop (didn't bet)


Poker Hand #RC3334564242: Hold'em No Limit ($0.02/$0.05) - 2025/02/17 21:33:22
Table 'RushAndCash629502' 6-max Seat #1 is the button
Seat 1: f84a49f0 ($5.11 in chips)
Seat 2: 23a65ab7 ($5.03 in chips)
Seat 3: 4fa289e4 ($6.01 in chips)
Seat 4: 6ab3ea38 ($5.02 in chips)
Seat 5: 9dd1ff39 ($5 in chips)
Seat 6: Hero ($6.81 in chips)
23a65ab7: posts small blind $0.02
4fa289e4: posts big blind $0.05
*** HOLE CARDS ***
Dealt to f84a49f0 
Dealt to 23a65ab7 
Dealt to 4fa289e4 
Dealt to 6ab3ea38 
Dealt to 9dd1ff39 
Dealt to Hero [Tc 8c]
6ab3ea38: folds
9dd1ff39: folds
Hero: folds
f84a49f0: folds
23a65ab7: raises $0.06 to $0.11
4fa289e4: folds
Uncalled bet ($0.06) returned to 23a65ab7
*** SHOWDOWN ***
23a65ab7 collected $0.1 from pot
*** SUMMARY ***
Total pot $0.1 | Rake $0 | Jackpot $0 | Bingo $0 | Fortune $0 | Tax $0
Seat 1: f84a49f0 (button) folded before Flop (didn't bet)
Seat 2: 23a65ab7 (small blind) collected ($0.1)
Seat 3: 4fa289e4 (big blind) folded before Flop
Seat 4: 6ab3ea38 folded before Flop (didn't bet)
Seat 5: 9dd1ff39 folded before Flop (didn't bet)
Seat 6: Hero folded before Flop (didn't bet)


Poker Hand #RC3334564202: Hold'em No Limit ($0.02/$0.05) - 2025/02/17 21:33:17
Table 'RushAndCash629462' 6-max Seat #1 is the button
Seat 1: d606d9 ($10.19 in chips)
Seat 2: cf7f09c2 ($14.92 in chips)
Seat 3: 3ed1e77f ($5.69 in chips)
Seat 4: 53a8c2fd ($10.61 in chips)
Seat 5: Hero ($6.81 in chips)
Seat 6: 2e8ab509 ($6.52 in chips)
cf7f09c2: posts small blind $0.02
3ed1e77f: posts big blind $0.05
*** HOLE CARDS ***
Dealt to d606d9 
Dealt to cf7f09c2 
Dealt to 3ed1e77f 
Dealt to 53a8c2fd 
Dealt to Hero [3d 8c]
Dealt to 2e8ab509 
53a8c2fd: folds
Hero: folds
2e8ab509: folds
d606d9: folds
cf7f09c2: folds
Uncalled bet ($0.03) returned to 3ed1e77f
*** SHOWDOWN ***
3ed1e77f collected $0.04 from pot
*** SUMMARY ***
Total pot $0.04 | Rake $0 | Jackpot $0 | Bingo $0 | Fortune $0 | Tax $0
Seat 1: d606d9 (button) folded before Flop (didn't bet)
Seat 2: cf7f09c2 (small blind) folded before Flop
Seat 3: 3ed1e77f (big blind) collected ($0.04)
Seat 4: 53a8c2fd folded before Flop (didn't bet)
Seat 5: Hero folded before Flop (didn't bet)
Seat 6: 2e8ab509 folded before Flop (didn't bet)


Poker Hand #RC3334564123: Hold'em No Limit ($0.02/$0.05) - 2025/02/17 21:33:08
Table 'RushAndCash629383' 6-max Seat #1 is the button
Seat 1: 1662188f ($5 in chips)
Seat 2: 2a10169c ($5 in chips)
Seat 3: Hero ($6.79 in chips)
Seat 4: e7a0ba42 ($22.06 in chips)
Seat 5: 86fb354d ($6.28 in chips)
Seat 6: 99df5763 ($4.79 in chips)
2a10169c: posts small blind $0.02
Hero: posts big blind $0.05
*** HOLE CARDS ***
Dealt to 1662188f 
Dealt to 2a10169c 
Dealt to Hero [7c 3c]
Dealt to e7a0ba42 
Dealt to 86fb354d 
Dealt to 99df5763 
e7a0ba42: folds
86fb354d: folds
99df5763: folds
1662188f: folds
2a10169c: folds
Uncalled bet ($0.03) returned to Hero
*** SHOWDOWN ***
Hero collected $0.04 from pot
*** SUMMARY ***
Total pot $0.04 | Rake $0 | Jackpot $0 | Bingo $0 | Fortune $0 | Tax $0
Seat 1: 1662188f (button) folded before Flop (didn't bet)
Seat 2: 2a10169c (small blind) folded before Flop
Seat 3: Hero (big blind) collected ($0.04)
Seat 4: e7a0ba42 folded before Flop (didn't bet)
Seat 5: 86fb354d folded before Flop (didn't bet)
Seat 6: 99df5763 folded before Flop (didn't bet)


Poker Hand #RC3334564082: Hold'em No Limit ($0.02/$0.05) - 2025/02/17 21:33:03
Table 'RushAndCash629342' 6-max Seat #1 is the button
Seat 1: edf2f3c ($5.96 in chips)
Seat 2: Hero ($6.81 in chips)
Seat 3: abef7df7 ($0.91 in chips)
Seat 4: e61a8cfb ($5 in chips)
Seat 5: a81aa4e3 ($5.52 in chips)
Seat 6: 9864109b ($5.64 in chips)
Hero: posts small blind $0.02
abef7df7: posts big blind $0.05
*** HOLE CARDS ***
Dealt to edf2f3c 
Dealt to Hero [Ad 8h]
Dealt to abef7df7 
Dealt to e61a8cfb 
Dealt to a81aa4e3 
Dealt to 9864109b 
e61a8cfb: folds
a81aa4e3: raises $0.05 to $0.1
9864109b: folds
edf2f3c: folds
Hero: folds
abef7df7: calls $0.05
*** FLOP *** [Ks As Ac]
abef7df7: checks
a81aa4e3: checks
*** TURN *** [Ks As Ac] [Qd]
abef7df7: bets $0.22
a81aa4e3: folds
Uncalled bet ($0.22) returned to abef7df7
*** SHOWDOWN ***
abef7df7 collected $0.21 from pot
*** SUMMARY ***
Total pot $0.22 | Rake $0.01 | Jackpot $0 | Bingo $0 | Fortune $0 | Tax $0
Board [Ks As Ac Qd]
Seat 1: edf2f3c (button) folded before Flop (didn't bet)
Seat 2: Hero (small blind) folded before Flop
Seat 3: abef7df7 (big blind) won ($0.21)
Seat 4: e61a8cfb folded before Flop (didn't bet)
Seat 5: a81aa4e3 folded on the Turn
Seat 6: 9864109b folded before Flop (didn't bet)


Poker Hand #RC3334564030: Hold'em No Limit ($0.02/$0.05) - 2025/02/17 21:32:57
Table 'RushAndCash629290' 6-max Seat #1 is the button
Seat 1: Hero ($6.81 in chips)
Seat 2: 4d8ae83 ($7.84 in chips)
Seat 3: b0c3ff95 ($10.37 in chips)
Seat 4: b9ae439d ($6.05 in chips)
Seat 5: abef7df7 ($0.91 in chips)
Seat 6: 53a8c2fd ($10.68 in chips)
4d8ae83: posts small blind $0.02
b0c3ff95: posts big blind $0.05
*** HOLE CARDS ***
Dealt to Hero [Ah Tc]
Dealt to 4d8ae83 
Dealt to b0c3ff95 
Dealt to b9ae439d 
Dealt to abef7df7 
Dealt to 53a8c2fd 
b9ae439d: raises $0.08 to $0.13
abef7df7: folds
53a8c2fd: folds
Hero: folds
4d8ae83: folds
b0c3ff95: folds
Uncalled bet ($0.08) returned to b9ae439d
*** SHOWDOWN ***
b9ae439d collected $0.12 from pot
*** SUMMARY ***
Total pot $0.12 | Rake $0 | Jackpot $0 | Bingo $0 | Fortune $0 | Tax $0
Seat 1: Hero (button) folded before Flop (didn't bet)
Seat 2: 4d8ae83 (small blind) folded before Flop
Seat 3: b0c3ff95 (big blind) folded before Flop
Seat 4: b9ae439d collected ($0.12)
Seat 5: abef7df7 folded before Flop (didn't bet)
Seat 6: 53a8c2fd folded before Flop (didn't bet)


Poker Hand #RC3334563942: Hold'em No Limit ($0.02/$0.05) - 2025/02/17 21:32:47
Table 'RushAndCash629202' 6-max Seat #1 is the button
Seat 1: Hero ($6.81 in chips)
Seat 2: 657ee1fc ($5.83 in chips)
Seat 3: 50cbaebe ($7.65 in chips)
Seat 4: f23a8d23 ($5.66 in chips)
Seat 5: 1fa8537 ($8.79 in chips)
Seat 6: 50b3f230 ($5 in chips)
657ee1fc: posts small blind $0.02
50cbaebe: posts big blind $0.05
*** HOLE CARDS ***
Dealt to Hero [8h Qh]
Dealt to 657ee1fc 
Dealt to 50cbaebe 
Dealt to f23a8d23 
Dealt to 1fa8537 
Dealt to 50b3f230 
f23a8d23: folds
1fa8537: raises $0.06 to $0.11
50b3f230: folds
Hero: folds
657ee1fc: folds
50cbaebe: folds
Uncalled bet ($0.06) returned to 1fa8537
*** SHOWDOWN ***
1fa8537 collected $0.12 from pot
*** SUMMARY ***
Total pot $0.12 | Rake $0 | Jackpot $0 | Bingo $0 | Fortune $0 | Tax $0
Seat 1: Hero (button) folded before Flop (didn't bet)
Seat 2: 657ee1fc (small blind) folded before Flop
Seat 3: 50cbaebe (big blind) folded before Flop
Seat 4: f23a8d23 folded before Flop (didn't bet)
Seat 5: 1fa8537 collected ($0.12)
Seat 6: 50b3f230 folded before Flop (didn't bet)


Poker Hand #RC3334563911: Hold'em No Limit ($0.02/$0.05) - 2025/02/17 21:32:43
Table 'RushAndCash629171' 6-max Seat #1 is the button
Seat 1: 826a79b4 ($6.41 in chips)
Seat 2: b8123d32 ($5.31 in chips)
Seat 3: c0a90b1a ($5.23 in chips)
Seat 4: Hero ($6.81 in chips)
Seat 5: 50cbaebe ($7.65 in chips)
Seat 6: 69373e56 ($5.36 in chips)
b8123d32: posts small blind $0.02
c0a90b1a: posts big blind $0.05
*** HOLE CARDS ***
Dealt to 826a79b4 
Dealt to b8123d32 
Dealt to c0a90b1a 
Dealt to Hero [3c Ac]
Dealt to 50cbaebe 
Dealt to 69373e56 
Hero: folds
50cbaebe: folds
69373e56: folds
826a79b4: raises $0.06 to $0.11
b8123d32: folds
c0a90b1a: raises $0.36 to $0.47
826a79b4: folds
Uncalled bet ($0.36) returned to c0a90b1a
*** SHOWDOWN ***
c0a90b1a collected $0.23 from pot
*** SUMMARY ***
Total pot $0.24 | Rake $0.01 | Jackpot $0 | Bingo $0 | Fortune $0 | Tax $0
Seat 1: 826a79b4 (button) folded before Flop
Seat 2: b8123d32 (small blind) folded before Flop
Seat 3: c0a90b1a (big blind) collected ($0.23)
Seat 4: Hero folded before Flop (didn't bet)
Seat 5: 50cbaebe folded before Flop (didn't bet)
Seat 6: 69373e56 folded before Flop (didn't bet)


Poker Hand #RC3334563614: Hold'em No Limit ($0.02/$0.05) - 2025/02/17 21:32:06
Table 'RushAndCash628874' 6-max Seat #1 is the button
Seat 1: ba806aaa ($2.18 in chips)
Seat 2: 44b5c3bb ($5 in chips)
Seat 3: 711af4a4 ($17.19 in chips)
Seat 4: 69373e56 ($5 in chips)
Seat 5: 8e07c53 ($6.34 in chips)
Seat 6: Hero ($7.13 in chips)
44b5c3bb: posts small blind $0.02
711af4a4: posts big blind $0.05
*** HOLE CARDS ***
Dealt to ba806aaa 
Dealt to 44b5c3bb 
Dealt to 711af4a4 
Dealt to 69373e56 
Dealt to 8e07c53 
Dealt to Hero [Ad Qc]
69373e56: raises $0.05 to $0.1
8e07c53: folds
Hero: raises $0.22 to $0.32
ba806aaa: folds
44b5c3bb: folds
711af4a4: folds
69373e56: raises $0.91 to $1.23
Hero: folds
Uncalled bet ($0.91) returned to 69373e56
*** SHOWDOWN ***
69373e56 collected $0.68 from pot
*** SUMMARY ***
Total pot $0.71 | Rake $0.03 | Jackpot $0 | Bingo $0 | Fortune $0 | Tax $0
Seat 1: ba806aaa (button) folded before Flop (didn't bet)
Seat 2: 44b5c3bb (small blind) folded before Flop
Seat 3: 711af4a4 (big blind) folded before Flop
Seat 4: 69373e56 collected ($0.68)
Seat 5: 8e07c53 folded before Flop (didn't bet)
Seat 6: Hero folded before Flop


Poker Hand #RC3334563584: Hold'em No Limit ($0.02/$0.05) - 2025/02/17 21:32:03
Table 'RushAndCash628844' 6-max Seat #1 is the button
Seat 1: 6008538 ($4.88 in chips)
Seat 2: 10b5ea2f ($9.83 in chips)
Seat 3: Hero ($7.18 in chips)
Seat 4: b8c09f2 ($6.68 in chips)
Seat 5: 11224f8 ($10.36 in chips)
Seat 6: 8196f154 ($5 in chips)
10b5ea2f: posts small blind $0.02
Hero: posts big blind $0.05
*** HOLE CARDS ***
Dealt to 6008538 
Dealt to 10b5ea2f 
Dealt to Hero [7c Ks]
Dealt to b8c09f2 
Dealt to 11224f8 
Dealt to 8196f154 
b8c09f2: raises $0.1 to $0.15
11224f8: folds
8196f154: folds
6008538: raises $0.2 to $0.35
10b5ea2f: folds
Hero: folds
b8c09f2: calls $0.2
*** FLOP *** [3c 4s 3h]
b8c09f2: checks
6008538: checks
*** TURN *** [3c 4s 3h] [Ac]
b8c09f2: checks
6008538: checks
*** RIVER *** [3c 4s 3h Ac] [7h]
b8c09f2: checks
6008538: checks
b8c09f2: shows [Qc Jc] (Pair of Treys)
6008538: shows [Qd Jd] (Pair of Treys)
*** SHOWDOWN ***
b8c09f2 collected $0.38 from pot
6008538 collected $0.37 from pot
*** SUMMARY ***
Total pot $0.77 | Rake $0.02 | Jackpot $0 | Bingo $0 | Fortune $0 | Tax $0
Board [3c 4s 3h Ac 7h]
Seat 1: 6008538 (button) showed [Qd Jd] and won ($0.37) with Pair of Treys
Seat 2: 10b5ea2f (small blind) folded before Flop
Seat 3: Hero (big blind) folded before Flop
Seat 4: b8c09f2 showed [Qc Jc] and won ($0.38) with Pair of Treys
Seat 5: 11224f8 folded before Flop (didn't bet)
Seat 6: 8196f154 folded before Flop (didn't bet)


Poker Hand #RC3334563552: Hold'em No Limit ($0.02/$0.05) - 2025/02/17 21:32:00
Table 'RushAndCash628812' 6-max Seat #1 is the button
Seat 1: 34df3734 ($5.41 in chips)
Seat 2: Hero ($7.2 in chips)
Seat 3: 97d67e86 ($5.5 in chips)
Seat 4: d121a46a ($5.96 in chips)
Seat 5: b66c51bb ($5.47 in chips)
Seat 6: 9fa2589a ($3.83 in chips)
Hero: posts small blind $0.02
97d67e86: posts big blind $0.05
*** HOLE CARDS ***
Dealt to 34df3734 
Dealt to Hero [7d Kh]
Dealt to 97d67e86 
Dealt to d121a46a 
Dealt to b66c51bb 
Dealt to 9fa2589a 
d121a46a: folds
b66c51bb: folds
9fa2589a: folds
34df3734: folds
Hero: folds
Uncalled bet ($0.03) returned to 97d67e86
*** SHOWDOWN ***
97d67e86 collected $0.04 from pot
*** SUMMARY ***
Total pot $0.04 | Rake $0 | Jackpot $0 | Bingo $0 | Fortune $0 | Tax $0
Seat 1: 34df3734 (button) folded before Flop (didn't bet)
Seat 2: Hero (small blind) folded before Flop
Seat 3: 97d67e86 (big blind) collected ($0.04)
Seat 4: d121a46a folded before Flop (didn't bet)
Seat 5: b66c51bb folded before Flop (didn't bet)
Seat 6: 9fa2589a folded before Flop (didn't bet)


Poker Hand #RC3334563524: Hold'em No Limit ($0.02/$0.05) - 2025/02/17 21:31:57
Table 'RushAndCash628784' 6-max Seat #1 is the button
Seat 1: 15141573 ($5.56 in chips)
Seat 2: c6e11d19 ($5.5 in chips)
Seat 3: a3b43a4c ($5.95 in chips)
Seat 4: Hero ($7.2 in chips)
Seat 5: dd5b2a2c ($5.14 in chips)
Seat 6: 9d7d4a76 ($5 in chips)
c6e11d19: posts small blind $0.02
a3b43a4c: posts big blind $0.05
*** HOLE CARDS ***
Dealt to 15141573 
Dealt to c6e11d19 
Dealt to a3b43a4c 
Dealt to Hero [2s 8d]
Dealt to dd5b2a2c 
Dealt to 9d7d4a76 
Hero: folds
dd5b2a2c: folds
9d7d4a76: raises $0.08 to $0.13
15141573: folds
c6e11d19: raises $0.42 to $0.55
a3b43a4c: folds
9d7d4a76: folds
Uncalled bet ($0.42) returned to c6e11d19
*** SHOWDOWN ***
c6e11d19 collected $0.3 from pot
*** SUMMARY ***
Total pot $0.31 | Rake $0.01 | Jackpot $0 | Bingo $0 | Fortune $0 | Tax $0
Seat 1: 15141573 (button) folded before Flop (didn't bet)
Seat 2: c6e11d19 (small blind) collected ($0.3)
Seat 3: a3b43a4c (big blind) folded before Flop
Seat 4: Hero folded before Flop (didn't bet)
Seat 5: dd5b2a2c folded before Flop (didn't bet)
Seat 6: 9d7d4a76 folded before Flop


Poker Hand #RC3334563475: Hold'em No Limit ($0.02/$0.05) - 2025/02/17 21:31:51
Table 'RushAndCash628735' 6-max Seat #1 is the button
Seat 1: 191b60c1 ($8.49 in chips)
Seat 2: Hero ($7.22 in chips)
Seat 3: e8a5680c ($6 in chips)
Seat 4: d58b99ca ($29.49 in chips)
Seat 5: af90d8d7 ($7.85 in chips)
Seat 6: 8212253a ($5.6 in chips)
Hero: posts small blind $0.02
e8a5680c: posts big blind $0.05
*** HOLE CARDS ***
Dealt to 191b60c1 
Dealt to Hero [5d Td]
Dealt to e8a5680c 
Dealt to d58b99ca 
Dealt to af90d8d7 
Dealt to 8212253a 
d58b99ca: folds
af90d8d7: folds
8212253a: folds
191b60c1: raises $0.07 to $0.12
Hero: folds
e8a5680c: folds
Uncalled bet ($0.07) returned to 191b60c1
*** SHOWDOWN ***
191b60c1 collected $0.12 from pot
*** SUMMARY ***
Total pot $0.12 | Rake $0 | Jackpot $0 | Bingo $0 | Fortune $0 | Tax $0
Seat 1: 191b60c1 (button) collected ($0.12)
Seat 2: Hero (small blind) folded before Flop
Seat 3: e8a5680c (big blind) folded before Flop
Seat 4: d58b99ca folded before Flop (didn't bet)
Seat 5: af90d8d7 folded before Flop (didn't bet)
Seat 6: 8212253a folded before Flop (didn't bet)


Poker Hand #RC3334563192: Hold'em No Limit ($0.02/$0.05) - 2025/02/17 21:31:18
Table 'RushAndCash628452' 6-max Seat #1 is the button
Seat 1: b39a93ce ($5 in chips)
Seat 2: bebd931c ($4.69 in chips)
Seat 3: 8212253a ($5.41 in chips)
Seat 4: 757f29d9 ($5.15 in chips)
Seat 5: Hero ($7.4 in chips)
Seat 6: edbb0bb6 ($5.12 in chips)
bebd931c: posts small blind $0.02
8212253a: posts big blind $0.05
*** HOLE CARDS ***
Dealt to b39a93ce 
Dealt to bebd931c 
Dealt to 8212253a 
Dealt to 757f29d9 
Dealt to Hero [Ad Ks]
Dealt to edbb0bb6 
757f29d9: folds
Hero: raises $0.05 to $0.1
edbb0bb6: folds
b39a93ce: folds
bebd931c: folds
8212253a: calls $0.05
*** FLOP *** [Qh Jc 9s]
8212253a: bets $0.08
Hero: calls $0.08
*** TURN *** [Qh Jc 9s] [3c]
8212253a: bets $0.19
Hero: folds
Uncalled bet ($0.19) returned to 8212253a
*** SHOWDOWN ***
8212253a collected $0.37 from pot
*** SUMMARY ***
Total pot $0.38 | Rake $0.01 | Jackpot $0 | Bingo $0 | Fortune $0 | Tax $0
Board [Qh Jc 9s 3c]
Seat 1: b39a93ce (button) folded before Flop (didn't bet)
Seat 2: bebd931c (small blind) folded before Flop
Seat 3: 8212253a (big blind) won ($0.37)
Seat 4: 757f29d9 folded before Flop (didn't bet)
Seat 5: Hero folded on the Turn
Seat 6: edbb0bb6 folded before Flop (didn't bet)


Poker Hand #RC3334563167: Hold'em No Limit ($0.02/$0.05) - 2025/02/17 21:31:14
Table 'RushAndCash628427' 6-max Seat #1 is the button
Seat 1: c16b612d ($5.94 in chips)
Seat 2: 87395f7a ($5.02 in chips)
Seat 3: 12ef643d ($5.08 in chips)
Seat 4: c806dd25 ($11.03 in chips)
Seat 5: Hero ($7.4 in chips)
Seat 6: e0a9129e ($2.81 in chips)
87395f7a: posts small blind $0.02
12ef643d: posts big blind $0.05
*** HOLE CARDS ***
Dealt to c16b612d 
Dealt to 87395f7a 
Dealt to 12ef643d 
Dealt to c806dd25 
Dealt to Hero [3d Jc]
Dealt to e0a9129e 
c806dd25: folds
Hero: folds
e0a9129e: folds
c16b612d: folds
87395f7a: folds
Uncalled bet ($0.03) returned to 12ef643d
*** SHOWDOWN ***
12ef643d collected $0.04 from pot
*** SUMMARY ***
Total pot $0.04 | Rake $0 | Jackpot $0 | Bingo $0 | Fortune $0 | Tax $0
Seat 1: c16b612d (button) folded before Flop (didn't bet)
Seat 2: 87395f7a (small blind) folded before Flop
Seat 3: 12ef643d (big blind) collected ($0.04)
Seat 4: c806dd25 folded before Flop (didn't bet)
Seat 5: Hero folded before Flop (didn't bet)
Seat 6: e0a9129e folded before Flop (didn't bet)


Poker Hand #RC3334563098: Hold'em No Limit ($0.02/$0.05) - 2025/02/17 21:31:07
Table 'RushAndCash628358' 6-max Seat #1 is the button
Seat 1: e8a5680c ($6.1 in chips)
Seat 2: 711af4a4 ($17.02 in chips)
Seat 3: Hero ($7.45 in chips)
Seat 4: d2fb1cd9 ($7.62 in chips)
Seat 5: 9013f95e ($9.08 in chips)
Seat 6: ee3fdfd8 ($5.19 in chips)
711af4a4: posts small blind $0.02
Hero: posts big blind $0.05
*** HOLE CARDS ***
Dealt to e8a5680c 
Dealt to 711af4a4 
Dealt to Hero [3d 6h]
Dealt to d2fb1cd9 
Dealt to 9013f95e 
Dealt to ee3fdfd8 
d2fb1cd9: raises $0.05 to $0.1
9013f95e: folds
ee3fdfd8: folds
e8a5680c: folds
711af4a4: folds
Hero: folds
Uncalled bet ($0.05) returned to d2fb1cd9
*** SHOWDOWN ***
d2fb1cd9 collected $0.12 from pot
*** SUMMARY ***
Total pot $0.12 | Rake $0 | Jackpot $0 | Bingo $0 | Fortune $0 | Tax $0
Seat 1: e8a5680c (button) folded before Flop (didn't bet)
Seat 2: 711af4a4 (small blind) folded before Flop
Seat 3: Hero (big blind) folded before Flop
Seat 4: d2fb1cd9 collected ($0.12)
Seat 5: 9013f95e folded before Flop (didn't bet)
Seat 6: ee3fdfd8 folded before Flop (didn't bet)


Poker Hand #RC3334563070: Hold'em No Limit ($0.02/$0.05) - 2025/02/17 21:31:04
Table 'RushAndCash628330' 6-max Seat #1 is the button
Seat 1: 46fb98 ($5 in chips)
Seat 2: 3bfcd529 ($5.18 in chips)
Seat 3: aabba297 ($5 in chips)
Seat 4: Hero ($7.45 in chips)
Seat 5: add6668e ($5.06 in chips)
Seat 6: ead6cfaf ($5 in chips)
3bfcd529: posts small blind $0.02
aabba297: posts big blind $0.05
*** HOLE CARDS ***
Dealt to 46fb98 
Dealt to 3bfcd529 
Dealt to aabba297 
Dealt to Hero [3h Jd]
Dealt to add6668e 
Dealt to ead6cfaf 
Hero: folds
add6668e: folds
ead6cfaf: raises $0.1 to $0.15
46fb98: folds
3bfcd529: folds
aabba297: calls $0.1
*** FLOP *** [4h 6d 8d]
aabba297: checks
ead6cfaf: bets $0.24
aabba297: folds
Uncalled bet ($0.24) returned to ead6cfaf
*** SHOWDOWN ***
ead6cfaf collected $0.31 from pot
*** SUMMARY ***
Total pot $0.32 | Rake $0.01 | Jackpot $0 | Bingo $0 | Fortune $0 | Tax $0
Board [4h 6d 8d]
Seat 1: 46fb98 (button) folded before Flop (didn't bet)
Seat 2: 3bfcd529 (small blind) folded before Flop
Seat 3: aabba297 (big blind) folded on the Flop
Seat 4: Hero folded before Flop (didn't bet)
Seat 5: add6668e folded before Flop (didn't bet)
Seat 6: ead6cfaf won ($0.31)


Poker Hand #RC3334563032: Hold'em No Limit ($0.02/$0.05) - 2025/02/17 21:30:59
Table 'RushAndCash628292' 6-max Seat #1 is the button
Seat 1: 12cda2e0 ($22.4 in chips)
Seat 2: b4bc5ab5 ($9.56 in chips)
Seat 3: 994faa22 ($5 in chips)
Seat 4: edf2f3c ($6.21 in chips)
Seat 5: 7615146e ($5.44 in chips)
Seat 6: Hero ($7.45 in chips)
b4bc5ab5: posts small blind $0.02
994faa22: posts big blind $0.05
*** HOLE CARDS ***
Dealt to 12cda2e0 
Dealt to b4bc5ab5 
Dealt to 994faa22 
Dealt to edf2f3c 
Dealt to 7615146e 
Dealt to Hero [Qh 6h]
edf2f3c: raises $0.05 to $0.1
7615146e: folds
Hero: folds
12cda2e0: folds
b4bc5ab5: folds
994faa22: calls $0.05
*** FLOP *** [7c Kc 3h]
994faa22: checks
edf2f3c: bets $0.08
994faa22: folds
Uncalled bet ($0.08) returned to edf2f3c
*** SHOWDOWN ***
edf2f3c collected $0.21 from pot
*** SUMMARY ***
Total pot $0.22 | Rake $0.01 | Jackpot $0 | Bingo $0 | Fortune $0 | Tax $0
Board [7c Kc 3h]
Seat 1: 12cda2e0 (button) folded before Flop (didn't bet)
Seat 2: b4bc5ab5 (small blind) folded before Flop
Seat 3: 994faa22 (big blind) folded on the Flop
Seat 4: edf2f3c won ($0.21)
Seat 5: 7615146e folded before Flop (didn't bet)
Seat 6: Hero folded before Flop (didn't bet)


Poker Hand #RC3334562987: Hold'em No Limit ($0.02/$0.05) - 2025/02/17 21:30:54
Table 'RushAndCash628247' 6-max Seat #1 is the button
Seat 1: 9590c0df ($5.4 in chips)
Seat 2: 4f7979c7 ($4.95 in chips)
Seat 3: 53a8c2fd ($10.02 in chips)
Seat 4: d278c831 ($7.43 in chips)
Seat 5: Hero ($7.45 in chips)
Seat 6: bb96e95c ($5 in chips)
4f7979c7: posts small blind $0.02
53a8c2fd: posts big blind $0.05
*** HOLE CARDS ***
Dealt to 9590c0df 
Dealt to 4f7979c7 
Dealt to 53a8c2fd 
Dealt to d278c831 
Dealt to Hero [9d 8c]
Dealt to bb96e95c 
d278c831: folds
Hero: folds
bb96e95c: folds
9590c0df: folds
4f7979c7: folds
Uncalled bet ($0.03) returned to 53a8c2fd
*** SHOWDOWN ***
53a8c2fd collected $0.04 from pot
*** SUMMARY ***
Total pot $0.04 | Rake $0 | Jackpot $0 | Bingo $0 | Fortune $0 | Tax $0
Seat 1: 9590c0df (button) folded before Flop (didn't bet)
Seat 2: 4f7979c7 (small blind) folded before Flop
Seat 3: 53a8c2fd (big blind) collected ($0.04)
Seat 4: d278c831 folded before Flop (didn't bet)
Seat 5: Hero folded before Flop (didn't bet)
Seat 6: bb96e95c folded before Flop (didn't bet)


Poker Hand #RC3334562963: Hold'em No Limit ($0.02/$0.05) - 2025/02/17 21:30:51
Table 'RushAndCash628223' 6-max Seat #1 is the button
Seat 1: 49b4f33a ($15.47 in chips)
Seat 2: Hero ($7.47 in chips)
Seat 3: 4f076d5f ($2.99 in chips)
Seat 4: 3db4c32a ($6.29 in chips)
Seat 5: b4bc5ab5 ($9.56 in chips)
Seat 6: 2dc40675 ($5 in chips)
Hero: posts small blind $0.02
4f076d5f: posts big blind $0.05
*** HOLE CARDS ***
Dealt to 49b4f33a 
Dealt to Hero [6d 7h]
Dealt to 4f076d5f 
Dealt to 3db4c32a 
Dealt to b4bc5ab5 
Dealt to 2dc40675 
3db4c32a: raises $0.06 to $0.11
b4bc5ab5: folds
2dc40675: folds
49b4f33a: folds
Hero: folds
4f076d5f: folds
Uncalled bet ($0.06) returned to 3db4c32a
*** SHOWDOWN ***
3db4c32a collected $0.12 from pot
*** SUMMARY ***
Total pot $0.12 | Rake $0 | Jackpot $0 | Bingo $0 | Fortune $0 | Tax $0
Seat 1: 49b4f33a (button) folded before Flop (didn't bet)
Seat 2: Hero (small blind) folded before Flop
Seat 3: 4f076d5f (big blind) folded before Flop
Seat 4: 3db4c32a collected ($0.12)
Seat 5: b4bc5ab5 folded before Flop (didn't bet)
Seat 6: 2dc40675 folded before Flop (didn't bet)


Poker Hand #RC3334562900: Hold'em No Limit ($0.02/$0.05) - 2025/02/17 21:30:44
Table 'RushAndCash628160' 6-max Seat #1 is the button
Seat 1: Hero ($7.47 in chips)
Seat 2: fcfd355a ($5.77 in chips)
Seat 3: bd394772 ($6.83 in chips)
Seat 4: 4f076d5f ($2.99 in chips)
Seat 5: 1ff264f7 ($5.14 in chips)
Seat 6: 56b9b8a5 ($5.76 in chips)
fcfd355a: posts small blind $0.02
bd394772: posts big blind $0.05
*** HOLE CARDS ***
Dealt to Hero [Td 7d]
Dealt to fcfd355a 
Dealt to bd394772 
Dealt to 4f076d5f 
Dealt to 1ff264f7 
Dealt to 56b9b8a5 
4f076d5f: folds
1ff264f7: folds
56b9b8a5: raises $0.07 to $0.12
Hero: folds
fcfd355a: folds
bd394772: calls $0.07
*** FLOP *** [2d As 8h]
bd394772: checks
56b9b8a5: bets $0.09
bd394772: calls $0.09
*** TURN *** [2d As 8h] [6d]
bd394772: checks
56b9b8a5: checks
*** RIVER *** [2d As 8h 6d] [9s]
bd394772: bets $0.35
56b9b8a5: calls $0.35
bd394772: shows [Jc Ad] (Pair of Aces)
56b9b8a5: shows [Th 9h] (Pair of Nines)
*** SHOWDOWN ***
bd394772 collected $1.09 from pot
*** SUMMARY ***
Total pot $1.14 | Rake $0.05 | Jackpot $0 | Bingo $0 | Fortune $0 | Tax $0
Board [2d As 8h 6d 9s]
Seat 1: Hero (button) folded before Flop (didn't bet)
Seat 2: fcfd355a (small blind) folded before Flop
Seat 3: bd394772 (big blind) showed [Jc Ad] and won ($1.09) with Pair of Aces
Seat 4: 4f076d5f folded before Flop (didn't bet)
Seat 5: 1ff264f7 folded before Flop (didn't bet)
Seat 6: 56b9b8a5 showed [Th 9h] and lost with Pair of Nines


Poker Hand #RC3334562857: Hold'em No Limit ($0.02/$0.05) - 2025/02/17 21:30:40
Table 'RushAndCash628117' 6-max Seat #1 is the button
Seat 1: 692417ff ($6.08 in chips)
Seat 2: Hero ($7.49 in chips)
Seat 3: 81004403 ($5.06 in chips)
Seat 4: d870506c ($4.91 in chips)
Seat 5: c9e4cf57 ($5.76 in chips)
Seat 6: d037279c ($6.44 in chips)
Hero: posts small blind $0.02
81004403: posts big blind $0.05
*** HOLE CARDS ***
Dealt to 692417ff 
Dealt to Hero [6h Qd]
Dealt to 81004403 
Dealt to d870506c 
Dealt to c9e4cf57 
Dealt to d037279c 
d870506c: raises $0.06 to $0.11
c9e4cf57: raises $0.44 to $0.55
d037279c: folds
692417ff: folds
Hero: folds
81004403: folds
d870506c: folds
Uncalled bet ($0.44) returned to c9e4cf57
*** SHOWDOWN ***
c9e4cf57 collected $0.28 from pot
*** SUMMARY ***
Total pot $0.29 | Rake $0.01 | Jackpot $0 | Bingo $0 | Fortune $0 | Tax $0
Seat 1: 692417ff (button) folded before Flop (didn't bet)
Seat 2: Hero (small blind) folded before Flop
Seat 3: 81004403 (big blind) folded before Flop
Seat 4: d870506c folded before Flop
Seat 5: c9e4cf57 collected ($0.28)
Seat 6: d037279c folded before Flop (didn't bet)


Poker Hand #RC3334562664: Hold'em No Limit ($0.02/$0.05) - 2025/02/17 21:30:17
Table 'RushAndCash627924' 6-max Seat #1 is the button
Seat 1: 4b71998b ($11.44 in chips)
Seat 2: 3ed1e77f ($5.97 in chips)
Seat 3: 43c437e9 ($18.74 in chips)
Seat 4: ee3fdfd8 ($5 in chips)
Seat 5: Hero ($7.8 in chips)
Seat 6: 692417ff ($5.73 in chips)
3ed1e77f: posts small blind $0.02
43c437e9: posts big blind $0.05
*** HOLE CARDS ***
Dealt to 4b71998b 
Dealt to 3ed1e77f 
Dealt to 43c437e9 
Dealt to ee3fdfd8 
Dealt to Hero [Qc Jc]
Dealt to 692417ff 
ee3fdfd8: folds
Hero: raises $0.05 to $0.1
692417ff: raises $0.21 to $0.31
4b71998b: folds
3ed1e77f: folds
43c437e9: folds
Hero: calls $0.21
*** FLOP *** [4h 9s Ks]
Hero: checks
692417ff: bets $0.54
Hero: folds
Uncalled bet ($0.54) returned to 692417ff
*** SHOWDOWN ***
692417ff collected $0.66 from pot
*** SUMMARY ***
Total pot $0.69 | Rake $0.03 | Jackpot $0 | Bingo $0 | Fortune $0 | Tax $0
Board [4h 9s Ks]
Seat 1: 4b71998b (button) folded before Flop (didn't bet)
Seat 2: 3ed1e77f (small blind) folded before Flop
Seat 3: 43c437e9 (big blind) folded before Flop
Seat 4: ee3fdfd8 folded before Flop (didn't bet)
Seat 5: Hero folded on the Flop
Seat 6: 692417ff won ($0.66)


Poker Hand #RC3334562639: Hold'em No Limit ($0.02/$0.05) - 2025/02/17 21:30:13
Table 'RushAndCash627899' 6-max Seat #1 is the button
Seat 1: 304e7bcd ($4.54 in chips)
Seat 2: db6b60a1 ($8.24 in chips)
Seat 3: Hero ($7.85 in chips)
Seat 4: d037279c ($6.44 in chips)
Seat 5: 91ad3969 ($8.66 in chips)
Seat 6: 486aa946 ($4.93 in chips)
db6b60a1: posts small blind $0.02
Hero: posts big blind $0.05
*** HOLE CARDS ***
Dealt to 304e7bcd 
Dealt to db6b60a1 
Dealt to Hero [6h Jc]
Dealt to d037279c 
Dealt to 91ad3969 
Dealt to 486aa946 
d037279c: folds
91ad3969: folds
486aa946: folds
304e7bcd: raises $0.05 to $0.1
db6b60a1: folds
Hero: folds
Uncalled bet ($0.05) returned to 304e7bcd
*** SHOWDOWN ***
304e7bcd collected $0.12 from pot
*** SUMMARY ***
Total pot $0.12 | Rake $0 | Jackpot $0 | Bingo $0 | Fortune $0 | Tax $0
Seat 1: 304e7bcd (button) collected ($0.12)
Seat 2: db6b60a1 (small blind) folded before Flop
Seat 3: Hero (big blind) folded before Flop
Seat 4: d037279c folded before Flop (didn't bet)
Seat 5: 91ad3969 folded before Flop (didn't bet)
Seat 6: 486aa946 folded before Flop (didn't bet)


Poker Hand #RC3334562601: Hold'em No Limit ($0.02/$0.05) - 2025/02/17 21:30:09
Table 'RushAndCash627861' 6-max Seat #1 is the button
Seat 1: Hero ($7.85 in chips)
Seat 2: 4b71998b ($11.46 in chips)
Seat 3: 1e76a4d8 ($6.13 in chips)
Seat 4: 12ef643d ($5.01 in chips)
Seat 5: b48f0b59 ($5.14 in chips)
Seat 6: 1e474bac ($5.73 in chips)
4b71998b: posts small blind $0.02
1e76a4d8: posts big blind $0.05
*** HOLE CARDS ***
Dealt to Hero [8d 2s]
Dealt to 4b71998b 
Dealt to 1e76a4d8 
Dealt to 12ef643d 
Dealt to b48f0b59 
Dealt to 1e474bac 
12ef643d: raises $0.07 to $0.12
b48f0b59: folds
1e474bac: folds
Hero: folds
4b71998b: folds
1e76a4d8: folds
Uncalled bet ($0.07) returned to 12ef643d
*** SHOWDOWN ***
12ef643d collected $0.12 from pot
*** SUMMARY ***
Total pot $0.12 | Rake $0 | Jackpot $0 | Bingo $0 | Fortune $0 | Tax $0
Seat 1: Hero (button) folded before Flop (didn't bet)
Seat 2: 4b71998b (small blind) folded before Flop
Seat 3: 1e76a4d8 (big blind) folded before Flop
Seat 4: 12ef643d collected ($0.12)
Seat 5: b48f0b59 folded before Flop (didn't bet)
Seat 6: 1e474bac folded before Flop (didn't bet)


Poker Hand #RC3334562563: Hold'em No Limit ($0.02/$0.05) - 2025/02/17 21:30:04
Table 'RushAndCash627823' 6-max Seat #1 is the button
Seat 1: 62fdcc3c ($5 in chips)
Seat 2: 5a5583b4 ($6.48 in chips)
Seat 3: 5c8c19b7 ($14.09 in chips)
Seat 4: 9c1c8cec ($3.94 in chips)
Seat 5: 35fb946f ($10.28 in chips)
Seat 6: Hero ($7.85 in chips)
5a5583b4: posts small blind $0.02
5c8c19b7: posts big blind $0.05
*** HOLE CARDS ***
Dealt to 62fdcc3c 
Dealt to 5a5583b4 
Dealt to 5c8c19b7 
Dealt to 9c1c8cec 
Dealt to 35fb946f 
Dealt to Hero [3h 8c]
9c1c8cec: calls $0.05
35fb946f: raises $0.17 to $0.22
Hero: folds
62fdcc3c: folds
5a5583b4: folds
5c8c19b7: folds
9c1c8cec: calls $0.17
*** FLOP *** [Ts 3c Qh]
9c1c8cec: checks
35fb946f: bets $0.15
9c1c8cec: folds
Uncalled bet ($0.15) returned to 35fb946f
*** SHOWDOWN ***
35fb946f collected $0.49 from pot
*** SUMMARY ***
Total pot $0.51 | Rake $0.02 | Jackpot $0 | Bingo $0 | Fortune $0 | Tax $0
Board [Ts 3c Qh]
Seat 1: 62fdcc3c (button) folded before Flop (didn't bet)
Seat 2: 5a5583b4 (small blind) folded before Flop
Seat 3: 5c8c19b7 (big blind) folded before Flop
Seat 4: 9c1c8cec folded on the Flop
Seat 5: 35fb946f won ($0.49)
Seat 6: Hero folded before Flop (didn't bet)


Poker Hand #RC3334562539: Hold'em No Limit ($0.02/$0.05) - 2025/02/17 21:30:01
Table 'RushAndCash627799' 6-max Seat #1 is the button
Seat 1: 2f650001 ($4.82 in chips)
Seat 2: 2d52b322 ($5.4 in chips)
Seat 3: b8c09f2 ($6.62 in chips)
Seat 4: Hero ($7.85 in chips)
Seat 5: 56d81d8 ($5.16 in chips)
Seat 6: d11ba472 ($8.45 in chips)
2d52b322: posts small blind $0.02
b8c09f2: posts big blind $0.05
*** HOLE CARDS ***
Dealt to 2f650001 
Dealt to 2d52b322 
Dealt to b8c09f2 
Dealt to Hero [3s 9d]
Dealt to 56d81d8 
Dealt to d11ba472 
Hero: folds
56d81d8: folds
d11ba472: calls $0.05
2f650001: folds
2d52b322: raises $0.12 to $0.17
b8c09f2: raises $0.52 to $0.69
d11ba472: folds
2d52b322: folds
Uncalled bet ($0.52) returned to b8c09f2
*** SHOWDOWN ***
b8c09f2 collected $0.38 from pot
*** SUMMARY ***
Total pot $0.39 | Rake $0.01 | Jackpot $0 | Bingo $0 | Fortune $0 | Tax $0
Seat 1: 2f650001 (button) folded before Flop (didn't bet)
Seat 2: 2d52b322 (small blind) folded before Flop
Seat 3: b8c09f2 (big blind) collected ($0.38)
Seat 4: Hero folded before Flop (didn't bet)
Seat 5: 56d81d8 folded before Flop (didn't bet)
Seat 6: d11ba472 folded before Flop


Poker Hand #RC3334562310: Hold'em No Limit ($0.02/$0.05) - 2025/02/17 21:29:35
Table 'RushAndCash627570' 6-max Seat #1 is the button
Seat 1: Hero ($7.95 in chips)
Seat 2: 2f650001 ($4.68 in chips)
Seat 3: ef7b5599 ($34.28 in chips)
Seat 4: 82c6ccfb ($4.8 in chips)
Seat 5: 9b7148f5 ($9.61 in chips)
Seat 6: 33b2f32d ($5.31 in chips)
2f650001: posts small blind $0.02
ef7b5599: posts big blind $0.05
*** HOLE CARDS ***
Dealt to Hero [Ac 8d]
Dealt to 2f650001 
Dealt to ef7b5599 
Dealt to 82c6ccfb 
Dealt to 9b7148f5 
Dealt to 33b2f32d 
82c6ccfb: folds
9b7148f5: folds
33b2f32d: folds
Hero: raises $0.05 to $0.1
2f650001: raises $0.19 to $0.29
ef7b5599: folds
Hero: folds
Uncalled bet ($0.19) returned to 2f650001
*** SHOWDOWN ***
2f650001 collected $0.24 from pot
*** SUMMARY ***
Total pot $0.25 | Rake $0.01 | Jackpot $0 | Bingo $0 | Fortune $0 | Tax $0
Seat 1: Hero (button) folded before Flop
Seat 2: 2f650001 (small blind) collected ($0.24)
Seat 3: ef7b5599 (big blind) folded before Flop
Seat 4: 82c6ccfb folded before Flop (didn't bet)
Seat 5: 9b7148f5 folded before Flop (didn't bet)
Seat 6: 33b2f32d folded before Flop (didn't bet)


Poker Hand #RC3334562222: Hold'em No Limit ($0.02/$0.05) - 2025/02/17 21:29:25
Table 'RushAndCash627482' 6-max Seat #1 is the button
Seat 1: Hero ($7.88 in chips)
Seat 2: 381c6d82 ($14.44 in chips)
Seat 3: 50254767 ($5.48 in chips)
Seat 4: 25f30dbe ($3.92 in chips)
Seat 5: 5abb6a6d ($4 in chips)
Seat 6: 516da84c ($3.43 in chips)
381c6d82: posts small blind $0.02
50254767: posts big blind $0.05
*** HOLE CARDS ***
Dealt to Hero [Qd 9c]
Dealt to 381c6d82 
Dealt to 50254767 
Dealt to 25f30dbe 
Dealt to 5abb6a6d 
Dealt to 516da84c 
25f30dbe: folds
5abb6a6d: folds
516da84c: folds
Hero: raises $0.05 to $0.1
381c6d82: folds
50254767: folds
Uncalled bet ($0.05) returned to Hero
*** SHOWDOWN ***
Hero collected $0.12 from pot
*** SUMMARY ***
Total pot $0.12 | Rake $0 | Jackpot $0 | Bingo $0 | Fortune $0 | Tax $0
Seat 1: Hero (button) collected ($0.12)
Seat 2: 381c6d82 (small blind) folded before Flop
Seat 3: 50254767 (big blind) folded before Flop
Seat 4: 25f30dbe folded before Flop (didn't bet)
Seat 5: 5abb6a6d folded before Flop (didn't bet)
Seat 6: 516da84c folded before Flop (didn't bet)


Poker Hand #RC3334562190: Hold'em No Limit ($0.02/$0.05) - 2025/02/17 21:29:22
Table 'RushAndCash627450' 6-max Seat #1 is the button
Seat 1: 5381eb4c ($8.04 in chips)
Seat 2: 76135c78 ($12.89 in chips)
Seat 3: Hero ($7.93 in chips)
Seat 4: d897e841 ($5 in chips)
Seat 5: 367e3140 ($5.52 in chips)
Seat 6: bc8371cb ($7.23 in chips)
76135c78: posts small blind $0.02
Hero: posts big blind $0.05
*** HOLE CARDS ***
Dealt to 5381eb4c 
Dealt to 76135c78 
Dealt to Hero [Js 8h]
Dealt to d897e841 
Dealt to 367e3140 
Dealt to bc8371cb 
d897e841: folds
367e3140: folds
bc8371cb: folds
5381eb4c: folds
76135c78: raises $0.1 to $0.15
Hero: folds
Uncalled bet ($0.1) returned to 76135c78
*** SHOWDOWN ***
76135c78 collected $0.1 from pot
*** SUMMARY ***
Total pot $0.1 | Rake $0 | Jackpot $0 | Bingo $0 | Fortune $0 | Tax $0
Seat 1: 5381eb4c (button) folded before Flop (didn't bet)
Seat 2: 76135c78 (small blind) collected ($0.1)
Seat 3: Hero (big blind) folded before Flop
Seat 4: d897e841 folded before Flop (didn't bet)
Seat 5: 367e3140 folded before Flop (didn't bet)
Seat 6: bc8371cb folded before Flop (didn't bet)


Poker Hand #RC3334562128: Hold'em No Limit ($0.02/$0.05) - 2025/02/17 21:29:14
Table 'RushAndCash627388' 6-max Seat #1 is the button
Seat 1: b258f9f9 ($5.1 in chips)
Seat 2: 84667b37 ($4.66 in chips)
Seat 3: 52f54c69 ($5.92 in chips)
Seat 4: Hero ($7.93 in chips)
Seat 5: e183d966 ($5 in chips)
Seat 6: 4238ab48 ($7.4 in chips)
84667b37: posts small blind $0.02
52f54c69: posts big blind $0.05
*** HOLE CARDS ***
Dealt to b258f9f9 
Dealt to 84667b37 
Dealt to 52f54c69 
Dealt to Hero [2s 9c]
Dealt to e183d966 
Dealt to 4238ab48 
Hero: folds
e183d966: folds
4238ab48: raises $0.06 to $0.11
b258f9f9: folds
84667b37: folds
52f54c69: calls $0.06
*** FLOP *** [Ks Td 7h]
52f54c69: checks
4238ab48: bets $0.08
52f54c69: calls $0.08
*** TURN *** [Ks Td 7h] [Jd]
52f54c69: checks
4238ab48: checks
*** RIVER *** [Ks Td 7h Jd] [As]
52f54c69: checks
4238ab48: bets $0.8
52f54c69: folds
Uncalled bet ($0.8) returned to 4238ab48
*** SHOWDOWN ***
4238ab48 collected $0.38 from pot
*** SUMMARY ***
Total pot $0.4 | Rake $0.02 | Jackpot $0 | Bingo $0 | Fortune $0 | Tax $0
Board [Ks Td 7h Jd As]
Seat 1: b258f9f9 (button) folded before Flop (didn't bet)
Seat 2: 84667b37 (small blind) folded before Flop
Seat 3: 52f54c69 (big blind) folded on the River
Seat 4: Hero folded before Flop (didn't bet)
Seat 5: e183d966 folded before Flop (didn't bet)
Seat 6: 4238ab48 won ($0.38)


Poker Hand #RC3334562025: Hold'em No Limit ($0.02/$0.05) - 2025/02/17 21:29:01
Table 'RushAndCash627285' 6-max Seat #1 is the button
Seat 1: 8f77797e ($3.76 in chips)
Seat 2: e16b78a9 ($7.98 in chips)
Seat 3: 8ec32764 ($5.37 in chips)
Seat 4: a9d8ced4 ($6.11 in chips)
Seat 5: dda0a24a ($5.71 in chips)
Seat 6: Hero ($7.93 in chips)
e16b78a9: posts small blind $0.02
8ec32764: posts big blind $0.05
*** HOLE CARDS ***
Dealt to 8f77797e 
Dealt to e16b78a9 
Dealt to 8ec32764 
Dealt to a9d8ced4 
Dealt to dda0a24a 
Dealt to Hero [3h 3d]
a9d8ced4: raises $0.09 to $0.14
dda0a24a: raises $0.27 to $0.41
Hero: folds
8f77797e: folds
e16b78a9: folds
8ec32764: folds
a9d8ced4: calls $0.27
*** FLOP *** [Qd 7c 3c]
a9d8ced4: bets $0.3
dda0a24a: folds
Uncalled bet ($0.3) returned to a9d8ced4
*** SHOWDOWN ***
a9d8ced4 collected $0.85 from pot
*** SUMMARY ***
Total pot $0.89 | Rake $0.04 | Jackpot $0 | Bingo $0 | Fortune $0 | Tax $0
Board [Qd 7c 3c]
Seat 1: 8f77797e (button) folded before Flop (didn't bet)
Seat 2: e16b78a9 (small blind) folded before Flop
Seat 3: 8ec32764 (big blind) folded before Flop
Seat 4: a9d8ced4 won ($0.85)
Seat 5: dda0a24a folded on the Flop
Seat 6: Hero folded before Flop (didn't bet)


Poker Hand #RC3334561702: Hold'em No Limit ($0.02/$0.05) - 2025/02/17 21:28:21
Table 'RushAndCash626962' 6-max Seat #1 is the button
Seat 1: c35cd20e ($5.4 in chips)
Seat 2: Hero ($6.61 in chips)
Seat 3: eb21bc62 ($3.51 in chips)
Seat 4: 8f77797e ($5.24 in chips)
Seat 5: 711af4a4 ($16.94 in chips)
Seat 6: 14620cce ($13.28 in chips)
Hero: posts small blind $0.02
eb21bc62: posts big blind $0.05
*** HOLE CARDS ***
Dealt to c35cd20e 
Dealt to Hero [Js Jh]
Dealt to eb21bc62 
Dealt to 8f77797e 
Dealt to 711af4a4 
Dealt to 14620cce 
8f77797e: raises $0.05 to $0.1
711af4a4: folds
14620cce: folds
c35cd20e: folds
Hero: raises $0.32 to $0.42
eb21bc62: folds
8f77797e: calls $0.32
*** FLOP *** [6h 8h 5s]
Hero: checks
8f77797e: checks
*** TURN *** [6h 8h 5s] [3h]
Hero: bets $0.46
8f77797e: calls $0.46
*** RIVER *** [6h 8h 5s 3h] [9c]
Hero: bets $0.6
8f77797e: calls $0.6
Hero: shows [Js Jh] (Pair of Jacks)
8f77797e: shows [8d Ad] (Pair of Eights)
*** SHOWDOWN ***
Hero collected $2.8 from pot
*** SUMMARY ***
Total pot $3.01 | Rake $0.14 | Jackpot $0.07 | Bingo $0 | Fortune $0 | Tax $0
Board [6h 8h 5s 3h 9c]
Seat 1: c35cd20e (button) folded before Flop (didn't bet)
Seat 2: Hero (small blind) showed [Js Jh] and won ($2.8) with Pair of Jacks
Seat 3: eb21bc62 (big blind) folded before Flop
Seat 4: 8f77797e showed [8d Ad] and lost with Pair of Eights
Seat 5: 711af4a4 folded before Flop (didn't bet)
Seat 6: 14620cce folded before Flop (didn't bet)


Poker Hand #RC3334561658: Hold'em No Limit ($0.02/$0.05) - 2025/02/17 21:28:16
Table 'RushAndCash626918' 6-max Seat #1 is the button
Seat 1: Hero ($6.61 in chips)
Seat 2: 8cf3ad10 ($7.06 in chips)
Seat 3: bf4557c ($1.82 in chips)
Seat 4: 3d2a56c8 ($5 in chips)
Seat 5: edbb0bb6 ($5.15 in chips)
Seat 6: 56b9b8a5 ($5 in chips)
8cf3ad10: posts small blind $0.02
bf4557c: posts big blind $0.05
*** HOLE CARDS ***
Dealt to Hero [2c 2h]
Dealt to 8cf3ad10 
Dealt to bf4557c 
Dealt to 3d2a56c8 
Dealt to edbb0bb6 
Dealt to 56b9b8a5 
3d2a56c8: folds
edbb0bb6: folds
56b9b8a5: folds
Hero: folds
8cf3ad10: folds
Uncalled bet ($0.03) returned to bf4557c
*** SHOWDOWN ***
bf4557c collected $0.04 from pot
*** SUMMARY ***
Total pot $0.04 | Rake $0 | Jackpot $0 | Bingo $0 | Fortune $0 | Tax $0
Seat 1: Hero (button) folded before Flop (didn't bet)
Seat 2: 8cf3ad10 (small blind) folded before Flop
Seat 3: bf4557c (big blind) collected ($0.04)
Seat 4: 3d2a56c8 folded before Flop (didn't bet)
Seat 5: edbb0bb6 folded before Flop (didn't bet)
Seat 6: 56b9b8a5 folded before Flop (didn't bet)


Poker Hand #RC3334561611: Hold'em No Limit ($0.02/$0.05) - 2025/02/17 21:28:11
Table 'RushAndCash626871' 6-max Seat #1 is the button
Seat 1: 33b2f32d ($5 in chips)
Seat 2: 2db50b0f ($5.78 in chips)
Seat 3: Hero ($6.66 in chips)
Seat 4: 3e3946b0 ($6.49 in chips)
Seat 5: d5150c28 ($13.39 in chips)
Seat 6: 93056ee9 ($7.32 in chips)
2db50b0f: posts small blind $0.02
Hero: posts big blind $0.05
*** HOLE CARDS ***
Dealt to 33b2f32d 
Dealt to 2db50b0f 
Dealt to Hero [7d Ac]
Dealt to 3e3946b0 
Dealt to d5150c28 
Dealt to 93056ee9 
3e3946b0: folds
d5150c28: raises $0.05 to $0.1
93056ee9: folds
33b2f32d: raises $0.25 to $0.35
2db50b0f: folds
Hero: folds
d5150c28: calls $0.25
*** FLOP *** [Ks 5s 9s]
d5150c28: checks
33b2f32d: bets $0.39
d5150c28: folds
Uncalled bet ($0.39) returned to 33b2f32d
*** SHOWDOWN ***
33b2f32d collected $0.73 from pot
*** SUMMARY ***
Total pot $0.77 | Rake $0.04 | Jackpot $0 | Bingo $0 | Fortune $0 | Tax $0
Board [Ks 5s 9s]
Seat 1: 33b2f32d (button) won ($0.73)
Seat 2: 2db50b0f (small blind) folded before Flop
Seat 3: Hero (big blind) folded before Flop
Seat 4: 3e3946b0 folded before Flop (didn't bet)
Seat 5: d5150c28 folded on the Flop
Seat 6: 93056ee9 folded before Flop (didn't bet)


Poker Hand #RC3334561573: Hold'em No Limit ($0.02/$0.05) - 2025/02/17 21:28:06
Table 'RushAndCash626833' 6-max Seat #1 is the button
Seat 1: 93056ee9 ($7.32 in chips)
Seat 2: Hero ($6.68 in chips)
Seat 3: 42fca4f9 ($10.47 in chips)
Seat 4: 9fa2589a ($3.58 in chips)
Seat 5: b8a41e4 ($5.44 in chips)
Seat 6: 2a10169c ($5.23 in chips)
Hero: posts small blind $0.02
42fca4f9: posts big blind $0.05
*** HOLE CARDS ***
Dealt to 93056ee9 
Dealt to Hero [5c Jd]
Dealt to 42fca4f9 
Dealt to 9fa2589a 
Dealt to b8a41e4 
Dealt to 2a10169c 
9fa2589a: raises $0.05 to $0.1
b8a41e4: folds
2a10169c: folds
93056ee9: folds
Hero: folds
42fca4f9: calls $0.05
*** FLOP *** [2h Kc Th]
42fca4f9: checks
9fa2589a: checks
*** TURN *** [2h Kc Th] [As]
42fca4f9: checks
9fa2589a: checks
*** RIVER *** [2h Kc Th As] [4c]
42fca4f9: checks
9fa2589a: checks
42fca4f9: shows [3s 6s] (Ace-High)
9fa2589a: shows [7h 7c] (Pair of Sevens)
*** SHOWDOWN ***
9fa2589a collected $0.21 from pot
*** SUMMARY ***
Total pot $0.22 | Rake $0.01 | Jackpot $0 | Bingo $0 | Fortune $0 | Tax $0
Board [2h Kc Th As 4c]
Seat 1: 93056ee9 (button) folded before Flop (didn't bet)
Seat 2: Hero (small blind) folded before Flop
Seat 3: 42fca4f9 (big blind) showed [3s 6s] and lost with Ace-High
Seat 4: 9fa2589a showed [7h 7c] and won ($0.21) with Pair of Sevens
Seat 5: b8a41e4 folded before Flop (didn't bet)
Seat 6: 2a10169c folded before Flop (didn't bet)


Poker Hand #RC3334561541: Hold'em No Limit ($0.02/$0.05) - 2025/02/17 21:28:03
Table 'RushAndCash626801' 6-max Seat #1 is the button
Seat 1: 1941fa92 ($2.16 in chips)
Seat 2: eb21bc62 ($3.53 in chips)
Seat 3: dbf5f543 ($4.66 in chips)
Seat 4: 15fafcaa ($5.2 in chips)
Seat 5: 65ca9276 ($10.24 in chips)
Seat 6: Hero ($6.68 in chips)
eb21bc62: posts small blind $0.02
dbf5f543: posts big blind $0.05
*** HOLE CARDS ***
Dealt to 1941fa92 
Dealt to eb21bc62 
Dealt to dbf5f543 
Dealt to 15fafcaa 
Dealt to 65ca9276 
Dealt to Hero [8d Jc]
15fafcaa: folds
65ca9276: folds
Hero: folds
1941fa92: folds
eb21bc62: folds
Uncalled bet ($0.03) returned to dbf5f543
*** SHOWDOWN ***
dbf5f543 collected $0.04 from pot
*** SUMMARY ***
Total pot $0.04 | Rake $0 | Jackpot $0 | Bingo $0 | Fortune $0 | Tax $0
Seat 1: 1941fa92 (button) folded before Flop (didn't bet)
Seat 2: eb21bc62 (small blind) folded before Flop
Seat 3: dbf5f543 (big blind) collected ($0.04)
Seat 4: 15fafcaa folded before Flop (didn't bet)
Seat 5: 65ca9276 folded before Flop (didn't bet)
Seat 6: Hero folded before Flop (didn't bet)


Poker Hand #RC3334561461: Hold'em No Limit ($0.02/$0.05) - 2025/02/17 21:27:53
Table 'RushAndCash626721' 6-max Seat #1 is the button
Seat 1: 45d33c76 ($10.02 in chips)
Seat 2: Hero ($6.7 in chips)
Seat 3: 100d4f9e ($4.98 in chips)
Seat 4: 71ee6520 ($5.07 in chips)
Seat 5: b02447b8 ($5.22 in chips)
Seat 6: 7aca7e93 ($5.26 in chips)
Hero: posts small blind $0.02
100d4f9e: posts big blind $0.05
*** HOLE CARDS ***
Dealt to 45d33c76 
Dealt to Hero [Qd Th]
Dealt to 100d4f9e 
Dealt to 71ee6520 
Dealt to b02447b8 
Dealt to 7aca7e93 
71ee6520: folds
b02447b8: folds
7aca7e93: raises $0.08 to $0.13
45d33c76: folds
Hero: folds
100d4f9e: folds
Uncalled bet ($0.08) returned to 7aca7e93
*** SHOWDOWN ***
7aca7e93 collected $0.12 from pot
*** SUMMARY ***
Total pot $0.12 | Rake $0 | Jackpot $0 | Bingo $0 | Fortune $0 | Tax $0
Seat 1: 45d33c76 (button) folded before Flop (didn't bet)
Seat 2: Hero (small blind) folded before Flop
Seat 3: 100d4f9e (big blind) folded before Flop
Seat 4: 71ee6520 folded before Flop (didn't bet)
Seat 5: b02447b8 folded before Flop (didn't bet)
Seat 6: 7aca7e93 collected ($0.12)


Poker Hand #RC3334561435: Hold'em No Limit ($0.02/$0.05) - 2025/02/17 21:27:50
Table 'RushAndCash626695' 6-max Seat #1 is the button
Seat 1: ec0e24ed ($5.41 in chips)
Seat 2: 77d77e59 ($5.69 in chips)
Seat 3: f72bf77b ($5.25 in chips)
Seat 4: Hero ($6.7 in chips)
Seat 5: 56d81d8 ($5.51 in chips)
Seat 6: e352a329 ($8.33 in chips)
77d77e59: posts small blind $0.02
f72bf77b: posts big blind $0.05
*** HOLE CARDS ***
Dealt to ec0e24ed 
Dealt to 77d77e59 
Dealt to f72bf77b 
Dealt to Hero [Kh 3h]
Dealt to 56d81d8 
Dealt to e352a329 
Hero: folds
56d81d8: folds
e352a329: folds
ec0e24ed: folds
77d77e59: folds
Uncalled bet ($0.03) returned to f72bf77b
*** SHOWDOWN ***
f72bf77b collected $0.04 from pot
*** SUMMARY ***
Total pot $0.04 | Rake $0 | Jackpot $0 | Bingo $0 | Fortune $0 | Tax $0
Seat 1: ec0e24ed (button) folded before Flop (didn't bet)
Seat 2: 77d77e59 (small blind) folded before Flop
Seat 3: f72bf77b (big blind) collected ($0.04)
Seat 4: Hero folded before Flop (didn't bet)
Seat 5: 56d81d8 folded before Flop (didn't bet)
Seat 6: e352a329 folded before Flop (didn't bet)


Poker Hand #RC3334561250: Hold'em No Limit ($0.02/$0.05) - 2025/02/17 21:27:27
Table 'RushAndCash626510' 6-max Seat #1 is the button
Seat 1: 56d81d8 ($5.35 in chips)
Seat 2: f3614ba1 ($7.05 in chips)
Seat 3: 80c22e34 ($5.86 in chips)
Seat 4: dda0a24a ($5.84 in chips)
Seat 5: 91e92de9 ($6.3 in chips)
Seat 6: Hero ($6.8 in chips)
f3614ba1: posts small blind $0.02
80c22e34: posts big blind $0.05
*** HOLE CARDS ***
Dealt to 56d81d8 
Dealt to f3614ba1 
Dealt to 80c22e34 
Dealt to dda0a24a 
Dealt to 91e92de9 
Dealt to Hero [Kd Td]
dda0a24a: folds
91e92de9: folds
Hero: raises $0.05 to $0.1
56d81d8: raises $0.27 to $0.37
f3614ba1: folds
80c22e34: folds
Hero: folds
Uncalled bet ($0.27) returned to 56d81d8
*** SHOWDOWN ***
56d81d8 collected $0.26 from pot
*** SUMMARY ***
Total pot $0.27 | Rake $0.01 | Jackpot $0 | Bingo $0 | Fortune $0 | Tax $0
Seat 1: 56d81d8 (button) collected ($0.26)
Seat 2: f3614ba1 (small blind) folded before Flop
Seat 3: 80c22e34 (big blind) folded before Flop
Seat 4: dda0a24a folded before Flop (didn't bet)
Seat 5: 91e92de9 folded before Flop (didn't bet)
Seat 6: Hero folded before Flop


Poker Hand #RC3334561220: Hold'em No Limit ($0.02/$0.05) - 2025/02/17 21:27:24
Table 'RushAndCash626480' 6-max Seat #1 is the button
Seat 1: 679a8f7 ($8.37 in chips)
Seat 2: 50cbaebe ($7.29 in chips)
Seat 3: ea7a7ae0 ($7.53 in chips)
Seat 4: Hero ($6.8 in chips)
Seat 5: 945593bf ($16.55 in chips)
Seat 6: 3b98b9ec ($22.52 in chips)
50cbaebe: posts small blind $0.02
ea7a7ae0: posts big blind $0.05
*** HOLE CARDS ***
Dealt to 679a8f7 
Dealt to 50cbaebe 
Dealt to ea7a7ae0 
Dealt to Hero [4h Ac]
Dealt to 945593bf 
Dealt to 3b98b9ec 
Hero: folds
945593bf: folds
3b98b9ec: folds
679a8f7: raises $0.05 to $0.1
50cbaebe: raises $0.35 to $0.45
ea7a7ae0: folds
679a8f7: folds
Uncalled bet ($0.35) returned to 50cbaebe
*** SHOWDOWN ***
50cbaebe collected $0.24 from pot
*** SUMMARY ***
Total pot $0.25 | Rake $0.01 | Jackpot $0 | Bingo $0 | Fortune $0 | Tax $0
Seat 1: 679a8f7 (button) folded before Flop
Seat 2: 50cbaebe (small blind) collected ($0.24)
Seat 3: ea7a7ae0 (big blind) folded before Flop
Seat 4: Hero folded before Flop (didn't bet)
Seat 5: 945593bf folded before Flop (didn't bet)
Seat 6: 3b98b9ec folded before Flop (didn't bet)


Poker Hand #RC3334561180: Hold'em No Limit ($0.02/$0.05) - 2025/02/17 21:27:19
Table 'RushAndCash626440' 6-max Seat #1 is the button
Seat 1: 15fafcaa ($5.4 in chips)
Seat 2: 92fd04c6 ($4.57 in chips)
Seat 3: 91ad3969 ($8.14 in chips)
Seat 4: 15346d36 ($6.23 in chips)
Seat 5: Hero ($6.8 in chips)
Seat 6: b39a93ce ($5.21 in chips)
92fd04c6: posts small blind $0.02
91ad3969: posts big blind $0.05
*** HOLE CARDS ***
Dealt to 15fafcaa 
Dealt to 92fd04c6 
Dealt to 91ad3969 
Dealt to 15346d36 
Dealt to Hero [5d 5h]
Dealt to b39a93ce 
15346d36: folds
Hero: folds
b39a93ce: folds
15fafcaa: raises $0.05 to $0.1
92fd04c6: folds
91ad3969: raises $0.2 to $0.3
15fafcaa: folds
Uncalled bet ($0.2) returned to 91ad3969
*** SHOWDOWN ***
91ad3969 collected $0.21 from pot
*** SUMMARY ***
Total pot $0.22 | Rake $0.01 | Jackpot $0 | Bingo $0 | Fortune $0 | Tax $0
Seat 1: 15fafcaa (button) folded before Flop
Seat 2: 92fd04c6 (small blind) folded before Flop
Seat 3: 91ad3969 (big blind) collected ($0.21)
Seat 4: 15346d36 folded before Flop (didn't bet)
Seat 5: Hero folded before Flop (didn't bet)
Seat 6: b39a93ce folded before Flop (didn't bet)


Poker Hand #RC3334561154: Hold'em No Limit ($0.02/$0.05) - 2025/02/17 21:27:16
Table 'RushAndCash626414' 6-max Seat #1 is the button
Seat 1: 4614c5cf ($5.14 in chips)
Seat 2: bfef046a ($18.78 in chips)
Seat 3: b70bdf37 ($5 in chips)
Seat 4: 3d2a56c8 ($5.02 in chips)
Seat 5: Hero ($6.8 in chips)
Seat 6: 304e7bcd ($4.74 in chips)
bfef046a: posts small blind $0.02
b70bdf37: posts big blind $0.05
*** HOLE CARDS ***
Dealt to 4614c5cf 
Dealt to bfef046a 
Dealt to b70bdf37 
Dealt to 3d2a56c8 
Dealt to Hero [4s 9c]
Dealt to 304e7bcd 
3d2a56c8: folds
Hero: folds
304e7bcd: raises $0.05 to $0.1
4614c5cf: raises $0.21 to $0.31
bfef046a: folds
b70bdf37: calls $0.26
304e7bcd: folds
*** FLOP *** [7h 3h 7s]
b70bdf37: checks
4614c5cf: checks
*** TURN *** [7h 3h 7s] [7d]
b70bdf37: bets $0.25
4614c5cf: calls $0.25
*** RIVER *** [7h 3h 7s 7d] [4c]
b70bdf37: bets $0.56
4614c5cf: folds
Uncalled bet ($0.56) returned to b70bdf37
*** SHOWDOWN ***
b70bdf37 collected $1.18 from pot
*** SUMMARY ***
Total pot $1.24 | Rake $0.06 | Jackpot $0 | Bingo $0 | Fortune $0 | Tax $0
Board [7h 3h 7s 7d 4c]
Seat 1: 4614c5cf (button) folded on the River
Seat 2: bfef046a (small blind) folded before Flop
Seat 3: b70bdf37 (big blind) won ($1.18)
Seat 4: 3d2a56c8 folded before Flop (didn't bet)
Seat 5: Hero folded before Flop (didn't bet)
Seat 6: 304e7bcd folded before Flop


Poker Hand #RC3334561127: Hold'em No Limit ($0.02/$0.05) - 2025/02/17 21:27:13
Table 'RushAndCash626387' 6-max Seat #1 is the button
Seat 1: 8d7c8253 ($5.54 in chips)
Seat 2: 2ae4e16 ($3.59 in chips)
Seat 3: Hero ($6.85 in chips)
Seat 4: c18cd900 ($4.61 in chips)
Seat 5: c83a952b ($5.07 in chips)
Seat 6: 1582a024 ($4.93 in chips)
2ae4e16: posts small blind $0.02
Hero: posts big blind $0.05
*** HOLE CARDS ***
Dealt to 8d7c8253 
Dealt to 2ae4e16 
Dealt to Hero [6d 2h]
Dealt to c18cd900 
Dealt to c83a952b 
Dealt to 1582a024 
c18cd900: raises $0.05 to $0.1
c83a952b: folds
1582a024: folds
8d7c8253: folds
2ae4e16: folds
Hero: folds
Uncalled bet ($0.05) returned to c18cd900
*** SHOWDOWN ***
c18cd900 collected $0.12 from pot
*** SUMMARY ***
Total pot $0.12 | Rake $0 | Jackpot $0 | Bingo $0 | Fortune $0 | Tax $0
Seat 1: 8d7c8253 (button) folded before Flop (didn't bet)
Seat 2: 2ae4e16 (small blind) folded before Flop
Seat 3: Hero (big blind) folded before Flop
Seat 4: c18cd900 collected ($0.12)
Seat 5: c83a952b folded before Flop (didn't bet)
Seat 6: 1582a024 folded before Flop (didn't bet)


Poker Hand #RC3334561102: Hold'em No Limit ($0.02/$0.05) - 2025/02/17 21:27:10
Table 'RushAndCash626362' 6-max Seat #1 is the button
Seat 1: a25931dc ($5.19 in chips)
Seat 2: dcd4e05 ($1.39 in chips)
Seat 3: 75a97e80 ($5.44 in chips)
Seat 4: Hero ($6.85 in chips)
Seat 5: 12cda2e0 ($21.58 in chips)
Seat 6: 180915b9 ($5.69 in chips)
dcd4e05: posts small blind $0.02
75a97e80: posts big blind $0.05
*** HOLE CARDS ***
Dealt to a25931dc 
Dealt to dcd4e05 
Dealt to 75a97e80 
Dealt to Hero [6h 9d]
Dealt to 12cda2e0 
Dealt to 180915b9 
Hero: folds
12cda2e0: folds
180915b9: folds
a25931dc: raises $0.05 to $0.1
dcd4e05: folds
75a97e80: folds
Uncalled bet ($0.05) returned to a25931dc
*** SHOWDOWN ***
a25931dc collected $0.12 from pot
*** SUMMARY ***
Total pot $0.12 | Rake $0 | Jackpot $0 | Bingo $0 | Fortune $0 | Tax $0
Seat 1: a25931dc (button) collected ($0.12)
Seat 2: dcd4e05 (small blind) folded before Flop
Seat 3: 75a97e80 (big blind) folded before Flop
Seat 4: Hero folded before Flop (didn't bet)
Seat 5: 12cda2e0 folded before Flop (didn't bet)
Seat 6: 180915b9 folded before Flop (didn't bet)


Poker Hand #RC3334560656: Hold'em No Limit ($0.02/$0.05) - 2025/02/17 21:26:17
Table 'RushAndCash625916' 6-max Seat #1 is the button
Seat 1: 62fdcc3c ($5.07 in chips)
Seat 2: Hero ($6.16 in chips)
Seat 3: c606a534 ($5 in chips)
Seat 4: 53a8c2fd ($10.25 in chips)
Seat 5: 64b39229 ($6.07 in chips)
Seat 6: b282789b ($12.02 in chips)
Hero: posts small blind $0.02
c606a534: posts big blind $0.05
*** HOLE CARDS ***
Dealt to 62fdcc3c 
Dealt to Hero [6s 7s]
Dealt to c606a534 
Dealt to 53a8c2fd 
Dealt to 64b39229 
Dealt to b282789b 
53a8c2fd: folds
64b39229: folds
b282789b: folds
62fdcc3c: raises $0.05 to $0.1
Hero: calls $0.08
c606a534: calls $0.05
*** FLOP *** [6d 7c 3d]
Hero: checks
c606a534: checks
62fdcc3c: checks
*** TURN *** [6d 7c 3d] [Js]
Hero: bets $0.16
c606a534: calls $0.16
62fdcc3c: folds
*** RIVER *** [6d 7c 3d Js] [4s]
Hero: bets $0.32
c606a534: calls $0.32
Hero: shows [6s 7s] (Pair of Sevens and Pair of Sixes)
c606a534: shows [2h Jh] (Pair of Jacks)
*** SHOWDOWN ***
Hero collected $1.2 from pot
*** SUMMARY ***
Total pot $1.26 | Rake $0.06 | Jackpot $0 | Bingo $0 | Fortune $0 | Tax $0
Board [6d 7c 3d Js 4s]
Seat 1: 62fdcc3c (button) folded on the Turn
Seat 2: Hero (small blind) showed [6s 7s] and won ($1.2) with Pair of Sevens and Pair of Sixes
Seat 3: c606a534 (big blind) showed [2h Jh] and lost with Pair of Jacks
Seat 4: 53a8c2fd folded before Flop (didn't bet)
Seat 5: 64b39229 folded before Flop (didn't bet)
Seat 6: b282789b folded before Flop (didn't bet)


Poker Hand #RC3334560629: Hold'em No Limit ($0.02/$0.05) - 2025/02/17 21:26:14
Table 'RushAndCash625889' 6-max Seat #1 is the button
Seat 1: e2d5acdf ($5.01 in chips)
Seat 2: e0d14e10 ($5.12 in chips)
Seat 3: Hero ($6.21 in chips)
Seat 4: 2e8ab509 ($5.43 in chips)
Seat 5: c606a534 ($5 in chips)
Seat 6: a5be70d9 ($12.46 in chips)
e0d14e10: posts small blind $0.02
Hero: posts big blind $0.05
*** HOLE CARDS ***
Dealt to e2d5acdf 
Dealt to e0d14e10 
Dealt to Hero [5d 4h]
Dealt to 2e8ab509 
Dealt to c606a534 
Dealt to a5be70d9 
2e8ab509: folds
c606a534: folds
a5be70d9: folds
e2d5acdf: folds
e0d14e10: folds
Uncalled bet ($0.03) returned to Hero
*** SHOWDOWN ***
Hero collected $0.04 from pot
*** SUMMARY ***
Total pot $0.04 | Rake $0 | Jackpot $0 | Bingo $0 | Fortune $0 | Tax $0
Seat 1: e2d5acdf (button) folded before Flop (didn't bet)
Seat 2: e0d14e10 (small blind) folded before Flop
Seat 3: Hero (big blind) collected ($0.04)
Seat 4: 2e8ab509 folded before Flop (didn't bet)
Seat 5: c606a534 folded before Flop (didn't bet)
Seat 6: a5be70d9 folded before Flop (didn't bet)


Poker Hand #RC3334560598: Hold'em No Limit ($0.02/$0.05) - 2025/02/17 21:26:10
Table 'RushAndCash625858' 6-max Seat #1 is the button
Seat 1: 628590b2 ($5.05 in chips)
Seat 2: fad81e68 ($6.85 in chips)
Seat 3: a75d2a3b ($0.95 in chips)
Seat 4: Hero ($6.21 in chips)
Seat 5: 37bc5b77 ($5 in chips)
Seat 6: d737deb4 ($5.11 in chips)
fad81e68: posts small blind $0.02
a75d2a3b: posts big blind $0.05
*** HOLE CARDS ***
Dealt to 628590b2 
Dealt to fad81e68 
Dealt to a75d2a3b 
Dealt to Hero [Jd 6h]
Dealt to 37bc5b77 
Dealt to d737deb4 
Hero: folds
37bc5b77: raises $0.08 to $0.13
d737deb4: folds
628590b2: raises $0.27 to $0.4
fad81e68: folds
a75d2a3b: raises $0.55 to $0.95 and is all-in
37bc5b77: calls $0.82
628590b2: raises $4.1 to $5.05 and is all-in
37bc5b77: folds
Uncalled bet ($4.1) returned to 628590b2
628590b2: shows [Kh Ad]
a75d2a3b: shows [8c 8d]
*** FLOP *** [Qh 9s Td]
*** TURN *** [Qh 9s Td] [9h]
*** RIVER *** [Qh 9s Td 9h] [Tc]
*** SHOWDOWN ***
628590b2 collected $2.66 from pot
*** SUMMARY ***
Total pot $2.87 | Rake $0.14 | Jackpot $0.07 | Bingo $0 | Fortune $0 | Tax $0
Board [Qh 9s Td 9h Tc]
Seat 1: 628590b2 (button) showed [Kh Ad] and won ($2.66) with Pair of Tens and Pair of Nines
Seat 2: fad81e68 (small blind) folded before Flop
Seat 3: a75d2a3b (big blind) showed [8c 8d] and lost with Pair of Tens and Pair of Nines
Seat 4: Hero folded before Flop (didn't bet)
Seat 5: 37bc5b77 folded before Flop
Seat 6: d737deb4 folded before Flop (didn't bet)


Poker Hand #RC3334560576: Hold'em No Limit ($0.02/$0.05) - 2025/02/17 21:26:07
Table 'RushAndCash625836' 6-max Seat #1 is the button
Seat 1: 9e6032ad ($5.18 in chips)
Seat 2: eb1bbc7a ($5.2 in chips)
Seat 3: 5abb6a6d ($7.35 in chips)
Seat 4: 981b7542 ($5 in chips)
Seat 5: Hero ($6.21 in chips)
Seat 6: 9c3abcbf ($15.73 in chips)
eb1bbc7a: posts small blind $0.02
5abb6a6d: posts big blind $0.05
*** HOLE CARDS ***
Dealt to 9e6032ad 
Dealt to eb1bbc7a 
Dealt to 5abb6a6d 
Dealt to 981b7542 
Dealt to Hero [3h 7d]
Dealt to 9c3abcbf 
981b7542: folds
Hero: folds
9c3abcbf: folds
9e6032ad: folds
eb1bbc7a: raises $0.1 to $0.15
5abb6a6d: folds
Uncalled bet ($0.1) returned to eb1bbc7a
*** SHOWDOWN ***
eb1bbc7a collected $0.1 from pot
*** SUMMARY ***
Total pot $0.1 | Rake $0 | Jackpot $0 | Bingo $0 | Fortune $0 | Tax $0
Seat 1: 9e6032ad (button) folded before Flop (didn't bet)
Seat 2: eb1bbc7a (small blind) collected ($0.1)
Seat 3: 5abb6a6d (big blind) folded before Flop
Seat 4: 981b7542 folded before Flop (didn't bet)
Seat 5: Hero folded before Flop (didn't bet)
Seat 6: 9c3abcbf folded before Flop (didn't bet)


Poker Hand #RC3334560523: Hold'em No Limit ($0.02/$0.05) - 2025/02/17 21:26:00
Table 'RushAndCash625783' 6-max Seat #1 is the button
Seat 1: e95d0223 ($5.37 in chips)
Seat 2: e6aa09ff ($5.23 in chips)
Seat 3: 100d4f9e ($5.17 in chips)
Seat 4: ef7b5599 ($34.34 in chips)
Seat 5: Hero ($6.14 in chips)
Seat 6: 97d67e86 ($4.19 in chips)
e6aa09ff: posts small blind $0.02
100d4f9e: posts big blind $0.05
*** HOLE CARDS ***
Dealt to e95d0223 
Dealt to e6aa09ff 
Dealt to 100d4f9e 
Dealt to ef7b5599 
Dealt to Hero [7h Ks]
Dealt to 97d67e86 
ef7b5599: raises $0.08 to $0.13
Hero: folds
97d67e86: folds
e95d0223: folds
e6aa09ff: folds
100d4f9e: folds
Uncalled bet ($0.08) returned to ef7b5599
*** SHOWDOWN ***
ef7b5599 collected $0.12 from pot
*** SUMMARY ***
Total pot $0.12 | Rake $0 | Jackpot $0 | Bingo $0 | Fortune $0 | Tax $0
Seat 1: e95d0223 (button) folded before Flop (didn't bet)
Seat 2: e6aa09ff (small blind) folded before Flop
Seat 3: 100d4f9e (big blind) folded before Flop
Seat 4: ef7b5599 collected ($0.12)
Seat 5: Hero folded before Flop (didn't bet)
Seat 6: 97d67e86 folded before Flop (didn't bet)


Poker Hand #RC3334560492: Hold'em No Limit ($0.02/$0.05) - 2025/02/17 21:25:57
Table 'RushAndCash625752' 6-max Seat #1 is the button
Seat 1: 94b22b92 ($7.57 in chips)
Seat 2: 2ffae4a2 ($13.04 in chips)
Seat 3: Hero ($6.19 in chips)
Seat 4: 8f3a3c0a ($14.13 in chips)
Seat 5: ef7b5599 ($34.34 in chips)
Seat 6: c8e72d1e ($4.95 in chips)
2ffae4a2: posts small blind $0.02
Hero: posts big blind $0.05
*** HOLE CARDS ***
Dealt to 94b22b92 
Dealt to 2ffae4a2 
Dealt to Hero [Kc 7s]
Dealt to 8f3a3c0a 
Dealt to ef7b5599 
Dealt to c8e72d1e 
8f3a3c0a: folds
ef7b5599: folds
c8e72d1e: folds
94b22b92: folds
2ffae4a2: folds
Uncalled bet ($0.03) returned to Hero
*** SHOWDOWN ***
Hero collected $0.04 from pot
*** SUMMARY ***
Total pot $0.04 | Rake $0 | Jackpot $0 | Bingo $0 | Fortune $0 | Tax $0
Seat 1: 94b22b92 (button) folded before Flop (didn't bet)
Seat 2: 2ffae4a2 (small blind) folded before Flop
Seat 3: Hero (big blind) collected ($0.04)
Seat 4: 8f3a3c0a folded before Flop (didn't bet)
Seat 5: ef7b5599 folded before Flop (didn't bet)
Seat 6: c8e72d1e folded before Flop (didn't bet)


Poker Hand #RC3334560205: Hold'em No Limit ($0.02/$0.05) - 2025/02/17 21:25:23
Table 'RushAndCash625465' 6-max Seat #1 is the button
Seat 1: 4b71998b ($10.78 in chips)
Seat 2: 304e7bcd ($4.72 in chips)
Seat 3: 7b9ea1f3 ($5 in chips)
Seat 4: cf7f09c2 ($16.98 in chips)
Seat 5: Hero ($5.73 in chips)
Seat 6: 75a97e80 ($5.13 in chips)
304e7bcd: posts small blind $0.02
7b9ea1f3: posts big blind $0.05
*** HOLE CARDS ***
Dealt to 4b71998b 
Dealt to 304e7bcd 
Dealt to 7b9ea1f3 
Dealt to cf7f09c2 
Dealt to Hero [Kc Qd]
Dealt to 75a97e80 
cf7f09c2: folds
Hero: raises $0.05 to $0.1
75a97e80: folds
4b71998b: folds
304e7bcd: folds
7b9ea1f3: calls $0.05
*** FLOP *** [9s 8c Jc]
7b9ea1f3: checks
Hero: bets $0.08
7b9ea1f3: calls $0.08
*** TURN *** [9s 8c Jc] [Tc]
7b9ea1f3: checks
Hero: bets $0.3
7b9ea1f3: calls $0.3
*** RIVER *** [9s 8c Jc Tc] [Jh]
7b9ea1f3: checks
Hero: checks
7b9ea1f3: shows [Ac 7h] (Jacks-High Straight)
Hero: shows [Kc Qd] (Kings-High Straight)
*** SHOWDOWN ***
Hero collected $0.94 from pot
*** SUMMARY ***
Total pot $0.98 | Rake $0.04 | Jackpot $0 | Bingo $0 | Fortune $0 | Tax $0
Board [9s 8c Jc Tc Jh]
Seat 1: 4b71998b (button) folded before Flop (didn't bet)
Seat 2: 304e7bcd (small blind) folded before Flop
Seat 3: 7b9ea1f3 (big blind) showed [Ac 7h] and lost with Jacks-High Straight
Seat 4: cf7f09c2 folded before Flop (didn't bet)
Seat 5: Hero showed [Kc Qd] and won ($0.94) with Kings-High Straight
Seat 6: 75a97e80 folded before Flop (didn't bet)


Poker Hand #RC3334560177: Hold'em No Limit ($0.02/$0.05) - 2025/02/17 21:25:20
Table 'RushAndCash625437' 6-max Seat #1 is the button
Seat 1: Hero ($5.73 in chips)
Seat 2: ac56502f ($4.88 in chips)
Seat 3: 2f650001 ($4.93 in chips)
Seat 4: 2d52b322 ($5.53 in chips)
Seat 5: 14d966a6 ($5 in chips)
Seat 6: b48f0b59 ($5.53 in chips)
ac56502f: posts small blind $0.02
2f650001: posts big blind $0.05
*** HOLE CARDS ***
Dealt to Hero [2c 4d]
Dealt to ac56502f 
Dealt to 2f650001 
Dealt to 2d52b322 
Dealt to 14d966a6 
Dealt to b48f0b59 
2d52b322: folds
14d966a6: raises $0.05 to $0.1
b48f0b59: folds
Hero: folds
ac56502f: calls $0.08
2f650001: folds
*** FLOP *** [8c 9c As]
ac56502f: checks
14d966a6: checks
*** TURN *** [8c 9c As] [Qd]
ac56502f: checks
14d966a6: checks
*** RIVER *** [8c 9c As Qd] [Th]
ac56502f: bets $0.14
14d966a6: raises $0.4 to $0.54
ac56502f: calls $0.4
14d966a6: shows [Kd Js] (Aces-High Straight)
ac56502f: shows [7h 6h] (Tens-High Straight)
*** SHOWDOWN ***
14d966a6 collected $1.27 from pot
*** SUMMARY ***
Total pot $1.33 | Rake $0.06 | Jackpot $0 | Bingo $0 | Fortune $0 | Tax $0
Board [8c 9c As Qd Th]
Seat 1: Hero (button) folded before Flop (didn't bet)
Seat 2: ac56502f (small blind) showed [7h 6h] and lost with Tens-High Straight
Seat 3: 2f650001 (big blind) folded before Flop
Seat 4: 2d52b322 folded before Flop (didn't bet)
Seat 5: 14d966a6 showed [Kd Js] and won ($1.27) with Aces-High Straight
Seat 6: b48f0b59 folded before Flop (didn't bet)


Poker Hand #RC3334560129: Hold'em No Limit ($0.02/$0.05) - 2025/02/17 21:25:14
Table 'RushAndCash625389' 6-max Seat #1 is the button
Seat 1: c7197736 ($8.75 in chips)
Seat 2: b74983a1 ($5.46 in chips)
Seat 3: d5f2b405 ($0.82 in chips)
Seat 4: 677c4b25 ($10.22 in chips)
Seat 5: 6be17d4e ($6 in chips)
Seat 6: Hero ($5.73 in chips)
b74983a1: posts small blind $0.02
d5f2b405: posts big blind $0.05
*** HOLE CARDS ***
Dealt to c7197736 
Dealt to b74983a1 
Dealt to d5f2b405 
Dealt to 677c4b25 
Dealt to 6be17d4e 
Dealt to Hero [9s Qh]
677c4b25: raises $0.06 to $0.11
6be17d4e: folds
Hero: folds
c7197736: folds
b74983a1: folds
d5f2b405: folds
Uncalled bet ($0.06) returned to 677c4b25
*** SHOWDOWN ***
677c4b25 collected $0.12 from pot
*** SUMMARY ***
Total pot $0.12 | Rake $0 | Jackpot $0 | Bingo $0 | Fortune $0 | Tax $0
Seat 1: c7197736 (button) folded before Flop (didn't bet)
Seat 2: b74983a1 (small blind) folded before Flop
Seat 3: d5f2b405 (big blind) folded before Flop
Seat 4: 677c4b25 collected ($0.12)
Seat 5: 6be17d4e folded before Flop (didn't bet)
Seat 6: Hero folded before Flop (didn't bet)


Poker Hand #RC3334559964: Hold'em No Limit ($0.02/$0.05) - 2025/02/17 21:24:54
Table 'RushAndCash625224' 6-max Seat #1 is the button
Seat 1: Hero ($5.83 in chips)
Seat 2: eed867f5 ($9.69 in chips)
Seat 3: 80c22e34 ($6.62 in chips)
Seat 4: dda0a24a ($6.01 in chips)
Seat 5: bd394772 ($6.41 in chips)
Seat 6: 6ab3ea38 ($5.07 in chips)
eed867f5: posts small blind $0.02
80c22e34: posts big blind $0.05
*** HOLE CARDS ***
Dealt to Hero [Kd 8d]
Dealt to eed867f5 
Dealt to 80c22e34 
Dealt to dda0a24a 
Dealt to bd394772 
Dealt to 6ab3ea38 
dda0a24a: folds
bd394772: folds
6ab3ea38: folds
Hero: raises $0.05 to $0.1
eed867f5: raises $0.35 to $0.45
80c22e34: folds
Hero: folds
Uncalled bet ($0.35) returned to eed867f5
*** SHOWDOWN ***
eed867f5 collected $0.24 from pot
*** SUMMARY ***
Total pot $0.25 | Rake $0.01 | Jackpot $0 | Bingo $0 | Fortune $0 | Tax $0
Seat 1: Hero (button) folded before Flop
Seat 2: eed867f5 (small blind) collected ($0.24)
Seat 3: 80c22e34 (big blind) folded before Flop
Seat 4: dda0a24a folded before Flop (didn't bet)
Seat 5: bd394772 folded before Flop (didn't bet)
Seat 6: 6ab3ea38 folded before Flop (didn't bet)


Poker Hand #RC3334559941: Hold'em No Limit ($0.02/$0.05) - 2025/02/17 21:24:51
Table 'RushAndCash625201' 6-max Seat #1 is the button
Seat 1: 419eb9fb ($4.93 in chips)
Seat 2: ee3fdfd8 ($5.02 in chips)
Seat 3: a291e856 ($5.35 in chips)
Seat 4: 54a16a21 ($5.17 in chips)
Seat 5: d5150c28 ($12.53 in chips)
Seat 6: Hero ($5.83 in chips)
ee3fdfd8: posts small blind $0.02
a291e856: posts big blind $0.05
*** HOLE CARDS ***
Dealt to 419eb9fb 
Dealt to ee3fdfd8 
Dealt to a291e856 
Dealt to 54a16a21 
Dealt to d5150c28 
Dealt to Hero [7s 8d]
54a16a21: folds
d5150c28: folds
Hero: folds
419eb9fb: folds
ee3fdfd8: folds
Uncalled bet ($0.03) returned to a291e856
*** SHOWDOWN ***
a291e856 collected $0.04 from pot
*** SUMMARY ***
Total pot $0.04 | Rake $0 | Jackpot $0 | Bingo $0 | Fortune $0 | Tax $0
Seat 1: 419eb9fb (button) folded before Flop (didn't bet)
Seat 2: ee3fdfd8 (small blind) folded before Flop
Seat 3: a291e856 (big blind) collected ($0.04)
Seat 4: 54a16a21 folded before Flop (didn't bet)
Seat 5: d5150c28 folded before Flop (didn't bet)
Seat 6: Hero folded before Flop (didn't bet)


Poker Hand #RC3334559909: Hold'em No Limit ($0.02/$0.05) - 2025/02/17 21:24:47
Table 'RushAndCash625169' 6-max Seat #1 is the button
Seat 1: fd5b33a8 ($5.43 in chips)
Seat 2: 34028f01 ($6.47 in chips)
Seat 3: 71e00d83 ($13.6 in chips)
Seat 4: 266a98da ($1.69 in chips)
Seat 5: 94b22b92 ($7.75 in chips)
Seat 6: Hero ($5.83 in chips)
34028f01: posts small blind $0.02
71e00d83: posts big blind $0.05
*** HOLE CARDS ***
Dealt to fd5b33a8 
Dealt to 34028f01 
Dealt to 71e00d83 
Dealt to 266a98da 
Dealt to 94b22b92 
Dealt to Hero [Qs 7c]
266a98da: folds
94b22b92: raises $0.05 to $0.1
Hero: folds
fd5b33a8: folds
34028f01: folds
71e00d83: calls $0.05
*** FLOP *** [6h Kd 8h]
71e00d83: checks
94b22b92: checks
*** TURN *** [6h Kd 8h] [Jh]
71e00d83: bets $0.22
94b22b92: calls $0.22
*** RIVER *** [6h Kd 8h Jh] [6c]
71e00d83: bets $0.33
94b22b92: folds
Uncalled bet ($0.33) returned to 71e00d83
*** SHOWDOWN ***
71e00d83 collected $0.63 from pot
*** SUMMARY ***
Total pot $0.66 | Rake $0.03 | Jackpot $0 | Bingo $0 | Fortune $0 | Tax $0
Board [6h Kd 8h Jh 6c]
Seat 1: fd5b33a8 (button) folded before Flop (didn't bet)
Seat 2: 34028f01 (small blind) folded before Flop
Seat 3: 71e00d83 (big blind) won ($0.63)
Seat 4: 266a98da folded before Flop (didn't bet)
Seat 5: 94b22b92 folded on the River
Seat 6: Hero folded before Flop (didn't bet)


Poker Hand #RC3334559882: Hold'em No Limit ($0.02/$0.05) - 2025/02/17 21:24:44
Table 'RushAndCash625142' 6-max Seat #1 is the button
Seat 1: af90d8d7 ($4.93 in chips)
Seat 2: 4e3c3196 ($30.53 in chips)
Seat 3: 6008538 ($3.67 in chips)
Seat 4: d32546a5 ($6.24 in chips)
Seat 5: e0d14e10 ($4.93 in chips)
Seat 6: Hero ($5.83 in chips)
4e3c3196: posts small blind $0.02
6008538: posts big blind $0.05
*** HOLE CARDS ***
Dealt to af90d8d7 
Dealt to 4e3c3196 
Dealt to 6008538 
Dealt to d32546a5 
Dealt to e0d14e10 
Dealt to Hero [5h 7s]
d32546a5: raises $0.05 to $0.1
e0d14e10: folds
Hero: folds
af90d8d7: folds
4e3c3196: folds
6008538: folds
Uncalled bet ($0.05) returned to d32546a5
*** SHOWDOWN ***
d32546a5 collected $0.12 from pot
*** SUMMARY ***
Total pot $0.12 | Rake $0 | Jackpot $0 | Bingo $0 | Fortune $0 | Tax $0
Seat 1: af90d8d7 (button) folded before Flop (didn't bet)
Seat 2: 4e3c3196 (small blind) folded before Flop
Seat 3: 6008538 (big blind) folded before Flop
Seat 4: d32546a5 collected ($0.12)
Seat 5: e0d14e10 folded before Flop (didn't bet)
Seat 6: Hero folded before Flop (didn't bet)


Poker Hand #RC3334559838: Hold'em No Limit ($0.02/$0.05) - 2025/02/17 21:24:38
Table 'RushAndCash625098' 6-max Seat #1 is the button
Seat 1: 4afebef ($5 in chips)
Seat 2: 8c6d38f2 ($8.17 in chips)
Seat 3: 5b79005a ($6 in chips)
Seat 4: Hero ($5.83 in chips)
Seat 5: 6ac4af54 ($13.25 in chips)
Seat 6: ec3424f5 ($5.25 in chips)
8c6d38f2: posts small blind $0.02
5b79005a: posts big blind $0.05
*** HOLE CARDS ***
Dealt to 4afebef 
Dealt to 8c6d38f2 
Dealt to 5b79005a 
Dealt to Hero [3h Ks]
Dealt to 6ac4af54 
Dealt to ec3424f5 
Hero: folds
6ac4af54: raises $0.05 to $0.1
ec3424f5: folds
4afebef: folds
8c6d38f2: folds
5b79005a: folds
Uncalled bet ($0.05) returned to 6ac4af54
*** SHOWDOWN ***
6ac4af54 collected $0.12 from pot
*** SUMMARY ***
Total pot $0.12 | Rake $0 | Jackpot $0 | Bingo $0 | Fortune $0 | Tax $0
Seat 1: 4afebef (button) folded before Flop (didn't bet)
Seat 2: 8c6d38f2 (small blind) folded before Flop
Seat 3: 5b79005a (big blind) folded before Flop
Seat 4: Hero folded before Flop (didn't bet)
Seat 5: 6ac4af54 collected ($0.12)
Seat 6: ec3424f5 folded before Flop (didn't bet)


Poker Hand #RC3334559811: Hold'em No Limit ($0.02/$0.05) - 2025/02/17 21:24:34
Table 'RushAndCash625071' 6-max Seat #1 is the button
Seat 1: 40bb6be1 ($5.36 in chips)
Seat 2: Hero ($5.78 in chips)
Seat 3: 473117d5 ($5 in chips)
Seat 4: 6ab3ea38 ($5 in chips)
Seat 5: c35cd20e ($5 in chips)
Seat 6: 4b3dba4 ($7.19 in chips)
Hero: posts small blind $0.02
473117d5: posts big blind $0.05
*** HOLE CARDS ***
Dealt to 40bb6be1 
Dealt to Hero [Tc Jd]
Dealt to 473117d5 
Dealt to 6ab3ea38 
Dealt to c35cd20e 
Dealt to 4b3dba4 
6ab3ea38: raises $0.06 to $0.11
c35cd20e: folds
4b3dba4: folds
40bb6be1: folds
Hero: folds
473117d5: folds
Uncalled bet ($0.06) returned to 6ab3ea38
*** SHOWDOWN ***
6ab3ea38 collected $0.12 from pot
*** SUMMARY ***
Total pot $0.12 | Rake $0 | Jackpot $0 | Bingo $0 | Fortune $0 | Tax $0
Seat 1: 40bb6be1 (button) folded before Flop (didn't bet)
Seat 2: Hero (small blind) folded before Flop
Seat 3: 473117d5 (big blind) folded before Flop
Seat 4: 6ab3ea38 collected ($0.12)
Seat 5: c35cd20e folded before Flop (didn't bet)
Seat 6: 4b3dba4 folded before Flop (didn't bet)


Poker Hand #RC3334559755: Hold'em No Limit ($0.02/$0.05) - 2025/02/17 21:24:27
Table 'RushAndCash625015' 6-max Seat #1 is the button
Seat 1: ecdacd2c ($5.67 in chips)
Seat 2: 5947e28d ($5.06 in chips)
Seat 3: Hero ($5.83 in chips)
Seat 4: 5c980949 ($6.4 in chips)
Seat 5: 866d801a ($5 in chips)
Seat 6: c6e11d19 ($5.05 in chips)
5947e28d: posts small blind $0.02
Hero: posts big blind $0.05
*** HOLE CARDS ***
Dealt to ecdacd2c 
Dealt to 5947e28d 
Dealt to Hero [7h Qs]
Dealt to 5c980949 
Dealt to 866d801a 
Dealt to c6e11d19 
5c980949: folds
866d801a: folds
c6e11d19: folds
ecdacd2c: folds
5947e28d: folds
Uncalled bet ($0.03) returned to Hero
*** SHOWDOWN ***
Hero collected $0.04 from pot
*** SUMMARY ***
Total pot $0.04 | Rake $0 | Jackpot $0 | Bingo $0 | Fortune $0 | Tax $0
Seat 1: ecdacd2c (button) folded before Flop (didn't bet)
Seat 2: 5947e28d (small blind) folded before Flop
Seat 3: Hero (big blind) collected ($0.04)
Seat 4: 5c980949 folded before Flop (didn't bet)
Seat 5: 866d801a folded before Flop (didn't bet)
Seat 6: c6e11d19 folded before Flop (didn't bet)


Poker Hand #RC3334558862: Hold'em No Limit ($0.02/$0.05) - 2025/02/17 21:22:33
Table 'RushAndCash624122' 6-max Seat #1 is the button
Seat 1: e201451e ($5.89 in chips)
Seat 2: a9d8ced4 ($5 in chips)
Seat 3: d916afa1 ($22.34 in chips)
Seat 4: 945593bf ($17.24 in chips)
Seat 5: a375b232 ($5.57 in chips)
Seat 6: Hero ($5.83 in chips)
a9d8ced4: posts small blind $0.02
d916afa1: posts big blind $0.05
*** HOLE CARDS ***
Dealt to e201451e 
Dealt to a9d8ced4 
Dealt to d916afa1 
Dealt to 945593bf 
Dealt to a375b232 
Dealt to Hero [6d Ad]
945593bf: folds
a375b232: folds
Hero: folds
e201451e: folds
a9d8ced4: folds
Uncalled bet ($0.03) returned to d916afa1
*** SHOWDOWN ***
d916afa1 collected $0.04 from pot
*** SUMMARY ***
Total pot $0.04 | Rake $0 | Jackpot $0 | Bingo $0 | Fortune $0 | Tax $0
Seat 1: e201451e (button) folded before Flop (didn't bet)
Seat 2: a9d8ced4 (small blind) folded before Flop
Seat 3: d916afa1 (big blind) collected ($0.04)
Seat 4: 945593bf folded before Flop (didn't bet)
Seat 5: a375b232 folded before Flop (didn't bet)
Seat 6: Hero folded before Flop (didn't bet)


Poker Hand #RC3334558836: Hold'em No Limit ($0.02/$0.05) - 2025/02/17 21:22:30
Table 'RushAndCash624096' 6-max Seat #1 is the button
Seat 1: c3c40ffa ($5.57 in chips)
Seat 2: Hero ($5.85 in chips)
Seat 3: 8ab2eae7 ($5.91 in chips)
Seat 4: 598d859f ($15.22 in chips)
Seat 5: d278c831 ($6.86 in chips)
Seat 6: d58b99ca ($31.35 in chips)
Hero: posts small blind $0.02
8ab2eae7: posts big blind $0.05
*** HOLE CARDS ***
Dealt to c3c40ffa 
Dealt to Hero [9c Kd]
Dealt to 8ab2eae7 
Dealt to 598d859f 
Dealt to d278c831 
Dealt to d58b99ca 
598d859f: folds
d278c831: folds
d58b99ca: folds
c3c40ffa: folds
Hero: folds
Uncalled bet ($0.03) returned to 8ab2eae7
*** SHOWDOWN ***
8ab2eae7 collected $0.04 from pot
*** SUMMARY ***
Total pot $0.04 | Rake $0 | Jackpot $0 | Bingo $0 | Fortune $0 | Tax $0
Seat 1: c3c40ffa (button) folded before Flop (didn't bet)
Seat 2: Hero (small blind) folded before Flop
Seat 3: 8ab2eae7 (big blind) collected ($0.04)
Seat 4: 598d859f folded before Flop (didn't bet)
Seat 5: d278c831 folded before Flop (didn't bet)
Seat 6: d58b99ca folded before Flop (didn't bet)


Poker Hand #RC3334558812: Hold'em No Limit ($0.02/$0.05) - 2025/02/17 21:22:26
Table 'RushAndCash624072' 6-max Seat #1 is the button
Seat 1: b0ee20aa ($21.95 in chips)
Seat 2: a39b5beb ($5.04 in chips)
Seat 3: 5a5583b4 ($6.28 in chips)
Seat 4: 4e5ae3cb ($6.46 in chips)
Seat 5: Hero ($5.85 in chips)
Seat 6: cd53b3fd ($5.17 in chips)
a39b5beb: posts small blind $0.02
5a5583b4: posts big blind $0.05
*** HOLE CARDS ***
Dealt to b0ee20aa 
Dealt to a39b5beb 
Dealt to 5a5583b4 
Dealt to 4e5ae3cb 
Dealt to Hero [7d 8h]
Dealt to cd53b3fd 
4e5ae3cb: folds
Hero: folds
cd53b3fd: folds
b0ee20aa: folds
a39b5beb: folds
Uncalled bet ($0.03) returned to 5a5583b4
*** SHOWDOWN ***
5a5583b4 collected $0.04 from pot
*** SUMMARY ***
Total pot $0.04 | Rake $0 | Jackpot $0 | Bingo $0 | Fortune $0 | Tax $0
Seat 1: b0ee20aa (button) folded before Flop (didn't bet)
Seat 2: a39b5beb (small blind) folded before Flop
Seat 3: 5a5583b4 (big blind) collected ($0.04)
Seat 4: 4e5ae3cb folded before Flop (didn't bet)
Seat 5: Hero folded before Flop (didn't bet)
Seat 6: cd53b3fd folded before Flop (didn't bet)


Poker Hand #RC3334558786: Hold'em No Limit ($0.02/$0.05) - 2025/02/17 21:22:23
Table 'RushAndCash624046' 6-max Seat #1 is the button
Seat 1: c806dd25 ($12.73 in chips)
Seat 2: 3b85f8e6 ($14.79 in chips)
Seat 3: de38466f ($1.27 in chips)
Seat 4: Hero ($5.85 in chips)
Seat 5: b4c33f6c ($6.16 in chips)
Seat 6: 1095926a ($6.86 in chips)
3b85f8e6: posts small blind $0.02
de38466f: posts big blind $0.05
*** HOLE CARDS ***
Dealt to c806dd25 
Dealt to 3b85f8e6 
Dealt to de38466f 
Dealt to Hero [8s 7c]
Dealt to b4c33f6c 
Dealt to 1095926a 
Hero: folds
b4c33f6c: folds
1095926a: raises $0.08 to $0.13
c806dd25: folds
3b85f8e6: folds
de38466f: folds
Uncalled bet ($0.08) returned to 1095926a
*** SHOWDOWN ***
1095926a collected $0.12 from pot
*** SUMMARY ***
Total pot $0.12 | Rake $0 | Jackpot $0 | Bingo $0 | Fortune $0 | Tax $0
Seat 1: c806dd25 (button) folded before Flop (didn't bet)
Seat 2: 3b85f8e6 (small blind) folded before Flop
Seat 3: de38466f (big blind) folded before Flop
Seat 4: Hero folded before Flop (didn't bet)
Seat 5: b4c33f6c folded before Flop (didn't bet)
Seat 6: 1095926a collected ($0.12)


Poker Hand #RC3334558674: Hold'em No Limit ($0.02/$0.05) - 2025/02/17 21:22:09
Table 'RushAndCash623934' 6-max Seat #1 is the button
Seat 1: cda83b9b ($6.76 in chips)
Seat 2: 266a98da ($1.8 in chips)
Seat 3: Hero ($5.9 in chips)
Seat 4: 76135c78 ($12 in chips)
Seat 5: 14d03752 ($7.64 in chips)
Seat 6: f51515ac ($5.43 in chips)
266a98da: posts small blind $0.02
Hero: posts big blind $0.05
*** HOLE CARDS ***
Dealt to cda83b9b 
Dealt to 266a98da 
Dealt to Hero [Ks 9s]
Dealt to 76135c78 
Dealt to 14d03752 
Dealt to f51515ac 
76135c78: folds
14d03752: folds
f51515ac: raises $0.05 to $0.1
cda83b9b: folds
266a98da: raises $0.25 to $0.35
Hero: folds
f51515ac: calls $0.25
*** FLOP *** [4s 7c Js]
266a98da: bets $0.38
f51515ac: folds
Uncalled bet ($0.38) returned to 266a98da
*** SHOWDOWN ***
266a98da collected $0.72 from pot
*** SUMMARY ***
Total pot $0.75 | Rake $0.03 | Jackpot $0 | Bingo $0 | Fortune $0 | Tax $0
Board [4s 7c Js]
Seat 1: cda83b9b (button) folded before Flop (didn't bet)
Seat 2: 266a98da (small blind) won ($0.72)
Seat 3: Hero (big blind) folded before Flop
Seat 4: 76135c78 folded before Flop (didn't bet)
Seat 5: 14d03752 folded before Flop (didn't bet)
Seat 6: f51515ac folded on the Flop


Poker Hand #RC3334558647: Hold'em No Limit ($0.02/$0.05) - 2025/02/17 21:22:06
Table 'RushAndCash623907' 6-max Seat #1 is the button
Seat 1: Hero ($5.9 in chips)
Seat 2: a28ca95c ($32.26 in chips)
Seat 3: 65900825 ($5.07 in chips)
Seat 4: 9f76b15b ($1.85 in chips)
Seat 5: 8974621f ($4.4 in chips)
Seat 6: 375be35a ($5 in chips)
a28ca95c: posts small blind $0.02
65900825: posts big blind $0.05
*** HOLE CARDS ***
Dealt to Hero [Tc 3d]
Dealt to a28ca95c 
Dealt to 65900825 
Dealt to 9f76b15b 
Dealt to 8974621f 
Dealt to 375be35a 
9f76b15b: folds
8974621f: raises $0.08 to $0.13
375be35a: folds
Hero: folds
a28ca95c: folds
65900825: calls $0.08
*** FLOP *** [4s 6h 8h]
65900825: checks
8974621f: checks
*** TURN *** [4s 6h 8h] [4h]
65900825: checks
8974621f: checks
*** RIVER *** [4s 6h 8h 4h] [Ah]
65900825: checks
8974621f: checks
65900825: shows [Ac 9s] (Pair of Aces and Pair of Fours)
8974621f: shows [As Js] (Pair of Aces and Pair of Fours)
*** SHOWDOWN ***
8974621f collected $0.27 from pot
*** SUMMARY ***
Total pot $0.28 | Rake $0.01 | Jackpot $0 | Bingo $0 | Fortune $0 | Tax $0
Board [4s 6h 8h 4h Ah]
Seat 1: Hero (button) folded before Flop (didn't bet)
Seat 2: a28ca95c (small blind) folded before Flop
Seat 3: 65900825 (big blind) showed [Ac 9s] and lost with Pair of Aces and Pair of Fours
Seat 4: 9f76b15b folded before Flop (didn't bet)
Seat 5: 8974621f showed [As Js] and won ($0.27) with Pair of Aces and Pair of Fours
Seat 6: 375be35a folded before Flop (didn't bet)


Poker Hand #RC3334558606: Hold'em No Limit ($0.02/$0.05) - 2025/02/17 21:22:01
Table 'RushAndCash623866' 6-max Seat #1 is the button
Seat 1: 7615146e ($5.26 in chips)
Seat 2: Hero ($5.92 in chips)
Seat 3: 981b7542 ($5 in chips)
Seat 4: 8e07c53 ($5.95 in chips)
Seat 5: 39bc2366 ($5.53 in chips)
Seat 6: ea7a7ae0 ($7.21 in chips)
Hero: posts small blind $0.02
981b7542: posts big blind $0.05
*** HOLE CARDS ***
Dealt to 7615146e 
Dealt to Hero [8d Qc]
Dealt to 981b7542 
Dealt to 8e07c53 
Dealt to 39bc2366 
Dealt to ea7a7ae0 
8e07c53: folds
39bc2366: raises $0.08 to $0.13
ea7a7ae0: folds
7615146e: folds
Hero: folds
981b7542: calls $0.08
*** FLOP *** [4h 3h Ks]
981b7542: checks
39bc2366: bets $0.1
981b7542: folds
Uncalled bet ($0.1) returned to 39bc2366
*** SHOWDOWN ***
39bc2366 collected $0.27 from pot
*** SUMMARY ***
Total pot $0.28 | Rake $0.01 | Jackpot $0 | Bingo $0 | Fortune $0 | Tax $0
Board [4h 3h Ks]
Seat 1: 7615146e (button) folded before Flop (didn't bet)
Seat 2: Hero (small blind) folded before Flop
Seat 3: 981b7542 (big blind) folded on the Flop
Seat 4: 8e07c53 folded before Flop (didn't bet)
Seat 5: 39bc2366 won ($0.27)
Seat 6: ea7a7ae0 folded before Flop (didn't bet)


Poker Hand #RC3334558582: Hold'em No Limit ($0.02/$0.05) - 2025/02/17 21:21:58
Table 'RushAndCash623842' 6-max Seat #1 is the button
Seat 1: Hero ($5.92 in chips)
Seat 2: 5e3616df ($5.14 in chips)
Seat 3: bacb67c8 ($7.6 in chips)
Seat 4: b1dc2d97 ($5.62 in chips)
Seat 5: 9f9e1094 ($5.46 in chips)
Seat 6: 36443158 ($4.95 in chips)
5e3616df: posts small blind $0.02
bacb67c8: posts big blind $0.05
*** HOLE CARDS ***
Dealt to Hero [6c 9d]
Dealt to 5e3616df 
Dealt to bacb67c8 
Dealt to b1dc2d97 
Dealt to 9f9e1094 
Dealt to 36443158 
b1dc2d97: folds
9f9e1094: folds
36443158: folds
Hero: folds
5e3616df: raises $0.06 to $0.11
bacb67c8: folds
Uncalled bet ($0.06) returned to 5e3616df
*** SHOWDOWN ***
5e3616df collected $0.1 from pot
*** SUMMARY ***
Total pot $0.1 | Rake $0 | Jackpot $0 | Bingo $0 | Fortune $0 | Tax $0
Seat 1: Hero (button) folded before Flop (didn't bet)
Seat 2: 5e3616df (small blind) collected ($0.1)
Seat 3: bacb67c8 (big blind) folded before Flop
Seat 4: b1dc2d97 folded before Flop (didn't bet)
Seat 5: 9f9e1094 folded before Flop (didn't bet)
Seat 6: 36443158 folded before Flop (didn't bet)


Poker Hand #RC3334558215: Hold'em No Limit ($0.02/$0.05) - 2025/02/17 21:21:14
Table 'RushAndCash623475' 6-max Seat #1 is the button
Seat 1: 94cb065d ($6.43 in chips)
Seat 2: 7fc44808 ($11.29 in chips)
Seat 3: 8b7080d0 ($5.43 in chips)
Seat 4: Hero ($6.25 in chips)
Seat 5: 92fa3d91 ($5.34 in chips)
Seat 6: 93a9dba6 ($5 in chips)
7fc44808: posts small blind $0.02
8b7080d0: posts big blind $0.05
*** HOLE CARDS ***
Dealt to 94cb065d 
Dealt to 7fc44808 
Dealt to 8b7080d0 
Dealt to Hero [9h 9d]
Dealt to 92fa3d91 
Dealt to 93a9dba6 
Hero: raises $0.05 to $0.1
92fa3d91: raises $0.23 to $0.33
93a9dba6: folds
94cb065d: calls $0.33
7fc44808: folds
8b7080d0: folds
Hero: calls $0.23
*** FLOP *** [6s Jd 3c]
Hero: checks
92fa3d91: checks
94cb065d: bets $0.53
Hero: folds
92fa3d91: folds
Uncalled bet ($0.53) returned to 94cb065d
*** SHOWDOWN ***
94cb065d collected $1.01 from pot
*** SUMMARY ***
Total pot $1.06 | Rake $0.05 | Jackpot $0 | Bingo $0 | Fortune $0 | Tax $0
Board [6s Jd 3c]
Seat 1: 94cb065d (button) won ($1.01)
Seat 2: 7fc44808 (small blind) folded before Flop
Seat 3: 8b7080d0 (big blind) folded before Flop
Seat 4: Hero folded on the Flop
Seat 5: 92fa3d91 folded on the Flop
Seat 6: 93a9dba6 folded before Flop (didn't bet)


Poker Hand #RC3334558100: Hold'em No Limit ($0.02/$0.05) - 2025/02/17 21:20:58
Table 'RushAndCash623360' 6-max Seat #1 is the button
Seat 1: cbfd6c92 ($10 in chips)
Seat 2: Hero ($6.27 in chips)
Seat 3: 692e3a83 ($9.1 in chips)
Seat 4: c7e9103c ($12.26 in chips)
Seat 5: 7aca7e93 ($5.71 in chips)
Seat 6: 3bfcd529 ($5.28 in chips)
Hero: posts small blind $0.02
692e3a83: posts big blind $0.05
*** HOLE CARDS ***
Dealt to cbfd6c92 
Dealt to Hero [8c Jc]
Dealt to 692e3a83 
Dealt to c7e9103c 
Dealt to 7aca7e93 
Dealt to 3bfcd529 
c7e9103c: folds
7aca7e93: folds
3bfcd529: raises $0.05 to $0.1
cbfd6c92: raises $0.21 to $0.31
Hero: folds
692e3a83: folds
3bfcd529: folds
Uncalled bet ($0.21) returned to cbfd6c92
*** SHOWDOWN ***
cbfd6c92 collected $0.26 from pot
*** SUMMARY ***
Total pot $0.27 | Rake $0.01 | Jackpot $0 | Bingo $0 | Fortune $0 | Tax $0
Seat 1: cbfd6c92 (button) collected ($0.26)
Seat 2: Hero (small blind) folded before Flop
Seat 3: 692e3a83 (big blind) folded before Flop
Seat 4: c7e9103c folded before Flop (didn't bet)
Seat 5: 7aca7e93 folded before Flop (didn't bet)
Seat 6: 3bfcd529 folded before Flop


Poker Hand #RC3334558074: Hold'em No Limit ($0.02/$0.05) - 2025/02/17 21:20:55
Table 'RushAndCash623334' 6-max Seat #1 is the button
Seat 1: Hero ($6.2 in chips)
Seat 2: 717e9861 ($9.41 in chips)
Seat 3: ab08c5da ($3.41 in chips)
Seat 4: 95096c6a ($5.49 in chips)
Seat 5: 2b8b2921 ($9.47 in chips)
Seat 6: aa08a1c ($5.04 in chips)
717e9861: posts small blind $0.02
ab08c5da: posts big blind $0.05
*** HOLE CARDS ***
Dealt to Hero [5h 7c]
Dealt to 717e9861 
Dealt to ab08c5da 
Dealt to 95096c6a 
Dealt to 2b8b2921 
Dealt to aa08a1c 
95096c6a: folds
2b8b2921: folds
aa08a1c: folds
Hero: folds
717e9861: raises $0.05 to $0.1
ab08c5da: folds
Uncalled bet ($0.05) returned to 717e9861
*** SHOWDOWN ***
717e9861 collected $0.1 from pot
*** SUMMARY ***
Total pot $0.1 | Rake $0 | Jackpot $0 | Bingo $0 | Fortune $0 | Tax $0
Seat 1: Hero (button) folded before Flop (didn't bet)
Seat 2: 717e9861 (small blind) collected ($0.1)
Seat 3: ab08c5da (big blind) folded before Flop
Seat 4: 95096c6a folded before Flop (didn't bet)
Seat 5: 2b8b2921 folded before Flop (didn't bet)
Seat 6: aa08a1c folded before Flop (didn't bet)


Poker Hand #RC3334558049: Hold'em No Limit ($0.02/$0.05) - 2025/02/17 21:20:52
Table 'RushAndCash623309' 6-max Seat #1 is the button
Seat 1: aa08a1c ($5.04 in chips)
Seat 2: a7365f1c ($6.79 in chips)
Seat 3: b02447b8 ($5 in chips)
Seat 4: a2123cbe ($9.85 in chips)
Seat 5: Hero ($6.2 in chips)
Seat 6: 8ec32764 ($5.54 in chips)
a7365f1c: posts small blind $0.02
b02447b8: posts big blind $0.05
*** HOLE CARDS ***
Dealt to aa08a1c 
Dealt to a7365f1c 
Dealt to b02447b8 
Dealt to a2123cbe 
Dealt to Hero [4h 2s]
Dealt to 8ec32764 
a2123cbe: folds
Hero: folds
8ec32764: raises $0.07 to $0.12
aa08a1c: folds
a7365f1c: folds
b02447b8: calls $0.07
*** FLOP *** [7d Kh Qs]
b02447b8: checks
8ec32764: bets $0.08
b02447b8: calls $0.08
*** TURN *** [7d Kh Qs] [2h]
b02447b8: checks
8ec32764: checks
*** RIVER *** [7d Kh Qs 2h] [Ks]
b02447b8: checks
8ec32764: checks
b02447b8: shows [Ts Js] (Pair of Kings)
8ec32764: shows [Jd Qd] (Pair of Kings and Pair of Queens)
*** SHOWDOWN ***
8ec32764 collected $0.4 from pot
*** SUMMARY ***
Total pot $0.42 | Rake $0.02 | Jackpot $0 | Bingo $0 | Fortune $0 | Tax $0
Board [7d Kh Qs 2h Ks]
Seat 1: aa08a1c (button) folded before Flop (didn't bet)
Seat 2: a7365f1c (small blind) folded before Flop
Seat 3: b02447b8 (big blind) showed [Ts Js] and lost with Pair of Kings
Seat 4: a2123cbe folded before Flop (didn't bet)
Seat 5: Hero folded before Flop (didn't bet)
Seat 6: 8ec32764 showed [Jd Qd] and won ($0.4) with Pair of Kings and Pair of Queens


Poker Hand #RC3334558028: Hold'em No Limit ($0.02/$0.05) - 2025/02/17 21:20:48
Table 'RushAndCash623288' 6-max Seat #1 is the button
Seat 1: 926bb191 ($5.42 in chips)
Seat 2: 8023de0f ($8.61 in chips)
Seat 3: 34028f01 ($6.72 in chips)
Seat 4: Hero ($6.2 in chips)
Seat 5: 6d5fa70b ($5.08 in chips)
Seat 6: 860b5247 ($11.09 in chips)
8023de0f: posts small blind $0.02
34028f01: posts big blind $0.05
*** HOLE CARDS ***
Dealt to 926bb191 
Dealt to 8023de0f 
Dealt to 34028f01 
Dealt to Hero [3h 9d]
Dealt to 6d5fa70b 
Dealt to 860b5247 
Hero: folds
6d5fa70b: folds
860b5247: folds
926bb191: folds
8023de0f: raises $0.05 to $0.1
34028f01: calls $0.05
*** FLOP *** [6c 3d 2d]
8023de0f: bets $0.16
34028f01: raises $0.23 to $0.39
8023de0f: raises $0.46 to $0.85
34028f01: folds
Uncalled bet ($0.46) returned to 8023de0f
*** SHOWDOWN ***
8023de0f collected $0.94 from pot
*** SUMMARY ***
Total pot $0.98 | Rake $0.04 | Jackpot $0 | Bingo $0 | Fortune $0 | Tax $0
Board [6c 3d 2d]
Seat 1: 926bb191 (button) folded before Flop (didn't bet)
Seat 2: 8023de0f (small blind) won ($0.94)
Seat 3: 34028f01 (big blind) folded on the Flop
Seat 4: Hero folded before Flop (didn't bet)
Seat 5: 6d5fa70b folded before Flop (didn't bet)
Seat 6: 860b5247 folded before Flop (didn't bet)


Poker Hand #RC3334558001: Hold'em No Limit ($0.02/$0.05) - 2025/02/17 21:20:45
Table 'RushAndCash623261' 6-max Seat #1 is the button
Seat 1: 3b85f8e6 ($14.54 in chips)
Seat 2: 266a98da ($1.56 in chips)
Seat 3: Hero ($6.25 in chips)
Seat 4: b59fc0b9 ($5.07 in chips)
Seat 5: b3aefb75 ($10.3 in chips)
Seat 6: 19259657 ($6.09 in chips)
266a98da: posts small blind $0.02
Hero: posts big blind $0.05
*** HOLE CARDS ***
Dealt to 3b85f8e6 
Dealt to 266a98da 
Dealt to Hero [Td 4h]
Dealt to b59fc0b9 
Dealt to b3aefb75 
Dealt to 19259657 
b59fc0b9: folds
b3aefb75: folds
19259657: folds
3b85f8e6: folds
266a98da: folds
Uncalled bet ($0.03) returned to Hero
*** SHOWDOWN ***
Hero collected $0.04 from pot
*** SUMMARY ***
Total pot $0.04 | Rake $0 | Jackpot $0 | Bingo $0 | Fortune $0 | Tax $0
Seat 1: 3b85f8e6 (button) folded before Flop (didn't bet)
Seat 2: 266a98da (small blind) folded before Flop
Seat 3: Hero (big blind) collected ($0.04)
Seat 4: b59fc0b9 folded before Flop (didn't bet)
Seat 5: b3aefb75 folded before Flop (didn't bet)
Seat 6: 19259657 folded before Flop (didn't bet)


Poker Hand #RC3334557971: Hold'em No Limit ($0.02/$0.05) - 2025/02/17 21:20:41
Table 'RushAndCash623231' 6-max Seat #1 is the button
Seat 1: e644e026 ($6.09 in chips)
Seat 2: 66be2112 ($5.02 in chips)
Seat 3: 83ea4f15 ($4.19 in chips)
Seat 4: Hero ($6.25 in chips)
Seat 5: 23258e5f ($4.88 in chips)
Seat 6: 53a8c2fd ($10.98 in chips)
66be2112: posts small blind $0.02
83ea4f15: posts big blind $0.05
*** HOLE CARDS ***
Dealt to e644e026 
Dealt to 66be2112 
Dealt to 83ea4f15 
Dealt to Hero [9h 5s]
Dealt to 23258e5f 
Dealt to 53a8c2fd 
Hero: folds
23258e5f: folds
53a8c2fd: folds
e644e026: folds
66be2112: folds
Uncalled bet ($0.03) returned to 83ea4f15
*** SHOWDOWN ***
83ea4f15 collected $0.04 from pot
*** SUMMARY ***
Total pot $0.04 | Rake $0 | Jackpot $0 | Bingo $0 | Fortune $0 | Tax $0
Seat 1: e644e026 (button) folded before Flop (didn't bet)
Seat 2: 66be2112 (small blind) folded before Flop
Seat 3: 83ea4f15 (big blind) collected ($0.04)
Seat 4: Hero folded before Flop (didn't bet)
Seat 5: 23258e5f folded before Flop (didn't bet)
Seat 6: 53a8c2fd folded before Flop (didn't bet)


Poker Hand #RC3334557498: Hold'em No Limit ($0.02/$0.05) - 2025/02/17 21:19:42
Table 'RushAndCash622758' 6-max Seat #1 is the button
Seat 1: 57a66aa7 ($5.33 in chips)
Seat 2: c3883bcf ($5 in chips)
Seat 3: Hero ($6.3 in chips)
Seat 4: 8e07c53 ($5 in chips)
Seat 5: 95e89c51 ($5.07 in chips)
Seat 6: ed18a71b ($5 in chips)
c3883bcf: posts small blind $0.02
Hero: posts big blind $0.05
*** HOLE CARDS ***
Dealt to 57a66aa7 
Dealt to c3883bcf 
Dealt to Hero [Ad Td]
Dealt to 8e07c53 
Dealt to 95e89c51 
Dealt to ed18a71b 
8e07c53: folds
95e89c51: raises $0.05 to $0.1
ed18a71b: folds
57a66aa7: calls $0.1
c3883bcf: raises $0.27 to $0.37
Hero: folds
95e89c51: folds
57a66aa7: folds
Uncalled bet ($0.27) returned to c3883bcf
*** SHOWDOWN ***
c3883bcf collected $0.34 from pot
*** SUMMARY ***
Total pot $0.35 | Rake $0.01 | Jackpot $0 | Bingo $0 | Fortune $0 | Tax $0
Seat 1: 57a66aa7 (button) folded before Flop
Seat 2: c3883bcf (small blind) collected ($0.34)
Seat 3: Hero (big blind) folded before Flop
Seat 4: 8e07c53 folded before Flop (didn't bet)
Seat 5: 95e89c51 folded before Flop
Seat 6: ed18a71b folded before Flop (didn't bet)


Poker Hand #RC3334557479: Hold'em No Limit ($0.02/$0.05) - 2025/02/17 21:19:39
Table 'RushAndCash622739' 6-max Seat #1 is the button
Seat 1: ec1214a6 ($12.34 in chips)
Seat 2: c8e72d1e ($5.43 in chips)
Seat 3: 23a65ab7 ($5.99 in chips)
Seat 4: 802a8ffb ($6.44 in chips)
Seat 5: Hero ($6.3 in chips)
Seat 6: 4ea8e2e ($12.69 in chips)
c8e72d1e: posts small blind $0.02
23a65ab7: posts big blind $0.05
*** HOLE CARDS ***
Dealt to ec1214a6 
Dealt to c8e72d1e 
Dealt to 23a65ab7 
Dealt to 802a8ffb 
Dealt to Hero [8h Jd]
Dealt to 4ea8e2e 
802a8ffb: folds
Hero: folds
4ea8e2e: raises $0.08 to $0.13
ec1214a6: folds
c8e72d1e: folds
23a65ab7: folds
Uncalled bet ($0.08) returned to 4ea8e2e
*** SHOWDOWN ***
4ea8e2e collected $0.12 from pot
*** SUMMARY ***
Total pot $0.12 | Rake $0 | Jackpot $0 | Bingo $0 | Fortune $0 | Tax $0
Seat 1: ec1214a6 (button) folded before Flop (didn't bet)
Seat 2: c8e72d1e (small blind) folded before Flop
Seat 3: 23a65ab7 (big blind) folded before Flop
Seat 4: 802a8ffb folded before Flop (didn't bet)
Seat 5: Hero folded before Flop (didn't bet)
Seat 6: 4ea8e2e collected ($0.12)


Poker Hand #RC3334557453: Hold'em No Limit ($0.02/$0.05) - 2025/02/17 21:19:36
Table 'RushAndCash622713' 6-max Seat #1 is the button
Seat 1: ca601b39 ($8.77 in chips)
Seat 2: c607d475 ($4.52 in chips)
Seat 3: 14d03752 ($7.72 in chips)
Seat 4: d49c6b7d ($5 in chips)
Seat 5: 3939bf98 ($5.02 in chips)
Seat 6: Hero ($6.3 in chips)
c607d475: posts small blind $0.02
14d03752: posts big blind $0.05
*** HOLE CARDS ***
Dealt to ca601b39 
Dealt to c607d475 
Dealt to 14d03752 
Dealt to d49c6b7d 
Dealt to 3939bf98 
Dealt to Hero [2c Ah]
d49c6b7d: folds
3939bf98: folds
Hero: folds
ca601b39: folds
c607d475: raises $0.1 to $0.15
14d03752: folds
Uncalled bet ($0.1) returned to c607d475
*** SHOWDOWN ***
c607d475 collected $0.1 from pot
*** SUMMARY ***
Total pot $0.1 | Rake $0 | Jackpot $0 | Bingo $0 | Fortune $0 | Tax $0
Seat 1: ca601b39 (button) folded before Flop (didn't bet)
Seat 2: c607d475 (small blind) collected ($0.1)
Seat 3: 14d03752 (big blind) folded before Flop
Seat 4: d49c6b7d folded before Flop (didn't bet)
Seat 5: 3939bf98 folded before Flop (didn't bet)
Seat 6: Hero folded before Flop (didn't bet)


Poker Hand #RC3334556894: Hold'em No Limit ($0.02/$0.05) - 2025/02/17 21:18:24
Table 'RushAndCash622154' 6-max Seat #1 is the button
Seat 1: 143ede8b ($10.76 in chips)
Seat 2: 8e93231a ($5.02 in chips)
Seat 3: 83cc7f46 ($5.2 in chips)
Seat 4: ca601b39 ($9.47 in chips)
Seat 5: Hero ($5.57 in chips)
Seat 6: 8a5a4b28 ($1.86 in chips)
8e93231a: posts small blind $0.02
83cc7f46: posts big blind $0.05
*** HOLE CARDS ***
Dealt to 143ede8b 
Dealt to 8e93231a 
Dealt to 83cc7f46 
Dealt to ca601b39 
Dealt to Hero [Ts Th]
Dealt to 8a5a4b28 
ca601b39: raises $0.05 to $0.1
Hero: calls $0.1
8a5a4b28: calls $0.1
143ede8b: folds
8e93231a: folds
83cc7f46: folds
*** FLOP *** [6c Td Ah]
ca601b39: checks
Hero: bets $0.2
8a5a4b28: folds
ca601b39: calls $0.2
*** TURN *** [6c Td Ah] [Kd]
ca601b39: checks
Hero: bets $0.4
ca601b39: calls $0.4
*** RIVER *** [6c Td Ah Kd] [Js]
ca601b39: checks
Hero: checks
ca601b39: shows [Ac 8c] (Pair of Aces)
Hero: shows [Ts Th] (Three Tens)
*** SHOWDOWN ***
Hero collected $1.43 from pot
*** SUMMARY ***
Total pot $1.57 | Rake $0.07 | Jackpot $0.07 | Bingo $0 | Fortune $0 | Tax $0
Board [6c Td Ah Kd Js]
Seat 1: 143ede8b (button) folded before Flop (didn't bet)
Seat 2: 8e93231a (small blind) folded before Flop
Seat 3: 83cc7f46 (big blind) folded before Flop
Seat 4: ca601b39 showed [Ac 8c] and lost with Pair of Aces
Seat 5: Hero showed [Ts Th] and won ($1.43) with Three Tens
Seat 6: 8a5a4b28 folded on the Flop


Poker Hand #RC3334556866: Hold'em No Limit ($0.02/$0.05) - 2025/02/17 21:18:20
Table 'RushAndCash622126' 6-max Seat #1 is the button
Seat 1: 25c12d13 ($6.53 in chips)
Seat 2: Hero ($5.59 in chips)
Seat 3: 71f2556b ($0.79 in chips)
Seat 4: 143ede8b ($10.76 in chips)
Seat 5: 9dba8a1e ($6.62 in chips)
Seat 6: 8a5a4b28 ($1.86 in chips)
Hero: posts small blind $0.02
71f2556b: posts big blind $0.05
*** HOLE CARDS ***
Dealt to 25c12d13 
Dealt to Hero [3d Jd]
Dealt to 71f2556b 
Dealt to 143ede8b 
Dealt to 9dba8a1e 
Dealt to 8a5a4b28 
143ede8b: folds
9dba8a1e: raises $0.05 to $0.1
8a5a4b28: folds
25c12d13: folds
Hero: folds
71f2556b: folds
Uncalled bet ($0.05) returned to 9dba8a1e
*** SHOWDOWN ***
9dba8a1e collected $0.12 from pot
*** SUMMARY ***
Total pot $0.12 | Rake $0 | Jackpot $0 | Bingo $0 | Fortune $0 | Tax $0
Seat 1: 25c12d13 (button) folded before Flop (didn't bet)
Seat 2: Hero (small blind) folded before Flop
Seat 3: 71f2556b (big blind) folded before Flop
Seat 4: 143ede8b folded before Flop (didn't bet)
Seat 5: 9dba8a1e collected ($0.12)
Seat 6: 8a5a4b28 folded before Flop (didn't bet)


Poker Hand #RC3334556839: Hold'em No Limit ($0.02/$0.05) - 2025/02/17 21:18:17
Table 'RushAndCash622099' 6-max Seat #1 is the button
Seat 1: Hero ($5.59 in chips)
Seat 2: a291e856 ($5 in chips)
Seat 3: c6158c9d ($5.14 in chips)
Seat 4: db6b60a1 ($6.4 in chips)
Seat 5: 11224f8 ($5.16 in chips)
Seat 6: 8c1d44c9 ($5.89 in chips)
a291e856: posts small blind $0.02
c6158c9d: posts big blind $0.05
*** HOLE CARDS ***
Dealt to Hero [3s Kd]
Dealt to a291e856 
Dealt to c6158c9d 
Dealt to db6b60a1 
Dealt to 11224f8 
Dealt to 8c1d44c9 
db6b60a1: folds
11224f8: folds
8c1d44c9: folds
Hero: folds
a291e856: folds
Uncalled bet ($0.03) returned to c6158c9d
*** SHOWDOWN ***
c6158c9d collected $0.04 from pot
*** SUMMARY ***
Total pot $0.04 | Rake $0 | Jackpot $0 | Bingo $0 | Fortune $0 | Tax $0
Seat 1: Hero (button) folded before Flop (didn't bet)
Seat 2: a291e856 (small blind) folded before Flop
Seat 3: c6158c9d (big blind) collected ($0.04)
Seat 4: db6b60a1 folded before Flop (didn't bet)
Seat 5: 11224f8 folded before Flop (didn't bet)
Seat 6: 8c1d44c9 folded before Flop (didn't bet)


Poker Hand #RC3334556811: Hold'em No Limit ($0.02/$0.05) - 2025/02/17 21:18:13
Table 'RushAndCash622071' 6-max Seat #1 is the button
Seat 1: 65ca9276 ($9.35 in chips)
Seat 2: 8ec32764 ($5 in chips)
Seat 3: 35fb946f ($6.38 in chips)
Seat 4: 74d92f2b ($10.85 in chips)
Seat 5: Hero ($5.59 in chips)
Seat 6: 8d378f31 ($5 in chips)
8ec32764: posts small blind $0.02
35fb946f: posts big blind $0.05
*** HOLE CARDS ***
Dealt to 65ca9276 
Dealt to 8ec32764 
Dealt to 35fb946f 
Dealt to 74d92f2b 
Dealt to Hero [Jd Qh]
Dealt to 8d378f31 
74d92f2b: raises $0.05 to $0.1
Hero: folds
8d378f31: raises $0.28 to $0.38
65ca9276: folds
8ec32764: folds
35fb946f: folds
74d92f2b: folds
Uncalled bet ($0.28) returned to 8d378f31
*** SHOWDOWN ***
8d378f31 collected $0.26 from pot
*** SUMMARY ***
Total pot $0.27 | Rake $0.01 | Jackpot $0 | Bingo $0 | Fortune $0 | Tax $0
Seat 1: 65ca9276 (button) folded before Flop (didn't bet)
Seat 2: 8ec32764 (small blind) folded before Flop
Seat 3: 35fb946f (big blind) folded before Flop
Seat 4: 74d92f2b folded before Flop
Seat 5: Hero folded before Flop (didn't bet)
Seat 6: 8d378f31 collected ($0.26)


Poker Hand #RC3334556744: Hold'em No Limit ($0.02/$0.05) - 2025/02/17 21:18:05
Table 'RushAndCash622004' 6-max Seat #1 is the button
Seat 1: 65900825 ($4.15 in chips)
Seat 2: 3c76a91d ($11.09 in chips)
Seat 3: Hero ($5.64 in chips)
Seat 4: 5197516b ($5.71 in chips)
Seat 5: e89071f6 ($7.36 in chips)
Seat 6: 5741d28a ($5.92 in chips)
3c76a91d: posts small blind $0.02
Hero: posts big blind $0.05
*** HOLE CARDS ***
Dealt to 65900825 
Dealt to 3c76a91d 
Dealt to Hero [8s 9d]
Dealt to 5197516b 
Dealt to e89071f6 
Dealt to 5741d28a 
5197516b: folds
e89071f6: raises $0.05 to $0.1
5741d28a: folds
65900825: folds
3c76a91d: folds
Hero: folds
Uncalled bet ($0.05) returned to e89071f6
*** SHOWDOWN ***
e89071f6 collected $0.12 from pot
*** SUMMARY ***
Total pot $0.12 | Rake $0 | Jackpot $0 | Bingo $0 | Fortune $0 | Tax $0
Seat 1: 65900825 (button) folded before Flop (didn't bet)
Seat 2: 3c76a91d (small blind) folded before Flop
Seat 3: Hero (big blind) folded before Flop
Seat 4: 5197516b folded before Flop (didn't bet)
Seat 5: e89071f6 collected ($0.12)
Seat 6: 5741d28a folded before Flop (didn't bet)


Poker Hand #RC3334556710: Hold'em No Limit ($0.02/$0.05) - 2025/02/17 21:18:01
Table 'RushAndCash621970' 6-max Seat #1 is the button
Seat 1: Hero ($5.64 in chips)
Seat 2: e3cc36cb ($5 in chips)
Seat 3: e349aa35 ($5.15 in chips)
Seat 4: 130fc8d7 ($18.93 in chips)
Seat 5: 5b97e983 ($4.84 in chips)
Seat 6: d916afa1 ($21.21 in chips)
e3cc36cb: posts small blind $0.02
e349aa35: posts big blind $0.05
*** HOLE CARDS ***
Dealt to Hero [4s Qh]
Dealt to e3cc36cb 
Dealt to e349aa35 
Dealt to 130fc8d7 
Dealt to 5b97e983 
Dealt to d916afa1 
130fc8d7: folds
5b97e983: folds
d916afa1: raises $0.1 to $0.15
Hero: folds
e3cc36cb: folds
e349aa35: calls $0.1
*** FLOP *** [Jc Ts Ac]
e349aa35: checks
d916afa1: bets $0.32
e349aa35: calls $0.32
*** TURN *** [Jc Ts Ac] [7c]
e349aa35: checks
d916afa1: bets $0.32
e349aa35: calls $0.32
*** RIVER *** [Jc Ts Ac 7c] [2h]
e349aa35: checks
d916afa1: bets $0.8
e349aa35: calls $0.8
d916afa1: shows [Ad Tc] (Pair of Aces and Pair of Tens)
e349aa35: shows [8s As] (Pair of Aces)
*** SHOWDOWN ***
d916afa1 collected $2.98 from pot
*** SUMMARY ***
Total pot $3.2 | Rake $0.15 | Jackpot $0.07 | Bingo $0 | Fortune $0 | Tax $0
Board [Jc Ts Ac 7c 2h]
Seat 1: Hero (button) folded before Flop (didn't bet)
Seat 2: e3cc36cb (small blind) folded before Flop
Seat 3: e349aa35 (big blind) showed [8s As] and lost with Pair of Aces
Seat 4: 130fc8d7 folded before Flop (didn't bet)
Seat 5: 5b97e983 folded before Flop (didn't bet)
Seat 6: d916afa1 showed [Ad Tc] and won ($2.98) with Pair of Aces and Pair of Tens


Poker Hand #RC3334556686: Hold'em No Limit ($0.02/$0.05) - 2025/02/17 21:17:58
Table 'RushAndCash621946' 6-max Seat #1 is the button
Seat 1: bacb67c8 ($7.56 in chips)
Seat 2: 38a4c833 ($4.2 in chips)
Seat 3: 80b2520f ($5.12 in chips)
Seat 4: 50254767 ($5.25 in chips)
Seat 5: Hero ($5.64 in chips)
Seat 6: 5c980949 ($6.93 in chips)
38a4c833: posts small blind $0.02
80b2520f: posts big blind $0.05
*** HOLE CARDS ***
Dealt to bacb67c8 
Dealt to 38a4c833 
Dealt to 80b2520f 
Dealt to 50254767 
Dealt to Hero [7d 5c]
Dealt to 5c980949 
50254767: raises $0.08 to $0.13
Hero: folds
5c980949: folds
bacb67c8: folds
38a4c833: folds
80b2520f: folds
Uncalled bet ($0.08) returned to 50254767
*** SHOWDOWN ***
50254767 collected $0.12 from pot
*** SUMMARY ***
Total pot $0.12 | Rake $0 | Jackpot $0 | Bingo $0 | Fortune $0 | Tax $0
Seat 1: bacb67c8 (button) folded before Flop (didn't bet)
Seat 2: 38a4c833 (small blind) folded before Flop
Seat 3: 80b2520f (big blind) folded before Flop
Seat 4: 50254767 collected ($0.12)
Seat 5: Hero folded before Flop (didn't bet)
Seat 6: 5c980949 folded before Flop (didn't bet)


Poker Hand #RC3334556662: Hold'em No Limit ($0.02/$0.05) - 2025/02/17 21:17:54
Table 'RushAndCash621922' 6-max Seat #1 is the button
Seat 1: 15fafcaa ($5 in chips)
Seat 2: 6e22a6c1 ($5.61 in chips)
Seat 3: 3324467a ($5 in chips)
Seat 4: 3ad90733 ($15.86 in chips)
Seat 5: ae0cde3d ($6.42 in chips)
Seat 6: Hero ($5.64 in chips)
6e22a6c1: posts small blind $0.02
3324467a: posts big blind $0.05
*** HOLE CARDS ***
Dealt to 15fafcaa 
Dealt to 6e22a6c1 
Dealt to 3324467a 
Dealt to 3ad90733 
Dealt to ae0cde3d 
Dealt to Hero [8d Ah]
3ad90733: folds
ae0cde3d: raises $0.06 to $0.11
Hero: folds
15fafcaa: folds
6e22a6c1: folds
3324467a: calls $0.06
*** FLOP *** [6s Kd Qs]
3324467a: checks
ae0cde3d: bets $0.09
3324467a: calls $0.09
*** TURN *** [6s Kd Qs] [7c]
3324467a: checks
ae0cde3d: checks
*** RIVER *** [6s Kd Qs 7c] [Qd]
3324467a: bets $0.32
ae0cde3d: calls $0.32
3324467a: shows [Jd Tc] (Pair of Queens)
ae0cde3d: shows [9h Ks] (Pair of Kings and Pair of Queens)
*** SHOWDOWN ***
ae0cde3d collected $1.01 from pot
*** SUMMARY ***
Total pot $1.06 | Rake $0.05 | Jackpot $0 | Bingo $0 | Fortune $0 | Tax $0
Board [6s Kd Qs 7c Qd]
Seat 1: 15fafcaa (button) folded before Flop (didn't bet)
Seat 2: 6e22a6c1 (small blind) folded before Flop
Seat 3: 3324467a (big blind) showed [Jd Tc] and lost with Pair of Queens
Seat 4: 3ad90733 folded before Flop (didn't bet)
Seat 5: ae0cde3d showed [9h Ks] and won ($1.01) with Pair of Kings and Pair of Queens
Seat 6: Hero folded before Flop (didn't bet)


Poker Hand #RC3334556328: Hold'em No Limit ($0.02/$0.05) - 2025/02/17 21:17:13
Table 'RushAndCash621588' 6-max Seat #1 is the button
Seat 1: Hero ($5.03 in chips)
Seat 2: 3ffd6491 ($9.75 in chips)
Seat 3: b67f7812 ($7.61 in chips)
Seat 4: fedfe7c6 ($14.37 in chips)
Seat 5: 4b3dba4 ($7.65 in chips)
Seat 6: 87d5083b ($23.39 in chips)
3ffd6491: posts small blind $0.02
b67f7812: posts big blind $0.05
*** HOLE CARDS ***
Dealt to Hero [5c 6c]
Dealt to 3ffd6491 
Dealt to b67f7812 
Dealt to fedfe7c6 
Dealt to 4b3dba4 
Dealt to 87d5083b 
fedfe7c6: folds
4b3dba4: folds
87d5083b: folds
Hero: raises $0.05 to $0.1
3ffd6491: folds
b67f7812: raises $0.22 to $0.32
Hero: calls $0.22
*** FLOP *** [Kc 9s 5d]
b67f7812: bets $0.33
Hero: calls $0.33
*** TURN *** [Kc 9s 5d] [2h]
b67f7812: checks
Hero: checks
*** RIVER *** [Kc 9s 5d 2h] [8s]
b67f7812: checks
Hero: checks
b67f7812: shows [Qc Ad] (Ace-High)
Hero: shows [5c 6c] (Pair of Fives)
*** SHOWDOWN ***
Hero collected $1.26 from pot
*** SUMMARY ***
Total pot $1.32 | Rake $0.06 | Jackpot $0 | Bingo $0 | Fortune $0 | Tax $0
Board [Kc 9s 5d 2h 8s]
Seat 1: Hero (button) showed [5c 6c] and won ($1.26) with Pair of Fives
Seat 2: 3ffd6491 (small blind) folded before Flop
Seat 3: b67f7812 (big blind) showed [Qc Ad] and lost with Ace-High
Seat 4: fedfe7c6 folded before Flop (didn't bet)
Seat 5: 4b3dba4 folded before Flop (didn't bet)
Seat 6: 87d5083b folded before Flop (didn't bet)


Poker Hand #RC3334556274: Hold'em No Limit ($0.02/$0.05) - 2025/02/17 21:17:06
Table 'RushAndCash621534' 6-max Seat #1 is the button
Seat 1: e20e5cfc ($6.02 in chips)
Seat 2: Hero ($5.05 in chips)
Seat 3: d916afa1 ($21.23 in chips)
Seat 4: 4b3dba4 ($7.65 in chips)
Seat 5: d737deb4 ($5 in chips)
Seat 6: d0d9ce45 ($3.08 in chips)
Hero: posts small blind $0.02
d916afa1: posts big blind $0.05
*** HOLE CARDS ***
Dealt to e20e5cfc 
Dealt to Hero [6d 4c]
Dealt to d916afa1 
Dealt to 4b3dba4 
Dealt to d737deb4 
Dealt to d0d9ce45 
4b3dba4: folds
d737deb4: folds
d0d9ce45: raises $0.06 to $0.11
e20e5cfc: folds
Hero: folds
d916afa1: folds
Uncalled bet ($0.06) returned to d0d9ce45
*** SHOWDOWN ***
d0d9ce45 collected $0.12 from pot
*** SUMMARY ***
Total pot $0.12 | Rake $0 | Jackpot $0 | Bingo $0 | Fortune $0 | Tax $0
Seat 1: e20e5cfc (button) folded before Flop (didn't bet)
Seat 2: Hero (small blind) folded before Flop
Seat 3: d916afa1 (big blind) folded before Flop
Seat 4: 4b3dba4 folded before Flop (didn't bet)
Seat 5: d737deb4 folded before Flop (didn't bet)
Seat 6: d0d9ce45 collected ($0.12)


Poker Hand #RC3334556249: Hold'em No Limit ($0.02/$0.05) - 2025/02/17 21:17:03
Table 'RushAndCash621509' 6-max Seat #1 is the button
Seat 1: bda6a3d1 ($5 in chips)
Seat 2: 9165e0e3 ($6.17 in chips)
Seat 3: 7a5bf293 ($9.35 in chips)
Seat 4: 9f9e1094 ($7 in chips)
Seat 5: 717e9861 ($8.88 in chips)
Seat 6: Hero ($5.05 in chips)
9165e0e3: posts small blind $0.02
7a5bf293: posts big blind $0.05
*** HOLE CARDS ***
Dealt to bda6a3d1 
Dealt to 9165e0e3 
Dealt to 7a5bf293 
Dealt to 9f9e1094 
Dealt to 717e9861 
Dealt to Hero [6c Tc]
9f9e1094: raises $0.06 to $0.11
717e9861: raises $0.23 to $0.34
Hero: folds
bda6a3d1: folds
9165e0e3: folds
7a5bf293: folds
9f9e1094: raises $0.38 to $0.72
717e9861: raises $8.16 to $8.88 and is all-in
9f9e1094: folds
Uncalled bet ($8.16) returned to 717e9861
*** SHOWDOWN ***
717e9861 collected $1.37 from pot
*** SUMMARY ***
Total pot $1.51 | Rake $0.07 | Jackpot $0.07 | Bingo $0 | Fortune $0 | Tax $0
Seat 1: bda6a3d1 (button) folded before Flop (didn't bet)
Seat 2: 9165e0e3 (small blind) folded before Flop
Seat 3: 7a5bf293 (big blind) folded before Flop
Seat 4: 9f9e1094 folded before Flop
Seat 5: 717e9861 collected ($1.37)
Seat 6: Hero folded before Flop (didn't bet)


Poker Hand #RC3334556187: Hold'em No Limit ($0.02/$0.05) - 2025/02/17 21:16:54
Table 'RushAndCash621447' 6-max Seat #1 is the button
Seat 1: 15141573 ($6.11 in chips)
Seat 2: Hero ($5.07 in chips)
Seat 3: d58b99ca ($32.28 in chips)
Seat 4: 3ad90733 ($15.86 in chips)
Seat 5: 22643080 ($6.85 in chips)
Seat 6: 6de2662f ($6.85 in chips)
Hero: posts small blind $0.02
d58b99ca: posts big blind $0.05
*** HOLE CARDS ***
Dealt to 15141573 
Dealt to Hero [9h 3d]
Dealt to d58b99ca 
Dealt to 3ad90733 
Dealt to 22643080 
Dealt to 6de2662f 
3ad90733: folds
22643080: raises $0.08 to $0.13
6de2662f: folds
15141573: folds
Hero: folds
d58b99ca: folds
Uncalled bet ($0.08) returned to 22643080
*** SHOWDOWN ***
22643080 collected $0.12 from pot
*** SUMMARY ***
Total pot $0.12 | Rake $0 | Jackpot $0 | Bingo $0 | Fortune $0 | Tax $0
Seat 1: 15141573 (button) folded before Flop (didn't bet)
Seat 2: Hero (small blind) folded before Flop
Seat 3: d58b99ca (big blind) folded before Flop
Seat 4: 3ad90733 folded before Flop (didn't bet)
Seat 5: 22643080 collected ($0.12)
Seat 6: 6de2662f folded before Flop (didn't bet)


Poker Hand #RC3334555698: Hold'em No Limit ($0.02/$0.05) - 2025/02/17 21:15:52
Table 'RushAndCash620958' 6-max Seat #1 is the button
Seat 1: 23a65ab7 ($5.21 in chips)
Seat 2: 14d966a6 ($5.7 in chips)
Seat 3: Hero ($5.3 in chips)
Seat 4: 7c65d0bd ($5.07 in chips)
Seat 5: f52f15b4 ($4.53 in chips)
Seat 6: 6d5fa70b ($5.05 in chips)
14d966a6: posts small blind $0.02
Hero: posts big blind $0.05
*** HOLE CARDS ***
Dealt to 23a65ab7 
Dealt to 14d966a6 
Dealt to Hero [8h 9h]
Dealt to 7c65d0bd 
Dealt to f52f15b4 
Dealt to 6d5fa70b 
7c65d0bd: folds
f52f15b4: folds
6d5fa70b: raises $0.08 to $0.13
23a65ab7: folds
14d966a6: folds
Hero: calls $0.08
*** FLOP *** [6h Jc Tc]
Hero: checks
6d5fa70b: bets $0.1
Hero: calls $0.1
*** TURN *** [6h Jc Tc] [Ad]
Hero: checks
6d5fa70b: checks
*** RIVER *** [6h Jc Tc Ad] [Qs]
Hero: checks
6d5fa70b: bets $0.16
Hero: folds
Uncalled bet ($0.16) returned to 6d5fa70b
*** SHOWDOWN ***
6d5fa70b collected $0.46 from pot
*** SUMMARY ***
Total pot $0.48 | Rake $0.02 | Jackpot $0 | Bingo $0 | Fortune $0 | Tax $0
Board [6h Jc Tc Ad Qs]
Seat 1: 23a65ab7 (button) folded before Flop (didn't bet)
Seat 2: 14d966a6 (small blind) folded before Flop
Seat 3: Hero (big blind) folded on the River
Seat 4: 7c65d0bd folded before Flop (didn't bet)
Seat 5: f52f15b4 folded before Flop (didn't bet)
Seat 6: 6d5fa70b won ($0.46)


Poker Hand #RC3334555677: Hold'em No Limit ($0.02/$0.05) - 2025/02/17 21:15:49
Table 'RushAndCash620937' 6-max Seat #1 is the button
Seat 1: 3e301744 ($4.1 in chips)
Seat 2: 4506a4f6 ($5.39 in chips)
Seat 3: 45d33c76 ($8.93 in chips)
Seat 4: e4fd27d ($23.09 in chips)
Seat 5: 33caafa3 ($5.04 in chips)
Seat 6: Hero ($5.3 in chips)
4506a4f6: posts small blind $0.02
45d33c76: posts big blind $0.05
*** HOLE CARDS ***
Dealt to 3e301744 
Dealt to 4506a4f6 
Dealt to 45d33c76 
Dealt to e4fd27d 
Dealt to 33caafa3 
Dealt to Hero [9h As]
e4fd27d: folds
33caafa3: folds
Hero: folds
3e301744: folds
4506a4f6: raises $0.06 to $0.11
45d33c76: raises $0.33 to $0.44
4506a4f6: folds
Uncalled bet ($0.33) returned to 45d33c76
*** SHOWDOWN ***
45d33c76 collected $0.21 from pot
*** SUMMARY ***
Total pot $0.22 | Rake $0.01 | Jackpot $0 | Bingo $0 | Fortune $0 | Tax $0
Seat 1: 3e301744 (button) folded before Flop (didn't bet)
Seat 2: 4506a4f6 (small blind) folded before Flop
Seat 3: 45d33c76 (big blind) collected ($0.21)
Seat 4: e4fd27d folded before Flop (didn't bet)
Seat 5: 33caafa3 folded before Flop (didn't bet)
Seat 6: Hero folded before Flop (didn't bet)


Poker Hand #RC3334555646: Hold'em No Limit ($0.02/$0.05) - 2025/02/17 21:15:45
Table 'RushAndCash620906' 6-max Seat #1 is the button
Seat 1: bc8371cb ($5.41 in chips)
Seat 2: 50cbaebe ($5.16 in chips)
Seat 3: 25c12d13 ($4.93 in chips)
Seat 4: 6650c8cb ($13.17 in chips)
Seat 5: Hero ($5.3 in chips)
Seat 6: 6dcd0788 ($15.42 in chips)
50cbaebe: posts small blind $0.02
25c12d13: posts big blind $0.05
*** HOLE CARDS ***
Dealt to bc8371cb 
Dealt to 50cbaebe 
Dealt to 25c12d13 
Dealt to 6650c8cb 
Dealt to Hero [8d 6h]
Dealt to 6dcd0788 
6650c8cb: folds
Hero: folds
6dcd0788: folds
bc8371cb: folds
50cbaebe: folds
Uncalled bet ($0.03) returned to 25c12d13
*** SHOWDOWN ***
25c12d13 collected $0.04 from pot
*** SUMMARY ***
Total pot $0.04 | Rake $0 | Jackpot $0 | Bingo $0 | Fortune $0 | Tax $0
Seat 1: bc8371cb (button) folded before Flop (didn't bet)
Seat 2: 50cbaebe (small blind) folded before Flop
Seat 3: 25c12d13 (big blind) collected ($0.04)
Seat 4: 6650c8cb folded before Flop (didn't bet)
Seat 5: Hero folded before Flop (didn't bet)
Seat 6: 6dcd0788 folded before Flop (didn't bet)


Poker Hand #RC3334555612: Hold'em No Limit ($0.02/$0.05) - 2025/02/17 21:15:40
Table 'RushAndCash620872' 6-max Seat #1 is the button
Seat 1: 516da84c ($4.99 in chips)
Seat 2: ab01942e ($4.48 in chips)
Seat 3: e0a9129e ($2.98 in chips)
Seat 4: 1e76a4d8 ($6.15 in chips)
Seat 5: Hero ($5.3 in chips)
Seat 6: d5150c28 ($6.09 in chips)
ab01942e: posts small blind $0.02
e0a9129e: posts big blind $0.05
*** HOLE CARDS ***
Dealt to 516da84c 
Dealt to ab01942e 
Dealt to e0a9129e 
Dealt to 1e76a4d8 
Dealt to Hero [Ts 3c]
Dealt to d5150c28 
1e76a4d8: folds
Hero: folds
d5150c28: folds
516da84c: calls $0.05
ab01942e: folds
e0a9129e: checks
*** FLOP *** [Ah 6h 4s]
e0a9129e: checks
516da84c: checks
*** TURN *** [Ah 6h 4s] [Ks]
e0a9129e: bets $0.06
516da84c: calls $0.06
*** RIVER *** [Ah 6h 4s Ks] [9d]
e0a9129e: checks
516da84c: checks
e0a9129e: shows [8c Js] (Ace-High)
516da84c: shows [2h 2c] (Pair of Twos)
*** SHOWDOWN ***
516da84c collected $0.23 from pot
*** SUMMARY ***
Total pot $0.24 | Rake $0.01 | Jackpot $0 | Bingo $0 | Fortune $0 | Tax $0
Board [Ah 6h 4s Ks 9d]
Seat 1: 516da84c (button) showed [2h 2c] and won ($0.23) with Pair of Twos
Seat 2: ab01942e (small blind) folded before Flop
Seat 3: e0a9129e (big blind) showed [8c Js] and lost with Ace-High
Seat 4: 1e76a4d8 folded before Flop (didn't bet)
Seat 5: Hero folded before Flop (didn't bet)
Seat 6: d5150c28 folded before Flop (didn't bet)


Poker Hand #RC3334555583: Hold'em No Limit ($0.02/$0.05) - 2025/02/17 21:15:36
Table 'RushAndCash620843' 6-max Seat #1 is the button
Seat 1: 9788125b ($5.8 in chips)
Seat 2: e6ee1d7f ($7.44 in chips)
Seat 3: 62fdcc3c ($5 in chips)
Seat 4: cbfd6c92 ($9.44 in chips)
Seat 5: 1e76a4d8 ($6.15 in chips)
Seat 6: Hero ($5.3 in chips)
e6ee1d7f: posts small blind $0.02
62fdcc3c: posts big blind $0.05
*** HOLE CARDS ***
Dealt to 9788125b 
Dealt to e6ee1d7f 
Dealt to 62fdcc3c 
Dealt to cbfd6c92 
Dealt to 1e76a4d8 
Dealt to Hero [2c 7c]
cbfd6c92: folds
1e76a4d8: folds
Hero: folds
9788125b: folds
e6ee1d7f: raises $0.06 to $0.11
62fdcc3c: folds
Uncalled bet ($0.06) returned to e6ee1d7f
*** SHOWDOWN ***
e6ee1d7f collected $0.1 from pot
*** SUMMARY ***
Total pot $0.1 | Rake $0 | Jackpot $0 | Bingo $0 | Fortune $0 | Tax $0
Seat 1: 9788125b (button) folded before Flop (didn't bet)
Seat 2: e6ee1d7f (small blind) collected ($0.1)
Seat 3: 62fdcc3c (big blind) folded before Flop
Seat 4: cbfd6c92 folded before Flop (didn't bet)
Seat 5: 1e76a4d8 folded before Flop (didn't bet)
Seat 6: Hero folded before Flop (didn't bet)


Poker Hand #RC3334555515: Hold'em No Limit ($0.02/$0.05) - 2025/02/17 21:15:28
Table 'RushAndCash620775' 6-max Seat #1 is the button
Seat 1: 9babc997 ($5.12 in chips)
Seat 2: Hero ($5.32 in chips)
Seat 3: 93056ee9 ($6.96 in chips)
Seat 4: 45d33c76 ($8.95 in chips)
Seat 5: 20c536f4 ($4.79 in chips)
Seat 6: 4ebd5be6 ($5.15 in chips)
Hero: posts small blind $0.02
93056ee9: posts big blind $0.05
*** HOLE CARDS ***
Dealt to 9babc997 
Dealt to Hero [8h Ac]
Dealt to 93056ee9 
Dealt to 45d33c76 
Dealt to 20c536f4 
Dealt to 4ebd5be6 
45d33c76: folds
20c536f4: folds
4ebd5be6: folds
9babc997: raises $0.07 to $0.12
Hero: folds
93056ee9: calls $0.07
*** FLOP *** [2h Jd Qh]
93056ee9: checks
9babc997: bets $0.13
93056ee9: calls $0.13
*** TURN *** [2h Jd Qh] [9c]
93056ee9: checks
9babc997: checks
*** RIVER *** [2h Jd Qh 9c] [2c]
93056ee9: bets $0.28
9babc997: folds
Uncalled bet ($0.28) returned to 93056ee9
*** SHOWDOWN ***
93056ee9 collected $0.5 from pot
*** SUMMARY ***
Total pot $0.52 | Rake $0.02 | Jackpot $0 | Bingo $0 | Fortune $0 | Tax $0
Board [2h Jd Qh 9c 2c]
Seat 1: 9babc997 (button) folded on the River
Seat 2: Hero (small blind) folded before Flop
Seat 3: 93056ee9 (big blind) won ($0.5)
Seat 4: 45d33c76 folded before Flop (didn't bet)
Seat 5: 20c536f4 folded before Flop (didn't bet)
Seat 6: 4ebd5be6 folded before Flop (didn't bet)


Poker Hand #RC3334555492: Hold'em No Limit ($0.02/$0.05) - 2025/02/17 21:15:25
Table 'RushAndCash620752' 6-max Seat #1 is the button
Seat 1: b05c1b36 ($4.77 in chips)
Seat 2: 428cd8c2 ($5 in chips)
Seat 3: Hero ($5.37 in chips)
Seat 4: e9c5dfd7 ($9.65 in chips)
Seat 5: f52f15b4 ($4.53 in chips)
Seat 6: 9864109b ($5.66 in chips)
428cd8c2: posts small blind $0.02
Hero: posts big blind $0.05
*** HOLE CARDS ***
Dealt to b05c1b36 
Dealt to 428cd8c2 
Dealt to Hero [6d Kh]
Dealt to e9c5dfd7 
Dealt to f52f15b4 
Dealt to 9864109b 
e9c5dfd7: raises $0.05 to $0.1
f52f15b4: folds
9864109b: calls $0.1
b05c1b36: folds
428cd8c2: folds
Hero: folds
*** FLOP *** [Ac 3s Ts]
e9c5dfd7: bets $0.14
9864109b: calls $0.14
*** TURN *** [Ac 3s Ts] [3d]
e9c5dfd7: checks
9864109b: checks
*** RIVER *** [Ac 3s Ts 3d] [5h]
e9c5dfd7: checks
9864109b: checks
e9c5dfd7: shows [Kc 9c] (Pair of Treys)
9864109b: shows [Jh Th] (Pair of Tens and Pair of Treys)
*** SHOWDOWN ***
9864109b collected $0.53 from pot
*** SUMMARY ***
Total pot $0.55 | Rake $0.02 | Jackpot $0 | Bingo $0 | Fortune $0 | Tax $0
Board [Ac 3s Ts 3d 5h]
Seat 1: b05c1b36 (button) folded before Flop (didn't bet)
Seat 2: 428cd8c2 (small blind) folded before Flop
Seat 3: Hero (big blind) folded before Flop
Seat 4: e9c5dfd7 showed [Kc 9c] and lost with Pair of Treys
Seat 5: f52f15b4 folded before Flop (didn't bet)
Seat 6: 9864109b showed [Jh Th] and won ($0.53) with Pair of Tens and Pair of Treys


Poker Hand #RC3334555416: Hold'em No Limit ($0.02/$0.05) - 2025/02/17 21:15:15
Table 'RushAndCash620676' 6-max Seat #1 is the button
Seat 1: a291e856 ($5.02 in chips)
Seat 2: 5b7051ae ($4.77 in chips)
Seat 3: d86379c5 ($5.58 in chips)
Seat 4: fbd2add5 ($7.17 in chips)
Seat 5: 23258e5f ($5.56 in chips)
Seat 6: Hero ($5.3 in chips)
5b7051ae: posts small blind $0.02
d86379c5: posts big blind $0.05
*** HOLE CARDS ***
Dealt to a291e856 
Dealt to 5b7051ae 
Dealt to d86379c5 
Dealt to fbd2add5 
Dealt to 23258e5f 
Dealt to Hero [8c As]
fbd2add5: folds
23258e5f: folds
Hero: raises $0.05 to $0.1
a291e856: folds
5b7051ae: folds
d86379c5: folds
Uncalled bet ($0.05) returned to Hero
*** SHOWDOWN ***
Hero collected $0.12 from pot
*** SUMMARY ***
Total pot $0.12 | Rake $0 | Jackpot $0 | Bingo $0 | Fortune $0 | Tax $0
Seat 1: a291e856 (button) folded before Flop (didn't bet)
Seat 2: 5b7051ae (small blind) folded before Flop
Seat 3: d86379c5 (big blind) folded before Flop
Seat 4: fbd2add5 folded before Flop (didn't bet)
Seat 5: 23258e5f folded before Flop (didn't bet)
Seat 6: Hero collected ($0.12)


Poker Hand #RC3334555165: Hold'em No Limit ($0.02/$0.05) - 2025/02/17 21:14:41
Table 'RushAndCash620425' 6-max Seat #1 is the button
Seat 1: 19259657 ($5.14 in chips)
Seat 2: 3565018d ($4.33 in chips)
Seat 3: 1fee54bc ($5.03 in chips)
Seat 4: Hero ($5.23 in chips)
Seat 5: 945593bf ($15.88 in chips)
Seat 6: 887ed1a2 ($4.74 in chips)
3565018d: posts small blind $0.02
1fee54bc: posts big blind $0.05
*** HOLE CARDS ***
Dealt to 19259657 
Dealt to 3565018d 
Dealt to 1fee54bc 
Dealt to Hero [8d 9d]
Dealt to 945593bf 
Dealt to 887ed1a2 
Hero: raises $0.05 to $0.1
945593bf: folds
887ed1a2: folds
19259657: folds
3565018d: folds
1fee54bc: folds
Uncalled bet ($0.05) returned to Hero
*** SHOWDOWN ***
Hero collected $0.12 from pot
*** SUMMARY ***
Total pot $0.12 | Rake $0 | Jackpot $0 | Bingo $0 | Fortune $0 | Tax $0
Seat 1: 19259657 (button) folded before Flop (didn't bet)
Seat 2: 3565018d (small blind) folded before Flop
Seat 3: 1fee54bc (big blind) folded before Flop
Seat 4: Hero collected ($0.12)
Seat 5: 945593bf folded before Flop (didn't bet)
Seat 6: 887ed1a2 folded before Flop (didn't bet)


Poker Hand #RC3334555138: Hold'em No Limit ($0.02/$0.05) - 2025/02/17 21:14:37
Table 'RushAndCash620398' 6-max Seat #1 is the button
Seat 1: 1aca371e ($9.29 in chips)
Seat 2: 256d985c ($5.87 in chips)
Seat 3: Hero ($5.28 in chips)
Seat 4: a291e856 ($5 in chips)
Seat 5: fcfd355a ($5.75 in chips)
Seat 6: cc0e3d69 ($1.33 in chips)
256d985c: posts small blind $0.02
Hero: posts big blind $0.05
*** HOLE CARDS ***
Dealt to 1aca371e 
Dealt to 256d985c 
Dealt to Hero [3h 7s]
Dealt to a291e856 
Dealt to fcfd355a 
Dealt to cc0e3d69 
a291e856: raises $0.05 to $0.1
fcfd355a: folds
cc0e3d69: folds
1aca371e: folds
256d985c: folds
Hero: folds
Uncalled bet ($0.05) returned to a291e856
*** SHOWDOWN ***
a291e856 collected $0.12 from pot
*** SUMMARY ***
Total pot $0.12 | Rake $0 | Jackpot $0 | Bingo $0 | Fortune $0 | Tax $0
Seat 1: 1aca371e (button) folded before Flop (didn't bet)
Seat 2: 256d985c (small blind) folded before Flop
Seat 3: Hero (big blind) folded before Flop
Seat 4: a291e856 collected ($0.12)
Seat 5: fcfd355a folded before Flop (didn't bet)
Seat 6: cc0e3d69 folded before Flop (didn't bet)


Poker Hand #RC3334554947: Hold'em No Limit ($0.02/$0.05) - 2025/02/17 21:14:13
Table 'RushAndCash620207' 6-max Seat #1 is the button
Seat 1: 4190d158 ($6.04 in chips)
Seat 2: cc0e3d69 ($1.19 in chips)
Seat 3: 3bfcd529 ($6.11 in chips)
Seat 4: 820e1571 ($6.42 in chips)
Seat 5: Hero ($5.38 in chips)
Seat 6: 2e388e95 ($6.66 in chips)
cc0e3d69: posts small blind $0.02
3bfcd529: posts big blind $0.05
*** HOLE CARDS ***
Dealt to 4190d158 
Dealt to cc0e3d69 
Dealt to 3bfcd529 
Dealt to 820e1571 
Dealt to Hero [As Th]
Dealt to 2e388e95 
820e1571: folds
Hero: raises $0.05 to $0.1
2e388e95: folds
4190d158: folds
cc0e3d69: calls $0.08
3bfcd529: folds
*** FLOP *** [9h 7c Kh]
cc0e3d69: checks
Hero: checks
*** TURN *** [9h 7c Kh] [5d]
cc0e3d69: bets $0.17
Hero: folds
Uncalled bet ($0.17) returned to cc0e3d69
*** SHOWDOWN ***
cc0e3d69 collected $0.24 from pot
*** SUMMARY ***
Total pot $0.25 | Rake $0.01 | Jackpot $0 | Bingo $0 | Fortune $0 | Tax $0
Board [9h 7c Kh 5d]
Seat 1: 4190d158 (button) folded before Flop (didn't bet)
Seat 2: cc0e3d69 (small blind) won ($0.24)
Seat 3: 3bfcd529 (big blind) folded before Flop
Seat 4: 820e1571 folded before Flop (didn't bet)
Seat 5: Hero folded on the Turn
Seat 6: 2e388e95 folded before Flop (didn't bet)


Poker Hand #RC3334484653: Hold'em No Limit ($0.02/$0.05) - 2025/02/17 21:13:35
Table 'RushAndCash619913' 6-max Seat #1 is the button
Seat 1: Hero ($5 in chips)
Seat 2: 32d40ce0 ($5.49 in chips)
Seat 3: b282789b ($5.16 in chips)
Seat 4: b2966865 ($9.18 in chips)
Seat 5: 2e388e95 ($7 in chips)
Seat 6: 8f9fd8b1 ($13.97 in chips)
32d40ce0: posts small blind $0.02
b282789b: posts big blind $0.05
*** HOLE CARDS ***
Dealt to Hero [Kc Ad]
Dealt to 32d40ce0 
Dealt to b282789b 
Dealt to b2966865 
Dealt to 2e388e95 
Dealt to 8f9fd8b1 
b2966865: folds
2e388e95: raises $0.06 to $0.11
8f9fd8b1: folds
Hero: raises $0.23 to $0.34
32d40ce0: folds
b282789b: folds
2e388e95: calls $0.23
*** FLOP *** [8h 4h 8c]
2e388e95: checks
Hero: checks
*** TURN *** [8h 4h 8c] [6d]
2e388e95: checks
Hero: checks
*** RIVER *** [8h 4h 8c 6d] [3h]
2e388e95: checks
Hero: checks
2e388e95: shows [Qd As] (Pair of Eights)
Hero: shows [Kc Ad] (Pair of Eights)
*** SHOWDOWN ***
Hero collected $0.72 from pot
*** SUMMARY ***
Total pot $0.75 | Rake $0.03 | Jackpot $0 | Bingo $0 | Fortune $0 | Tax $0
Board [8h 4h 8c 6d 3h]
Seat 1: Hero (button) showed [Kc Ad] and won ($0.72) with Pair of Eights
Seat 2: 32d40ce0 (small blind) folded before Flop
Seat 3: b282789b (big blind) folded before Flop
Seat 4: b2966865 folded before Flop (didn't bet)
Seat 5: 2e388e95 showed [Qd As] and lost with Pair of Eights
Seat 6: 8f9fd8b1 folded before Flop (didn't bet)


Poker Hand #RC3334484628: Hold'em No Limit ($0.02/$0.05) - 2025/02/17 21:13:32
Table 'RushAndCash619888' 6-max Seat #1 is the button
Seat 1: 25f30dbe ($2.3 in chips)
Seat 2: 717e9861 ($8.43 in chips)
Seat 3: 381c6d82 ($5.04 in chips)
Seat 4: 6f565fd ($5.05 in chips)
Seat 5: 1e474bac ($5 in chips)
Seat 6: Hero ($5 in chips)
717e9861: posts small blind $0.02
381c6d82: posts big blind $0.05
*** HOLE CARDS ***
Dealt to 25f30dbe 
Dealt to 717e9861 
Dealt to 381c6d82 
Dealt to 6f565fd 
Dealt to 1e474bac 
Dealt to Hero [6h Qh]
6f565fd: folds
1e474bac: raises $0.05 to $0.1
Hero: folds
25f30dbe: raises $0.2 to $0.3
717e9861: folds
381c6d82: folds
1e474bac: folds
Uncalled bet ($0.2) returned to 25f30dbe
*** SHOWDOWN ***
25f30dbe collected $0.26 from pot
*** SUMMARY ***
Total pot $0.27 | Rake $0.01 | Jackpot $0 | Bingo $0 | Fortune $0 | Tax $0
Seat 1: 25f30dbe (button) collected ($0.26)
Seat 2: 717e9861 (small blind) folded before Flop
Seat 3: 381c6d82 (big blind) folded before Flop
Seat 4: 6f565fd folded before Flop (didn't bet)
Seat 5: 1e474bac folded before Flop
Seat 6: Hero folded before Flop (didn't bet)


Poker Hand #RC3334484599: Hold'em No Limit ($0.02/$0.05) - 2025/02/17 21:13:28
Table 'RushAndCash619859' 6-max Seat #1 is the button
Seat 1: 9604af2 ($7.64 in chips)
Seat 2: Hero ($5 in chips)
Seat 3: a9472a77 ($2.91 in chips)
Seat 4: edf64ec2 ($5 in chips)
Seat 5: 515dd56 ($4.36 in chips)
Seat 6: 1e474bac ($5 in chips)
Hero: posts small blind $0.02
a9472a77: posts big blind $0.05
*** HOLE CARDS ***
Dealt to 9604af2 
Dealt to Hero [6s 9c]
Dealt to a9472a77 
Dealt to edf64ec2 
Dealt to 515dd56 
Dealt to 1e474bac 
edf64ec2: folds
515dd56: folds
1e474bac: folds
9604af2: folds
Hero: folds
Uncalled bet ($0.03) returned to a9472a77
*** SHOWDOWN ***
a9472a77 collected $0.04 from pot
*** SUMMARY ***
Total pot $0.04 | Rake $0 | Jackpot $0 | Bingo $0 | Fortune $0 | Tax $0
Seat 1: 9604af2 (button) folded before Flop (didn't bet)
Seat 2: Hero (small blind) folded before Flop
Seat 3: a9472a77 (big blind) collected ($0.04)
Seat 4: edf64ec2 folded before Flop (didn't bet)
Seat 5: 515dd56 folded before Flop (didn't bet)
Seat 6: 1e474bac folded before Flop (didn't bet)


Poker Hand #RC3334484576: Hold'em No Limit ($0.02/$0.05) - 2025/02/17 21:13:25
Table 'RushAndCash619836' 6-max Seat #1 is the button
Seat 1: Hero ($5 in chips)
Seat 2: fad7078a ($5.81 in chips)
Seat 3: 18767060 ($10.34 in chips)
Seat 4: e7c4d687 ($2.34 in chips)
Seat 5: 22a3f0e8 ($6.8 in chips)
Seat 6: 93a9dba6 ($5 in chips)
fad7078a: posts small blind $0.02
18767060: posts big blind $0.05
*** HOLE CARDS ***
Dealt to Hero [3h Qs]
Dealt to fad7078a 
Dealt to 18767060 
Dealt to e7c4d687 
Dealt to 22a3f0e8 
Dealt to 93a9dba6 
e7c4d687: raises $0.05 to $0.1
22a3f0e8: folds
93a9dba6: raises $0.21 to $0.31
Hero: folds
fad7078a: folds
18767060: folds
e7c4d687: calls $0.21
*** FLOP *** [Js Qh 4s]
e7c4d687: checks
93a9dba6: bets $0.23
e7c4d687: raises $0.58 to $0.81
93a9dba6: calls $0.58
*** TURN *** [Js Qh 4s] [Qd]
e7c4d687: bets $1.22 and is all-in
93a9dba6: calls $1.22
e7c4d687: shows [6s 9s] (Pair of Queens)
93a9dba6: shows [Jh As] (Pair of Queens and Pair of Jacks)
*** RIVER *** [Js Qh 4s Qd] [8s]
*** SHOWDOWN ***
e7c4d687 collected $4.53 from pot
*** SUMMARY ***
Total pot $4.75 | Rake $0.15 | Jackpot $0.07 | Bingo $0 | Fortune $0 | Tax $0
Board [Js Qh 4s Qd 8s]
Seat 1: Hero (button) folded before Flop (didn't bet)
Seat 2: fad7078a (small blind) folded before Flop
Seat 3: 18767060 (big blind) folded before Flop
Seat 4: e7c4d687 showed [6s 9s] and won ($4.53) with Jack High Flush
Seat 5: 22a3f0e8 folded before Flop (didn't bet)
Seat 6: 93a9dba6 showed [Jh As] and lost with Pair of Queens and Pair of Jacks


Poker Hand #RC3334484548: Hold'em No Limit ($0.02/$0.05) - 2025/02/17 21:13:21
Table 'RushAndCash619808' 6-max Seat #1 is the button
Seat 1: 66981141 ($10.63 in chips)
Seat 2: 8d31c727 ($10.65 in chips)
Seat 3: e3b51b04 ($8.67 in chips)
Seat 4: 22a3f0e8 ($6.8 in chips)
Seat 5: a73946fe ($4.91 in chips)
Seat 6: Hero ($5 in chips)
8d31c727: posts small blind $0.02
e3b51b04: posts big blind $0.05
*** HOLE CARDS ***
Dealt to 66981141 
Dealt to 8d31c727 
Dealt to e3b51b04 
Dealt to 22a3f0e8 
Dealt to a73946fe 
Dealt to Hero [6c Qs]
22a3f0e8: folds
a73946fe: folds
Hero: folds
66981141: raises $0.12 to $0.17
8d31c727: folds
e3b51b04: folds
Uncalled bet ($0.12) returned to 66981141
*** SHOWDOWN ***
66981141 collected $0.12 from pot
*** SUMMARY ***
Total pot $0.12 | Rake $0 | Jackpot $0 | Bingo $0 | Fortune $0 | Tax $0
Seat 1: 66981141 (button) collected ($0.12)
Seat 2: 8d31c727 (small blind) folded before Flop
Seat 3: e3b51b04 (big blind) folded before Flop
Seat 4: 22a3f0e8 folded before Flop (didn't bet)
Seat 5: a73946fe folded before Flop (didn't bet)
Seat 6: Hero folded before Flop (didn't bet)


Poker Hand #RC3334484464: Hold'em No Limit ($0.02/$0.05) - 2025/02/17 21:13:10
Table 'RushAndCash619724' 6-max Seat #1 is the button
Seat 1: 3b85f8e6 ($8.24 in chips)
Seat 2: 90c3e611 ($5 in chips)
Seat 3: 45d33c76 ($8.93 in chips)
Seat 4: Hero ($5.01 in chips)
Seat 5: d7f656ca ($6.33 in chips)
Seat 6: 54c506e4 ($5.05 in chips)
90c3e611: posts small blind $0.02
45d33c76: posts big blind $0.05
*** HOLE CARDS ***
Dealt to 3b85f8e6 
Dealt to 90c3e611 
Dealt to 45d33c76 
Dealt to Hero [Qd Td]
Dealt to d7f656ca 
Dealt to 54c506e4 
Hero: raises $0.05 to $0.1
d7f656ca: folds
54c506e4: folds
3b85f8e6: raises $0.28 to $0.38
90c3e611: folds
45d33c76: folds
Hero: folds
Uncalled bet ($0.28) returned to 3b85f8e6
*** SHOWDOWN ***
3b85f8e6 collected $0.26 from pot
*** SUMMARY ***
Total pot $0.27 | Rake $0.01 | Jackpot $0 | Bingo $0 | Fortune $0 | Tax $0
Seat 1: 3b85f8e6 (button) collected ($0.26)
Seat 2: 90c3e611 (small blind) folded before Flop
Seat 3: 45d33c76 (big blind) folded before Flop
Seat 4: Hero folded before Flop
Seat 5: d7f656ca folded before Flop (didn't bet)
Seat 6: 54c506e4 folded before Flop (didn't bet)


Poker Hand #RC3334484436: Hold'em No Limit ($0.02/$0.05) - 2025/02/17 21:13:07
Table 'RushAndCash619696' 6-max Seat #1 is the button
Seat 1: 5bf5cd50 ($5.15 in chips)
Seat 2: Hero ($5.03 in chips)
Seat 3: 5422bec9 ($5.18 in chips)
Seat 4: 45d33c76 ($8.93 in chips)
Seat 5: c7197736 ($5 in chips)
Seat 6: 54c506e4 ($5.05 in chips)
Hero: posts small blind $0.02
5422bec9: posts big blind $0.05
*** HOLE CARDS ***
Dealt to 5bf5cd50 
Dealt to Hero [8c Ks]
Dealt to 5422bec9 
Dealt to 45d33c76 
Dealt to c7197736 
Dealt to 54c506e4 
45d33c76: folds
c7197736: folds
54c506e4: folds
5bf5cd50: folds
Hero: folds
Uncalled bet ($0.03) returned to 5422bec9
*** SHOWDOWN ***
5422bec9 collected $0.04 from pot
*** SUMMARY ***
Total pot $0.04 | Rake $0 | Jackpot $0 | Bingo $0 | Fortune $0 | Tax $0
Seat 1: 5bf5cd50 (button) folded before Flop (didn't bet)
Seat 2: Hero (small blind) folded before Flop
Seat 3: 5422bec9 (big blind) collected ($0.04)
Seat 4: 45d33c76 folded before Flop (didn't bet)
Seat 5: c7197736 folded before Flop (didn't bet)
Seat 6: 54c506e4 folded before Flop (didn't bet)


Poker Hand #RC3334484407: Hold'em No Limit ($0.02/$0.05) - 2025/02/17 21:13:04
Table 'RushAndCash619667' 6-max Seat #1 is the button
Seat 1: Hero ($5.03 in chips)
Seat 2: eff2ac0d ($2.77 in chips)
Seat 3: ccabd9d2 ($5.21 in chips)
Seat 4: 70521b8f ($5.17 in chips)
Seat 5: 229ec9a7 ($6.76 in chips)
Seat 6: 8ab2eae7 ($5.08 in chips)
eff2ac0d: posts small blind $0.02
ccabd9d2: posts big blind $0.05
*** HOLE CARDS ***
Dealt to Hero [3d Qs]
Dealt to eff2ac0d 
Dealt to ccabd9d2 
Dealt to 70521b8f 
Dealt to 229ec9a7 
Dealt to 8ab2eae7 
70521b8f: folds
229ec9a7: folds
8ab2eae7: folds
Hero: folds
eff2ac0d: folds
Uncalled bet ($0.03) returned to ccabd9d2
*** SHOWDOWN ***
ccabd9d2 collected $0.04 from pot
*** SUMMARY ***
Total pot $0.04 | Rake $0 | Jackpot $0 | Bingo $0 | Fortune $0 | Tax $0
Seat 1: Hero (button) folded before Flop (didn't bet)
Seat 2: eff2ac0d (small blind) folded before Flop
Seat 3: ccabd9d2 (big blind) collected ($0.04)
Seat 4: 70521b8f folded before Flop (didn't bet)
Seat 5: 229ec9a7 folded before Flop (didn't bet)
Seat 6: 8ab2eae7 folded before Flop (didn't bet)


Poker Hand #RC3334484297: Hold'em No Limit ($0.02/$0.05) - 2025/02/17 21:12:49
Table 'RushAndCash619557' 6-max Seat #1 is the button
Seat 1: 21c758a ($5.59 in chips)
Seat 2: 677c4b25 ($9.37 in chips)
Seat 3: Hero ($5.08 in chips)
Seat 4: ccabd9d2 ($5.21 in chips)
Seat 5: 65ca9276 ($8.6 in chips)
Seat 6: c4dfffce ($6.79 in chips)
677c4b25: posts small blind $0.02
Hero: posts big blind $0.05
*** HOLE CARDS ***
Dealt to 21c758a 
Dealt to 677c4b25 
Dealt to Hero [9s Ks]
Dealt to ccabd9d2 
Dealt to 65ca9276 
Dealt to c4dfffce 
ccabd9d2: folds
65ca9276: folds
c4dfffce: raises $0.06 to $0.11
21c758a: raises $0.29 to $0.4
677c4b25: folds
Hero: folds
c4dfffce: calls $0.29
*** FLOP *** [3d Ah Tc]
c4dfffce: checks
21c758a: checks
*** TURN *** [3d Ah Tc] [Kd]
c4dfffce: checks
21c758a: bets $0.44
c4dfffce: calls $0.44
*** RIVER *** [3d Ah Tc Kd] [8s]
c4dfffce: checks
21c758a: checks
c4dfffce: shows [Th Jh] (Pair of Tens)
21c758a: shows [As Jc] (Pair of Aces)
*** SHOWDOWN ***
21c758a collected $1.6 from pot
*** SUMMARY ***
Total pot $1.75 | Rake $0.08 | Jackpot $0.07 | Bingo $0 | Fortune $0 | Tax $0
Board [3d Ah Tc Kd 8s]
Seat 1: 21c758a (button) showed [As Jc] and won ($1.6) with Pair of Aces
Seat 2: 677c4b25 (small blind) folded before Flop
Seat 3: Hero (big blind) folded before Flop
Seat 4: ccabd9d2 folded before Flop (didn't bet)
Seat 5: 65ca9276 folded before Flop (didn't bet)
Seat 6: c4dfffce showed [Th Jh] and lost with Pair of Tens


Poker Hand #RC3334484277: Hold'em No Limit ($0.02/$0.05) - 2025/02/17 21:12:46
Table 'RushAndCash619537' 6-max Seat #1 is the button
Seat 1: c635f4d8 ($5.16 in chips)
Seat 2: b9d877b0 ($5 in chips)
Seat 3: Hero ($5.13 in chips)
Seat 4: b9ae439d ($3.77 in chips)
Seat 5: 57a66aa7 ($5.28 in chips)
Seat 6: b39a93ce ($7.83 in chips)
b9d877b0: posts small blind $0.02
Hero: posts big blind $0.05
*** HOLE CARDS ***
Dealt to c635f4d8 
Dealt to b9d877b0 
Dealt to Hero [3c Ks]
Dealt to b9ae439d 
Dealt to 57a66aa7 
Dealt to b39a93ce 
b9ae439d: folds
57a66aa7: folds
b39a93ce: raises $0.05 to $0.1
c635f4d8: calls $0.1
b9d877b0: folds
Hero: folds
*** FLOP *** [9d Jh 8c]
b39a93ce: bets $0.1
c635f4d8: calls $0.1
*** TURN *** [9d Jh 8c] [5s]
b39a93ce: checks
c635f4d8: bets $0.36
b39a93ce: folds
Uncalled bet ($0.36) returned to c635f4d8
*** SHOWDOWN ***
c635f4d8 collected $0.45 from pot
*** SUMMARY ***
Total pot $0.47 | Rake $0.02 | Jackpot $0 | Bingo $0 | Fortune $0 | Tax $0
Board [9d Jh 8c 5s]
Seat 1: c635f4d8 (button) won ($0.45)
Seat 2: b9d877b0 (small blind) folded before Flop
Seat 3: Hero (big blind) folded before Flop
Seat 4: b9ae439d folded before Flop (didn't bet)
Seat 5: 57a66aa7 folded before Flop (didn't bet)
Seat 6: b39a93ce folded on the Turn


Poker Hand #RC3334484019: Hold'em No Limit ($0.02/$0.05) - 2025/02/17 21:12:11
Table 'RushAndCash619279' 6-max Seat #1 is the button
Seat 1: cf6d512a ($3.78 in chips)
Seat 2: 4812f5c8 ($5.46 in chips)
Seat 3: 5c14c443 ($5.26 in chips)
Seat 4: 22a3f0e8 ($7.2 in chips)
Seat 5: 4238ab48 ($6.31 in chips)
Seat 6: Hero ($5.26 in chips)
4812f5c8: posts small blind $0.02
5c14c443: posts big blind $0.05
*** HOLE CARDS ***
Dealt to cf6d512a 
Dealt to 4812f5c8 
Dealt to 5c14c443 
Dealt to 22a3f0e8 
Dealt to 4238ab48 
Dealt to Hero [3s 3h]
22a3f0e8: folds
4238ab48: raises $0.08 to $0.13
Hero: calls $0.13
cf6d512a: folds
4812f5c8: folds
5c14c443: calls $0.08
*** FLOP *** [5c 7c 2c]
5c14c443: checks
4238ab48: checks
Hero: checks
*** TURN *** [5c 7c 2c] [Ts]
5c14c443: bets $0.14
4238ab48: folds
Hero: folds
Uncalled bet ($0.14) returned to 5c14c443
*** SHOWDOWN ***
5c14c443 collected $0.39 from pot
*** SUMMARY ***
Total pot $0.41 | Rake $0.02 | Jackpot $0 | Bingo $0 | Fortune $0 | Tax $0
Board [5c 7c 2c Ts]
Seat 1: cf6d512a (button) folded before Flop (didn't bet)
Seat 2: 4812f5c8 (small blind) folded before Flop
Seat 3: 5c14c443 (big blind) won ($0.39)
Seat 4: 22a3f0e8 folded before Flop (didn't bet)
Seat 5: 4238ab48 folded on the Turn
Seat 6: Hero folded on the Turn


Poker Hand #RC3334483989: Hold'em No Limit ($0.02/$0.05) - 2025/02/17 21:12:07
Table 'RushAndCash619249' 6-max Seat #1 is the button
Seat 1: 711af4a4 ($11.85 in chips)
Seat 2: cf6d512a ($3.8 in chips)
Seat 3: c635f4d8 ($5 in chips)
Seat 4: bf84714d ($5.95 in chips)
Seat 5: c7197736 ($5.04 in chips)
Seat 6: Hero ($5.26 in chips)
cf6d512a: posts small blind $0.02
c635f4d8: posts big blind $0.05
*** HOLE CARDS ***
Dealt to 711af4a4 
Dealt to cf6d512a 
Dealt to c635f4d8 
Dealt to bf84714d 
Dealt to c7197736 
Dealt to Hero [Kh 5s]
bf84714d: folds
c7197736: folds
Hero: folds
711af4a4: folds
cf6d512a: folds
Uncalled bet ($0.03) returned to c635f4d8
*** SHOWDOWN ***
c635f4d8 collected $0.04 from pot
*** SUMMARY ***
Total pot $0.04 | Rake $0 | Jackpot $0 | Bingo $0 | Fortune $0 | Tax $0
Seat 1: 711af4a4 (button) folded before Flop (didn't bet)
Seat 2: cf6d512a (small blind) folded before Flop
Seat 3: c635f4d8 (big blind) collected ($0.04)
Seat 4: bf84714d folded before Flop (didn't bet)
Seat 5: c7197736 folded before Flop (didn't bet)
Seat 6: Hero folded before Flop (didn't bet)


Poker Hand #RC3334483753: Hold'em No Limit ($0.02/$0.05) - 2025/02/17 21:11:37
Table 'RushAndCash619013' 6-max Seat #1 is the button
Seat 1: bf84714d ($5.79 in chips)
Seat 2: c27051e0 ($5.27 in chips)
Seat 3: f2a32196 ($7.67 in chips)
Seat 4: 753630f ($5.08 in chips)
Seat 5: be2277bf ($5.12 in chips)
Seat 6: Hero ($5.36 in chips)
c27051e0: posts small blind $0.02
f2a32196: posts big blind $0.05
*** HOLE CARDS ***
Dealt to bf84714d 
Dealt to c27051e0 
Dealt to f2a32196 
Dealt to 753630f 
Dealt to be2277bf 
Dealt to Hero [Js Kh]
753630f: folds
be2277bf: folds
Hero: raises $0.05 to $0.1
bf84714d: raises $0.26 to $0.36
c27051e0: folds
f2a32196: folds
Hero: folds
Uncalled bet ($0.26) returned to bf84714d
*** SHOWDOWN ***
bf84714d collected $0.26 from pot
*** SUMMARY ***
Total pot $0.27 | Rake $0.01 | Jackpot $0 | Bingo $0 | Fortune $0 | Tax $0
Seat 1: bf84714d (button) collected ($0.26)
Seat 2: c27051e0 (small blind) folded before Flop
Seat 3: f2a32196 (big blind) folded before Flop
Seat 4: 753630f folded before Flop (didn't bet)
Seat 5: be2277bf folded before Flop (didn't bet)
Seat 6: Hero folded before Flop


Poker Hand #RC3334483721: Hold'em No Limit ($0.02/$0.05) - 2025/02/17 21:11:34
Table 'RushAndCash618981' 6-max Seat #1 is the button
Seat 1: Hero ($5.36 in chips)
Seat 2: a1fd9df7 ($6.34 in chips)
Seat 3: 7cef55a1 ($5.65 in chips)
Seat 4: 5858308f ($5.54 in chips)
Seat 5: c1f4858e ($5 in chips)
Seat 6: 94c257a9 ($7.79 in chips)
a1fd9df7: posts small blind $0.02
7cef55a1: posts big blind $0.05
*** HOLE CARDS ***
Dealt to Hero [Jd 3s]
Dealt to a1fd9df7 
Dealt to 7cef55a1 
Dealt to 5858308f 
Dealt to c1f4858e 
Dealt to 94c257a9 
5858308f: raises $0.05 to $0.1
c1f4858e: folds
94c257a9: calls $0.1
Hero: folds
a1fd9df7: folds
7cef55a1: folds
*** FLOP *** [Jc Qs Kd]
5858308f: checks
94c257a9: bets $0.1
5858308f: raises $0.36 to $0.46
94c257a9: folds
Uncalled bet ($0.36) returned to 5858308f
*** SHOWDOWN ***
5858308f collected $0.45 from pot
*** SUMMARY ***
Total pot $0.47 | Rake $0.02 | Jackpot $0 | Bingo $0 | Fortune $0 | Tax $0
Board [Jc Qs Kd]
Seat 1: Hero (button) folded before Flop (didn't bet)
Seat 2: a1fd9df7 (small blind) folded before Flop
Seat 3: 7cef55a1 (big blind) folded before Flop
Seat 4: 5858308f won ($0.45)
Seat 5: c1f4858e folded before Flop (didn't bet)
Seat 6: 94c257a9 folded on the Flop


Poker Hand #RC3334483647: Hold'em No Limit ($0.02/$0.05) - 2025/02/17 21:11:25
Table 'RushAndCash618907' 6-max Seat #1 is the button
Seat 1: e4d8df1d ($5.19 in chips)
Seat 2: Hero ($5.38 in chips)
Seat 3: 66be2112 ($5.06 in chips)
Seat 4: ef7e6107 ($5 in chips)
Seat 5: 1e2c3e8b ($5.55 in chips)
Seat 6: 93056ee9 ($6.75 in chips)
Hero: posts small blind $0.02
66be2112: posts big blind $0.05
*** HOLE CARDS ***
Dealt to e4d8df1d 
Dealt to Hero [2c 2h]
Dealt to 66be2112 
Dealt to ef7e6107 
Dealt to 1e2c3e8b 
Dealt to 93056ee9 
ef7e6107: folds
1e2c3e8b: raises $0.08 to $0.13
93056ee9: folds
e4d8df1d: folds
Hero: folds
66be2112: folds
Uncalled bet ($0.08) returned to 1e2c3e8b
*** SHOWDOWN ***
1e2c3e8b collected $0.12 from pot
*** SUMMARY ***
Total pot $0.12 | Rake $0 | Jackpot $0 | Bingo $0 | Fortune $0 | Tax $0
Seat 1: e4d8df1d (button) folded before Flop (didn't bet)
Seat 2: Hero (small blind) folded before Flop
Seat 3: 66be2112 (big blind) folded before Flop
Seat 4: ef7e6107 folded before Flop (didn't bet)
Seat 5: 1e2c3e8b collected ($0.12)
Seat 6: 93056ee9 folded before Flop (didn't bet)


Poker Hand #RC3334483618: Hold'em No Limit ($0.02/$0.05) - 2025/02/17 21:11:22
Table 'RushAndCash618878' 6-max Seat #1 is the button
Seat 1: 8f1315bb ($6.21 in chips)
Seat 2: 8f77797e ($5.8 in chips)
Seat 3: 57a66aa7 ($5.16 in chips)
Seat 4: e89f6814 ($1.8 in chips)
Seat 5: Hero ($5.38 in chips)
Seat 6: f71501ed ($5.15 in chips)
8f77797e: posts small blind $0.02
57a66aa7: posts big blind $0.05
*** HOLE CARDS ***
Dealt to 8f1315bb 
Dealt to 8f77797e 
Dealt to 57a66aa7 
Dealt to e89f6814 
Dealt to Hero [7h 2d]
Dealt to f71501ed 
e89f6814: raises $0.05 to $0.1
Hero: folds
f71501ed: folds
8f1315bb: folds
8f77797e: folds
57a66aa7: calls $0.05
*** FLOP *** [8c 6d 3h]
57a66aa7: checks
e89f6814: bets $0.11
57a66aa7: calls $0.11
*** TURN *** [8c 6d 3h] [2h]
57a66aa7: checks
e89f6814: checks
*** RIVER *** [8c 6d 3h 2h] [Th]
57a66aa7: bets $0.39
e89f6814: folds
Uncalled bet ($0.39) returned to 57a66aa7
*** SHOWDOWN ***
57a66aa7 collected $0.42 from pot
*** SUMMARY ***
Total pot $0.44 | Rake $0.02 | Jackpot $0 | Bingo $0 | Fortune $0 | Tax $0
Board [8c 6d 3h 2h Th]
Seat 1: 8f1315bb (button) folded before Flop (didn't bet)
Seat 2: 8f77797e (small blind) folded before Flop
Seat 3: 57a66aa7 (big blind) won ($0.42)
Seat 4: e89f6814 folded on the River
Seat 5: Hero folded before Flop (didn't bet)
Seat 6: f71501ed folded before Flop (didn't bet)


Poker Hand #RC3334483590: Hold'em No Limit ($0.02/$0.05) - 2025/02/17 21:11:18
Table 'RushAndCash618850' 6-max Seat #1 is the button
Seat 1: a63aa4b7 ($19.03 in chips)
Seat 2: 70545399 ($3.56 in chips)
Seat 3: 94c257a9 ($7.84 in chips)
Seat 4: 717e9861 ($7.72 in chips)
Seat 5: Hero ($5.38 in chips)
Seat 6: 66981141 ($10.64 in chips)
70545399: posts small blind $0.02
94c257a9: posts big blind $0.05
*** HOLE CARDS ***
Dealt to a63aa4b7 
Dealt to 70545399 
Dealt to 94c257a9 
Dealt to 717e9861 
Dealt to Hero [Th 5c]
Dealt to 66981141 
717e9861: folds
Hero: folds
66981141: raises $0.05 to $0.1
a63aa4b7: folds
70545399: folds
94c257a9: folds
Uncalled bet ($0.05) returned to 66981141
*** SHOWDOWN ***
66981141 collected $0.12 from pot
*** SUMMARY ***
Total pot $0.12 | Rake $0 | Jackpot $0 | Bingo $0 | Fortune $0 | Tax $0
Seat 1: a63aa4b7 (button) folded before Flop (didn't bet)
Seat 2: 70545399 (small blind) folded before Flop
Seat 3: 94c257a9 (big blind) folded before Flop
Seat 4: 717e9861 folded before Flop (didn't bet)
Seat 5: Hero folded before Flop (didn't bet)
Seat 6: 66981141 collected ($0.12)


Poker Hand #RC3334483564: Hold'em No Limit ($0.02/$0.05) - 2025/02/17 21:11:15
Table 'RushAndCash618824' 6-max Seat #1 is the button
Seat 1: d2b9404f ($5.98 in chips)
Seat 2: 8e5db286 ($10.91 in chips)
Seat 3: 8bfa05cc ($5.55 in chips)
Seat 4: Hero ($5.38 in chips)
Seat 5: b4c33f6c ($5.63 in chips)
Seat 6: a86de18f ($0.81 in chips)
8e5db286: posts small blind $0.02
8bfa05cc: posts big blind $0.05
*** HOLE CARDS ***
Dealt to d2b9404f 
Dealt to 8e5db286 
Dealt to 8bfa05cc 
Dealt to Hero [Kh 5s]
Dealt to b4c33f6c 
Dealt to a86de18f 
Hero: folds
b4c33f6c: folds
a86de18f: folds
d2b9404f: folds
8e5db286: raises $0.07 to $0.12
8bfa05cc: raises $0.28 to $0.4
8e5db286: calls $0.28
*** FLOP *** [Kc 7s 2h]
8e5db286: bets $0.4
8bfa05cc: calls $0.4
*** TURN *** [Kc 7s 2h] [4d]
8e5db286: checks
8bfa05cc: checks
*** RIVER *** [Kc 7s 2h 4d] [Th]
8e5db286: checks
8bfa05cc: checks
8e5db286: shows [Jh Qd] (King-High)
8bfa05cc: shows [Qs Ah] (Ace-High)
*** SHOWDOWN ***
8bfa05cc collected $1.46 from pot
*** SUMMARY ***
Total pot $1.6 | Rake $0.07 | Jackpot $0.07 | Bingo $0 | Fortune $0 | Tax $0
Board [Kc 7s 2h 4d Th]
Seat 1: d2b9404f (button) folded before Flop (didn't bet)
Seat 2: 8e5db286 (small blind) showed [Jh Qd] and lost with King-High
Seat 3: 8bfa05cc (big blind) showed [Qs Ah] and won ($1.46) with Ace-High
Seat 4: Hero folded before Flop (didn't bet)
Seat 5: b4c33f6c folded before Flop (didn't bet)
Seat 6: a86de18f folded before Flop (didn't bet)


Poker Hand #RC3334483490: Hold'em No Limit ($0.02/$0.05) - 2025/02/17 21:11:05
Table 'RushAndCash618750' 6-max Seat #1 is the button
Seat 1: 1b6c31ec ($6.79 in chips)
Seat 2: a73946fe ($4.35 in chips)
Seat 3: Hero ($5.43 in chips)
Seat 4: 820e1571 ($5.12 in chips)
Seat 5: c1784884 ($5 in chips)
Seat 6: afceb40a ($3.21 in chips)
a73946fe: posts small blind $0.02
Hero: posts big blind $0.05
*** HOLE CARDS ***
Dealt to 1b6c31ec 
Dealt to a73946fe 
Dealt to Hero [8h 3h]
Dealt to 820e1571 
Dealt to c1784884 
Dealt to afceb40a 
820e1571: folds
c1784884: folds
afceb40a: folds
1b6c31ec: folds
a73946fe: raises $0.1 to $0.15
Hero: folds
Uncalled bet ($0.1) returned to a73946fe
*** SHOWDOWN ***
a73946fe collected $0.1 from pot
*** SUMMARY ***
Total pot $0.1 | Rake $0 | Jackpot $0 | Bingo $0 | Fortune $0 | Tax $0
Seat 1: 1b6c31ec (button) folded before Flop (didn't bet)
Seat 2: a73946fe (small blind) collected ($0.1)
Seat 3: Hero (big blind) folded before Flop
Seat 4: 820e1571 folded before Flop (didn't bet)
Seat 5: c1784884 folded before Flop (didn't bet)
Seat 6: afceb40a folded before Flop (didn't bet)


Poker Hand #RC3334483446: Hold'em No Limit ($0.02/$0.05) - 2025/02/17 21:10:58
Table 'RushAndCash618706' 6-max Seat #1 is the button
Seat 1: f1a26906 ($5.36 in chips)
Seat 2: 8ab2eae7 ($5 in chips)
Seat 3: 99df5763 ($7.72 in chips)
Seat 4: 3f9611b6 ($4.96 in chips)
Seat 5: 9165e0e3 ($7.84 in chips)
Seat 6: Hero ($5.43 in chips)
8ab2eae7: posts small blind $0.02
99df5763: posts big blind $0.05
*** HOLE CARDS ***
Dealt to f1a26906 
Dealt to 8ab2eae7 
Dealt to 99df5763 
Dealt to 3f9611b6 
Dealt to 9165e0e3 
Dealt to Hero [8h 6s]
3f9611b6: folds
9165e0e3: folds
Hero: folds
f1a26906: folds
8ab2eae7: raises $0.07 to $0.12
99df5763: calls $0.07
*** FLOP *** [6c Kh 8c]
8ab2eae7: bets $0.06
99df5763: folds
Uncalled bet ($0.06) returned to 8ab2eae7
*** SHOWDOWN ***
8ab2eae7 collected $0.23 from pot
*** SUMMARY ***
Total pot $0.24 | Rake $0.01 | Jackpot $0 | Bingo $0 | Fortune $0 | Tax $0
Board [6c Kh 8c]
Seat 1: f1a26906 (button) folded before Flop (didn't bet)
Seat 2: 8ab2eae7 (small blind) won ($0.23)
Seat 3: 99df5763 (big blind) folded on the Flop
Seat 4: 3f9611b6 folded before Flop (didn't bet)
Seat 5: 9165e0e3 folded before Flop (didn't bet)
Seat 6: Hero folded before Flop (didn't bet)


Poker Hand #RC3334483415: Hold'em No Limit ($0.02/$0.05) - 2025/02/17 21:10:55
Table 'RushAndCash618675' 6-max Seat #1 is the button
Seat 1: fd5b33a8 ($4.04 in chips)
Seat 2: 5dd6ae74 ($4.99 in chips)
Seat 3: afceb40a ($3.26 in chips)
Seat 4: fe9dbb50 ($5.25 in chips)
Seat 5: f68df189 ($5.74 in chips)
Seat 6: Hero ($5.43 in chips)
5dd6ae74: posts small blind $0.02
afceb40a: posts big blind $0.05
*** HOLE CARDS ***
Dealt to fd5b33a8 
Dealt to 5dd6ae74 
Dealt to afceb40a 
Dealt to fe9dbb50 
Dealt to f68df189 
Dealt to Hero [3c Kc]
fe9dbb50: raises $0.05 to $0.1
f68df189: folds
Hero: folds
fd5b33a8: folds
5dd6ae74: folds
afceb40a: folds
Uncalled bet ($0.05) returned to fe9dbb50
*** SHOWDOWN ***
fe9dbb50 collected $0.12 from pot
*** SUMMARY ***
Total pot $0.12 | Rake $0 | Jackpot $0 | Bingo $0 | Fortune $0 | Tax $0
Seat 1: fd5b33a8 (button) folded before Flop (didn't bet)
Seat 2: 5dd6ae74 (small blind) folded before Flop
Seat 3: afceb40a (big blind) folded before Flop
Seat 4: fe9dbb50 collected ($0.12)
Seat 5: f68df189 folded before Flop (didn't bet)
Seat 6: Hero folded before Flop (didn't bet)


Poker Hand #RC3334483331: Hold'em No Limit ($0.02/$0.05) - 2025/02/17 21:10:44
Table 'RushAndCash618591' 6-max Seat #1 is the button
Seat 1: e9396ee6 ($6.23 in chips)
Seat 2: Hero ($5.45 in chips)
Seat 3: 76fbfdb7 ($5.05 in chips)
Seat 4: 82282522 ($5.34 in chips)
Seat 5: b2966865 ($5.21 in chips)
Seat 6: 3ff27d73 ($5 in chips)
Cash Drop to Pot : total $0.5 
Hero: posts small blind $0.02
76fbfdb7: posts big blind $0.05
*** HOLE CARDS ***
Dealt to e9396ee6 
Dealt to Hero [Js 2c]
Dealt to 76fbfdb7 
Dealt to 82282522 
Dealt to b2966865 
Dealt to 3ff27d73 
82282522: raises $0.1 to $0.15
b2966865: raises $5.06 to $5.21 and is all-in
3ff27d73: folds
e9396ee6: folds
Hero: folds
76fbfdb7: folds
82282522: calls $5.06
b2966865: shows [6s Ad]
82282522: shows [Kh Ac]
*** FLOP *** [Ts 6d 5s]
b2966865: Chooses to EV Cashout
*** TURN *** [Ts 6d 5s] [8s]
*** RIVER *** [Ts 6d 5s 8s] [Th]
b2966865: Pays Cashout Risk ($1.57)
*** SHOWDOWN ***
b2966865 collected $10.77 from pot
*** SUMMARY ***
Total pot $10.99 | Rake $0.15 | Jackpot $0.07 | Bingo $0 | Fortune $0 | Tax $0
Board [Ts 6d 5s 8s Th]
Seat 1: e9396ee6 (button) folded before Flop (didn't bet)
Seat 2: Hero (small blind) folded before Flop
Seat 3: 76fbfdb7 (big blind) folded before Flop
Seat 4: 82282522 showed [Kh Ac] and lost with Pair of Tens
Seat 5: b2966865 showed [6s Ad] and won ($10.77) with Pair of Tens and Pair of Sixes, Cashout Risk ($1.57)
Seat 6: 3ff27d73 folded before Flop (didn't bet)


Poker Hand #RC3334483271: Hold'em No Limit ($0.02/$0.05) - 2025/02/17 21:10:37
Table 'RushAndCash618531' 6-max Seat #1 is the button
Seat 1: Hero ($5.45 in chips)
Seat 2: 9f09d482 ($8.86 in chips)
Seat 3: e20e5cfc ($6.09 in chips)
Seat 4: b67f7812 ($9.43 in chips)
Seat 5: a2123cbe ($11.99 in chips)
Seat 6: 8bfa05cc ($5.01 in chips)
9f09d482: posts small blind $0.02
e20e5cfc: posts big blind $0.05
*** HOLE CARDS ***
Dealt to Hero [4c 8h]
Dealt to 9f09d482 
Dealt to e20e5cfc 
Dealt to b67f7812 
Dealt to a2123cbe 
Dealt to 8bfa05cc 
b67f7812: folds
a2123cbe: raises $0.05 to $0.1
8bfa05cc: folds
Hero: folds
9f09d482: folds
e20e5cfc: folds
Uncalled bet ($0.05) returned to a2123cbe
*** SHOWDOWN ***
a2123cbe collected $0.12 from pot
*** SUMMARY ***
Total pot $0.12 | Rake $0 | Jackpot $0 | Bingo $0 | Fortune $0 | Tax $0
Seat 1: Hero (button) folded before Flop (didn't bet)
Seat 2: 9f09d482 (small blind) folded before Flop
Seat 3: e20e5cfc (big blind) folded before Flop
Seat 4: b67f7812 folded before Flop (didn't bet)
Seat 5: a2123cbe collected ($0.12)
Seat 6: 8bfa05cc folded before Flop (didn't bet)


Poker Hand #RC3334483200: Hold'em No Limit ($0.02/$0.05) - 2025/02/17 21:10:28
Table 'RushAndCash618460' 6-max Seat #1 is the button
Seat 1: 21c758a ($5.66 in chips)
Seat 2: 92e1348d ($8.13 in chips)
Seat 3: Hero ($5.5 in chips)
Seat 4: 82282522 ($5.27 in chips)
Seat 5: 4e3c3196 ($28.39 in chips)
Seat 6: 3dd0afef ($6.83 in chips)
92e1348d: posts small blind $0.02
Hero: posts big blind $0.05
*** HOLE CARDS ***
Dealt to 21c758a 
Dealt to 92e1348d 
Dealt to Hero [Kc 4c]
Dealt to 82282522 
Dealt to 4e3c3196 
Dealt to 3dd0afef 
82282522: raises $0.1 to $0.15
4e3c3196: folds
3dd0afef: folds
21c758a: folds
92e1348d: folds
Hero: folds
Uncalled bet ($0.1) returned to 82282522
*** SHOWDOWN ***
82282522 collected $0.12 from pot
*** SUMMARY ***
Total pot $0.12 | Rake $0 | Jackpot $0 | Bingo $0 | Fortune $0 | Tax $0
Seat 1: 21c758a (button) folded before Flop (didn't bet)
Seat 2: 92e1348d (small blind) folded before Flop
Seat 3: Hero (big blind) folded before Flop
Seat 4: 82282522 collected ($0.12)
Seat 5: 4e3c3196 folded before Flop (didn't bet)
Seat 6: 3dd0afef folded before Flop (didn't bet)


Poker Hand #RC3334483157: Hold'em No Limit ($0.02/$0.05) - 2025/02/17 21:10:23
Table 'RushAndCash618417' 6-max Seat #1 is the button
Seat 1: 4812f5c8 ($5.14 in chips)
Seat 2: 1fa8537 ($6.93 in chips)
Seat 3: 198a1e4 ($5.67 in chips)
Seat 4: f52f15b4 ($5 in chips)
Seat 5: b7bd1225 ($5.24 in chips)
Seat 6: Hero ($5.5 in chips)
1fa8537: posts small blind $0.02
198a1e4: posts big blind $0.05
*** HOLE CARDS ***
Dealt to 4812f5c8 
Dealt to 1fa8537 
Dealt to 198a1e4 
Dealt to f52f15b4 
Dealt to b7bd1225 
Dealt to Hero [3c 9c]
f52f15b4: folds
b7bd1225: folds
Hero: folds
4812f5c8: folds
1fa8537: folds
Uncalled bet ($0.03) returned to 198a1e4
*** SHOWDOWN ***
198a1e4 collected $0.04 from pot
*** SUMMARY ***
Total pot $0.04 | Rake $0 | Jackpot $0 | Bingo $0 | Fortune $0 | Tax $0
Seat 1: 4812f5c8 (button) folded before Flop (didn't bet)
Seat 2: 1fa8537 (small blind) folded before Flop
Seat 3: 198a1e4 (big blind) collected ($0.04)
Seat 4: f52f15b4 folded before Flop (didn't bet)
Seat 5: b7bd1225 folded before Flop (didn't bet)
Seat 6: Hero folded before Flop (didn't bet)


Poker Hand #RC3334483129: Hold'em No Limit ($0.02/$0.05) - 2025/02/17 21:10:20
Table 'RushAndCash618389' 6-max Seat #1 is the button
Seat 1: 3b85f8e6 ($7.64 in chips)
Seat 2: a63aa4b7 ($19.16 in chips)
Seat 3: edb41254 ($6.69 in chips)
Seat 4: 20e2d62 ($5.65 in chips)
Seat 5: d5f2b405 ($1.53 in chips)
Seat 6: Hero ($5.5 in chips)
a63aa4b7: posts small blind $0.02
edb41254: posts big blind $0.05
*** HOLE CARDS ***
Dealt to 3b85f8e6 
Dealt to a63aa4b7 
Dealt to edb41254 
Dealt to 20e2d62 
Dealt to d5f2b405 
Dealt to Hero [Ah 2d]
20e2d62: folds
d5f2b405: folds
Hero: folds
3b85f8e6: folds
a63aa4b7: raises $0.08 to $0.13
edb41254: folds
Uncalled bet ($0.08) returned to a63aa4b7
*** SHOWDOWN ***
a63aa4b7 collected $0.1 from pot
*** SUMMARY ***
Total pot $0.1 | Rake $0 | Jackpot $0 | Bingo $0 | Fortune $0 | Tax $0
Seat 1: 3b85f8e6 (button) folded before Flop (didn't bet)
Seat 2: a63aa4b7 (small blind) collected ($0.1)
Seat 3: edb41254 (big blind) folded before Flop
Seat 4: 20e2d62 folded before Flop (didn't bet)
Seat 5: d5f2b405 folded before Flop (didn't bet)
Seat 6: Hero folded before Flop (didn't bet)


Poker Hand #RC3334483087: Hold'em No Limit ($0.02/$0.05) - 2025/02/17 21:10:15
Table 'RushAndCash618347' 6-max Seat #1 is the button
Seat 1: 808dd9c ($5.84 in chips)
Seat 2: 3b85f8e6 ($7.66 in chips)
Seat 3: c8e72d1e ($5.15 in chips)
Seat 4: 70521b8f ($5 in chips)
Seat 5: Hero ($5.5 in chips)
Seat 6: f56d4922 ($5.28 in chips)
3b85f8e6: posts small blind $0.02
c8e72d1e: posts big blind $0.05
*** HOLE CARDS ***
Dealt to 808dd9c 
Dealt to 3b85f8e6 
Dealt to c8e72d1e 
Dealt to 70521b8f 
Dealt to Hero [Qd Th]
Dealt to f56d4922 
70521b8f: folds
Hero: folds
f56d4922: folds
808dd9c: raises $0.05 to $0.1
3b85f8e6: folds
c8e72d1e: folds
Uncalled bet ($0.05) returned to 808dd9c
*** SHOWDOWN ***
808dd9c collected $0.12 from pot
*** SUMMARY ***
Total pot $0.12 | Rake $0 | Jackpot $0 | Bingo $0 | Fortune $0 | Tax $0
Seat 1: 808dd9c (button) collected ($0.12)
Seat 2: 3b85f8e6 (small blind) folded before Flop
Seat 3: c8e72d1e (big blind) folded before Flop
Seat 4: 70521b8f folded before Flop (didn't bet)
Seat 5: Hero folded before Flop (didn't bet)
Seat 6: f56d4922 folded before Flop (didn't bet)


Poker Hand #RC3334483052: Hold'em No Limit ($0.02/$0.05) - 2025/02/17 21:10:11
Table 'RushAndCash618312' 6-max Seat #1 is the button
Seat 1: Hero ($5.5 in chips)
Seat 2: be86537 ($6.72 in chips)
Seat 3: 8e93231a ($5.07 in chips)
Seat 4: 2e8ab509 ($5.25 in chips)
Seat 5: 151b0c91 ($5.02 in chips)
Seat 6: 2ad19ee2 ($5 in chips)
be86537: posts small blind $0.02
8e93231a: posts big blind $0.05
*** HOLE CARDS ***
Dealt to Hero [6h Td]
Dealt to be86537 
Dealt to 8e93231a 
Dealt to 2e8ab509 
Dealt to 151b0c91 
Dealt to 2ad19ee2 
2e8ab509: raises $0.08 to $0.13
151b0c91: raises $0.25 to $0.38
2ad19ee2: folds
Hero: folds
be86537: folds
8e93231a: folds
2e8ab509: raises $0.62 to $1
151b0c91: raises $4.02 to $5.02 and is all-in
2e8ab509: folds
Uncalled bet ($4.02) returned to 151b0c91
*** SHOWDOWN ***
151b0c91 collected $1.9 from pot
*** SUMMARY ***
Total pot $2.07 | Rake $0.1 | Jackpot $0.07 | Bingo $0 | Fortune $0 | Tax $0
Seat 1: Hero (button) folded before Flop (didn't bet)
Seat 2: be86537 (small blind) folded before Flop
Seat 3: 8e93231a (big blind) folded before Flop
Seat 4: 2e8ab509 folded before Flop
Seat 5: 151b0c91 collected ($1.9)
Seat 6: 2ad19ee2 folded before Flop (didn't bet)


Poker Hand #RC3334483026: Hold'em No Limit ($0.02/$0.05) - 2025/02/17 21:10:08
Table 'RushAndCash618286' 6-max Seat #1 is the button
Seat 1: d5b0e893 ($6.33 in chips)
Seat 2: Hero ($5.52 in chips)
Seat 3: 22643080 ($11.2 in chips)
Seat 4: ce1cdeb ($5.17 in chips)
Seat 5: 6aafda73 ($7.91 in chips)
Seat 6: 3ad90733 ($5.06 in chips)
Hero: posts small blind $0.02
22643080: posts big blind $0.05
*** HOLE CARDS ***
Dealt to d5b0e893 
Dealt to Hero [Ks 6h]
Dealt to 22643080 
Dealt to ce1cdeb 
Dealt to 6aafda73 
Dealt to 3ad90733 
ce1cdeb: folds
6aafda73: folds
3ad90733: raises $0.05 to $0.1
d5b0e893: folds
Hero: folds
22643080: calls $0.05
*** FLOP *** [Kc Ad Js]
22643080: checks
3ad90733: checks
*** TURN *** [Kc Ad Js] [8c]
22643080: bets $0.08
3ad90733: folds
Uncalled bet ($0.08) returned to 22643080
*** SHOWDOWN ***
22643080 collected $0.21 from pot
*** SUMMARY ***
Total pot $0.22 | Rake $0.01 | Jackpot $0 | Bingo $0 | Fortune $0 | Tax $0
Board [Kc Ad Js 8c]
Seat 1: d5b0e893 (button) folded before Flop (didn't bet)
Seat 2: Hero (small blind) folded before Flop
Seat 3: 22643080 (big blind) won ($0.21)
Seat 4: ce1cdeb folded before Flop (didn't bet)
Seat 5: 6aafda73 folded before Flop (didn't bet)
Seat 6: 3ad90733 folded on the Turn


Poker Hand #RC3334482716: Hold'em No Limit ($0.02/$0.05) - 2025/02/17 21:09:31
Table 'RushAndCash617976' 6-max Seat #1 is the button
Seat 1: 9f70f94d ($5.48 in chips)
Seat 2: Hero ($5.42 in chips)
Seat 3: 5c980949 ($7.93 in chips)
Seat 4: 534f7ad0 ($2.91 in chips)
Seat 5: cea9730b ($7.92 in chips)
Seat 6: 24aff26b ($5 in chips)
Hero: posts small blind $0.02
5c980949: posts big blind $0.05
*** HOLE CARDS ***
Dealt to 9f70f94d 
Dealt to Hero [Js Kd]
Dealt to 5c980949 
Dealt to 534f7ad0 
Dealt to cea9730b 
Dealt to 24aff26b 
534f7ad0: folds
cea9730b: folds
24aff26b: folds
9f70f94d: folds
Hero: calls $0.03
5c980949: checks
*** FLOP *** [Qh Qs 4c]
Hero: checks
5c980949: bets $0.06
Hero: calls $0.06
*** TURN *** [Qh Qs 4c] [Th]
Hero: checks
5c980949: checks
*** RIVER *** [Qh Qs 4c Th] [3s]
Hero: checks
5c980949: checks
Hero: shows [Js Kd] (Pair of Queens)
5c980949: shows [9s 2s] (Pair of Queens)
*** SHOWDOWN ***
Hero collected $0.21 from pot
*** SUMMARY ***
Total pot $0.22 | Rake $0.01 | Jackpot $0 | Bingo $0 | Fortune $0 | Tax $0
Board [Qh Qs 4c Th 3s]
Seat 1: 9f70f94d (button) folded before Flop (didn't bet)
Seat 2: Hero (small blind) showed [Js Kd] and won ($0.21) with Pair of Queens
Seat 3: 5c980949 (big blind) showed [9s 2s] and lost with Pair of Queens
Seat 4: 534f7ad0 folded before Flop (didn't bet)
Seat 5: cea9730b folded before Flop (didn't bet)
Seat 6: 24aff26b folded before Flop (didn't bet)


Poker Hand #RC3334482684: Hold'em No Limit ($0.02/$0.05) - 2025/02/17 21:09:28
Table 'RushAndCash617944' 6-max Seat #1 is the button
Seat 1: 534f7ad0 ($2.91 in chips)
Seat 2: 6de2662f ($5.52 in chips)
Seat 3: a8c71cd6 ($5.6 in chips)
Seat 4: Hero ($5.42 in chips)
Seat 5: e5e6041b ($6.31 in chips)
Seat 6: 24aff26b ($5 in chips)
6de2662f: posts small blind $0.02
a8c71cd6: posts big blind $0.05
*** HOLE CARDS ***
Dealt to 534f7ad0 
Dealt to 6de2662f 
Dealt to a8c71cd6 
Dealt to Hero [8d 3c]
Dealt to e5e6041b 
Dealt to 24aff26b 
Hero: folds
e5e6041b: folds
24aff26b: folds
534f7ad0: folds
6de2662f: folds
Uncalled bet ($0.03) returned to a8c71cd6
*** SHOWDOWN ***
a8c71cd6 collected $0.04 from pot
*** SUMMARY ***
Total pot $0.04 | Rake $0 | Jackpot $0 | Bingo $0 | Fortune $0 | Tax $0
Seat 1: 534f7ad0 (button) folded before Flop (didn't bet)
Seat 2: 6de2662f (small blind) folded before Flop
Seat 3: a8c71cd6 (big blind) collected ($0.04)
Seat 4: Hero folded before Flop (didn't bet)
Seat 5: e5e6041b folded before Flop (didn't bet)
Seat 6: 24aff26b folded before Flop (didn't bet)


Poker Hand #RC3334482646: Hold'em No Limit ($0.02/$0.05) - 2025/02/17 21:09:23
Table 'RushAndCash617906' 6-max Seat #1 is the button
Seat 1: 191b60c1 ($8.21 in chips)
Seat 2: 188c8947 ($7.52 in chips)
Seat 3: 692b0e1d ($4.63 in chips)
Seat 4: 577aa3d3 ($5.98 in chips)
Seat 5: c4483bd8 ($5.38 in chips)
Seat 6: Hero ($5.42 in chips)
188c8947: posts small blind $0.02
692b0e1d: posts big blind $0.05
*** HOLE CARDS ***
Dealt to 191b60c1 
Dealt to 188c8947 
Dealt to 692b0e1d 
Dealt to 577aa3d3 
Dealt to c4483bd8 
Dealt to Hero [Ac 3h]
577aa3d3: folds
c4483bd8: raises $0.05 to $0.1
Hero: folds
191b60c1: folds
188c8947: folds
692b0e1d: folds
Uncalled bet ($0.05) returned to c4483bd8
*** SHOWDOWN ***
c4483bd8 collected $0.12 from pot
*** SUMMARY ***
Total pot $0.12 | Rake $0 | Jackpot $0 | Bingo $0 | Fortune $0 | Tax $0
Seat 1: 191b60c1 (button) folded before Flop (didn't bet)
Seat 2: 188c8947 (small blind) folded before Flop
Seat 3: 692b0e1d (big blind) folded before Flop
Seat 4: 577aa3d3 folded before Flop (didn't bet)
Seat 5: c4483bd8 collected ($0.12)
Seat 6: Hero folded before Flop (didn't bet)


Poker Hand #RC3334482614: Hold'em No Limit ($0.02/$0.05) - 2025/02/17 21:09:19
Table 'RushAndCash617874' 6-max Seat #1 is the button
Seat 1: dbf5f543 ($5.84 in chips)
Seat 2: 7a24974a ($5.17 in chips)
Seat 3: 8dbd0a2d ($9.42 in chips)
Seat 4: Hero ($5.42 in chips)
Seat 5: 75a97e80 ($4.86 in chips)
Seat 6: c4483bd8 ($5.38 in chips)
7a24974a: posts small blind $0.02
8dbd0a2d: posts big blind $0.05
*** HOLE CARDS ***
Dealt to dbf5f543 
Dealt to 7a24974a 
Dealt to 8dbd0a2d 
Dealt to Hero [7c Jd]
Dealt to 75a97e80 
Dealt to c4483bd8 
Hero: folds
75a97e80: folds
c4483bd8: folds
dbf5f543: folds
7a24974a: folds
Uncalled bet ($0.03) returned to 8dbd0a2d
*** SHOWDOWN ***
8dbd0a2d collected $0.04 from pot
*** SUMMARY ***
Total pot $0.04 | Rake $0 | Jackpot $0 | Bingo $0 | Fortune $0 | Tax $0
Seat 1: dbf5f543 (button) folded before Flop (didn't bet)
Seat 2: 7a24974a (small blind) folded before Flop
Seat 3: 8dbd0a2d (big blind) collected ($0.04)
Seat 4: Hero folded before Flop (didn't bet)
Seat 5: 75a97e80 folded before Flop (didn't bet)
Seat 6: c4483bd8 folded before Flop (didn't bet)


Poker Hand #RC3334482580: Hold'em No Limit ($0.02/$0.05) - 2025/02/17 21:09:16
Table 'RushAndCash617840' 6-max Seat #1 is the button
Seat 1: Hero ($5.42 in chips)
Seat 2: 22e7e468 ($5.34 in chips)
Seat 3: a4e63c5 ($5.14 in chips)
Seat 4: b7bd1225 ($5.11 in chips)
Seat 5: 92e1348d ($8.55 in chips)
Seat 6: 35fb946f ($7.4 in chips)
22e7e468: posts small blind $0.02
a4e63c5: posts big blind $0.05
*** HOLE CARDS ***
Dealt to Hero [4h 6d]
Dealt to 22e7e468 
Dealt to a4e63c5 
Dealt to b7bd1225 
Dealt to 92e1348d 
Dealt to 35fb946f 
b7bd1225: folds
92e1348d: folds
35fb946f: raises $0.05 to $0.1
Hero: folds
22e7e468: folds
a4e63c5: folds
Uncalled bet ($0.05) returned to 35fb946f
*** SHOWDOWN ***
35fb946f collected $0.12 from pot
*** SUMMARY ***
Total pot $0.12 | Rake $0 | Jackpot $0 | Bingo $0 | Fortune $0 | Tax $0
Seat 1: Hero (button) folded before Flop (didn't bet)
Seat 2: 22e7e468 (small blind) folded before Flop
Seat 3: a4e63c5 (big blind) folded before Flop
Seat 4: b7bd1225 folded before Flop (didn't bet)
Seat 5: 92e1348d folded before Flop (didn't bet)
Seat 6: 35fb946f collected ($0.12)


Poker Hand #RC3334482514: Hold'em No Limit ($0.02/$0.05) - 2025/02/17 21:09:08
Table 'RushAndCash617774' 6-max Seat #1 is the button
Seat 1: 7be6fd7d ($5 in chips)
Seat 2: b05c1b36 ($4.37 in chips)
Seat 3: Hero ($5.47 in chips)
Seat 4: 20e2d62 ($5 in chips)
Seat 5: 8d378f31 ($6.53 in chips)
Seat 6: 20c536f4 ($5.48 in chips)
b05c1b36: posts small blind $0.02
Hero: posts big blind $0.05
*** HOLE CARDS ***
Dealt to 7be6fd7d 
Dealt to b05c1b36 
Dealt to Hero [Qc As]
Dealt to 20e2d62 
Dealt to 8d378f31 
Dealt to 20c536f4 
20e2d62: raises $0.05 to $0.1
8d378f31: raises $0.28 to $0.38
20c536f4: folds
7be6fd7d: folds
b05c1b36: folds
Hero: folds
20e2d62: calls $0.28
*** FLOP *** [6c 4s Qs]
20e2d62: checks
8d378f31: bets $0.3
20e2d62: calls $0.3
*** TURN *** [6c 4s Qs] [3c]
20e2d62: checks
8d378f31: checks
*** RIVER *** [6c 4s Qs 3c] [7c]
20e2d62: bets $1.15
8d378f31: folds
Uncalled bet ($1.15) returned to 20e2d62
*** SHOWDOWN ***
20e2d62 collected $1.36 from pot
*** SUMMARY ***
Total pot $1.43 | Rake $0.07 | Jackpot $0 | Bingo $0 | Fortune $0 | Tax $0
Board [6c 4s Qs 3c 7c]
Seat 1: 7be6fd7d (button) folded before Flop (didn't bet)
Seat 2: b05c1b36 (small blind) folded before Flop
Seat 3: Hero (big blind) folded before Flop
Seat 4: 20e2d62 won ($1.36)
Seat 5: 8d378f31 folded on the River
Seat 6: 20c536f4 folded before Flop (didn't bet)


Poker Hand #RC3334482424: Hold'em No Limit ($0.02/$0.05) - 2025/02/17 21:08:56
Table 'RushAndCash617684' 6-max Seat #1 is the button
Seat 1: 8c3789e ($5.37 in chips)
Seat 2: 5c980949 ($7.95 in chips)
Seat 3: Hero ($5.45 in chips)
Seat 4: 887ed1a2 ($4.54 in chips)
Seat 5: f68df189 ($5.53 in chips)
Seat 6: 753630f ($5.33 in chips)
5c980949: posts small blind $0.02
Hero: posts big blind $0.05
*** HOLE CARDS ***
Dealt to 8c3789e 
Dealt to 5c980949 
Dealt to Hero [4c Ac]
Dealt to 887ed1a2 
Dealt to f68df189 
Dealt to 753630f 
887ed1a2: folds
f68df189: folds
753630f: folds
8c3789e: folds
5c980949: folds
Uncalled bet ($0.03) returned to Hero
*** SHOWDOWN ***
Hero collected $0.04 from pot
*** SUMMARY ***
Total pot $0.04 | Rake $0 | Jackpot $0 | Bingo $0 | Fortune $0 | Tax $0
Seat 1: 8c3789e (button) folded before Flop (didn't bet)
Seat 2: 5c980949 (small blind) folded before Flop
Seat 3: Hero (big blind) collected ($0.04)
Seat 4: 887ed1a2 folded before Flop (didn't bet)
Seat 5: f68df189 folded before Flop (didn't bet)
Seat 6: 753630f folded before Flop (didn't bet)


Poker Hand #RC3334482401: Hold'em No Limit ($0.02/$0.05) - 2025/02/17 21:08:53
Table 'RushAndCash617661' 6-max Seat #1 is the button
Seat 1: c585480d ($7.38 in chips)
Seat 2: f1a26906 ($5.27 in chips)
Seat 3: 71e00d83 ($12.69 in chips)
Seat 4: b39a93ce ($8.77 in chips)
Seat 5: 4dde37a5 ($5.23 in chips)
Seat 6: Hero ($5.45 in chips)
f1a26906: posts small blind $0.02
71e00d83: posts big blind $0.05
*** HOLE CARDS ***
Dealt to c585480d 
Dealt to f1a26906 
Dealt to 71e00d83 
Dealt to b39a93ce 
Dealt to 4dde37a5 
Dealt to Hero [2h 9d]
b39a93ce: folds
4dde37a5: folds
Hero: folds
c585480d: raises $0.08 to $0.13
f1a26906: folds
71e00d83: calls $0.08
*** FLOP *** [2s 5s 7s]
71e00d83: checks
c585480d: bets $0.1
71e00d83: folds
Uncalled bet ($0.1) returned to c585480d
*** SHOWDOWN ***
c585480d collected $0.27 from pot
*** SUMMARY ***
Total pot $0.28 | Rake $0.01 | Jackpot $0 | Bingo $0 | Fortune $0 | Tax $0
Board [2s 5s 7s]
Seat 1: c585480d (button) won ($0.27)
Seat 2: f1a26906 (small blind) folded before Flop
Seat 3: 71e00d83 (big blind) folded on the Flop
Seat 4: b39a93ce folded before Flop (didn't bet)
Seat 5: 4dde37a5 folded before Flop (didn't bet)
Seat 6: Hero folded before Flop (didn't bet)


Poker Hand #RC3334481951: Hold'em No Limit ($0.02/$0.05) - 2025/02/17 21:07:55
Table 'RushAndCash617211' 6-max Seat #1 is the button
Seat 1: e72c7748 ($12.48 in chips)
Seat 2: Hero ($6.03 in chips)
Seat 3: 3bfcd529 ($5.23 in chips)
Seat 4: b282789b ($5.21 in chips)
Seat 5: 9864109b ($6.89 in chips)
Seat 6: c8e834fc ($4.89 in chips)
Hero: posts small blind $0.02
3bfcd529: posts big blind $0.05
*** HOLE CARDS ***
Dealt to e72c7748 
Dealt to Hero [Qc As]
Dealt to 3bfcd529 
Dealt to b282789b 
Dealt to 9864109b 
Dealt to c8e834fc 
b282789b: folds
9864109b: folds
c8e834fc: folds
e72c7748: raises $0.05 to $0.1
Hero: raises $0.32 to $0.42
3bfcd529: folds
e72c7748: calls $0.32
*** FLOP *** [4c 4s Tc]
Hero: checks
e72c7748: bets $0.07
Hero: calls $0.07
*** TURN *** [4c 4s Tc] [2s]
Hero: checks
e72c7748: bets $0.09
Hero: calls $0.09
*** RIVER *** [4c 4s Tc 2s] [4h]
Hero: checks
e72c7748: bets $0.67
Hero: folds
Uncalled bet ($0.67) returned to e72c7748
*** SHOWDOWN ***
e72c7748 collected $1.15 from pot
*** SUMMARY ***
Total pot $1.21 | Rake $0.06 | Jackpot $0 | Bingo $0 | Fortune $0 | Tax $0
Board [4c 4s Tc 2s 4h]
Seat 1: e72c7748 (button) won ($1.15)
Seat 2: Hero (small blind) folded on the River
Seat 3: 3bfcd529 (big blind) folded before Flop
Seat 4: b282789b folded before Flop (didn't bet)
Seat 5: 9864109b folded before Flop (didn't bet)
Seat 6: c8e834fc folded before Flop (didn't bet)


Poker Hand #RC3334481794: Hold'em No Limit ($0.02/$0.05) - 2025/02/17 21:07:36
Table 'RushAndCash617054' 6-max Seat #1 is the button
Seat 1: 9e3e5e70 ($7.66 in chips)
Seat 2: 95096c6a ($6.41 in chips)
Seat 3: Hero ($6.13 in chips)
Seat 4: 69c3afd2 ($3.04 in chips)
Seat 5: c8e834fc ($4.78 in chips)
Seat 6: e390e48e ($9.69 in chips)
95096c6a: posts small blind $0.02
Hero: posts big blind $0.05
*** HOLE CARDS ***
Dealt to 9e3e5e70 
Dealt to 95096c6a 
Dealt to Hero [5d As]
Dealt to 69c3afd2 
Dealt to c8e834fc 
Dealt to e390e48e 
69c3afd2: folds
c8e834fc: raises $0.05 to $0.1
e390e48e: folds
9e3e5e70: folds
95096c6a: folds
Hero: calls $0.05
*** FLOP *** [Kd Qc 9h]
Hero: checks
c8e834fc: bets $0.11
Hero: folds
Uncalled bet ($0.11) returned to c8e834fc
*** SHOWDOWN ***
c8e834fc collected $0.21 from pot
*** SUMMARY ***
Total pot $0.22 | Rake $0.01 | Jackpot $0 | Bingo $0 | Fortune $0 | Tax $0
Board [Kd Qc 9h]
Seat 1: 9e3e5e70 (button) folded before Flop (didn't bet)
Seat 2: 95096c6a (small blind) folded before Flop
Seat 3: Hero (big blind) folded on the Flop
Seat 4: 69c3afd2 folded before Flop (didn't bet)
Seat 5: c8e834fc won ($0.21)
Seat 6: e390e48e folded before Flop (didn't bet)


Poker Hand #RC3334481762: Hold'em No Limit ($0.02/$0.05) - 2025/02/17 21:07:32
Table 'RushAndCash617022' 6-max Seat #1 is the button
Seat 1: Hero ($6.13 in chips)
Seat 2: 9135e49d ($15.33 in chips)
Seat 3: f994138c ($7.67 in chips)
Seat 4: 5c8c19b7 ($15.09 in chips)
Seat 5: c1784884 ($5.12 in chips)
Seat 6: 19259657 ($5.1 in chips)
9135e49d: posts small blind $0.02
f994138c: posts big blind $0.05
*** HOLE CARDS ***
Dealt to Hero [6c Kd]
Dealt to 9135e49d 
Dealt to f994138c 
Dealt to 5c8c19b7 
Dealt to c1784884 
Dealt to 19259657 
5c8c19b7: folds
c1784884: folds
19259657: folds
Hero: folds
9135e49d: raises $0.1 to $0.15
f994138c: raises $0.35 to $0.5
9135e49d: raises $0.55 to $1.05
f994138c: raises $6.62 to $7.67 and is all-in
9135e49d: folds
Uncalled bet ($6.62) returned to f994138c
*** SHOWDOWN ***
f994138c collected $1.93 from pot
*** SUMMARY ***
Total pot $2.1 | Rake $0.1 | Jackpot $0.07 | Bingo $0 | Fortune $0 | Tax $0
Seat 1: Hero (button) folded before Flop (didn't bet)
Seat 2: 9135e49d (small blind) folded before Flop
Seat 3: f994138c (big blind) collected ($1.93)
Seat 4: 5c8c19b7 folded before Flop (didn't bet)
Seat 5: c1784884 folded before Flop (didn't bet)
Seat 6: 19259657 folded before Flop (didn't bet)


Poker Hand #RC3334481464: Hold'em No Limit ($0.02/$0.05) - 2025/02/17 21:06:55
Table 'RushAndCash616724' 6-max Seat #1 is the button
Seat 1: 8f3a3c0a ($9.91 in chips)
Seat 2: fa30bfa7 ($5.62 in chips)
Seat 3: 5c8c19b7 ($15.27 in chips)
Seat 4: Hero ($5.94 in chips)
Seat 5: 87256f31 ($5.73 in chips)
Seat 6: d58b99ca ($29.39 in chips)
fa30bfa7: posts small blind $0.02
5c8c19b7: posts big blind $0.05
*** HOLE CARDS ***
Dealt to 8f3a3c0a 
Dealt to fa30bfa7 
Dealt to 5c8c19b7 
Dealt to Hero [Tc As]
Dealt to 87256f31 
Dealt to d58b99ca 
Hero: raises $0.05 to $0.1
87256f31: folds
d58b99ca: folds
8f3a3c0a: folds
fa30bfa7: folds
5c8c19b7: calls $0.05
*** FLOP *** [6h 7h Kc]
5c8c19b7: checks
Hero: bets $0.08
5c8c19b7: calls $0.08
*** TURN *** [6h 7h Kc] [7c]
5c8c19b7: checks
Hero: checks
*** RIVER *** [6h 7h Kc 7c] [Ad]
5c8c19b7: checks
Hero: bets $0.2
5c8c19b7: folds
Uncalled bet ($0.2) returned to Hero
*** SHOWDOWN ***
Hero collected $0.37 from pot
*** SUMMARY ***
Total pot $0.38 | Rake $0.01 | Jackpot $0 | Bingo $0 | Fortune $0 | Tax $0
Board [6h 7h Kc 7c Ad]
Seat 1: 8f3a3c0a (button) folded before Flop (didn't bet)
Seat 2: fa30bfa7 (small blind) folded before Flop
Seat 3: 5c8c19b7 (big blind) folded on the River
Seat 4: Hero won ($0.37)
Seat 5: 87256f31 folded before Flop (didn't bet)
Seat 6: d58b99ca folded before Flop (didn't bet)


Poker Hand #RC3334481427: Hold'em No Limit ($0.02/$0.05) - 2025/02/17 21:06:50
Table 'RushAndCash616687' 6-max Seat #1 is the button
Seat 1: f4ed7f83 ($5.07 in chips)
Seat 2: f6abc1da ($5.7 in chips)
Seat 3: ded3640 ($5.37 in chips)
Seat 4: 8e93231a ($5.23 in chips)
Seat 5: 4f7979c7 ($4.98 in chips)
Seat 6: Hero ($5.94 in chips)
f6abc1da: posts small blind $0.02
ded3640: posts big blind $0.05
*** HOLE CARDS ***
Dealt to f4ed7f83 
Dealt to f6abc1da 
Dealt to ded3640 
Dealt to 8e93231a 
Dealt to 4f7979c7 
Dealt to Hero [5h 6d]
8e93231a: raises $0.08 to $0.13
4f7979c7: folds
Hero: folds
f4ed7f83: folds
f6abc1da: folds
ded3640: folds
Uncalled bet ($0.08) returned to 8e93231a
*** SHOWDOWN ***
8e93231a collected $0.12 from pot
*** SUMMARY ***
Total pot $0.12 | Rake $0 | Jackpot $0 | Bingo $0 | Fortune $0 | Tax $0
Seat 1: f4ed7f83 (button) folded before Flop (didn't bet)
Seat 2: f6abc1da (small blind) folded before Flop
Seat 3: ded3640 (big blind) folded before Flop
Seat 4: 8e93231a collected ($0.12)
Seat 5: 4f7979c7 folded before Flop (didn't bet)
Seat 6: Hero folded before Flop (didn't bet)


Poker Hand #RC3334481347: Hold'em No Limit ($0.02/$0.05) - 2025/02/17 21:06:41
Table 'RushAndCash616607' 6-max Seat #1 is the button
Seat 1: 38a4c833 ($8.62 in chips)
Seat 2: f1f26d78 ($5.6 in chips)
Seat 3: d676606b ($5.64 in chips)
Seat 4: c4483bd8 ($5.63 in chips)
Seat 5: Hero ($6.04 in chips)
Seat 6: 23c23672 ($5 in chips)
f1f26d78: posts small blind $0.02
d676606b: posts big blind $0.05
*** HOLE CARDS ***
Dealt to 38a4c833 
Dealt to f1f26d78 
Dealt to d676606b 
Dealt to c4483bd8 
Dealt to Hero [6c 5c]
Dealt to 23c23672 
c4483bd8: folds
Hero: raises $0.05 to $0.1
23c23672: calls $0.1
38a4c833: raises $0.37 to $0.47
f1f26d78: folds
d676606b: folds
Hero: folds
23c23672: folds
Uncalled bet ($0.37) returned to 38a4c833
*** SHOWDOWN ***
38a4c833 collected $0.36 from pot
*** SUMMARY ***
Total pot $0.37 | Rake $0.01 | Jackpot $0 | Bingo $0 | Fortune $0 | Tax $0
Seat 1: 38a4c833 (button) collected ($0.36)
Seat 2: f1f26d78 (small blind) folded before Flop
Seat 3: d676606b (big blind) folded before Flop
Seat 4: c4483bd8 folded before Flop (didn't bet)
Seat 5: Hero folded before Flop
Seat 6: 23c23672 folded before Flop


Poker Hand #RC3334481319: Hold'em No Limit ($0.02/$0.05) - 2025/02/17 21:06:38
Table 'RushAndCash616579' 6-max Seat #1 is the button
Seat 1: d676606b ($5.64 in chips)
Seat 2: e4025e7f ($5 in chips)
Seat 3: 55630016 ($10.59 in chips)
Seat 4: 64b39229 ($5.82 in chips)
Seat 5: Hero ($6.04 in chips)
Seat 6: 3dd0afef ($5.49 in chips)
e4025e7f: posts small blind $0.02
55630016: posts big blind $0.05
*** HOLE CARDS ***
Dealt to d676606b 
Dealt to e4025e7f 
Dealt to 55630016 
Dealt to 64b39229 
Dealt to Hero [2h Ad]
Dealt to 3dd0afef 
64b39229: folds
Hero: folds
3dd0afef: folds
d676606b: folds
e4025e7f: folds
Uncalled bet ($0.03) returned to 55630016
*** SHOWDOWN ***
55630016 collected $0.04 from pot
*** SUMMARY ***
Total pot $0.04 | Rake $0 | Jackpot $0 | Bingo $0 | Fortune $0 | Tax $0
Seat 1: d676606b (button) folded before Flop (didn't bet)
Seat 2: e4025e7f (small blind) folded before Flop
Seat 3: 55630016 (big blind) collected ($0.04)
Seat 4: 64b39229 folded before Flop (didn't bet)
Seat 5: Hero folded before Flop (didn't bet)
Seat 6: 3dd0afef folded before Flop (didn't bet)


Poker Hand #RC3334481289: Hold'em No Limit ($0.02/$0.05) - 2025/02/17 21:06:35
Table 'RushAndCash616549' 6-max Seat #1 is the button
Seat 1: 4b71998b ($5.77 in chips)
Seat 2: 48dc6454 ($2.56 in chips)
Seat 3: d92ddef8 ($4.82 in chips)
Seat 4: Hero ($6.04 in chips)
Seat 5: d676606b ($5.64 in chips)
Seat 6: 1b8b89c1 ($14.56 in chips)
48dc6454: posts small blind $0.02
d92ddef8: posts big blind $0.05
*** HOLE CARDS ***
Dealt to 4b71998b 
Dealt to 48dc6454 
Dealt to d92ddef8 
Dealt to Hero [8h 5d]
Dealt to d676606b 
Dealt to 1b8b89c1 
Hero: folds
d676606b: folds
1b8b89c1: folds
4b71998b: folds
48dc6454: folds
Uncalled bet ($0.03) returned to d92ddef8
*** SHOWDOWN ***
d92ddef8 collected $0.04 from pot
*** SUMMARY ***
Total pot $0.04 | Rake $0 | Jackpot $0 | Bingo $0 | Fortune $0 | Tax $0
Seat 1: 4b71998b (button) folded before Flop (didn't bet)
Seat 2: 48dc6454 (small blind) folded before Flop
Seat 3: d92ddef8 (big blind) collected ($0.04)
Seat 4: Hero folded before Flop (didn't bet)
Seat 5: d676606b folded before Flop (didn't bet)
Seat 6: 1b8b89c1 folded before Flop (didn't bet)


Poker Hand #RC3334481264: Hold'em No Limit ($0.02/$0.05) - 2025/02/17 21:06:32
Table 'RushAndCash616524' 6-max Seat #1 is the button
Seat 1: d5150c28 ($6.15 in chips)
Seat 2: Hero ($6.06 in chips)
Seat 3: 1b8b89c1 ($14.61 in chips)
Seat 4: fbd2add5 ($5.16 in chips)
Seat 5: caa19347 ($5.14 in chips)
Seat 6: 860fa4c9 ($8.94 in chips)
Hero: posts small blind $0.02
1b8b89c1: posts big blind $0.05
*** HOLE CARDS ***
Dealt to d5150c28 
Dealt to Hero [7d 3c]
Dealt to 1b8b89c1 
Dealt to fbd2add5 
Dealt to caa19347 
Dealt to 860fa4c9 
fbd2add5: folds
caa19347: folds
860fa4c9: raises $0.08 to $0.13
d5150c28: folds
Hero: folds
1b8b89c1: folds
Uncalled bet ($0.08) returned to 860fa4c9
*** SHOWDOWN ***
860fa4c9 collected $0.12 from pot
*** SUMMARY ***
Total pot $0.12 | Rake $0 | Jackpot $0 | Bingo $0 | Fortune $0 | Tax $0
Seat 1: d5150c28 (button) folded before Flop (didn't bet)
Seat 2: Hero (small blind) folded before Flop
Seat 3: 1b8b89c1 (big blind) folded before Flop
Seat 4: fbd2add5 folded before Flop (didn't bet)
Seat 5: caa19347 folded before Flop (didn't bet)
Seat 6: 860fa4c9 collected ($0.12)


Poker Hand #RC3334481237: Hold'em No Limit ($0.02/$0.05) - 2025/02/17 21:06:29
Table 'RushAndCash616497' 6-max Seat #1 is the button
Seat 1: fedfe7c6 ($7.16 in chips)
Seat 2: Hero ($6.08 in chips)
Seat 3: 92e1348d ($8.38 in chips)
Seat 4: 4cfbe5bf ($5.32 in chips)
Seat 5: d5150c28 ($6.15 in chips)
Seat 6: 24484a46 ($5 in chips)
Hero: posts small blind $0.02
92e1348d: posts big blind $0.05
*** HOLE CARDS ***
Dealt to fedfe7c6 
Dealt to Hero [Ks 3h]
Dealt to 92e1348d 
Dealt to 4cfbe5bf 
Dealt to d5150c28 
Dealt to 24484a46 
4cfbe5bf: raises $0.05 to $0.1
d5150c28: folds
24484a46: folds
fedfe7c6: folds
Hero: folds
92e1348d: folds
Uncalled bet ($0.05) returned to 4cfbe5bf
*** SHOWDOWN ***
4cfbe5bf collected $0.12 from pot
*** SUMMARY ***
Total pot $0.12 | Rake $0 | Jackpot $0 | Bingo $0 | Fortune $0 | Tax $0
Seat 1: fedfe7c6 (button) folded before Flop (didn't bet)
Seat 2: Hero (small blind) folded before Flop
Seat 3: 92e1348d (big blind) folded before Flop
Seat 4: 4cfbe5bf collected ($0.12)
Seat 5: d5150c28 folded before Flop (didn't bet)
Seat 6: 24484a46 folded before Flop (didn't bet)


Poker Hand #RC3334481210: Hold'em No Limit ($0.02/$0.05) - 2025/02/17 21:06:25
Table 'RushAndCash616470' 6-max Seat #1 is the button
Seat 1: 12cda2e0 ($21.83 in chips)
Seat 2: 97ae2208 ($5.22 in chips)
Seat 3: ead6cfaf ($5 in chips)
Seat 4: Hero ($6.08 in chips)
Seat 5: cda83b9b ($5.05 in chips)
Seat 6: 64526212 ($4.93 in chips)
97ae2208: posts small blind $0.02
ead6cfaf: posts big blind $0.05
*** HOLE CARDS ***
Dealt to 12cda2e0 
Dealt to 97ae2208 
Dealt to ead6cfaf 
Dealt to Hero [5s As]
Dealt to cda83b9b 
Dealt to 64526212 
Hero: folds
cda83b9b: folds
64526212: folds
12cda2e0: folds
97ae2208: folds
Uncalled bet ($0.03) returned to ead6cfaf
*** SHOWDOWN ***
ead6cfaf collected $0.04 from pot
*** SUMMARY ***
Total pot $0.04 | Rake $0 | Jackpot $0 | Bingo $0 | Fortune $0 | Tax $0
Seat 1: 12cda2e0 (button) folded before Flop (didn't bet)
Seat 2: 97ae2208 (small blind) folded before Flop
Seat 3: ead6cfaf (big blind) collected ($0.04)
Seat 4: Hero folded before Flop (didn't bet)
Seat 5: cda83b9b folded before Flop (didn't bet)
Seat 6: 64526212 folded before Flop (didn't bet)


Poker Hand #RC3334481179: Hold'em No Limit ($0.02/$0.05) - 2025/02/17 21:06:22
Table 'RushAndCash616439' 6-max Seat #1 is the button
Seat 1: 6ebc3323 ($8.44 in chips)
Seat 2: e14d48fa ($3.73 in chips)
Seat 3: Hero ($6.13 in chips)
Seat 4: 57d6169c ($5 in chips)
Seat 5: ce479ad2 ($8.05 in chips)
Seat 6: ac083cf2 ($4.05 in chips)
e14d48fa: posts small blind $0.02
Hero: posts big blind $0.05
*** HOLE CARDS ***
Dealt to 6ebc3323 
Dealt to e14d48fa 
Dealt to Hero [2c Ts]
Dealt to 57d6169c 
Dealt to ce479ad2 
Dealt to ac083cf2 
57d6169c: folds
ce479ad2: folds
ac083cf2: raises $0.05 to $0.1
6ebc3323: folds
e14d48fa: folds
Hero: folds
Uncalled bet ($0.05) returned to ac083cf2
*** SHOWDOWN ***
ac083cf2 collected $0.12 from pot
*** SUMMARY ***
Total pot $0.12 | Rake $0 | Jackpot $0 | Bingo $0 | Fortune $0 | Tax $0
Seat 1: 6ebc3323 (button) folded before Flop (didn't bet)
Seat 2: e14d48fa (small blind) folded before Flop
Seat 3: Hero (big blind) folded before Flop
Seat 4: 57d6169c folded before Flop (didn't bet)
Seat 5: ce479ad2 folded before Flop (didn't bet)
Seat 6: ac083cf2 collected ($0.12)


Poker Hand #RC3334481147: Hold'em No Limit ($0.02/$0.05) - 2025/02/17 21:06:18
Table 'RushAndCash616407' 6-max Seat #1 is the button
Seat 1: Hero ($6.13 in chips)
Seat 2: 302a1708 ($5.15 in chips)
Seat 3: 757f29d9 ($5.08 in chips)
Seat 4: 4812f5c8 ($5 in chips)
Seat 5: cc8de981 ($5 in chips)
Seat 6: 17d82e36 ($3.13 in chips)
302a1708: posts small blind $0.02
757f29d9: posts big blind $0.05
*** HOLE CARDS ***
Dealt to Hero [6s 9c]
Dealt to 302a1708 
Dealt to 757f29d9 
Dealt to 4812f5c8 
Dealt to cc8de981 
Dealt to 17d82e36 
4812f5c8: folds
cc8de981: folds
17d82e36: folds
Hero: folds
302a1708: folds
Uncalled bet ($0.03) returned to 757f29d9
*** SHOWDOWN ***
757f29d9 collected $0.04 from pot
*** SUMMARY ***
Total pot $0.04 | Rake $0 | Jackpot $0 | Bingo $0 | Fortune $0 | Tax $0
Seat 1: Hero (button) folded before Flop (didn't bet)
Seat 2: 302a1708 (small blind) folded before Flop
Seat 3: 757f29d9 (big blind) collected ($0.04)
Seat 4: 4812f5c8 folded before Flop (didn't bet)
Seat 5: cc8de981 folded before Flop (didn't bet)
Seat 6: 17d82e36 folded before Flop (didn't bet)


Poker Hand #RC3334481120: Hold'em No Limit ($0.02/$0.05) - 2025/02/17 21:06:15
Table 'RushAndCash616380' 6-max Seat #1 is the button
Seat 1: b0ee20aa ($22.87 in chips)
Seat 2: 92e1348d ($8.4 in chips)
Seat 3: e4025e7f ($5 in chips)
Seat 4: 1e48524e ($5 in chips)
Seat 5: Hero ($6.13 in chips)
Seat 6: 5e527a1a ($6.45 in chips)
92e1348d: posts small blind $0.02
e4025e7f: posts big blind $0.05
*** HOLE CARDS ***
Dealt to b0ee20aa 
Dealt to 92e1348d 
Dealt to e4025e7f 
Dealt to 1e48524e 
Dealt to Hero [3s 4c]
Dealt to 5e527a1a 
1e48524e: folds
Hero: folds
5e527a1a: raises $0.05 to $0.1
b0ee20aa: folds
92e1348d: folds
e4025e7f: folds
Uncalled bet ($0.05) returned to 5e527a1a
*** SHOWDOWN ***
5e527a1a collected $0.12 from pot
*** SUMMARY ***
Total pot $0.12 | Rake $0 | Jackpot $0 | Bingo $0 | Fortune $0 | Tax $0
Seat 1: b0ee20aa (button) folded before Flop (didn't bet)
Seat 2: 92e1348d (small blind) folded before Flop
Seat 3: e4025e7f (big blind) folded before Flop
Seat 4: 1e48524e folded before Flop (didn't bet)
Seat 5: Hero folded before Flop (didn't bet)
Seat 6: 5e527a1a collected ($0.12)


Poker Hand #RC3334481093: Hold'em No Limit ($0.02/$0.05) - 2025/02/17 21:06:12
Table 'RushAndCash616353' 6-max Seat #1 is the button
Seat 1: 2ae4e16 ($10.36 in chips)
Seat 2: 918d412c ($3.15 in chips)
Seat 3: 90c3e611 ($5 in chips)
Seat 4: c7e9103c ($11.79 in chips)
Seat 5: 9b1a3dd2 ($9.67 in chips)
Seat 6: Hero ($6.13 in chips)
918d412c: posts small blind $0.02
90c3e611: posts big blind $0.05
*** HOLE CARDS ***
Dealt to 2ae4e16 
Dealt to 918d412c 
Dealt to 90c3e611 
Dealt to c7e9103c 
Dealt to 9b1a3dd2 
Dealt to Hero [3s Ts]
c7e9103c: folds
9b1a3dd2: folds
Hero: folds
2ae4e16: raises $0.1 to $0.15
918d412c: folds
90c3e611: raises $0.6 to $0.75
2ae4e16: folds
Uncalled bet ($0.6) returned to 90c3e611
*** SHOWDOWN ***
90c3e611 collected $0.31 from pot
*** SUMMARY ***
Total pot $0.32 | Rake $0.01 | Jackpot $0 | Bingo $0 | Fortune $0 | Tax $0
Seat 1: 2ae4e16 (button) folded before Flop
Seat 2: 918d412c (small blind) folded before Flop
Seat 3: 90c3e611 (big blind) collected ($0.31)
Seat 4: c7e9103c folded before Flop (didn't bet)
Seat 5: 9b1a3dd2 folded before Flop (didn't bet)
Seat 6: Hero folded before Flop (didn't bet)


Poker Hand #RC3334481012: Hold'em No Limit ($0.02/$0.05) - 2025/02/17 21:06:02
Table 'RushAndCash616272' 6-max Seat #1 is the button
Seat 1: Hero ($6.13 in chips)
Seat 2: 8e5db286 ($10.96 in chips)
Seat 3: ef7e6107 ($5 in chips)
Seat 4: a223d3ca ($5 in chips)
Seat 5: d29f701c ($5.76 in chips)
Seat 6: 899a8bc6 ($5.83 in chips)
8e5db286: posts small blind $0.02
ef7e6107: posts big blind $0.05
*** HOLE CARDS ***
Dealt to Hero [Td Jc]
Dealt to 8e5db286 
Dealt to ef7e6107 
Dealt to a223d3ca 
Dealt to d29f701c 
Dealt to 899a8bc6 
a223d3ca: folds
d29f701c: folds
899a8bc6: raises $0.15 to $0.2
Hero: folds
8e5db286: folds
ef7e6107: folds
Uncalled bet ($0.15) returned to 899a8bc6
*** SHOWDOWN ***
899a8bc6 collected $0.12 from pot
*** SUMMARY ***
Total pot $0.12 | Rake $0 | Jackpot $0 | Bingo $0 | Fortune $0 | Tax $0
Seat 1: Hero (button) folded before Flop (didn't bet)
Seat 2: 8e5db286 (small blind) folded before Flop
Seat 3: ef7e6107 (big blind) folded before Flop
Seat 4: a223d3ca folded before Flop (didn't bet)
Seat 5: d29f701c folded before Flop (didn't bet)
Seat 6: 899a8bc6 collected ($0.12)


Poker Hand #RC3334480967: Hold'em No Limit ($0.02/$0.05) - 2025/02/17 21:05:56
Table 'RushAndCash616227' 6-max Seat #1 is the button
Seat 1: e3b51b04 ($9.29 in chips)
Seat 2: 2b9f39df ($5.69 in chips)
Seat 3: Hero ($6.18 in chips)
Seat 4: 944e9aa3 ($5.07 in chips)
Seat 5: c585480d ($7.22 in chips)
Seat 6: 7fe74cc5 ($7.69 in chips)
2b9f39df: posts small blind $0.02
Hero: posts big blind $0.05
*** HOLE CARDS ***
Dealt to e3b51b04 
Dealt to 2b9f39df 
Dealt to Hero [Ac 8h]
Dealt to 944e9aa3 
Dealt to c585480d 
Dealt to 7fe74cc5 
944e9aa3: folds
c585480d: folds
7fe74cc5: raises $0.06 to $0.11
e3b51b04: folds
2b9f39df: folds
Hero: folds
Uncalled bet ($0.06) returned to 7fe74cc5
*** SHOWDOWN ***
7fe74cc5 collected $0.12 from pot
*** SUMMARY ***
Total pot $0.12 | Rake $0 | Jackpot $0 | Bingo $0 | Fortune $0 | Tax $0
Seat 1: e3b51b04 (button) folded before Flop (didn't bet)
Seat 2: 2b9f39df (small blind) folded before Flop
Seat 3: Hero (big blind) folded before Flop
Seat 4: 944e9aa3 folded before Flop (didn't bet)
Seat 5: c585480d folded before Flop (didn't bet)
Seat 6: 7fe74cc5 collected ($0.12)


Poker Hand #RC3334480915: Hold'em No Limit ($0.02/$0.05) - 2025/02/17 21:05:49
Table 'RushAndCash616175' 6-max Seat #1 is the button
Seat 1: 12cda2e0 ($22.01 in chips)
Seat 2: Hero ($6.2 in chips)
Seat 3: bea1a357 ($3.09 in chips)
Seat 4: 66981141 ($11.88 in chips)
Seat 5: 8c6d38f2 ($10.59 in chips)
Seat 6: 3b1b6d04 ($6.08 in chips)
Hero: posts small blind $0.02
bea1a357: posts big blind $0.05
*** HOLE CARDS ***
Dealt to 12cda2e0 
Dealt to Hero [9c Ad]
Dealt to bea1a357 
Dealt to 66981141 
Dealt to 8c6d38f2 
Dealt to 3b1b6d04 
66981141: folds
8c6d38f2: raises $0.08 to $0.13
3b1b6d04: folds
12cda2e0: folds
Hero: folds
bea1a357: calls $0.08
*** FLOP *** [6h 6c 5c]
bea1a357: bets $0.14
8c6d38f2: calls $0.14
*** TURN *** [6h 6c 5c] [8c]
bea1a357: bets $0.42
8c6d38f2: folds
Uncalled bet ($0.42) returned to bea1a357
*** SHOWDOWN ***
bea1a357 collected $0.54 from pot
*** SUMMARY ***
Total pot $0.56 | Rake $0.02 | Jackpot $0 | Bingo $0 | Fortune $0 | Tax $0
Board [6h 6c 5c 8c]
Seat 1: 12cda2e0 (button) folded before Flop (didn't bet)
Seat 2: Hero (small blind) folded before Flop
Seat 3: bea1a357 (big blind) won ($0.54)
Seat 4: 66981141 folded before Flop (didn't bet)
Seat 5: 8c6d38f2 folded on the Turn
Seat 6: 3b1b6d04 folded before Flop (didn't bet)


Poker Hand #RC3334480885: Hold'em No Limit ($0.02/$0.05) - 2025/02/17 21:05:45
Table 'RushAndCash616145' 6-max Seat #1 is the button
Seat 1: Hero ($6.2 in chips)
Seat 2: 94cb065d ($7.6 in chips)
Seat 3: c75b2ba0 ($5.53 in chips)
Seat 4: b6d5854b ($6.54 in chips)
Seat 5: 54fe77bd ($12.8 in chips)
Seat 6: b9d877b0 ($5.17 in chips)
94cb065d: posts small blind $0.02
c75b2ba0: posts big blind $0.05
*** HOLE CARDS ***
Dealt to Hero [Ts 4c]
Dealt to 94cb065d 
Dealt to c75b2ba0 
Dealt to b6d5854b 
Dealt to 54fe77bd 
Dealt to b9d877b0 
b6d5854b: folds
54fe77bd: folds
b9d877b0: folds
Hero: folds
94cb065d: folds
Uncalled bet ($0.03) returned to c75b2ba0
*** SHOWDOWN ***
c75b2ba0 collected $0.04 from pot
*** SUMMARY ***
Total pot $0.04 | Rake $0 | Jackpot $0 | Bingo $0 | Fortune $0 | Tax $0
Seat 1: Hero (button) folded before Flop (didn't bet)
Seat 2: 94cb065d (small blind) folded before Flop
Seat 3: c75b2ba0 (big blind) collected ($0.04)
Seat 4: b6d5854b folded before Flop (didn't bet)
Seat 5: 54fe77bd folded before Flop (didn't bet)
Seat 6: b9d877b0 folded before Flop (didn't bet)


Poker Hand #RC3334480844: Hold'em No Limit ($0.02/$0.05) - 2025/02/17 21:05:40
Table 'RushAndCash616104' 6-max Seat #1 is the button
Seat 1: 2ae4e16 ($10.38 in chips)
Seat 2: 57d6169c ($5.09 in chips)
Seat 3: 816260d0 ($9.23 in chips)
Seat 4: 5197516b ($8.43 in chips)
Seat 5: 23c23672 ($5.06 in chips)
Seat 6: Hero ($6.2 in chips)
57d6169c: posts small blind $0.02
816260d0: posts big blind $0.05
*** HOLE CARDS ***
Dealt to 2ae4e16 
Dealt to 57d6169c 
Dealt to 816260d0 
Dealt to 5197516b 
Dealt to 23c23672 
Dealt to Hero [Th 3h]
5197516b: folds
23c23672: folds
Hero: folds
2ae4e16: folds
57d6169c: folds
Uncalled bet ($0.03) returned to 816260d0
*** SHOWDOWN ***
816260d0 collected $0.04 from pot
*** SUMMARY ***
Total pot $0.04 | Rake $0 | Jackpot $0 | Bingo $0 | Fortune $0 | Tax $0
Seat 1: 2ae4e16 (button) folded before Flop (didn't bet)
Seat 2: 57d6169c (small blind) folded before Flop
Seat 3: 816260d0 (big blind) collected ($0.04)
Seat 4: 5197516b folded before Flop (didn't bet)
Seat 5: 23c23672 folded before Flop (didn't bet)
Seat 6: Hero folded before Flop (didn't bet)


Poker Hand #RC3334480807: Hold'em No Limit ($0.02/$0.05) - 2025/02/17 21:05:35
Table 'RushAndCash616067' 6-max Seat #1 is the button
Seat 1: 69c3afd2 ($3.6 in chips)
Seat 2: 75a97e80 ($3.88 in chips)
Seat 3: 621c3c07 ($6.16 in chips)
Seat 4: Hero ($6.2 in chips)
Seat 5: 14620cce ($15.9 in chips)
Seat 6: 9a69a3a0 ($10.78 in chips)
75a97e80: posts small blind $0.02
621c3c07: posts big blind $0.05
*** HOLE CARDS ***
Dealt to 69c3afd2 
Dealt to 75a97e80 
Dealt to 621c3c07 
Dealt to Hero [3s Qc]
Dealt to 14620cce 
Dealt to 9a69a3a0 
Hero: folds
14620cce: folds
9a69a3a0: folds
69c3afd2: raises $0.05 to $0.1
75a97e80: folds
621c3c07: calls $0.05
*** FLOP *** [7d 6h Jh]
621c3c07: checks
69c3afd2: bets $0.08
621c3c07: folds
Uncalled bet ($0.08) returned to 69c3afd2
*** SHOWDOWN ***
69c3afd2 collected $0.21 from pot
*** SUMMARY ***
Total pot $0.22 | Rake $0.01 | Jackpot $0 | Bingo $0 | Fortune $0 | Tax $0
Board [7d 6h Jh]
Seat 1: 69c3afd2 (button) won ($0.21)
Seat 2: 75a97e80 (small blind) folded before Flop
Seat 3: 621c3c07 (big blind) folded on the Flop
Seat 4: Hero folded before Flop (didn't bet)
Seat 5: 14620cce folded before Flop (didn't bet)
Seat 6: 9a69a3a0 folded before Flop (didn't bet)


Poker Hand #RC3334480771: Hold'em No Limit ($0.02/$0.05) - 2025/02/17 21:05:30
Table 'RushAndCash616031' 6-max Seat #1 is the button
Seat 1: 21c758a ($5.74 in chips)
Seat 2: 8023de0f ($6.13 in chips)
Seat 3: a86de18f ($1.11 in chips)
Seat 4: Hero ($6.2 in chips)
Seat 5: 7a40fb8f ($5.55 in chips)
Seat 6: e7868a11 ($5 in chips)
8023de0f: posts small blind $0.02
a86de18f: posts big blind $0.05
*** HOLE CARDS ***
Dealt to 21c758a 
Dealt to 8023de0f 
Dealt to a86de18f 
Dealt to Hero [Js 4h]
Dealt to 7a40fb8f 
Dealt to e7868a11 
Hero: folds
7a40fb8f: folds
e7868a11: folds
21c758a: folds
8023de0f: raises $0.05 to $0.1
a86de18f: calls $0.05
*** FLOP *** [8s 6h Kd]
8023de0f: bets $0.08
a86de18f: calls $0.08
*** TURN *** [8s 6h Kd] [2h]
8023de0f: bets $0.28
a86de18f: calls $0.28
*** RIVER *** [8s 6h Kd 2h] [9c]
8023de0f: checks
a86de18f: checks
8023de0f: shows [3h 7s] (King-High)
a86de18f: shows [7h 8c] (Pair of Eights)
*** SHOWDOWN ***
a86de18f collected $0.88 from pot
*** SUMMARY ***
Total pot $0.92 | Rake $0.04 | Jackpot $0 | Bingo $0 | Fortune $0 | Tax $0
Board [8s 6h Kd 2h 9c]
Seat 1: 21c758a (button) folded before Flop (didn't bet)
Seat 2: 8023de0f (small blind) showed [3h 7s] and lost with King-High
Seat 3: a86de18f (big blind) showed [7h 8c] and won ($0.88) with Pair of Eights
Seat 4: Hero folded before Flop (didn't bet)
Seat 5: 7a40fb8f folded before Flop (didn't bet)
Seat 6: e7868a11 folded before Flop (didn't bet)


Poker Hand #RC3334480745: Hold'em No Limit ($0.02/$0.05) - 2025/02/17 21:05:26
Table 'RushAndCash616005' 6-max Seat #1 is the button
Seat 1: 730098b8 ($6.46 in chips)
Seat 2: 4262311b ($5.02 in chips)
Seat 3: 7fe74cc5 ($7.67 in chips)
Seat 4: e7868a11 ($5 in chips)
Seat 5: 7a40fb8f ($5.55 in chips)
Seat 6: Hero ($6.2 in chips)
4262311b: posts small blind $0.02
7fe74cc5: posts big blind $0.05
*** HOLE CARDS ***
Dealt to 730098b8 
Dealt to 4262311b 
Dealt to 7fe74cc5 
Dealt to e7868a11 
Dealt to 7a40fb8f 
Dealt to Hero [2c Tc]
e7868a11: folds
7a40fb8f: folds
Hero: folds
730098b8: folds
4262311b: folds
Uncalled bet ($0.03) returned to 7fe74cc5
*** SHOWDOWN ***
7fe74cc5 collected $0.04 from pot
*** SUMMARY ***
Total pot $0.04 | Rake $0 | Jackpot $0 | Bingo $0 | Fortune $0 | Tax $0
Seat 1: 730098b8 (button) folded before Flop (didn't bet)
Seat 2: 4262311b (small blind) folded before Flop
Seat 3: 7fe74cc5 (big blind) collected ($0.04)
Seat 4: e7868a11 folded before Flop (didn't bet)
Seat 5: 7a40fb8f folded before Flop (didn't bet)
Seat 6: Hero folded before Flop (didn't bet)


Poker Hand #RC3334480548: Hold'em No Limit ($0.02/$0.05) - 2025/02/17 21:05:02
Table 'RushAndCash615808' 6-max Seat #1 is the button
Seat 1: 23c23672 ($5 in chips)
Seat 2: 825e110f ($7.55 in chips)
Seat 3: 860fa4c9 ($9.39 in chips)
Seat 4: c75b2ba0 ($5.6 in chips)
Seat 5: 1da8eae5 ($5.28 in chips)
Seat 6: Hero ($6.3 in chips)
825e110f: posts small blind $0.02
860fa4c9: posts big blind $0.05
*** HOLE CARDS ***
Dealt to 23c23672 
Dealt to 825e110f 
Dealt to 860fa4c9 
Dealt to c75b2ba0 
Dealt to 1da8eae5 
Dealt to Hero [Kc 5c]
c75b2ba0: folds
1da8eae5: folds
Hero: raises $0.05 to $0.1
23c23672: raises $0.24 to $0.34
825e110f: folds
860fa4c9: folds
Hero: folds
Uncalled bet ($0.24) returned to 23c23672
*** SHOWDOWN ***
23c23672 collected $0.26 from pot
*** SUMMARY ***
Total pot $0.27 | Rake $0.01 | Jackpot $0 | Bingo $0 | Fortune $0 | Tax $0
Seat 1: 23c23672 (button) collected ($0.26)
Seat 2: 825e110f (small blind) folded before Flop
Seat 3: 860fa4c9 (big blind) folded before Flop
Seat 4: c75b2ba0 folded before Flop (didn't bet)
Seat 5: 1da8eae5 folded before Flop (didn't bet)
Seat 6: Hero folded before Flop


Poker Hand #RC3334480492: Hold'em No Limit ($0.02/$0.05) - 2025/02/17 21:04:54
Table 'RushAndCash615752' 6-max Seat #1 is the button
Seat 1: Hero ($6.3 in chips)
Seat 2: 76135c78 ($12.85 in chips)
Seat 3: f1f26d78 ($6.57 in chips)
Seat 4: 42c7d5a0 ($5 in chips)
Seat 5: b67f7812 ($10.29 in chips)
Seat 6: 38a4c833 ($8.15 in chips)
76135c78: posts small blind $0.02
f1f26d78: posts big blind $0.05
*** HOLE CARDS ***
Dealt to Hero [8s 2c]
Dealt to 76135c78 
Dealt to f1f26d78 
Dealt to 42c7d5a0 
Dealt to b67f7812 
Dealt to 38a4c833 
42c7d5a0: folds
b67f7812: raises $0.05 to $0.1
38a4c833: calls $0.1
Hero: folds
76135c78: folds
f1f26d78: folds
*** FLOP *** [As Js Qd]
b67f7812: bets $0.14
38a4c833: calls $0.14
*** TURN *** [As Js Qd] [Qh]
b67f7812: checks
38a4c833: bets $0.19
b67f7812: folds
Uncalled bet ($0.19) returned to 38a4c833
*** SHOWDOWN ***
38a4c833 collected $0.53 from pot
*** SUMMARY ***
Total pot $0.55 | Rake $0.02 | Jackpot $0 | Bingo $0 | Fortune $0 | Tax $0
Board [As Js Qd Qh]
Seat 1: Hero (button) folded before Flop (didn't bet)
Seat 2: 76135c78 (small blind) folded before Flop
Seat 3: f1f26d78 (big blind) folded before Flop
Seat 4: 42c7d5a0 folded before Flop (didn't bet)
Seat 5: b67f7812 folded on the Turn
Seat 6: 38a4c833 won ($0.53)


Poker Hand #RC3334480462: Hold'em No Limit ($0.02/$0.05) - 2025/02/17 21:04:50
Table 'RushAndCash615722' 6-max Seat #1 is the button
Seat 1: bc64c9e6 ($5 in chips)
Seat 2: Hero ($6.32 in chips)
Seat 3: c75b2ba0 ($5.58 in chips)
Seat 4: d29f701c ($5.5 in chips)
Seat 5: 8f1315bb ($5.46 in chips)
Seat 6: 688b40f9 ($6.03 in chips)
Hero: posts small blind $0.02
c75b2ba0: posts big blind $0.05
*** HOLE CARDS ***
Dealt to bc64c9e6 
Dealt to Hero [3d Ts]
Dealt to c75b2ba0 
Dealt to d29f701c 
Dealt to 8f1315bb 
Dealt to 688b40f9 
d29f701c: folds
8f1315bb: folds
688b40f9: folds
bc64c9e6: folds
Hero: folds
Uncalled bet ($0.03) returned to c75b2ba0
*** SHOWDOWN ***
c75b2ba0 collected $0.04 from pot
*** SUMMARY ***
Total pot $0.04 | Rake $0 | Jackpot $0 | Bingo $0 | Fortune $0 | Tax $0
Seat 1: bc64c9e6 (button) folded before Flop (didn't bet)
Seat 2: Hero (small blind) folded before Flop
Seat 3: c75b2ba0 (big blind) collected ($0.04)
Seat 4: d29f701c folded before Flop (didn't bet)
Seat 5: 8f1315bb folded before Flop (didn't bet)
Seat 6: 688b40f9 folded before Flop (didn't bet)


Poker Hand #RC3334480435: Hold'em No Limit ($0.02/$0.05) - 2025/02/17 21:04:47
Table 'RushAndCash615695' 6-max Seat #1 is the button
Seat 1: 67b2dab9 ($5.18 in chips)
Seat 2: 20c536f4 ($5.49 in chips)
Seat 3: Hero ($6.37 in chips)
Seat 4: 8c3789e ($5 in chips)
Seat 5: fc71f850 ($5.75 in chips)
Seat 6: d29f701c ($5.5 in chips)
20c536f4: posts small blind $0.02
Hero: posts big blind $0.05
*** HOLE CARDS ***
Dealt to 67b2dab9 
Dealt to 20c536f4 
Dealt to Hero [Qd 4d]
Dealt to 8c3789e 
Dealt to fc71f850 
Dealt to d29f701c 
8c3789e: folds
fc71f850: folds
d29f701c: folds
67b2dab9: raises $0.06 to $0.11
20c536f4: folds
Hero: folds
Uncalled bet ($0.06) returned to 67b2dab9
*** SHOWDOWN ***
67b2dab9 collected $0.12 from pot
*** SUMMARY ***
Total pot $0.12 | Rake $0 | Jackpot $0 | Bingo $0 | Fortune $0 | Tax $0
Seat 1: 67b2dab9 (button) collected ($0.12)
Seat 2: 20c536f4 (small blind) folded before Flop
Seat 3: Hero (big blind) folded before Flop
Seat 4: 8c3789e folded before Flop (didn't bet)
Seat 5: fc71f850 folded before Flop (didn't bet)
Seat 6: d29f701c folded before Flop (didn't bet)


Poker Hand #RC3334480413: Hold'em No Limit ($0.02/$0.05) - 2025/02/17 21:04:44
Table 'RushAndCash615673' 6-max Seat #1 is the button
Seat 1: fad7078a ($6.2 in chips)
Seat 2: 626359de ($12.3 in chips)
Seat 3: d47cb19 ($5.07 in chips)
Seat 4: Hero ($6.37 in chips)
Seat 5: bb090dff ($5.16 in chips)
Seat 6: 98b7c00d ($5 in chips)
626359de: posts small blind $0.02
d47cb19: posts big blind $0.05
*** HOLE CARDS ***
Dealt to fad7078a 
Dealt to 626359de 
Dealt to d47cb19 
Dealt to Hero [2d Ad]
Dealt to bb090dff 
Dealt to 98b7c00d 
Hero: folds
bb090dff: folds
98b7c00d: folds
fad7078a: raises $0.05 to $0.1
626359de: folds
d47cb19: raises $0.05 to $0.15
fad7078a: calls $0.05
*** FLOP *** [Jc 4h 2s]
d47cb19: checks
fad7078a: checks
*** TURN *** [Jc 4h 2s] [3d]
d47cb19: checks
fad7078a: checks
*** RIVER *** [Jc 4h 2s 3d] [As]
d47cb19: checks
fad7078a: bets $0.16
d47cb19: folds
Uncalled bet ($0.16) returned to fad7078a
*** SHOWDOWN ***
fad7078a collected $0.31 from pot
*** SUMMARY ***
Total pot $0.32 | Rake $0.01 | Jackpot $0 | Bingo $0 | Fortune $0 | Tax $0
Board [Jc 4h 2s 3d As]
Seat 1: fad7078a (button) won ($0.31)
Seat 2: 626359de (small blind) folded before Flop
Seat 3: d47cb19 (big blind) folded on the River
Seat 4: Hero folded before Flop (didn't bet)
Seat 5: bb090dff folded before Flop (didn't bet)
Seat 6: 98b7c00d folded before Flop (didn't bet)


Poker Hand #RC3334480388: Hold'em No Limit ($0.02/$0.05) - 2025/02/17 21:04:41
Table 'RushAndCash615648' 6-max Seat #1 is the button
Seat 1: ee3fdfd8 ($5.41 in chips)
Seat 2: Hero ($6.39 in chips)
Seat 3: bfef046a ($29.76 in chips)
Seat 4: 1157f85d ($9.18 in chips)
Seat 5: 5422bec9 ($5 in chips)
Seat 6: 8d378f31 ($11.33 in chips)
Hero: posts small blind $0.02
bfef046a: posts big blind $0.05
*** HOLE CARDS ***
Dealt to ee3fdfd8 
Dealt to Hero [Qc 7h]
Dealt to bfef046a 
Dealt to 1157f85d 
Dealt to 5422bec9 
Dealt to 8d378f31 
1157f85d: folds
5422bec9: folds
8d378f31: raises $0.06 to $0.11
ee3fdfd8: folds
Hero: folds
bfef046a: folds
Uncalled bet ($0.06) returned to 8d378f31
*** SHOWDOWN ***
8d378f31 collected $0.12 from pot
*** SUMMARY ***
Total pot $0.12 | Rake $0 | Jackpot $0 | Bingo $0 | Fortune $0 | Tax $0
Seat 1: ee3fdfd8 (button) folded before Flop (didn't bet)
Seat 2: Hero (small blind) folded before Flop
Seat 3: bfef046a (big blind) folded before Flop
Seat 4: 1157f85d folded before Flop (didn't bet)
Seat 5: 5422bec9 folded before Flop (didn't bet)
Seat 6: 8d378f31 collected ($0.12)


Poker Hand #RC3334480367: Hold'em No Limit ($0.02/$0.05) - 2025/02/17 21:04:38
Table 'RushAndCash615627' 6-max Seat #1 is the button
Seat 1: b3bca39d ($2.27 in chips)
Seat 2: eb1bbc7a ($3.33 in chips)
Seat 3: ae2aee6e ($5.84 in chips)
Seat 4: 1157f85d ($9.18 in chips)
Seat 5: a28ca95c ($23.25 in chips)
Seat 6: Hero ($6.39 in chips)
eb1bbc7a: posts small blind $0.02
ae2aee6e: posts big blind $0.05
*** HOLE CARDS ***
Dealt to b3bca39d 
Dealt to eb1bbc7a 
Dealt to ae2aee6e 
Dealt to 1157f85d 
Dealt to a28ca95c 
Dealt to Hero [Qd 5s]
1157f85d: folds
a28ca95c: folds
Hero: folds
b3bca39d: folds
eb1bbc7a: raises $0.08 to $0.13
ae2aee6e: calls $0.08
*** FLOP *** [4c Kh 2h]
eb1bbc7a: bets $0.13
ae2aee6e: folds
Uncalled bet ($0.13) returned to eb1bbc7a
*** SHOWDOWN ***
eb1bbc7a collected $0.25 from pot
*** SUMMARY ***
Total pot $0.26 | Rake $0.01 | Jackpot $0 | Bingo $0 | Fortune $0 | Tax $0
Board [4c Kh 2h]
Seat 1: b3bca39d (button) folded before Flop (didn't bet)
Seat 2: eb1bbc7a (small blind) won ($0.25)
Seat 3: ae2aee6e (big blind) folded on the Flop
Seat 4: 1157f85d folded before Flop (didn't bet)
Seat 5: a28ca95c folded before Flop (didn't bet)
Seat 6: Hero folded before Flop (didn't bet)


Poker Hand #RC3334480344: Hold'em No Limit ($0.02/$0.05) - 2025/02/17 21:04:35
Table 'RushAndCash615604' 6-max Seat #1 is the button
Seat 1: Hero ($6.39 in chips)
Seat 2: 711af4a4 ($12.17 in chips)
Seat 3: 8dbd0a2d ($9.77 in chips)
Seat 4: 528d10e7 ($5.6 in chips)
Seat 5: 4c7728b5 ($7.41 in chips)
Seat 6: 5a1e8ed6 ($1.82 in chips)
711af4a4: posts small blind $0.02
8dbd0a2d: posts big blind $0.05
*** HOLE CARDS ***
Dealt to Hero [4c Td]
Dealt to 711af4a4 
Dealt to 8dbd0a2d 
Dealt to 528d10e7 
Dealt to 4c7728b5 
Dealt to 5a1e8ed6 
528d10e7: folds
4c7728b5: folds
5a1e8ed6: calls $0.05
Hero: folds
711af4a4: folds
8dbd0a2d: checks
*** FLOP *** [5c 6h Kc]
8dbd0a2d: checks
5a1e8ed6: checks
*** TURN *** [5c 6h Kc] [Ts]
8dbd0a2d: checks
5a1e8ed6: checks
*** RIVER *** [5c 6h Kc Ts] [4s]
8dbd0a2d: checks
5a1e8ed6: checks
8dbd0a2d: shows [Jc 4h] (Pair of Fours)
5a1e8ed6: shows [Ac 2s] (Ace-High)
*** SHOWDOWN ***
8dbd0a2d collected $0.12 from pot
*** SUMMARY ***
Total pot $0.12 | Rake $0 | Jackpot $0 | Bingo $0 | Fortune $0 | Tax $0
Board [5c 6h Kc Ts 4s]
Seat 1: Hero (button) folded before Flop (didn't bet)
Seat 2: 711af4a4 (small blind) folded before Flop
Seat 3: 8dbd0a2d (big blind) showed [Jc 4h] and won ($0.12) with Pair of Fours
Seat 4: 528d10e7 folded before Flop (didn't bet)
Seat 5: 4c7728b5 folded before Flop (didn't bet)
Seat 6: 5a1e8ed6 showed [Ac 2s] and lost with Ace-High


Poker Hand #RC3334479983: Hold'em No Limit ($0.02/$0.05) - 2025/02/17 21:03:49
Table 'RushAndCash615243' 6-max Seat #1 is the button
Seat 1: 9dba8a1e ($6.52 in chips)
Seat 2: f994138c ($7.39 in chips)
Seat 3: Hero ($6.12 in chips)
Seat 4: b3bca39d ($2.21 in chips)
Seat 5: 6f8bb9d1 ($6.18 in chips)
Seat 6: 7df4712d ($7.81 in chips)
f994138c: posts small blind $0.02
Hero: posts big blind $0.05
*** HOLE CARDS ***
Dealt to 9dba8a1e 
Dealt to f994138c 
Dealt to Hero [5c 6c]
Dealt to b3bca39d 
Dealt to 6f8bb9d1 
Dealt to 7df4712d 
b3bca39d: folds
6f8bb9d1: folds
7df4712d: folds
9dba8a1e: raises $0.05 to $0.1
f994138c: folds
Hero: calls $0.05
*** FLOP *** [Ac 7d 8c]
Hero: checks
9dba8a1e: bets $0.17
Hero: calls $0.17
*** TURN *** [Ac 7d 8c] [2h]
Hero: checks
9dba8a1e: checks
*** RIVER *** [Ac 7d 8c 2h] [6s]
Hero: checks
9dba8a1e: checks
Hero: shows [5c 6c] (Pair of Sixes)
9dba8a1e: shows [Jh Qc] (Ace-High)
*** SHOWDOWN ***
Hero collected $0.54 from pot
*** SUMMARY ***
Total pot $0.56 | Rake $0.02 | Jackpot $0 | Bingo $0 | Fortune $0 | Tax $0
Board [Ac 7d 8c 2h 6s]
Seat 1: 9dba8a1e (button) showed [Jh Qc] and lost with Ace-High
Seat 2: f994138c (small blind) folded before Flop
Seat 3: Hero (big blind) showed [5c 6c] and won ($0.54) with Pair of Sixes
Seat 4: b3bca39d folded before Flop (didn't bet)
Seat 5: 6f8bb9d1 folded before Flop (didn't bet)
Seat 6: 7df4712d folded before Flop (didn't bet)


Poker Hand #RC3334479952: Hold'em No Limit ($0.02/$0.05) - 2025/02/17 21:03:45
Table 'RushAndCash615212' 6-max Seat #1 is the button
Seat 1: 81060c15 ($3.49 in chips)
Seat 2: 3b2a8270 ($14.6 in chips)
Seat 3: 9b152430 ($5.62 in chips)
Seat 4: Hero ($6.12 in chips)
Seat 5: 9b99e93a ($14.71 in chips)
Seat 6: 320e8d82 ($8.5 in chips)
3b2a8270: posts small blind $0.02
9b152430: posts big blind $0.05
*** HOLE CARDS ***
Dealt to 81060c15 
Dealt to 3b2a8270 
Dealt to 9b152430 
Dealt to Hero [7d 6c]
Dealt to 9b99e93a 
Dealt to 320e8d82 
Hero: folds
9b99e93a: raises $0.05 to $0.1
320e8d82: folds
81060c15: calls $0.1
3b2a8270: folds
9b152430: folds
*** FLOP *** [Qh 5d 3d]
9b99e93a: bets $0.14
81060c15: calls $0.14
*** TURN *** [Qh 5d 3d] [Ad]
9b99e93a: checks
81060c15: checks
*** RIVER *** [Qh 5d 3d Ad] [4h]
9b99e93a: bets $0.28
81060c15: folds
Uncalled bet ($0.28) returned to 9b99e93a
*** SHOWDOWN ***
9b99e93a collected $0.53 from pot
*** SUMMARY ***
Total pot $0.55 | Rake $0.02 | Jackpot $0 | Bingo $0 | Fortune $0 | Tax $0
Board [Qh 5d 3d Ad 4h]
Seat 1: 81060c15 (button) folded on the River
Seat 2: 3b2a8270 (small blind) folded before Flop
Seat 3: 9b152430 (big blind) folded before Flop
Seat 4: Hero folded before Flop (didn't bet)
Seat 5: 9b99e93a won ($0.53)
Seat 6: 320e8d82 folded before Flop (didn't bet)


Poker Hand #RC3334479925: Hold'em No Limit ($0.02/$0.05) - 2025/02/17 21:03:42
Table 'RushAndCash615185' 6-max Seat #1 is the button
Seat 1: e606bcb0 ($5 in chips)
Seat 2: c49da358 ($5 in chips)
Seat 3: 38f4cc4d ($4.96 in chips)
Seat 4: Hero ($6.12 in chips)
Seat 5: 1157f85d ($9.18 in chips)
Seat 6: 6acbb6b6 ($3.18 in chips)
c49da358: posts small blind $0.02
38f4cc4d: posts big blind $0.05
*** HOLE CARDS ***
Dealt to e606bcb0 
Dealt to c49da358 
Dealt to 38f4cc4d 
Dealt to Hero [Jh 7c]
Dealt to 1157f85d 
Dealt to 6acbb6b6 
Hero: folds
1157f85d: folds
6acbb6b6: folds
e606bcb0: folds
c49da358: folds
Uncalled bet ($0.03) returned to 38f4cc4d
*** SHOWDOWN ***
38f4cc4d collected $0.04 from pot
*** SUMMARY ***
Total pot $0.04 | Rake $0 | Jackpot $0 | Bingo $0 | Fortune $0 | Tax $0
Seat 1: e606bcb0 (button) folded before Flop (didn't bet)
Seat 2: c49da358 (small blind) folded before Flop
Seat 3: 38f4cc4d (big blind) collected ($0.04)
Seat 4: Hero folded before Flop (didn't bet)
Seat 5: 1157f85d folded before Flop (didn't bet)
Seat 6: 6acbb6b6 folded before Flop (didn't bet)


Poker Hand #RC3334479620: Hold'em No Limit ($0.02/$0.05) - 2025/02/17 21:03:02
Table 'RushAndCash614880' 6-max Seat #1 is the button
Seat 1: 70521b8f ($6.35 in chips)
Seat 2: da41ab59 ($10.77 in chips)
Seat 3: d201e5fe ($9.64 in chips)
Seat 4: db0f0c64 ($6.16 in chips)
Seat 5: Hero ($6.1 in chips)
Seat 6: 302a1708 ($5.56 in chips)
da41ab59: posts small blind $0.02
d201e5fe: posts big blind $0.05
*** HOLE CARDS ***
Dealt to 70521b8f 
Dealt to da41ab59 
Dealt to d201e5fe 
Dealt to db0f0c64 
Dealt to Hero [Ts Ad]
Dealt to 302a1708 
db0f0c64: folds
Hero: raises $0.05 to $0.1
302a1708: folds
70521b8f: folds
da41ab59: calls $0.08
d201e5fe: folds
*** FLOP *** [Qs 8d 9d]
da41ab59: checks
Hero: checks
*** TURN *** [Qs 8d 9d] [9s]
da41ab59: checks
Hero: checks
*** RIVER *** [Qs 8d 9d 9s] [Qh]
da41ab59: checks
Hero: checks
da41ab59: shows [2c Ah] (Pair of Queens and Pair of Nines)
Hero: shows [Ts Ad] (Pair of Queens and Pair of Nines)
*** SHOWDOWN ***
da41ab59 collected $0.13 from pot
Hero collected $0.12 from pot
*** SUMMARY ***
Total pot $0.25 | Rake $0 | Jackpot $0 | Bingo $0 | Fortune $0 | Tax $0
Board [Qs 8d 9d 9s Qh]
Seat 1: 70521b8f (button) folded before Flop (didn't bet)
Seat 2: da41ab59 (small blind) showed [2c Ah] and won ($0.13) with Pair of Queens and Pair of Nines
Seat 3: d201e5fe (big blind) folded before Flop
Seat 4: db0f0c64 folded before Flop (didn't bet)
Seat 5: Hero showed [Ts Ad] and won ($0.12) with Pair of Queens and Pair of Nines
Seat 6: 302a1708 folded before Flop (didn't bet)


Poker Hand #RC3334479593: Hold'em No Limit ($0.02/$0.05) - 2025/02/17 21:02:59
Table 'RushAndCash614853' 6-max Seat #1 is the button
Seat 1: d201e5fe ($9.64 in chips)
Seat 2: e10f146c ($5.78 in chips)
Seat 3: 66981141 ($11.29 in chips)
Seat 4: 70521b8f ($6.35 in chips)
Seat 5: Hero ($6.1 in chips)
Seat 6: 44a9f3f0 ($6.55 in chips)
e10f146c: posts small blind $0.02
66981141: posts big blind $0.05
*** HOLE CARDS ***
Dealt to d201e5fe 
Dealt to e10f146c 
Dealt to 66981141 
Dealt to 70521b8f 
Dealt to Hero [9c Qs]
Dealt to 44a9f3f0 
70521b8f: folds
Hero: folds
44a9f3f0: raises $0.05 to $0.1
d201e5fe: folds
e10f146c: raises $0.42 to $0.52
66981141: folds
44a9f3f0: raises $0.53 to $1.05
e10f146c: raises $4.73 to $5.78 and is all-in
44a9f3f0: folds
Uncalled bet ($4.73) returned to e10f146c
*** SHOWDOWN ***
e10f146c collected $1.98 from pot
*** SUMMARY ***
Total pot $2.15 | Rake $0.1 | Jackpot $0.07 | Bingo $0 | Fortune $0 | Tax $0
Seat 1: d201e5fe (button) folded before Flop (didn't bet)
Seat 2: e10f146c (small blind) collected ($1.98)
Seat 3: 66981141 (big blind) folded before Flop
Seat 4: 70521b8f folded before Flop (didn't bet)
Seat 5: Hero folded before Flop (didn't bet)
Seat 6: 44a9f3f0 folded before Flop


Poker Hand #RC3334479481: Hold'em No Limit ($0.02/$0.05) - 2025/02/17 21:02:46
Table 'RushAndCash614741' 6-max Seat #1 is the button
Seat 1: 95096c6a ($6.89 in chips)
Seat 2: c7e9103c ($11.97 in chips)
Seat 3: Hero ($6.15 in chips)
Seat 4: 9dd1ff39 ($7.31 in chips)
Seat 5: ab43c8b8 ($5.9 in chips)
Seat 6: 6670b08e ($4.6 in chips)
c7e9103c: posts small blind $0.02
Hero: posts big blind $0.05
*** HOLE CARDS ***
Dealt to 95096c6a 
Dealt to c7e9103c 
Dealt to Hero [3d Jd]
Dealt to 9dd1ff39 
Dealt to ab43c8b8 
Dealt to 6670b08e 
9dd1ff39: folds
ab43c8b8: folds
6670b08e: raises $0.08 to $0.13
95096c6a: raises $0.29 to $0.42
c7e9103c: folds
Hero: folds
6670b08e: calls $0.29
*** FLOP *** [8c Qs 6c]
6670b08e: checks
95096c6a: checks
*** TURN *** [8c Qs 6c] [Ts]
6670b08e: bets $0.31
95096c6a: calls $0.31
*** RIVER *** [8c Qs 6c Ts] [7d]
6670b08e: bets $1.53
95096c6a: folds
Uncalled bet ($1.53) returned to 6670b08e
*** SHOWDOWN ***
6670b08e collected $1.39 from pot
*** SUMMARY ***
Total pot $1.53 | Rake $0.07 | Jackpot $0.07 | Bingo $0 | Fortune $0 | Tax $0
Board [8c Qs 6c Ts 7d]
Seat 1: 95096c6a (button) folded on the River
Seat 2: c7e9103c (small blind) folded before Flop
Seat 3: Hero (big blind) folded before Flop
Seat 4: 9dd1ff39 folded before Flop (didn't bet)
Seat 5: ab43c8b8 folded before Flop (didn't bet)
Seat 6: 6670b08e won ($1.39)


Poker Hand #RC3334479452: Hold'em No Limit ($0.02/$0.05) - 2025/02/17 21:02:42
Table 'RushAndCash614712' 6-max Seat #1 is the button
Seat 1: a598408a ($5.07 in chips)
Seat 2: 23619adf ($5.85 in chips)
Seat 3: 186b316a ($8.71 in chips)
Seat 4: 8f77797e ($5.07 in chips)
Seat 5: ab43c8b8 ($5.9 in chips)
Seat 6: Hero ($6.15 in chips)
23619adf: posts small blind $0.02
186b316a: posts big blind $0.05
*** HOLE CARDS ***
Dealt to a598408a 
Dealt to 23619adf 
Dealt to 186b316a 
Dealt to 8f77797e 
Dealt to ab43c8b8 
Dealt to Hero [5d 7c]
8f77797e: raises $0.05 to $0.1
ab43c8b8: folds
Hero: folds
a598408a: folds
23619adf: folds
186b316a: folds
Uncalled bet ($0.05) returned to 8f77797e
*** SHOWDOWN ***
8f77797e collected $0.12 from pot
*** SUMMARY ***
Total pot $0.12 | Rake $0 | Jackpot $0 | Bingo $0 | Fortune $0 | Tax $0
Seat 1: a598408a (button) folded before Flop (didn't bet)
Seat 2: 23619adf (small blind) folded before Flop
Seat 3: 186b316a (big blind) folded before Flop
Seat 4: 8f77797e collected ($0.12)
Seat 5: ab43c8b8 folded before Flop (didn't bet)
Seat 6: Hero folded before Flop (didn't bet)


Poker Hand #RC3334479426: Hold'em No Limit ($0.02/$0.05) - 2025/02/17 21:02:39
Table 'RushAndCash614686' 6-max Seat #1 is the button
Seat 1: Hero ($6.15 in chips)
Seat 2: f2e82cf4 ($8.27 in chips)
Seat 3: c9e4cf57 ($6.58 in chips)
Seat 4: e3cc36cb ($5.4 in chips)
Seat 5: 87d5083b ($24.04 in chips)
Seat 6: bc8371cb ($5.65 in chips)
f2e82cf4: posts small blind $0.02
c9e4cf57: posts big blind $0.05
*** HOLE CARDS ***
Dealt to Hero [3s 7h]
Dealt to f2e82cf4 
Dealt to c9e4cf57 
Dealt to e3cc36cb 
Dealt to 87d5083b 
Dealt to bc8371cb 
e3cc36cb: folds
87d5083b: raises $0.05 to $0.1
bc8371cb: raises $0.26 to $0.36
Hero: folds
f2e82cf4: folds
c9e4cf57: folds
87d5083b: folds
Uncalled bet ($0.26) returned to bc8371cb
*** SHOWDOWN ***
bc8371cb collected $0.26 from pot
*** SUMMARY ***
Total pot $0.27 | Rake $0.01 | Jackpot $0 | Bingo $0 | Fortune $0 | Tax $0
Seat 1: Hero (button) folded before Flop (didn't bet)
Seat 2: f2e82cf4 (small blind) folded before Flop
Seat 3: c9e4cf57 (big blind) folded before Flop
Seat 4: e3cc36cb folded before Flop (didn't bet)
Seat 5: 87d5083b folded before Flop
Seat 6: bc8371cb collected ($0.26)


Poker Hand #RC3334479399: Hold'em No Limit ($0.02/$0.05) - 2025/02/17 21:02:36
Table 'RushAndCash614659' 6-max Seat #1 is the button
Seat 1: e3c5673f ($4.9 in chips)
Seat 2: f994138c ($6.74 in chips)
Seat 3: 77936ad9 ($6.61 in chips)
Seat 4: b8a41e4 ($5.63 in chips)
Seat 5: Hero ($6.15 in chips)
Seat 6: bc8371cb ($5.65 in chips)
f994138c: posts small blind $0.02
77936ad9: posts big blind $0.05
*** HOLE CARDS ***
Dealt to e3c5673f 
Dealt to f994138c 
Dealt to 77936ad9 
Dealt to b8a41e4 
Dealt to Hero [Qc Jh]
Dealt to bc8371cb 
b8a41e4: folds
Hero: folds
bc8371cb: folds
e3c5673f: folds
f994138c: raises $0.08 to $0.13
77936ad9: raises $0.41 to $0.54
f994138c: calls $0.41
*** FLOP *** [Ad 6c Kd]
f994138c: checks
77936ad9: bets $0.16
f994138c: calls $0.16
*** TURN *** [Ad 6c Kd] [7h]
f994138c: checks
77936ad9: checks
*** RIVER *** [Ad 6c Kd 7h] [3h]
f994138c: checks
77936ad9: checks
f994138c: shows [Ac Jc] (Pair of Aces)
77936ad9: shows [Js 8s] (Ace-High)
*** SHOWDOWN ***
f994138c collected $1.33 from pot
*** SUMMARY ***
Total pot $1.4 | Rake $0.07 | Jackpot $0 | Bingo $0 | Fortune $0 | Tax $0
Board [Ad 6c Kd 7h 3h]
Seat 1: e3c5673f (button) folded before Flop (didn't bet)
Seat 2: f994138c (small blind) showed [Ac Jc] and won ($1.33) with Pair of Aces
Seat 3: 77936ad9 (big blind) showed [Js 8s] and lost with Ace-High
Seat 4: b8a41e4 folded before Flop (didn't bet)
Seat 5: Hero folded before Flop (didn't bet)
Seat 6: bc8371cb folded before Flop (didn't bet)


Poker Hand #RC3334479371: Hold'em No Limit ($0.02/$0.05) - 2025/02/17 21:02:33
Table 'RushAndCash614631' 6-max Seat #1 is the button
Seat 1: 31bef4 ($6.17 in chips)
Seat 2: Hero ($6.17 in chips)
Seat 3: 902b47de ($5.55 in chips)
Seat 4: 77368e62 ($5.6 in chips)
Seat 5: bc8371cb ($5.65 in chips)
Seat 6: 32c94dea ($7.03 in chips)
Hero: posts small blind $0.02
902b47de: posts big blind $0.05
*** HOLE CARDS ***
Dealt to 31bef4 
Dealt to Hero [3s Ac]
Dealt to 902b47de 
Dealt to 77368e62 
Dealt to bc8371cb 
Dealt to 32c94dea 
77368e62: folds
bc8371cb: folds
32c94dea: folds
31bef4: folds
Hero: folds
Uncalled bet ($0.03) returned to 902b47de
*** SHOWDOWN ***
902b47de collected $0.04 from pot
*** SUMMARY ***
Total pot $0.04 | Rake $0 | Jackpot $0 | Bingo $0 | Fortune $0 | Tax $0
Seat 1: 31bef4 (button) folded before Flop (didn't bet)
Seat 2: Hero (small blind) folded before Flop
Seat 3: 902b47de (big blind) collected ($0.04)
Seat 4: 77368e62 folded before Flop (didn't bet)
Seat 5: bc8371cb folded before Flop (didn't bet)
Seat 6: 32c94dea folded before Flop (didn't bet)


Poker Hand #RC3334479350: Hold'em No Limit ($0.02/$0.05) - 2025/02/17 21:02:30
Table 'RushAndCash614610' 6-max Seat #1 is the button
Seat 1: b8a41e4 ($5.63 in chips)
Seat 2: Hero ($6.19 in chips)
Seat 3: 86e70506 ($5.32 in chips)
Seat 4: 528d10e7 ($4.33 in chips)
Seat 5: 8dbd0a2d ($9.47 in chips)
Seat 6: ef96c0c8 ($5.02 in chips)
Hero: posts small blind $0.02
86e70506: posts big blind $0.05
*** HOLE CARDS ***
Dealt to b8a41e4 
Dealt to Hero [3c 5s]
Dealt to 86e70506 
Dealt to 528d10e7 
Dealt to 8dbd0a2d 
Dealt to ef96c0c8 
528d10e7: raises $0.06 to $0.11
8dbd0a2d: folds
ef96c0c8: folds
b8a41e4: folds
Hero: folds
86e70506: raises $0.44 to $0.55
528d10e7: calls $0.44
*** FLOP *** [5h 7d 4d]
86e70506: bets $0.37
528d10e7: calls $0.37
*** TURN *** [5h 7d 4d] [Qc]
86e70506: checks
528d10e7: bets $0.62
86e70506: folds
Uncalled bet ($0.62) returned to 528d10e7
*** SHOWDOWN ***
528d10e7 collected $1.7 from pot
*** SUMMARY ***
Total pot $1.86 | Rake $0.09 | Jackpot $0.07 | Bingo $0 | Fortune $0 | Tax $0
Board [5h 7d 4d Qc]
Seat 1: b8a41e4 (button) folded before Flop (didn't bet)
Seat 2: Hero (small blind) folded before Flop
Seat 3: 86e70506 (big blind) folded on the Turn
Seat 4: 528d10e7 won ($1.7)
Seat 5: 8dbd0a2d folded before Flop (didn't bet)
Seat 6: ef96c0c8 folded before Flop (didn't bet)


Poker Hand #RC3334479328: Hold'em No Limit ($0.02/$0.05) - 2025/02/17 21:02:27
Table 'RushAndCash614588' 6-max Seat #1 is the button
Seat 1: 7f0fed0a ($5.16 in chips)
Seat 2: Hero ($6.21 in chips)
Seat 3: 21bff972 ($6.11 in chips)
Seat 4: 650e9dc7 ($7.32 in chips)
Seat 5: 6c00745d ($5.59 in chips)
Seat 6: bc64c9e6 ($5 in chips)
Hero: posts small blind $0.02
21bff972: posts big blind $0.05
*** HOLE CARDS ***
Dealt to 7f0fed0a 
Dealt to Hero [6d 3s]
Dealt to 21bff972 
Dealt to 650e9dc7 
Dealt to 6c00745d 
Dealt to bc64c9e6 
650e9dc7: folds
6c00745d: folds
bc64c9e6: folds
7f0fed0a: raises $0.08 to $0.13
Hero: folds
21bff972: calls $0.08
*** FLOP *** [4h 2d 9s]
21bff972: checks
7f0fed0a: checks
*** TURN *** [4h 2d 9s] [Jc]
21bff972: checks
7f0fed0a: bets $0.1
21bff972: folds
Uncalled bet ($0.1) returned to 7f0fed0a
*** SHOWDOWN ***
7f0fed0a collected $0.27 from pot
*** SUMMARY ***
Total pot $0.28 | Rake $0.01 | Jackpot $0 | Bingo $0 | Fortune $0 | Tax $0
Board [4h 2d 9s Jc]
Seat 1: 7f0fed0a (button) won ($0.27)
Seat 2: Hero (small blind) folded before Flop
Seat 3: 21bff972 (big blind) folded on the Turn
Seat 4: 650e9dc7 folded before Flop (didn't bet)
Seat 5: 6c00745d folded before Flop (didn't bet)
Seat 6: bc64c9e6 folded before Flop (didn't bet)


Poker Hand #RC3334479302: Hold'em No Limit ($0.02/$0.05) - 2025/02/17 21:02:23
Table 'RushAndCash614562' 6-max Seat #1 is the button
Seat 1: 84667b37 ($4.43 in chips)
Seat 2: a291e856 ($5.64 in chips)
Seat 3: c579f93c ($9.86 in chips)
Seat 4: 18767060 ($10.61 in chips)
Seat 5: 9013f95e ($12.98 in chips)
Seat 6: Hero ($6.21 in chips)
a291e856: posts small blind $0.02
c579f93c: posts big blind $0.05
*** HOLE CARDS ***
Dealt to 84667b37 
Dealt to a291e856 
Dealt to c579f93c 
Dealt to 18767060 
Dealt to 9013f95e 
Dealt to Hero [Kc 5c]
18767060: folds
9013f95e: folds
Hero: folds
84667b37: folds
a291e856: raises $0.08 to $0.13
c579f93c: folds
Uncalled bet ($0.08) returned to a291e856
*** SHOWDOWN ***
a291e856 collected $0.1 from pot
*** SUMMARY ***
Total pot $0.1 | Rake $0 | Jackpot $0 | Bingo $0 | Fortune $0 | Tax $0
Seat 1: 84667b37 (button) folded before Flop (didn't bet)
Seat 2: a291e856 (small blind) collected ($0.1)
Seat 3: c579f93c (big blind) folded before Flop
Seat 4: 18767060 folded before Flop (didn't bet)
Seat 5: 9013f95e folded before Flop (didn't bet)
Seat 6: Hero folded before Flop (didn't bet)


Poker Hand #RC3334479273: Hold'em No Limit ($0.02/$0.05) - 2025/02/17 21:02:19
Table 'RushAndCash614533' 6-max Seat #1 is the button
Seat 1: 73c2df1f ($15.72 in chips)
Seat 2: 4b9621a6 ($6 in chips)
Seat 3: Hero ($6.26 in chips)
Seat 4: e3b51b04 ($9.1 in chips)
Seat 5: 15346d36 ($4.74 in chips)
Seat 6: ee3fdfd8 ($6.38 in chips)
4b9621a6: posts small blind $0.02
Hero: posts big blind $0.05
*** HOLE CARDS ***
Dealt to 73c2df1f 
Dealt to 4b9621a6 
Dealt to Hero [3d 2c]
Dealt to e3b51b04 
Dealt to 15346d36 
Dealt to ee3fdfd8 
e3b51b04: folds
15346d36: folds
ee3fdfd8: folds
73c2df1f: folds
4b9621a6: calls $0.03
Hero: checks
*** FLOP *** [4s 4d 6c]
4b9621a6: bets $0.05
Hero: folds
Uncalled bet ($0.05) returned to 4b9621a6
*** SHOWDOWN ***
4b9621a6 collected $0.1 from pot
*** SUMMARY ***
Total pot $0.1 | Rake $0 | Jackpot $0 | Bingo $0 | Fortune $0 | Tax $0
Board [4s 4d 6c]
Seat 1: 73c2df1f (button) folded before Flop (didn't bet)
Seat 2: 4b9621a6 (small blind) won ($0.1)
Seat 3: Hero (big blind) folded on the Flop
Seat 4: e3b51b04 folded before Flop (didn't bet)
Seat 5: 15346d36 folded before Flop (didn't bet)
Seat 6: ee3fdfd8 folded before Flop (didn't bet)


Poker Hand #RC3334479237: Hold'em No Limit ($0.02/$0.05) - 2025/02/17 21:02:15
Table 'RushAndCash614497' 6-max Seat #1 is the button
Seat 1: Hero ($6.26 in chips)
Seat 2: 966c483f ($5 in chips)
Seat 3: 92e1348d ($6.67 in chips)
Seat 4: fa499268 ($6.49 in chips)
Seat 5: 23a65ab7 ($5 in chips)
Seat 6: 11778018 ($2.91 in chips)
966c483f: posts small blind $0.02
92e1348d: posts big blind $0.05
*** HOLE CARDS ***
Dealt to Hero [4c Qd]
Dealt to 966c483f 
Dealt to 92e1348d 
Dealt to fa499268 
Dealt to 23a65ab7 
Dealt to 11778018 
fa499268: folds
23a65ab7: folds
11778018: folds
Hero: folds
966c483f: raises $0.1 to $0.15
92e1348d: calls $0.1
*** FLOP *** [Ts Jh 7c]
966c483f: bets $0.1
92e1348d: calls $0.1
*** TURN *** [Ts Jh 7c] [7h]
966c483f: bets $0.38
92e1348d: calls $0.38
*** RIVER *** [Ts Jh 7c 7h] [8s]
966c483f: checks
92e1348d: bets $0.95
966c483f: folds
Uncalled bet ($0.95) returned to 92e1348d
*** SHOWDOWN ***
92e1348d collected $1.2 from pot
*** SUMMARY ***
Total pot $1.26 | Rake $0.06 | Jackpot $0 | Bingo $0 | Fortune $0 | Tax $0
Board [Ts Jh 7c 7h 8s]
Seat 1: Hero (button) folded before Flop (didn't bet)
Seat 2: 966c483f (small blind) folded on the River
Seat 3: 92e1348d (big blind) won ($1.2)
Seat 4: fa499268 folded before Flop (didn't bet)
Seat 5: 23a65ab7 folded before Flop (didn't bet)
Seat 6: 11778018 folded before Flop (didn't bet)


Poker Hand #RC3334479200: Hold'em No Limit ($0.02/$0.05) - 2025/02/17 21:02:10
Table 'RushAndCash614460' 6-max Seat #1 is the button
Seat 1: 6bc74d1d ($6.12 in chips)
Seat 2: d92ddef8 ($4.8 in chips)
Seat 3: ef96c0c8 ($5.02 in chips)
Seat 4: Hero ($6.26 in chips)
Seat 5: 2e8ab509 ($6.05 in chips)
Seat 6: 6c8cb957 ($5.18 in chips)
d92ddef8: posts small blind $0.02
ef96c0c8: posts big blind $0.05
*** HOLE CARDS ***
Dealt to 6bc74d1d 
Dealt to d92ddef8 
Dealt to ef96c0c8 
Dealt to Hero [6s 5c]
Dealt to 2e8ab509 
Dealt to 6c8cb957 
Hero: folds
2e8ab509: folds
6c8cb957: folds
6bc74d1d: folds
d92ddef8: folds
Uncalled bet ($0.03) returned to ef96c0c8
*** SHOWDOWN ***
ef96c0c8 collected $0.04 from pot
*** SUMMARY ***
Total pot $0.04 | Rake $0 | Jackpot $0 | Bingo $0 | Fortune $0 | Tax $0
Seat 1: 6bc74d1d (button) folded before Flop (didn't bet)
Seat 2: d92ddef8 (small blind) folded before Flop
Seat 3: ef96c0c8 (big blind) collected ($0.04)
Seat 4: Hero folded before Flop (didn't bet)
Seat 5: 2e8ab509 folded before Flop (didn't bet)
Seat 6: 6c8cb957 folded before Flop (didn't bet)


Poker Hand #RC3334478918: Hold'em No Limit ($0.02/$0.05) - 2025/02/17 21:01:35
Table 'RushAndCash614178' 6-max Seat #1 is the button
Seat 1: 77d1364f ($5.33 in chips)
Seat 2: b8a41e4 ($6.08 in chips)
Seat 3: 4c7728b5 ($8.84 in chips)
Seat 4: 22005c45 ($4.98 in chips)
Seat 5: ec1214a6 ($5.12 in chips)
Seat 6: Hero ($5.6 in chips)
b8a41e4: posts small blind $0.02
4c7728b5: posts big blind $0.05
*** HOLE CARDS ***
Dealt to 77d1364f 
Dealt to b8a41e4 
Dealt to 4c7728b5 
Dealt to 22005c45 
Dealt to ec1214a6 
Dealt to Hero [Kc Kh]
22005c45: folds
ec1214a6: raises $0.08 to $0.13
Hero: raises $0.25 to $0.38
77d1364f: folds
b8a41e4: folds
4c7728b5: folds
ec1214a6: calls $0.25
*** FLOP *** [5d Kd Jh]
ec1214a6: checks
Hero: bets $0.28
ec1214a6: calls $0.28
*** TURN *** [5d Kd Jh] [5s]
ec1214a6: checks
Hero: checks
*** RIVER *** [5d Kd Jh 5s] [6c]
ec1214a6: checks
Hero: bets $0.7
ec1214a6: folds
Uncalled bet ($0.7) returned to Hero
*** SHOWDOWN ***
Hero collected $1.32 from pot
*** SUMMARY ***
Total pot $1.39 | Rake $0.07 | Jackpot $0 | Bingo $0 | Fortune $0 | Tax $0
Board [5d Kd Jh 5s 6c]
Seat 1: 77d1364f (button) folded before Flop (didn't bet)
Seat 2: b8a41e4 (small blind) folded before Flop
Seat 3: 4c7728b5 (big blind) folded before Flop
Seat 4: 22005c45 folded before Flop (didn't bet)
Seat 5: ec1214a6 folded on the River
Seat 6: Hero won ($1.32)


Poker Hand #RC3334475355: Hold'em No Limit ($0.02/$0.05) - 2025/02/17 20:53:34
Table 'RushAndCash610615' 6-max Seat #1 is the button
Seat 1: fb6c913 ($10.8 in chips)
Seat 2: 194ee370 ($4.32 in chips)
Seat 3: Hero ($5.7 in chips)
Seat 4: c4483bd8 ($5.24 in chips)
Seat 5: bda9ba33 ($4.58 in chips)
Seat 6: 6dc21e6a ($5.69 in chips)
194ee370: posts small blind $0.02
Hero: posts big blind $0.05
*** HOLE CARDS ***
Dealt to fb6c913 
Dealt to 194ee370 
Dealt to Hero [8d 9d]
Dealt to c4483bd8 
Dealt to bda9ba33 
Dealt to 6dc21e6a 
c4483bd8: raises $0.05 to $0.1
bda9ba33: folds
6dc21e6a: folds
fb6c913: calls $0.1
194ee370: calls $0.08
Hero: calls $0.05
*** FLOP *** [8c 6h Jd]
194ee370: checks
Hero: checks
c4483bd8: checks
fb6c913: checks
*** TURN *** [8c 6h Jd] [Ac]
194ee370: checks
Hero: checks
c4483bd8: checks
fb6c913: checks
*** RIVER *** [8c 6h Jd Ac] [4s]
194ee370: bets $0.4
Hero: folds
c4483bd8: folds
fb6c913: folds
Uncalled bet ($0.4) returned to 194ee370
*** SHOWDOWN ***
194ee370 collected $0.38 from pot
*** SUMMARY ***
Total pot $0.4 | Rake $0.02 | Jackpot $0 | Bingo $0 | Fortune $0 | Tax $0
Board [8c 6h Jd Ac 4s]
Seat 1: fb6c913 (button) folded on the River
Seat 2: 194ee370 (small blind) won ($0.38)
Seat 3: Hero (big blind) folded on the River
Seat 4: c4483bd8 folded on the River
Seat 5: bda9ba33 folded before Flop (didn't bet)
Seat 6: 6dc21e6a folded before Flop (didn't bet)


Poker Hand #RC3334475324: Hold'em No Limit ($0.02/$0.05) - 2025/02/17 20:53:30
Table 'RushAndCash610584' 6-max Seat #1 is the button
Seat 1: 66981141 ($10.7 in chips)
Seat 2: 21c758a ($5.51 in chips)
Seat 3: fe0566a4 ($7.99 in chips)
Seat 4: Hero ($5.7 in chips)
Seat 5: f71501ed ($5.44 in chips)
Seat 6: 673e17b3 ($5.09 in chips)
21c758a: posts small blind $0.02
fe0566a4: posts big blind $0.05
*** HOLE CARDS ***
Dealt to 66981141 
Dealt to 21c758a 
Dealt to fe0566a4 
Dealt to Hero [9c Td]
Dealt to f71501ed 
Dealt to 673e17b3 
Hero: folds
f71501ed: folds
673e17b3: folds
66981141: raises $0.1 to $0.15
21c758a: folds
fe0566a4: folds
Uncalled bet ($0.1) returned to 66981141
*** SHOWDOWN ***
66981141 collected $0.12 from pot
*** SUMMARY ***
Total pot $0.12 | Rake $0 | Jackpot $0 | Bingo $0 | Fortune $0 | Tax $0
Seat 1: 66981141 (button) collected ($0.12)
Seat 2: 21c758a (small blind) folded before Flop
Seat 3: fe0566a4 (big blind) folded before Flop
Seat 4: Hero folded before Flop (didn't bet)
Seat 5: f71501ed folded before Flop (didn't bet)
Seat 6: 673e17b3 folded before Flop (didn't bet)


Poker Hand #RC3334475181: Hold'em No Limit ($0.02/$0.05) - 2025/02/17 20:53:13
Table 'RushAndCash610441' 6-max Seat #1 is the button
Seat 1: f71501ed ($5 in chips)
Seat 2: d1cd1071 ($13.64 in chips)
Seat 3: e8992002 ($5.38 in chips)
Seat 4: fe374609 ($4.95 in chips)
Seat 5: Hero ($5.8 in chips)
Seat 6: da8f3ac5 ($5 in chips)
d1cd1071: posts small blind $0.02
e8992002: posts big blind $0.05
*** HOLE CARDS ***
Dealt to f71501ed 
Dealt to d1cd1071 
Dealt to e8992002 
Dealt to fe374609 
Dealt to Hero [Ts 9s]
Dealt to da8f3ac5 
fe374609: folds
Hero: raises $0.05 to $0.1
da8f3ac5: raises $0.21 to $0.31
f71501ed: raises $0.6 to $0.91
d1cd1071: folds
e8992002: folds
Hero: folds
da8f3ac5: folds
Uncalled bet ($0.6) returned to f71501ed
*** SHOWDOWN ***
f71501ed collected $0.75 from pot
*** SUMMARY ***
Total pot $0.79 | Rake $0.04 | Jackpot $0 | Bingo $0 | Fortune $0 | Tax $0
Seat 1: f71501ed (button) collected ($0.75)
Seat 2: d1cd1071 (small blind) folded before Flop
Seat 3: e8992002 (big blind) folded before Flop
Seat 4: fe374609 folded before Flop (didn't bet)
Seat 5: Hero folded before Flop
Seat 6: da8f3ac5 folded before Flop


Poker Hand #RC3334475047: Hold'em No Limit ($0.02/$0.05) - 2025/02/17 20:52:57
Table 'RushAndCash610307' 6-max Seat #1 is the button
Seat 1: Hero ($5.73 in chips)
Seat 2: b8a41e4 ($6.32 in chips)
Seat 3: 621c3c07 ($5 in chips)
Seat 4: 77d1364f ($5.8 in chips)
Seat 5: a28ca95c ($21.35 in chips)
Seat 6: baaf0b0d ($5.2 in chips)
b8a41e4: posts small blind $0.02
621c3c07: posts big blind $0.05
*** HOLE CARDS ***
Dealt to Hero [Jc Kd]
Dealt to b8a41e4 
Dealt to 621c3c07 
Dealt to 77d1364f 
Dealt to a28ca95c 
Dealt to baaf0b0d 
77d1364f: folds
a28ca95c: folds
baaf0b0d: folds
Hero: raises $0.05 to $0.1
b8a41e4: folds
621c3c07: folds
Uncalled bet ($0.05) returned to Hero
*** SHOWDOWN ***
Hero collected $0.12 from pot
*** SUMMARY ***
Total pot $0.12 | Rake $0 | Jackpot $0 | Bingo $0 | Fortune $0 | Tax $0
Seat 1: Hero (button) collected ($0.12)
Seat 2: b8a41e4 (small blind) folded before Flop
Seat 3: 621c3c07 (big blind) folded before Flop
Seat 4: 77d1364f folded before Flop (didn't bet)
Seat 5: a28ca95c folded before Flop (didn't bet)
Seat 6: baaf0b0d folded before Flop (didn't bet)


Poker Hand #RC3334475019: Hold'em No Limit ($0.02/$0.05) - 2025/02/17 20:52:53
Table 'RushAndCash610279' 6-max Seat #1 is the button
Seat 1: 6af54020 ($7.46 in chips)
Seat 2: f83d0c9c ($5.23 in chips)
Seat 3: fa7bb2c5 ($5 in chips)
Seat 4: 656af102 ($5 in chips)
Seat 5: Hero ($5.73 in chips)
Seat 6: eaffe61e ($5 in chips)
f83d0c9c: posts small blind $0.02
fa7bb2c5: posts big blind $0.05
*** HOLE CARDS ***
Dealt to 6af54020 
Dealt to f83d0c9c 
Dealt to fa7bb2c5 
Dealt to 656af102 
Dealt to Hero [6s 2h]
Dealt to eaffe61e 
656af102: raises $0.05 to $0.1
Hero: folds
eaffe61e: folds
6af54020: raises $0.25 to $0.35
f83d0c9c: folds
fa7bb2c5: folds
656af102: raises $0.51 to $0.86
6af54020: folds
Uncalled bet ($0.51) returned to 656af102
*** SHOWDOWN ***
656af102 collected $0.74 from pot
*** SUMMARY ***
Total pot $0.77 | Rake $0.03 | Jackpot $0 | Bingo $0 | Fortune $0 | Tax $0
Seat 1: 6af54020 (button) folded before Flop
Seat 2: f83d0c9c (small blind) folded before Flop
Seat 3: fa7bb2c5 (big blind) folded before Flop
Seat 4: 656af102 collected ($0.74)
Seat 5: Hero folded before Flop (didn't bet)
Seat 6: eaffe61e folded before Flop (didn't bet)


Poker Hand #RC3334474989: Hold'em No Limit ($0.02/$0.05) - 2025/02/17 20:52:49
Table 'RushAndCash610249' 6-max Seat #1 is the button
Seat 1: 9ad74e07 ($5.36 in chips)
Seat 2: Hero ($5.75 in chips)
Seat 3: 842d7655 ($8.12 in chips)
Seat 4: f50925e7 ($5.02 in chips)
Seat 5: 23a65ab7 ($5 in chips)
Seat 6: cf593991 ($5 in chips)
Hero: posts small blind $0.02
842d7655: posts big blind $0.05
*** HOLE CARDS ***
Dealt to 9ad74e07 
Dealt to Hero [4d 2s]
Dealt to 842d7655 
Dealt to f50925e7 
Dealt to 23a65ab7 
Dealt to cf593991 
f50925e7: folds
23a65ab7: folds
cf593991: folds
9ad74e07: folds
Hero: folds
Uncalled bet ($0.03) returned to 842d7655
*** SHOWDOWN ***
842d7655 collected $0.04 from pot
*** SUMMARY ***
Total pot $0.04 | Rake $0 | Jackpot $0 | Bingo $0 | Fortune $0 | Tax $0
Seat 1: 9ad74e07 (button) folded before Flop (didn't bet)
Seat 2: Hero (small blind) folded before Flop
Seat 3: 842d7655 (big blind) collected ($0.04)
Seat 4: f50925e7 folded before Flop (didn't bet)
Seat 5: 23a65ab7 folded before Flop (didn't bet)
Seat 6: cf593991 folded before Flop (didn't bet)


Poker Hand #RC3334474957: Hold'em No Limit ($0.02/$0.05) - 2025/02/17 20:52:45
Table 'RushAndCash610217' 6-max Seat #1 is the button
Seat 1: 653af57c ($5.33 in chips)
Seat 2: 7fe74cc5 ($5.09 in chips)
Seat 3: 8e93231a ($5 in chips)
Seat 4: e877c9db ($6.36 in chips)
Seat 5: Hero ($5.75 in chips)
Seat 6: 3f138d48 ($6.21 in chips)
7fe74cc5: posts small blind $0.02
8e93231a: posts big blind $0.05
*** HOLE CARDS ***
Dealt to 653af57c 
Dealt to 7fe74cc5 
Dealt to 8e93231a 
Dealt to e877c9db 
Dealt to Hero [3c 8h]
Dealt to 3f138d48 
e877c9db: raises $0.08 to $0.13
Hero: folds
3f138d48: folds
653af57c: folds
7fe74cc5: folds
8e93231a: folds
Uncalled bet ($0.08) returned to e877c9db
*** SHOWDOWN ***
e877c9db collected $0.12 from pot
*** SUMMARY ***
Total pot $0.12 | Rake $0 | Jackpot $0 | Bingo $0 | Fortune $0 | Tax $0
Seat 1: 653af57c (button) folded before Flop (didn't bet)
Seat 2: 7fe74cc5 (small blind) folded before Flop
Seat 3: 8e93231a (big blind) folded before Flop
Seat 4: e877c9db collected ($0.12)
Seat 5: Hero folded before Flop (didn't bet)
Seat 6: 3f138d48 folded before Flop (didn't bet)


Poker Hand #RC3334474935: Hold'em No Limit ($0.02/$0.05) - 2025/02/17 20:52:42
Table 'RushAndCash610195' 6-max Seat #1 is the button
Seat 1: 3c79b0ff ($5.82 in chips)
Seat 2: 651cc52f ($3.37 in chips)
Seat 3: f71501ed ($5 in chips)
Seat 4: 1bc9d557 ($4.9 in chips)
Seat 5: 64e5de41 ($6 in chips)
Seat 6: Hero ($5.75 in chips)
651cc52f: posts small blind $0.02
f71501ed: posts big blind $0.05
*** HOLE CARDS ***
Dealt to 3c79b0ff 
Dealt to 651cc52f 
Dealt to f71501ed 
Dealt to 1bc9d557 
Dealt to 64e5de41 
Dealt to Hero [9s Td]
1bc9d557: folds
64e5de41: folds
Hero: folds
3c79b0ff: raises $0.06 to $0.11
651cc52f: folds
f71501ed: folds
Uncalled bet ($0.06) returned to 3c79b0ff
*** SHOWDOWN ***
3c79b0ff collected $0.12 from pot
*** SUMMARY ***
Total pot $0.12 | Rake $0 | Jackpot $0 | Bingo $0 | Fortune $0 | Tax $0
Seat 1: 3c79b0ff (button) collected ($0.12)
Seat 2: 651cc52f (small blind) folded before Flop
Seat 3: f71501ed (big blind) folded before Flop
Seat 4: 1bc9d557 folded before Flop (didn't bet)
Seat 5: 64e5de41 folded before Flop (didn't bet)
Seat 6: Hero folded before Flop (didn't bet)


Poker Hand #RC3334444510: Hold'em No Limit ($0.02/$0.05) - 2025/02/17 20:51:46
Table 'RushAndCash609770' 6-max Seat #1 is the button
Seat 1: 9135e49d ($5.4 in chips)
Seat 2: e8992002 ($5.33 in chips)
Seat 3: Hero ($5.64 in chips)
Seat 4: 1b8b89c1 ($6.41 in chips)
Seat 5: 6670b08e ($3.75 in chips)
Seat 6: 1bc9d557 ($5 in chips)
e8992002: posts small blind $0.02
Hero: posts big blind $0.05
*** HOLE CARDS ***
Dealt to 9135e49d 
Dealt to e8992002 
Dealt to Hero [3c 6c]
Dealt to 1b8b89c1 
Dealt to 6670b08e 
Dealt to 1bc9d557 
1b8b89c1: folds
6670b08e: folds
1bc9d557: raises $0.05 to $0.1
9135e49d: folds
e8992002: folds
Hero: calls $0.05
*** FLOP *** [Kd Td 6s]
Hero: checks
1bc9d557: checks
*** TURN *** [Kd Td 6s] [6h]
Hero: bets $0.12
1bc9d557: folds
Uncalled bet ($0.12) returned to Hero
*** SHOWDOWN ***
Hero collected $0.21 from pot
*** SUMMARY ***
Total pot $0.22 | Rake $0.01 | Jackpot $0 | Bingo $0 | Fortune $0 | Tax $0
Board [Kd Td 6s 6h]
Seat 1: 9135e49d (button) folded before Flop (didn't bet)
Seat 2: e8992002 (small blind) folded before Flop
Seat 3: Hero (big blind) won ($0.21)
Seat 4: 1b8b89c1 folded before Flop (didn't bet)
Seat 5: 6670b08e folded before Flop (didn't bet)
Seat 6: 1bc9d557 folded on the Turn


Poker Hand #RC3334444489: Hold'em No Limit ($0.02/$0.05) - 2025/02/17 20:51:43
Table 'RushAndCash609749' 6-max Seat #1 is the button
Seat 1: Hero ($5.64 in chips)
Seat 2: ed41f291 ($6.19 in chips)
Seat 3: f18b40b7 ($4.77 in chips)
Seat 4: 17d82e36 ($4.68 in chips)
Seat 5: 69407b3a ($6.65 in chips)
Seat 6: f9d64f1a ($5.16 in chips)
ed41f291: posts small blind $0.02
f18b40b7: posts big blind $0.05
*** HOLE CARDS ***
Dealt to Hero [8c Qh]
Dealt to ed41f291 
Dealt to f18b40b7 
Dealt to 17d82e36 
Dealt to 69407b3a 
Dealt to f9d64f1a 
17d82e36: folds
69407b3a: raises $0.05 to $0.1
f9d64f1a: folds
Hero: folds
ed41f291: folds
f18b40b7: folds
Uncalled bet ($0.05) returned to 69407b3a
*** SHOWDOWN ***
69407b3a collected $0.12 from pot
*** SUMMARY ***
Total pot $0.12 | Rake $0 | Jackpot $0 | Bingo $0 | Fortune $0 | Tax $0
Seat 1: Hero (button) folded before Flop (didn't bet)
Seat 2: ed41f291 (small blind) folded before Flop
Seat 3: f18b40b7 (big blind) folded before Flop
Seat 4: 17d82e36 folded before Flop (didn't bet)
Seat 5: 69407b3a collected ($0.12)
Seat 6: f9d64f1a folded before Flop (didn't bet)


Poker Hand #RC3334444328: Hold'em No Limit ($0.02/$0.05) - 2025/02/17 20:51:22
Table 'RushAndCash609588' 6-max Seat #1 is the button
Seat 1: e4d8df1d ($6.43 in chips)
Seat 2: fb6c913 ($11.46 in chips)
Seat 3: 188c8947 ($11.92 in chips)
Seat 4: d606d9 ($4.3 in chips)
Seat 5: Hero ($5.53 in chips)
Seat 6: 3ffd6491 ($5 in chips)
fb6c913: posts small blind $0.02
188c8947: posts big blind $0.05
*** HOLE CARDS ***
Dealt to e4d8df1d 
Dealt to fb6c913 
Dealt to 188c8947 
Dealt to d606d9 
Dealt to Hero [4h 4s]
Dealt to 3ffd6491 
d606d9: folds
Hero: raises $0.05 to $0.1
3ffd6491: folds
e4d8df1d: folds
fb6c913: folds
188c8947: calls $0.05
*** FLOP *** [Ac 4d Jd]
188c8947: checks
Hero: bets $0.12
188c8947: folds
Uncalled bet ($0.12) returned to Hero
*** SHOWDOWN ***
Hero collected $0.21 from pot
*** SUMMARY ***
Total pot $0.22 | Rake $0.01 | Jackpot $0 | Bingo $0 | Fortune $0 | Tax $0
Board [Ac 4d Jd]
Seat 1: e4d8df1d (button) folded before Flop (didn't bet)
Seat 2: fb6c913 (small blind) folded before Flop
Seat 3: 188c8947 (big blind) folded on the Flop
Seat 4: d606d9 folded before Flop (didn't bet)
Seat 5: Hero won ($0.21)
Seat 6: 3ffd6491 folded before Flop (didn't bet)


Poker Hand #RC3334444283: Hold'em No Limit ($0.02/$0.05) - 2025/02/17 20:51:15
Table 'RushAndCash609543' 6-max Seat #1 is the button
Seat 1: b7bd1225 ($5 in chips)
Seat 2: Hero ($5.55 in chips)
Seat 3: 93a6c244 ($7.69 in chips)
Seat 4: 6af54020 ($7.61 in chips)
Seat 5: 28e11496 ($15.99 in chips)
Seat 6: 1d2427ef ($5 in chips)
Hero: posts small blind $0.02
93a6c244: posts big blind $0.05
*** HOLE CARDS ***
Dealt to b7bd1225 
Dealt to Hero [Qh 6h]
Dealt to 93a6c244 
Dealt to 6af54020 
Dealt to 28e11496 
Dealt to 1d2427ef 
6af54020: raises $0.05 to $0.1
28e11496: folds
1d2427ef: folds
b7bd1225: folds
Hero: folds
93a6c244: folds
Uncalled bet ($0.05) returned to 6af54020
*** SHOWDOWN ***
6af54020 collected $0.12 from pot
*** SUMMARY ***
Total pot $0.12 | Rake $0 | Jackpot $0 | Bingo $0 | Fortune $0 | Tax $0
Seat 1: b7bd1225 (button) folded before Flop (didn't bet)
Seat 2: Hero (small blind) folded before Flop
Seat 3: 93a6c244 (big blind) folded before Flop
Seat 4: 6af54020 collected ($0.12)
Seat 5: 28e11496 folded before Flop (didn't bet)
Seat 6: 1d2427ef folded before Flop (didn't bet)


Poker Hand #RC3334444264: Hold'em No Limit ($0.02/$0.05) - 2025/02/17 20:51:12
Table 'RushAndCash609524' 6-max Seat #1 is the button
Seat 1: 6008538 ($2.28 in chips)
Seat 2: 780645d6 ($5 in chips)
Seat 3: ded3640 ($5.16 in chips)
Seat 4: 188c8947 ($11.92 in chips)
Seat 5: Hero ($5.55 in chips)
Seat 6: 860fa4c9 ($10.23 in chips)
780645d6: posts small blind $0.02
ded3640: posts big blind $0.05
*** HOLE CARDS ***
Dealt to 6008538 
Dealt to 780645d6 
Dealt to ded3640 
Dealt to 188c8947 
Dealt to Hero [2d 4d]
Dealt to 860fa4c9 
188c8947: folds
Hero: folds
860fa4c9: folds
6008538: raises $0.06 to $0.11
780645d6: folds
ded3640: folds
Uncalled bet ($0.06) returned to 6008538
*** SHOWDOWN ***
6008538 collected $0.12 from pot
*** SUMMARY ***
Total pot $0.12 | Rake $0 | Jackpot $0 | Bingo $0 | Fortune $0 | Tax $0
Seat 1: 6008538 (button) collected ($0.12)
Seat 2: 780645d6 (small blind) folded before Flop
Seat 3: ded3640 (big blind) folded before Flop
Seat 4: 188c8947 folded before Flop (didn't bet)
Seat 5: Hero folded before Flop (didn't bet)
Seat 6: 860fa4c9 folded before Flop (didn't bet)


Poker Hand #RC3334444238: Hold'em No Limit ($0.02/$0.05) - 2025/02/17 20:51:09
Table 'RushAndCash609498' 6-max Seat #1 is the button
Seat 1: d949b23d ($5 in chips)
Seat 2: 9165e0e3 ($5 in chips)
Seat 3: Hero ($5.6 in chips)
Seat 4: 5e166e9a ($5 in chips)
Seat 5: 93dfef8b ($11.01 in chips)
Seat 6: 6a231779 ($15.94 in chips)
9165e0e3: posts small blind $0.02
Hero: posts big blind $0.05
*** HOLE CARDS ***
Dealt to d949b23d 
Dealt to 9165e0e3 
Dealt to Hero [Qd 5d]
Dealt to 5e166e9a 
Dealt to 93dfef8b 
Dealt to 6a231779 
5e166e9a: raises $0.06 to $0.11
93dfef8b: folds
6a231779: folds
d949b23d: folds
9165e0e3: folds
Hero: folds
Uncalled bet ($0.06) returned to 5e166e9a
*** SHOWDOWN ***
5e166e9a collected $0.12 from pot
*** SUMMARY ***
Total pot $0.12 | Rake $0 | Jackpot $0 | Bingo $0 | Fortune $0 | Tax $0
Seat 1: d949b23d (button) folded before Flop (didn't bet)
Seat 2: 9165e0e3 (small blind) folded before Flop
Seat 3: Hero (big blind) folded before Flop
Seat 4: 5e166e9a collected ($0.12)
Seat 5: 93dfef8b folded before Flop (didn't bet)
Seat 6: 6a231779 folded before Flop (didn't bet)


Poker Hand #RC3334444212: Hold'em No Limit ($0.02/$0.05) - 2025/02/17 20:51:05
Table 'RushAndCash609472' 6-max Seat #1 is the button
Seat 1: bfef046a ($26.93 in chips)
Seat 2: e97b3270 ($5.09 in chips)
Seat 3: f0407b74 ($4.59 in chips)
Seat 4: 9885e0a0 ($13.15 in chips)
Seat 5: c3b473c1 ($5.14 in chips)
Seat 6: Hero ($5.6 in chips)
e97b3270: posts small blind $0.02
f0407b74: posts big blind $0.05
*** HOLE CARDS ***
Dealt to bfef046a 
Dealt to e97b3270 
Dealt to f0407b74 
Dealt to 9885e0a0 
Dealt to c3b473c1 
Dealt to Hero [3h Js]
9885e0a0: folds
c3b473c1: raises $0.05 to $0.1
Hero: folds
bfef046a: calls $0.1
e97b3270: folds
f0407b74: folds
*** FLOP *** [3c Ts 7c]
c3b473c1: checks
bfef046a: bets $0.1
c3b473c1: calls $0.1
*** TURN *** [3c Ts 7c] [8c]
c3b473c1: checks
bfef046a: bets $0.57
c3b473c1: folds
Uncalled bet ($0.57) returned to bfef046a
*** SHOWDOWN ***
bfef046a collected $0.45 from pot
*** SUMMARY ***
Total pot $0.47 | Rake $0.02 | Jackpot $0 | Bingo $0 | Fortune $0 | Tax $0
Board [3c Ts 7c 8c]
Seat 1: bfef046a (button) won ($0.45)
Seat 2: e97b3270 (small blind) folded before Flop
Seat 3: f0407b74 (big blind) folded before Flop
Seat 4: 9885e0a0 folded before Flop (didn't bet)
Seat 5: c3b473c1 folded on the Turn
Seat 6: Hero folded before Flop (didn't bet)


Poker Hand #RC3334444140: Hold'em No Limit ($0.02/$0.05) - 2025/02/17 20:50:55
Table 'RushAndCash609400' 6-max Seat #1 is the button
Seat 1: Hero ($5.6 in chips)
Seat 2: a3538261 ($5.25 in chips)
Seat 3: e4a1f2d2 ($6.57 in chips)
Seat 4: 1da8eae5 ($4.85 in chips)
Seat 5: 3b2a8270 ($5.06 in chips)
Seat 6: 742ccfee ($3.58 in chips)
a3538261: posts small blind $0.02
e4a1f2d2: posts big blind $0.05
*** HOLE CARDS ***
Dealt to Hero [8h Ad]
Dealt to a3538261 
Dealt to e4a1f2d2 
Dealt to 1da8eae5 
Dealt to 3b2a8270 
Dealt to 742ccfee 
1da8eae5: folds
3b2a8270: folds
742ccfee: folds
Hero: folds
a3538261: folds
Uncalled bet ($0.03) returned to e4a1f2d2
*** SHOWDOWN ***
e4a1f2d2 collected $0.04 from pot
*** SUMMARY ***
Total pot $0.04 | Rake $0 | Jackpot $0 | Bingo $0 | Fortune $0 | Tax $0
Seat 1: Hero (button) folded before Flop (didn't bet)
Seat 2: a3538261 (small blind) folded before Flop
Seat 3: e4a1f2d2 (big blind) collected ($0.04)
Seat 4: 1da8eae5 folded before Flop (didn't bet)
Seat 5: 3b2a8270 folded before Flop (didn't bet)
Seat 6: 742ccfee folded before Flop (didn't bet)


Poker Hand #RC3334444023: Hold'em No Limit ($0.02/$0.05) - 2025/02/17 20:50:39
Table 'RushAndCash609283' 6-max Seat #1 is the button
Seat 1: 860fa4c9 ($10.23 in chips)
Seat 2: 5446d20c ($5.03 in chips)
Seat 3: 12cda2e0 ($21.99 in chips)
Seat 4: 207d9345 ($22.73 in chips)
Seat 5: Hero ($5.6 in chips)
Seat 6: 4c783157 ($5.26 in chips)
5446d20c: posts small blind $0.02
12cda2e0: posts big blind $0.05
*** HOLE CARDS ***
Dealt to 860fa4c9 
Dealt to 5446d20c 
Dealt to 12cda2e0 
Dealt to 207d9345 
Dealt to Hero [7h 4h]
Dealt to 4c783157 
207d9345: folds
Hero: folds
4c783157: folds
860fa4c9: folds
5446d20c: folds
Uncalled bet ($0.03) returned to 12cda2e0
*** SHOWDOWN ***
12cda2e0 collected $0.04 from pot
*** SUMMARY ***
Total pot $0.04 | Rake $0 | Jackpot $0 | Bingo $0 | Fortune $0 | Tax $0
Seat 1: 860fa4c9 (button) folded before Flop (didn't bet)
Seat 2: 5446d20c (small blind) folded before Flop
Seat 3: 12cda2e0 (big blind) collected ($0.04)
Seat 4: 207d9345 folded before Flop (didn't bet)
Seat 5: Hero folded before Flop (didn't bet)
Seat 6: 4c783157 folded before Flop (didn't bet)


Poker Hand #RC3334443992: Hold'em No Limit ($0.02/$0.05) - 2025/02/17 20:50:35
Table 'RushAndCash609252' 6-max Seat #1 is the button
Seat 1: cea9730b ($6.6 in chips)
Seat 2: 9b1a3dd2 ($7.03 in chips)
Seat 3: Hero ($5.65 in chips)
Seat 4: fa499268 ($5.86 in chips)
Seat 5: 32d40ce0 ($6.2 in chips)
Seat 6: c826a560 ($5.07 in chips)
9b1a3dd2: posts small blind $0.02
Hero: posts big blind $0.05
*** HOLE CARDS ***
Dealt to cea9730b 
Dealt to 9b1a3dd2 
Dealt to Hero [Qd 2c]
Dealt to fa499268 
Dealt to 32d40ce0 
Dealt to c826a560 
fa499268: raises $0.08 to $0.13
32d40ce0: folds
c826a560: folds
cea9730b: folds
9b1a3dd2: calls $0.11
Hero: folds
*** FLOP *** [5h Tc 2s]
9b1a3dd2: checks
fa499268: bets $0.11
9b1a3dd2: calls $0.11
*** TURN *** [5h Tc 2s] [Ah]
9b1a3dd2: checks
fa499268: checks
*** RIVER *** [5h Tc 2s Ah] [4c]
9b1a3dd2: bets $0.18
fa499268: calls $0.18
9b1a3dd2: shows [9s Ts] (Pair of Tens)
fa499268: shows [7h 7s] (Pair of Sevens)
*** SHOWDOWN ***
9b1a3dd2 collected $0.85 from pot
*** SUMMARY ***
Total pot $0.89 | Rake $0.04 | Jackpot $0 | Bingo $0 | Fortune $0 | Tax $0
Board [5h Tc 2s Ah 4c]
Seat 1: cea9730b (button) folded before Flop (didn't bet)
Seat 2: 9b1a3dd2 (small blind) showed [9s Ts] and won ($0.85) with Pair of Tens
Seat 3: Hero (big blind) folded before Flop
Seat 4: fa499268 showed [7h 7s] and lost with Pair of Sevens
Seat 5: 32d40ce0 folded before Flop (didn't bet)
Seat 6: c826a560 folded before Flop (didn't bet)


Poker Hand #RC3334443968: Hold'em No Limit ($0.02/$0.05) - 2025/02/17 20:50:31
Table 'RushAndCash609228' 6-max Seat #1 is the button
Seat 1: b9e511a ($23.68 in chips)
Seat 2: 842d7655 ($8.26 in chips)
Seat 3: b9ae439d ($7.18 in chips)
Seat 4: 99af2b58 ($13.01 in chips)
Seat 5: Hero ($5.65 in chips)
Seat 6: d58b99ca ($24.72 in chips)
842d7655: posts small blind $0.02
b9ae439d: posts big blind $0.05
*** HOLE CARDS ***
Dealt to b9e511a 
Dealt to 842d7655 
Dealt to b9ae439d 
Dealt to 99af2b58 
Dealt to Hero [2h 9h]
Dealt to d58b99ca 
99af2b58: folds
Hero: folds
d58b99ca: folds
b9e511a: raises $0.1 to $0.15
842d7655: raises $0.35 to $0.5
b9ae439d: folds
b9e511a: raises $0.63 to $1.13
842d7655: calls $0.63
*** FLOP *** [Js 6d Jc]
842d7655: checks
b9e511a: bets $0.77
842d7655: folds
Uncalled bet ($0.77) returned to b9e511a
*** SHOWDOWN ***
b9e511a collected $2.13 from pot
*** SUMMARY ***
Total pot $2.31 | Rake $0.11 | Jackpot $0.07 | Bingo $0 | Fortune $0 | Tax $0
Board [Js 6d Jc]
Seat 1: b9e511a (button) won ($2.13)
Seat 2: 842d7655 (small blind) folded on the Flop
Seat 3: b9ae439d (big blind) folded before Flop
Seat 4: 99af2b58 folded before Flop (didn't bet)
Seat 5: Hero folded before Flop (didn't bet)
Seat 6: d58b99ca folded before Flop (didn't bet)


Poker Hand #RC3334443946: Hold'em No Limit ($0.02/$0.05) - 2025/02/17 20:50:28
Table 'RushAndCash609206' 6-max Seat #1 is the button
Seat 1: 7a5bf293 ($8.55 in chips)
Seat 2: fe0566a4 ($9.49 in chips)
Seat 3: 86cb159 ($5.56 in chips)
Seat 4: 16f2e5ce ($5.29 in chips)
Seat 5: fa40c39c ($3.04 in chips)
Seat 6: Hero ($5.65 in chips)
fe0566a4: posts small blind $0.02
86cb159: posts big blind $0.05
*** HOLE CARDS ***
Dealt to 7a5bf293 
Dealt to fe0566a4 
Dealt to 86cb159 
Dealt to 16f2e5ce 
Dealt to fa40c39c 
Dealt to Hero [3h 5h]
16f2e5ce: folds
fa40c39c: folds
Hero: folds
7a5bf293: folds
fe0566a4: raises $0.05 to $0.1
86cb159: calls $0.05
*** FLOP *** [As 4s Kd]
fe0566a4: bets $0.2
86cb159: calls $0.2
*** TURN *** [As 4s Kd] [Qs]
fe0566a4: bets $0.3
86cb159: raises $0.9 to $1.2
fe0566a4: folds
Uncalled bet ($0.9) returned to 86cb159
*** SHOWDOWN ***
86cb159 collected $1.14 from pot
*** SUMMARY ***
Total pot $1.2 | Rake $0.06 | Jackpot $0 | Bingo $0 | Fortune $0 | Tax $0
Board [As 4s Kd Qs]
Seat 1: 7a5bf293 (button) folded before Flop (didn't bet)
Seat 2: fe0566a4 (small blind) folded on the Turn
Seat 3: 86cb159 (big blind) won ($1.14)
Seat 4: 16f2e5ce folded before Flop (didn't bet)
Seat 5: fa40c39c folded before Flop (didn't bet)
Seat 6: Hero folded before Flop (didn't bet)


Poker Hand #RC3334443921: Hold'em No Limit ($0.02/$0.05) - 2025/02/17 20:50:25
Table 'RushAndCash609181' 6-max Seat #1 is the button
Seat 1: Hero ($5.65 in chips)
Seat 2: 673e17b3 ($5.04 in chips)
Seat 3: 5197516b ($5 in chips)
Seat 4: e7a0ba42 ($9.82 in chips)
Seat 5: 2eb4439f ($11.54 in chips)
Seat 6: 6f8bb9d1 ($6.4 in chips)
673e17b3: posts small blind $0.02
5197516b: posts big blind $0.05
*** HOLE CARDS ***
Dealt to Hero [Th 4d]
Dealt to 673e17b3 
Dealt to 5197516b 
Dealt to e7a0ba42 
Dealt to 2eb4439f 
Dealt to 6f8bb9d1 
e7a0ba42: raises $0.06 to $0.11
2eb4439f: folds
6f8bb9d1: folds
Hero: folds
673e17b3: folds
5197516b: folds
Uncalled bet ($0.06) returned to e7a0ba42
*** SHOWDOWN ***
e7a0ba42 collected $0.12 from pot
*** SUMMARY ***
Total pot $0.12 | Rake $0 | Jackpot $0 | Bingo $0 | Fortune $0 | Tax $0
Seat 1: Hero (button) folded before Flop (didn't bet)
Seat 2: 673e17b3 (small blind) folded before Flop
Seat 3: 5197516b (big blind) folded before Flop
Seat 4: e7a0ba42 collected ($0.12)
Seat 5: 2eb4439f folded before Flop (didn't bet)
Seat 6: 6f8bb9d1 folded before Flop (didn't bet)


Poker Hand #RC3334443867: Hold'em No Limit ($0.02/$0.05) - 2025/02/17 20:50:18
Table 'RushAndCash609127' 6-max Seat #1 is the button
Seat 1: 1e474bac ($7.22 in chips)
Seat 2: Hero ($5.67 in chips)
Seat 3: f71501ed ($5.05 in chips)
Seat 4: c607d475 ($8.58 in chips)
Seat 5: a51b9462 ($5.3 in chips)
Seat 6: 320e8d82 ($6.28 in chips)
Hero: posts small blind $0.02
f71501ed: posts big blind $0.05
*** HOLE CARDS ***
Dealt to 1e474bac 
Dealt to Hero [5c 9s]
Dealt to f71501ed 
Dealt to c607d475 
Dealt to a51b9462 
Dealt to 320e8d82 
c607d475: folds
a51b9462: raises $0.05 to $0.1
320e8d82: folds
1e474bac: folds
Hero: folds
f71501ed: folds
Uncalled bet ($0.05) returned to a51b9462
*** SHOWDOWN ***
a51b9462 collected $0.12 from pot
*** SUMMARY ***
Total pot $0.12 | Rake $0 | Jackpot $0 | Bingo $0 | Fortune $0 | Tax $0
Seat 1: 1e474bac (button) folded before Flop (didn't bet)
Seat 2: Hero (small blind) folded before Flop
Seat 3: f71501ed (big blind) folded before Flop
Seat 4: c607d475 folded before Flop (didn't bet)
Seat 5: a51b9462 collected ($0.12)
Seat 6: 320e8d82 folded before Flop (didn't bet)


Poker Hand #RC3334443846: Hold'em No Limit ($0.02/$0.05) - 2025/02/17 20:50:15
Table 'RushAndCash609106' 6-max Seat #1 is the button
Seat 1: b9e511a ($23.75 in chips)
Seat 2: 71e00d83 ($7.61 in chips)
Seat 3: 1c6a80d2 ($5 in chips)
Seat 4: e183d966 ($7.22 in chips)
Seat 5: Hero ($5.67 in chips)
Seat 6: 3d2a56c8 ($5 in chips)
71e00d83: posts small blind $0.02
1c6a80d2: posts big blind $0.05
*** HOLE CARDS ***
Dealt to b9e511a 
Dealt to 71e00d83 
Dealt to 1c6a80d2 
Dealt to e183d966 
Dealt to Hero [Qs 6s]
Dealt to 3d2a56c8 
e183d966: folds
Hero: folds
3d2a56c8: raises $0.07 to $0.12
b9e511a: folds
71e00d83: calls $0.1
1c6a80d2: calls $0.07
*** FLOP *** [7h Kc 7c]
71e00d83: checks
1c6a80d2: bets $0.05
3d2a56c8: folds
71e00d83: folds
Uncalled bet ($0.05) returned to 1c6a80d2
*** SHOWDOWN ***
1c6a80d2 collected $0.35 from pot
*** SUMMARY ***
Total pot $0.36 | Rake $0.01 | Jackpot $0 | Bingo $0 | Fortune $0 | Tax $0
Board [7h Kc 7c]
Seat 1: b9e511a (button) folded before Flop (didn't bet)
Seat 2: 71e00d83 (small blind) folded on the Flop
Seat 3: 1c6a80d2 (big blind) won ($0.35)
Seat 4: e183d966 folded before Flop (didn't bet)
Seat 5: Hero folded before Flop (didn't bet)
Seat 6: 3d2a56c8 folded on the Flop


Poker Hand #RC3334443787: Hold'em No Limit ($0.02/$0.05) - 2025/02/17 20:50:07
Table 'RushAndCash609047' 6-max Seat #1 is the button
Seat 1: bfef046a ($26.97 in chips)
Seat 2: 18cb11a ($5 in chips)
Seat 3: Hero ($5.72 in chips)
Seat 4: 69407b3a ($6.1 in chips)
Seat 5: c73f4765 ($1.85 in chips)
Seat 6: 23619adf ($5.25 in chips)
18cb11a: posts small blind $0.02
Hero: posts big blind $0.05
*** HOLE CARDS ***
Dealt to bfef046a 
Dealt to 18cb11a 
Dealt to Hero [4h 9s]
Dealt to 69407b3a 
Dealt to c73f4765 
Dealt to 23619adf 
69407b3a: folds
c73f4765: folds
23619adf: folds
bfef046a: raises $0.08 to $0.13
18cb11a: folds
Hero: folds
Uncalled bet ($0.08) returned to bfef046a
*** SHOWDOWN ***
bfef046a collected $0.12 from pot
*** SUMMARY ***
Total pot $0.12 | Rake $0 | Jackpot $0 | Bingo $0 | Fortune $0 | Tax $0
Seat 1: bfef046a (button) collected ($0.12)
Seat 2: 18cb11a (small blind) folded before Flop
Seat 3: Hero (big blind) folded before Flop
Seat 4: 69407b3a folded before Flop (didn't bet)
Seat 5: c73f4765 folded before Flop (didn't bet)
Seat 6: 23619adf folded before Flop (didn't bet)


Poker Hand #RC3334443763: Hold'em No Limit ($0.02/$0.05) - 2025/02/17 20:50:04
Table 'RushAndCash609023' 6-max Seat #1 is the button
Seat 1: 6f8bb9d1 ($6.47 in chips)
Seat 2: Hero ($5.74 in chips)
Seat 3: fe0566a4 ($9.47 in chips)
Seat 4: 18cb11a ($5 in chips)
Seat 5: fbd2add5 ($5.41 in chips)
Seat 6: f2a32196 ($5.94 in chips)
Hero: posts small blind $0.02
fe0566a4: posts big blind $0.05
*** HOLE CARDS ***
Dealt to 6f8bb9d1 
Dealt to Hero [Qh 5d]
Dealt to fe0566a4 
Dealt to 18cb11a 
Dealt to fbd2add5 
Dealt to f2a32196 
18cb11a: folds
fbd2add5: raises $0.08 to $0.13
f2a32196: folds
6f8bb9d1: folds
Hero: folds
fe0566a4: folds
Uncalled bet ($0.08) returned to fbd2add5
*** SHOWDOWN ***
fbd2add5 collected $0.12 from pot
*** SUMMARY ***
Total pot $0.12 | Rake $0 | Jackpot $0 | Bingo $0 | Fortune $0 | Tax $0
Seat 1: 6f8bb9d1 (button) folded before Flop (didn't bet)
Seat 2: Hero (small blind) folded before Flop
Seat 3: fe0566a4 (big blind) folded before Flop
Seat 4: 18cb11a folded before Flop (didn't bet)
Seat 5: fbd2add5 collected ($0.12)
Seat 6: f2a32196 folded before Flop (didn't bet)


Poker Hand #RC3334443735: Hold'em No Limit ($0.02/$0.05) - 2025/02/17 20:50:00
Table 'RushAndCash608995' 6-max Seat #1 is the button
Seat 1: d58b99ca ($24.77 in chips)
Seat 2: d88bd80a ($5.45 in chips)
Seat 3: 31c8057a ($4.95 in chips)
Seat 4: Hero ($5.74 in chips)
Seat 5: 95eed447 ($1.53 in chips)
Seat 6: 573eb753 ($6.7 in chips)
d88bd80a: posts small blind $0.02
31c8057a: posts big blind $0.05
*** HOLE CARDS ***
Dealt to d58b99ca 
Dealt to d88bd80a 
Dealt to 31c8057a 
Dealt to Hero [Ks 5c]
Dealt to 95eed447 
Dealt to 573eb753 
Hero: folds
95eed447: folds
573eb753: raises $0.07 to $0.12
d58b99ca: folds
d88bd80a: folds
31c8057a: folds
Uncalled bet ($0.07) returned to 573eb753
*** SHOWDOWN ***
573eb753 collected $0.12 from pot
*** SUMMARY ***
Total pot $0.12 | Rake $0 | Jackpot $0 | Bingo $0 | Fortune $0 | Tax $0
Seat 1: d58b99ca (button) folded before Flop (didn't bet)
Seat 2: d88bd80a (small blind) folded before Flop
Seat 3: 31c8057a (big blind) folded before Flop
Seat 4: Hero folded before Flop (didn't bet)
Seat 5: 95eed447 folded before Flop (didn't bet)
Seat 6: 573eb753 collected ($0.12)


Poker Hand #RC3334443712: Hold'em No Limit ($0.02/$0.05) - 2025/02/17 20:49:57
Table 'RushAndCash608972' 6-max Seat #1 is the button
Seat 1: Hero ($5.74 in chips)
Seat 2: e3cc36cb ($5.44 in chips)
Seat 3: 87a9a23b ($2.55 in chips)
Seat 4: 802a8ffb ($5.24 in chips)
Seat 5: f3fc119a ($7.88 in chips)
Seat 6: da8f3ac5 ($5.07 in chips)
e3cc36cb: posts small blind $0.02
87a9a23b: posts big blind $0.05
*** HOLE CARDS ***
Dealt to Hero [2d Qd]
Dealt to e3cc36cb 
Dealt to 87a9a23b 
Dealt to 802a8ffb 
Dealt to f3fc119a 
Dealt to da8f3ac5 
802a8ffb: raises $0.1 to $0.15
f3fc119a: folds
da8f3ac5: folds
Hero: folds
e3cc36cb: folds
87a9a23b: calls $0.1
*** FLOP *** [5c Jc Jd]
87a9a23b: checks
802a8ffb: bets $0.17
87a9a23b: calls $0.17
*** TURN *** [5c Jc Jd] [Th]
87a9a23b: checks
802a8ffb: checks
*** RIVER *** [5c Jc Jd Th] [6h]
87a9a23b: bets $0.33
802a8ffb: calls $0.33
87a9a23b: shows [9h Jh] (Three Jacks)
802a8ffb: shows [9d 9s] (Pair of Jacks and Pair of Nines)
*** SHOWDOWN ***
87a9a23b collected $1.26 from pot
*** SUMMARY ***
Total pot $1.32 | Rake $0.06 | Jackpot $0 | Bingo $0 | Fortune $0 | Tax $0
Board [5c Jc Jd Th 6h]
Seat 1: Hero (button) folded before Flop (didn't bet)
Seat 2: e3cc36cb (small blind) folded before Flop
Seat 3: 87a9a23b (big blind) showed [9h Jh] and won ($1.26) with Three Jacks
Seat 4: 802a8ffb showed [9d 9s] and lost with Pair of Jacks and Pair of Nines
Seat 5: f3fc119a folded before Flop (didn't bet)
Seat 6: da8f3ac5 folded before Flop (didn't bet)


Poker Hand #RC3334443691: Hold'em No Limit ($0.02/$0.05) - 2025/02/17 20:49:54
Table 'RushAndCash608951' 6-max Seat #1 is the button
Seat 1: 95eed447 ($1.53 in chips)
Seat 2: f3f5406e ($15.22 in chips)
Seat 3: 19bb03b5 ($13.12 in chips)
Seat 4: Hero ($5.74 in chips)
Seat 5: 2b8b2921 ($8.46 in chips)
Seat 6: 6aa0c391 ($5.36 in chips)
f3f5406e: posts small blind $0.02
19bb03b5: posts big blind $0.05
*** HOLE CARDS ***
Dealt to 95eed447 
Dealt to f3f5406e 
Dealt to 19bb03b5 
Dealt to Hero [4c Jh]
Dealt to 2b8b2921 
Dealt to 6aa0c391 
Hero: folds
2b8b2921: folds
6aa0c391: raises $0.08 to $0.13
95eed447: folds
f3f5406e: folds
19bb03b5: folds
Uncalled bet ($0.08) returned to 6aa0c391
*** SHOWDOWN ***
6aa0c391 collected $0.12 from pot
*** SUMMARY ***
Total pot $0.12 | Rake $0 | Jackpot $0 | Bingo $0 | Fortune $0 | Tax $0
Seat 1: 95eed447 (button) folded before Flop (didn't bet)
Seat 2: f3f5406e (small blind) folded before Flop
Seat 3: 19bb03b5 (big blind) folded before Flop
Seat 4: Hero folded before Flop (didn't bet)
Seat 5: 2b8b2921 folded before Flop (didn't bet)
Seat 6: 6aa0c391 collected ($0.12)


Poker Hand #RC3334443664: Hold'em No Limit ($0.02/$0.05) - 2025/02/17 20:49:49
Table 'RushAndCash608924' 6-max Seat #1 is the button
Seat 1: e74a324 ($6.76 in chips)
Seat 2: Hero ($5.76 in chips)
Seat 3: 11778018 ($4.76 in chips)
Seat 4: 92099542 ($12.98 in chips)
Seat 5: 38d2fc1e ($6.99 in chips)
Seat 6: 85a41100 ($5.35 in chips)
Hero: posts small blind $0.02
11778018: posts big blind $0.05
*** HOLE CARDS ***
Dealt to e74a324 
Dealt to Hero [6h Tc]
Dealt to 11778018 
Dealt to 92099542 
Dealt to 38d2fc1e 
Dealt to 85a41100 
92099542: folds
38d2fc1e: folds
85a41100: raises $0.08 to $0.13
e74a324: folds
Hero: folds
11778018: folds
Uncalled bet ($0.08) returned to 85a41100
*** SHOWDOWN ***
85a41100 collected $0.12 from pot
*** SUMMARY ***
Total pot $0.12 | Rake $0 | Jackpot $0 | Bingo $0 | Fortune $0 | Tax $0
Seat 1: e74a324 (button) folded before Flop (didn't bet)
Seat 2: Hero (small blind) folded before Flop
Seat 3: 11778018 (big blind) folded before Flop
Seat 4: 92099542 folded before Flop (didn't bet)
Seat 5: 38d2fc1e folded before Flop (didn't bet)
Seat 6: 85a41100 collected ($0.12)


Poker Hand #RC3334443627: Hold'em No Limit ($0.02/$0.05) - 2025/02/17 20:49:45
Table 'RushAndCash608887' 6-max Seat #1 is the button
Seat 1: ef7e6107 ($5 in chips)
Seat 2: 5466aa49 ($8.01 in chips)
Seat 3: ec1214a6 ($5.19 in chips)
Seat 4: 64e5de41 ($6.13 in chips)
Seat 5: Hero ($5.76 in chips)
Seat 6: 35fb946f ($6.83 in chips)
5466aa49: posts small blind $0.02
ec1214a6: posts big blind $0.05
*** HOLE CARDS ***
Dealt to ef7e6107 
Dealt to 5466aa49 
Dealt to ec1214a6 
Dealt to 64e5de41 
Dealt to Hero [8s 6s]
Dealt to 35fb946f 
64e5de41: folds
Hero: folds
35fb946f: raises $0.05 to $0.1
ef7e6107: folds
5466aa49: folds
ec1214a6: calls $0.05
*** FLOP *** [5d Ks 7d]
ec1214a6: checks
35fb946f: checks
*** TURN *** [5d Ks 7d] [8h]
ec1214a6: checks
35fb946f: bets $0.11
ec1214a6: folds
Uncalled bet ($0.11) returned to 35fb946f
*** SHOWDOWN ***
35fb946f collected $0.21 from pot
*** SUMMARY ***
Total pot $0.22 | Rake $0.01 | Jackpot $0 | Bingo $0 | Fortune $0 | Tax $0
Board [5d Ks 7d 8h]
Seat 1: ef7e6107 (button) folded before Flop (didn't bet)
Seat 2: 5466aa49 (small blind) folded before Flop
Seat 3: ec1214a6 (big blind) folded on the Turn
Seat 4: 64e5de41 folded before Flop (didn't bet)
Seat 5: Hero folded before Flop (didn't bet)
Seat 6: 35fb946f won ($0.21)


Poker Hand #RC3334443603: Hold'em No Limit ($0.02/$0.05) - 2025/02/17 20:49:42
Table 'RushAndCash608863' 6-max Seat #1 is the button
Seat 1: 130fc8d7 ($17.05 in chips)
Seat 2: b940aa44 ($9.61 in chips)
Seat 3: Hero ($5.81 in chips)
Seat 4: 35fb946f ($6.83 in chips)
Seat 5: 719071b8 ($5.02 in chips)
Seat 6: eabdba88 ($3.11 in chips)
b940aa44: posts small blind $0.02
Hero: posts big blind $0.05
*** HOLE CARDS ***
Dealt to 130fc8d7 
Dealt to b940aa44 
Dealt to Hero [7d 9c]
Dealt to 35fb946f 
Dealt to 719071b8 
Dealt to eabdba88 
35fb946f: folds
719071b8: folds
eabdba88: folds
130fc8d7: raises $0.08 to $0.13
b940aa44: calls $0.11
Hero: folds
*** FLOP *** [3c 8d 6c]
b940aa44: checks
130fc8d7: checks
*** TURN *** [3c 8d 6c] [5h]
b940aa44: bets $0.16
130fc8d7: folds
Uncalled bet ($0.16) returned to b940aa44
*** SHOWDOWN ***
b940aa44 collected $0.3 from pot
*** SUMMARY ***
Total pot $0.31 | Rake $0.01 | Jackpot $0 | Bingo $0 | Fortune $0 | Tax $0
Board [3c 8d 6c 5h]
Seat 1: 130fc8d7 (button) folded on the Turn
Seat 2: b940aa44 (small blind) won ($0.3)
Seat 3: Hero (big blind) folded before Flop
Seat 4: 35fb946f folded before Flop (didn't bet)
Seat 5: 719071b8 folded before Flop (didn't bet)
Seat 6: eabdba88 folded before Flop (didn't bet)


Poker Hand #RC3334443578: Hold'em No Limit ($0.02/$0.05) - 2025/02/17 20:49:39
Table 'RushAndCash608838' 6-max Seat #1 is the button
Seat 1: 18767060 ($12.21 in chips)
Seat 2: 2509f499 ($4.74 in chips)
Seat 3: 29ffb7d5 ($5.77 in chips)
Seat 4: c1784884 ($7.49 in chips)
Seat 5: fc9f1189 ($12.79 in chips)
Seat 6: Hero ($5.81 in chips)
2509f499: posts small blind $0.02
29ffb7d5: posts big blind $0.05
*** HOLE CARDS ***
Dealt to 18767060 
Dealt to 2509f499 
Dealt to 29ffb7d5 
Dealt to c1784884 
Dealt to fc9f1189 
Dealt to Hero [Qh 7h]
c1784884: folds
fc9f1189: raises $0.05 to $0.1
Hero: folds
18767060: folds
2509f499: folds
29ffb7d5: folds
Uncalled bet ($0.05) returned to fc9f1189
*** SHOWDOWN ***
fc9f1189 collected $0.12 from pot
*** SUMMARY ***
Total pot $0.12 | Rake $0 | Jackpot $0 | Bingo $0 | Fortune $0 | Tax $0
Seat 1: 18767060 (button) folded before Flop (didn't bet)
Seat 2: 2509f499 (small blind) folded before Flop
Seat 3: 29ffb7d5 (big blind) folded before Flop
Seat 4: c1784884 folded before Flop (didn't bet)
Seat 5: fc9f1189 collected ($0.12)
Seat 6: Hero folded before Flop (didn't bet)


Poker Hand #RC3334443555: Hold'em No Limit ($0.02/$0.05) - 2025/02/17 20:49:36
Table 'RushAndCash608815' 6-max Seat #1 is the button
Seat 1: 50053f22 ($6.25 in chips)
Seat 2: 1d0217bc ($13.76 in chips)
Seat 3: ee368e2c ($6.22 in chips)
Seat 4: 64b39229 ($5.43 in chips)
Seat 5: c7d7e6aa ($18.3 in chips)
Seat 6: Hero ($5.81 in chips)
1d0217bc: posts small blind $0.02
ee368e2c: posts big blind $0.05
*** HOLE CARDS ***
Dealt to 50053f22 
Dealt to 1d0217bc 
Dealt to ee368e2c 
Dealt to 64b39229 
Dealt to c7d7e6aa 
Dealt to Hero [Ks 2c]
64b39229: folds
c7d7e6aa: raises $0.05 to $0.1
Hero: folds
50053f22: folds
1d0217bc: folds
ee368e2c: folds
Uncalled bet ($0.05) returned to c7d7e6aa
*** SHOWDOWN ***
c7d7e6aa collected $0.12 from pot
*** SUMMARY ***
Total pot $0.12 | Rake $0 | Jackpot $0 | Bingo $0 | Fortune $0 | Tax $0
Seat 1: 50053f22 (button) folded before Flop (didn't bet)
Seat 2: 1d0217bc (small blind) folded before Flop
Seat 3: ee368e2c (big blind) folded before Flop
Seat 4: 64b39229 folded before Flop (didn't bet)
Seat 5: c7d7e6aa collected ($0.12)
Seat 6: Hero folded before Flop (didn't bet)


Poker Hand #RC3334443325: Hold'em No Limit ($0.02/$0.05) - 2025/02/17 20:49:06
Table 'RushAndCash608585' 6-max Seat #1 is the button
Seat 1: Hero ($6.04 in chips)
Seat 2: 5c8c19b7 ($11.01 in chips)
Seat 3: cd1f87c8 ($9.75 in chips)
Seat 4: f4cb4fd0 ($5.52 in chips)
Seat 5: 1fa8537 ($5.21 in chips)
Seat 6: 8ed17f8c ($5.21 in chips)
5c8c19b7: posts small blind $0.02
cd1f87c8: posts big blind $0.05
*** HOLE CARDS ***
Dealt to Hero [4h 4s]
Dealt to 5c8c19b7 
Dealt to cd1f87c8 
Dealt to f4cb4fd0 
Dealt to 1fa8537 
Dealt to 8ed17f8c 
f4cb4fd0: folds
1fa8537: folds
8ed17f8c: folds
Hero: raises $0.05 to $0.1
5c8c19b7: calls $0.08
cd1f87c8: folds
*** FLOP *** [5s Th 3c]
5c8c19b7: checks
Hero: checks
*** TURN *** [5s Th 3c] [7c]
5c8c19b7: bets $0.13
Hero: calls $0.13
*** RIVER *** [5s Th 3c 7c] [7d]
5c8c19b7: checks
Hero: checks
5c8c19b7: shows [9c 9s] (Pair of Nines and Pair of Sevens)
Hero: shows [4h 4s] (Pair of Sevens and Pair of Fours)
*** SHOWDOWN ***
5c8c19b7 collected $0.49 from pot
*** SUMMARY ***
Total pot $0.51 | Rake $0.02 | Jackpot $0 | Bingo $0 | Fortune $0 | Tax $0
Board [5s Th 3c 7c 7d]
Seat 1: Hero (button) showed [4h 4s] and lost with Pair of Sevens and Pair of Fours
Seat 2: 5c8c19b7 (small blind) showed [9c 9s] and won ($0.49) with Pair of Nines and Pair of Sevens
Seat 3: cd1f87c8 (big blind) folded before Flop
Seat 4: f4cb4fd0 folded before Flop (didn't bet)
Seat 5: 1fa8537 folded before Flop (didn't bet)
Seat 6: 8ed17f8c folded before Flop (didn't bet)


Poker Hand #RC3334443293: Hold'em No Limit ($0.02/$0.05) - 2025/02/17 20:49:02
Table 'RushAndCash608553' 6-max Seat #1 is the button
Seat 1: 31c8057a ($4.95 in chips)
Seat 2: 16f2e5ce ($5.55 in chips)
Seat 3: 66981141 ($10.87 in chips)
Seat 4: a223d3ca ($5.16 in chips)
Seat 5: 4238ab48 ($5.31 in chips)
Seat 6: Hero ($6.04 in chips)
16f2e5ce: posts small blind $0.02
66981141: posts big blind $0.05
*** HOLE CARDS ***
Dealt to 31c8057a 
Dealt to 16f2e5ce 
Dealt to 66981141 
Dealt to a223d3ca 
Dealt to 4238ab48 
Dealt to Hero [Jc 9s]
a223d3ca: folds
4238ab48: raises $0.06 to $0.11
Hero: folds
31c8057a: folds
16f2e5ce: folds
66981141: raises $0.18 to $0.29
4238ab48: calls $0.18
*** FLOP *** [Ad 7c 7h]
66981141: checks
4238ab48: checks
*** TURN *** [Ad 7c 7h] [6s]
66981141: bets $0.3
4238ab48: folds
Uncalled bet ($0.3) returned to 66981141
*** SHOWDOWN ***
66981141 collected $0.57 from pot
*** SUMMARY ***
Total pot $0.6 | Rake $0.03 | Jackpot $0 | Bingo $0 | Fortune $0 | Tax $0
Board [Ad 7c 7h 6s]
Seat 1: 31c8057a (button) folded before Flop (didn't bet)
Seat 2: 16f2e5ce (small blind) folded before Flop
Seat 3: 66981141 (big blind) won ($0.57)
Seat 4: a223d3ca folded before Flop (didn't bet)
Seat 5: 4238ab48 folded on the Turn
Seat 6: Hero folded before Flop (didn't bet)


Poker Hand #RC3334443173: Hold'em No Limit ($0.02/$0.05) - 2025/02/17 20:48:44
Table 'RushAndCash608433' 6-max Seat #1 is the button
Seat 1: 1f7fd8bc ($5.74 in chips)
Seat 2: a276507b ($5.18 in chips)
Seat 3: f3a68bc9 ($5 in chips)
Seat 4: 653af57c ($5.19 in chips)
Seat 5: Hero ($6.14 in chips)
Seat 6: a223d3ca ($5 in chips)
a276507b: posts small blind $0.02
f3a68bc9: posts big blind $0.05
*** HOLE CARDS ***
Dealt to 1f7fd8bc 
Dealt to a276507b 
Dealt to f3a68bc9 
Dealt to 653af57c 
Dealt to Hero [As Jc]
Dealt to a223d3ca 
653af57c: folds
Hero: raises $0.05 to $0.1
a223d3ca: raises $0.2 to $0.3
1f7fd8bc: folds
a276507b: folds
f3a68bc9: folds
Hero: folds
Uncalled bet ($0.2) returned to a223d3ca
*** SHOWDOWN ***
a223d3ca collected $0.26 from pot
*** SUMMARY ***
Total pot $0.27 | Rake $0.01 | Jackpot $0 | Bingo $0 | Fortune $0 | Tax $0
Seat 1: 1f7fd8bc (button) folded before Flop (didn't bet)
Seat 2: a276507b (small blind) folded before Flop
Seat 3: f3a68bc9 (big blind) folded before Flop
Seat 4: 653af57c folded before Flop (didn't bet)
Seat 5: Hero folded before Flop
Seat 6: a223d3ca collected ($0.26)


Poker Hand #RC3334443142: Hold'em No Limit ($0.02/$0.05) - 2025/02/17 20:48:40
Table 'RushAndCash608402' 6-max Seat #1 is the button
Seat 1: 7e677a64 ($2.53 in chips)
Seat 2: 64e5de41 ($6.09 in chips)
Seat 3: 679a8f7 ($8.18 in chips)
Seat 4: Hero ($6.14 in chips)
Seat 5: 80b2520f ($5.59 in chips)
Seat 6: 1f187ba0 ($4.25 in chips)
64e5de41: posts small blind $0.02
679a8f7: posts big blind $0.05
*** HOLE CARDS ***
Dealt to 7e677a64 
Dealt to 64e5de41 
Dealt to 679a8f7 
Dealt to Hero [Tc 4s]
Dealt to 80b2520f 
Dealt to 1f187ba0 
Hero: folds
80b2520f: folds
1f187ba0: folds
7e677a64: raises $0.08 to $0.13
64e5de41: raises $0.37 to $0.5
679a8f7: folds
7e677a64: folds
Uncalled bet ($0.37) returned to 64e5de41
*** SHOWDOWN ***
64e5de41 collected $0.3 from pot
*** SUMMARY ***
Total pot $0.31 | Rake $0.01 | Jackpot $0 | Bingo $0 | Fortune $0 | Tax $0
Seat 1: 7e677a64 (button) folded before Flop
Seat 2: 64e5de41 (small blind) collected ($0.3)
Seat 3: 679a8f7 (big blind) folded before Flop
Seat 4: Hero folded before Flop (didn't bet)
Seat 5: 80b2520f folded before Flop (didn't bet)
Seat 6: 1f187ba0 folded before Flop (didn't bet)


Poker Hand #RC3334443121: Hold'em No Limit ($0.02/$0.05) - 2025/02/17 20:48:37
Table 'RushAndCash608381' 6-max Seat #1 is the button
Seat 1: f739af93 ($12.07 in chips)
Seat 2: Hero ($6.16 in chips)
Seat 3: 7fe74cc5 ($5 in chips)
Seat 4: 65964033 ($5.69 in chips)
Seat 5: 7fc44808 ($11.56 in chips)
Seat 6: 835df346 ($14.58 in chips)
Hero: posts small blind $0.02
7fe74cc5: posts big blind $0.05
*** HOLE CARDS ***
Dealt to f739af93 
Dealt to Hero [Js 8d]
Dealt to 7fe74cc5 
Dealt to 65964033 
Dealt to 7fc44808 
Dealt to 835df346 
65964033: folds
7fc44808: folds
835df346: folds
f739af93: raises $0.05 to $0.1
Hero: folds
7fe74cc5: folds
Uncalled bet ($0.05) returned to f739af93
*** SHOWDOWN ***
f739af93 collected $0.12 from pot
*** SUMMARY ***
Total pot $0.12 | Rake $0 | Jackpot $0 | Bingo $0 | Fortune $0 | Tax $0
Seat 1: f739af93 (button) collected ($0.12)
Seat 2: Hero (small blind) folded before Flop
Seat 3: 7fe74cc5 (big blind) folded before Flop
Seat 4: 65964033 folded before Flop (didn't bet)
Seat 5: 7fc44808 folded before Flop (didn't bet)
Seat 6: 835df346 folded before Flop (didn't bet)


Poker Hand #RC3334443094: Hold'em No Limit ($0.02/$0.05) - 2025/02/17 20:48:33
Table 'RushAndCash608354' 6-max Seat #1 is the button
Seat 1: e5903036 ($16.08 in chips)
Seat 2: 510f8c9f ($5 in chips)
Seat 3: Hero ($6.21 in chips)
Seat 4: d21ca4f4 ($4.74 in chips)
Seat 5: e58420c8 ($5 in chips)
Seat 6: 598d859f ($5.07 in chips)
510f8c9f: posts small blind $0.02
Hero: posts big blind $0.05
*** HOLE CARDS ***
Dealt to e5903036 
Dealt to 510f8c9f 
Dealt to Hero [8c 3d]
Dealt to d21ca4f4 
Dealt to e58420c8 
Dealt to 598d859f 
d21ca4f4: folds
e58420c8: raises $0.06 to $0.11
598d859f: folds
e5903036: folds
510f8c9f: folds
Hero: folds
Uncalled bet ($0.06) returned to e58420c8
*** SHOWDOWN ***
e58420c8 collected $0.12 from pot
*** SUMMARY ***
Total pot $0.12 | Rake $0 | Jackpot $0 | Bingo $0 | Fortune $0 | Tax $0
Seat 1: e5903036 (button) folded before Flop (didn't bet)
Seat 2: 510f8c9f (small blind) folded before Flop
Seat 3: Hero (big blind) folded before Flop
Seat 4: d21ca4f4 folded before Flop (didn't bet)
Seat 5: e58420c8 collected ($0.12)
Seat 6: 598d859f folded before Flop (didn't bet)


Poker Hand #RC3334443066: Hold'em No Limit ($0.02/$0.05) - 2025/02/17 20:48:29
Table 'RushAndCash608326' 6-max Seat #1 is the button
Seat 1: f3a68bc9 ($5 in chips)
Seat 2: e56ac911 ($3.04 in chips)
Seat 3: 650e9dc7 ($5.97 in chips)
Seat 4: dc00ecae ($5 in chips)
Seat 5: Hero ($6.21 in chips)
Seat 6: b282789b ($5.14 in chips)
e56ac911: posts small blind $0.02
650e9dc7: posts big blind $0.05
*** HOLE CARDS ***
Dealt to f3a68bc9 
Dealt to e56ac911 
Dealt to 650e9dc7 
Dealt to dc00ecae 
Dealt to Hero [2h 9c]
Dealt to b282789b 
dc00ecae: folds
Hero: folds
b282789b: raises $0.07 to $0.12
f3a68bc9: folds
e56ac911: folds
650e9dc7: calls $0.07
*** FLOP *** [Ac 5h 9d]
650e9dc7: checks
b282789b: bets $0.09
650e9dc7: folds
Uncalled bet ($0.09) returned to b282789b
*** SHOWDOWN ***
b282789b collected $0.25 from pot
*** SUMMARY ***
Total pot $0.26 | Rake $0.01 | Jackpot $0 | Bingo $0 | Fortune $0 | Tax $0
Board [Ac 5h 9d]
Seat 1: f3a68bc9 (button) folded before Flop (didn't bet)
Seat 2: e56ac911 (small blind) folded before Flop
Seat 3: 650e9dc7 (big blind) folded on the Flop
Seat 4: dc00ecae folded before Flop (didn't bet)
Seat 5: Hero folded before Flop (didn't bet)
Seat 6: b282789b won ($0.25)


Poker Hand #RC3334443038: Hold'em No Limit ($0.02/$0.05) - 2025/02/17 20:48:25
Table 'RushAndCash608298' 6-max Seat #1 is the button
Seat 1: Hero ($6.21 in chips)
Seat 2: 75d5d480 ($5 in chips)
Seat 3: e1263ddd ($5.6 in chips)
Seat 4: 95096c6a ($7.89 in chips)
Seat 5: b8a41e4 ($5.39 in chips)
Seat 6: 6dcd0788 ($5.94 in chips)
75d5d480: posts small blind $0.02
e1263ddd: posts big blind $0.05
*** HOLE CARDS ***
Dealt to Hero [Js 6h]
Dealt to 75d5d480 
Dealt to e1263ddd 
Dealt to 95096c6a 
Dealt to b8a41e4 
Dealt to 6dcd0788 
95096c6a: folds
b8a41e4: raises $0.05 to $0.1
6dcd0788: folds
Hero: folds
75d5d480: folds
e1263ddd: folds
Uncalled bet ($0.05) returned to b8a41e4
*** SHOWDOWN ***
b8a41e4 collected $0.12 from pot
*** SUMMARY ***
Total pot $0.12 | Rake $0 | Jackpot $0 | Bingo $0 | Fortune $0 | Tax $0
Seat 1: Hero (button) folded before Flop (didn't bet)
Seat 2: 75d5d480 (small blind) folded before Flop
Seat 3: e1263ddd (big blind) folded before Flop
Seat 4: 95096c6a folded before Flop (didn't bet)
Seat 5: b8a41e4 collected ($0.12)
Seat 6: 6dcd0788 folded before Flop (didn't bet)


Poker Hand #RC3334442960: Hold'em No Limit ($0.02/$0.05) - 2025/02/17 20:48:14
Table 'RushAndCash608220' 6-max Seat #1 is the button
Seat 1: 8012317b ($11.68 in chips)
Seat 2: 80b2520f ($5.61 in chips)
Seat 3: 780645d6 ($5 in chips)
Seat 4: 22a3f0e8 ($5 in chips)
Seat 5: Hero ($6.14 in chips)
Seat 6: 4c783157 ($5.07 in chips)
80b2520f: posts small blind $0.02
780645d6: posts big blind $0.05
*** HOLE CARDS ***
Dealt to 8012317b 
Dealt to 80b2520f 
Dealt to 780645d6 
Dealt to 22a3f0e8 
Dealt to Hero [As Js]
Dealt to 4c783157 
22a3f0e8: folds
Hero: raises $0.05 to $0.1
4c783157: folds
8012317b: folds
80b2520f: folds
780645d6: folds
Uncalled bet ($0.05) returned to Hero
*** SHOWDOWN ***
Hero collected $0.12 from pot
*** SUMMARY ***
Total pot $0.12 | Rake $0 | Jackpot $0 | Bingo $0 | Fortune $0 | Tax $0
Seat 1: 8012317b (button) folded before Flop (didn't bet)
Seat 2: 80b2520f (small blind) folded before Flop
Seat 3: 780645d6 (big blind) folded before Flop
Seat 4: 22a3f0e8 folded before Flop (didn't bet)
Seat 5: Hero collected ($0.12)
Seat 6: 4c783157 folded before Flop (didn't bet)


Poker Hand #RC3334442925: Hold'em No Limit ($0.02/$0.05) - 2025/02/17 20:48:10
Table 'RushAndCash608185' 6-max Seat #1 is the button
Seat 1: Hero ($6.14 in chips)
Seat 2: 1063406 ($10.15 in chips)
Seat 3: d88bd80a ($5.5 in chips)
Seat 4: f8db84a ($6.16 in chips)
Seat 5: c62b7a0b ($19.38 in chips)
Seat 6: 7dd18ea7 ($8.11 in chips)
1063406: posts small blind $0.02
d88bd80a: posts big blind $0.05
*** HOLE CARDS ***
Dealt to Hero [Ts 6c]
Dealt to 1063406 
Dealt to d88bd80a 
Dealt to f8db84a 
Dealt to c62b7a0b 
Dealt to 7dd18ea7 
f8db84a: folds
c62b7a0b: raises $0.06 to $0.11
7dd18ea7: folds
Hero: folds
1063406: raises $0.35 to $0.46
d88bd80a: folds
c62b7a0b: folds
Uncalled bet ($0.35) returned to 1063406
*** SHOWDOWN ***
1063406 collected $0.26 from pot
*** SUMMARY ***
Total pot $0.27 | Rake $0.01 | Jackpot $0 | Bingo $0 | Fortune $0 | Tax $0
Seat 1: Hero (button) folded before Flop (didn't bet)
Seat 2: 1063406 (small blind) collected ($0.26)
Seat 3: d88bd80a (big blind) folded before Flop
Seat 4: f8db84a folded before Flop (didn't bet)
Seat 5: c62b7a0b folded before Flop
Seat 6: 7dd18ea7 folded before Flop (didn't bet)


Poker Hand #RC3334442903: Hold'em No Limit ($0.02/$0.05) - 2025/02/17 20:48:07
Table 'RushAndCash608163' 6-max Seat #1 is the button
Seat 1: 688b40f9 ($5 in chips)
Seat 2: bce71d0e ($4.95 in chips)
Seat 3: 9f70f94d ($5 in chips)
Seat 4: b9e511a ($22.52 in chips)
Seat 5: Hero ($6.14 in chips)
Seat 6: 3b98b9ec ($6.79 in chips)
bce71d0e: posts small blind $0.02
9f70f94d: posts big blind $0.05
*** HOLE CARDS ***
Dealt to 688b40f9 
Dealt to bce71d0e 
Dealt to 9f70f94d 
Dealt to b9e511a 
Dealt to Hero [4c 5s]
Dealt to 3b98b9ec 
b9e511a: folds
Hero: folds
3b98b9ec: folds
688b40f9: folds
bce71d0e: folds
Uncalled bet ($0.03) returned to 9f70f94d
*** SHOWDOWN ***
9f70f94d collected $0.04 from pot
*** SUMMARY ***
Total pot $0.04 | Rake $0 | Jackpot $0 | Bingo $0 | Fortune $0 | Tax $0
Seat 1: 688b40f9 (button) folded before Flop (didn't bet)
Seat 2: bce71d0e (small blind) folded before Flop
Seat 3: 9f70f94d (big blind) collected ($0.04)
Seat 4: b9e511a folded before Flop (didn't bet)
Seat 5: Hero folded before Flop (didn't bet)
Seat 6: 3b98b9ec folded before Flop (didn't bet)


Poker Hand #RC3334442878: Hold'em No Limit ($0.02/$0.05) - 2025/02/17 20:48:03
Table 'RushAndCash608138' 6-max Seat #1 is the button
Seat 1: 9885e0a0 ($10.33 in chips)
Seat 2: Hero ($6.16 in chips)
Seat 3: 207d9345 ($22.6 in chips)
Seat 4: 9babc997 ($4.78 in chips)
Seat 5: 5c980949 ($6.31 in chips)
Seat 6: 80b2520f ($5.61 in chips)
Hero: posts small blind $0.02
207d9345: posts big blind $0.05
*** HOLE CARDS ***
Dealt to 9885e0a0 
Dealt to Hero [7c Jh]
Dealt to 207d9345 
Dealt to 9babc997 
Dealt to 5c980949 
Dealt to 80b2520f 
9babc997: raises $0.07 to $0.12
5c980949: folds
80b2520f: folds
9885e0a0: folds
Hero: folds
207d9345: folds
Uncalled bet ($0.07) returned to 9babc997
*** SHOWDOWN ***
9babc997 collected $0.12 from pot
*** SUMMARY ***
Total pot $0.12 | Rake $0 | Jackpot $0 | Bingo $0 | Fortune $0 | Tax $0
Seat 1: 9885e0a0 (button) folded before Flop (didn't bet)
Seat 2: Hero (small blind) folded before Flop
Seat 3: 207d9345 (big blind) folded before Flop
Seat 4: 9babc997 collected ($0.12)
Seat 5: 5c980949 folded before Flop (didn't bet)
Seat 6: 80b2520f folded before Flop (didn't bet)


Poker Hand #RC3334442851: Hold'em No Limit ($0.02/$0.05) - 2025/02/17 20:47:59
Table 'RushAndCash608111' 6-max Seat #1 is the button
Seat 1: 31bef4 ($6.76 in chips)
Seat 2: de247624 ($5 in chips)
Seat 3: Hero ($6.21 in chips)
Seat 4: d57160ed ($4.9 in chips)
Seat 5: 6c00745d ($5 in chips)
Seat 6: 77d1364f ($4.23 in chips)
de247624: posts small blind $0.02
Hero: posts big blind $0.05
*** HOLE CARDS ***
Dealt to 31bef4 
Dealt to de247624 
Dealt to Hero [9d 6h]
Dealt to d57160ed 
Dealt to 6c00745d 
Dealt to 77d1364f 
d57160ed: raises $0.13 to $0.18
6c00745d: folds
77d1364f: folds
31bef4: calls $0.18
de247624: folds
Hero: folds
*** FLOP *** [Qs 6c 8d]
d57160ed: checks
31bef4: bets $0.15
d57160ed: raises $0.3 to $0.45
31bef4: folds
Uncalled bet ($0.3) returned to d57160ed
*** SHOWDOWN ***
d57160ed collected $0.7 from pot
*** SUMMARY ***
Total pot $0.73 | Rake $0.03 | Jackpot $0 | Bingo $0 | Fortune $0 | Tax $0
Board [Qs 6c 8d]
Seat 1: 31bef4 (button) folded on the Flop
Seat 2: de247624 (small blind) folded before Flop
Seat 3: Hero (big blind) folded before Flop
Seat 4: d57160ed won ($0.7)
Seat 5: 6c00745d folded before Flop (didn't bet)
Seat 6: 77d1364f folded before Flop (didn't bet)


Poker Hand #RC3334442824: Hold'em No Limit ($0.02/$0.05) - 2025/02/17 20:47:55
Table 'RushAndCash608084' 6-max Seat #1 is the button
Seat 1: 5197516b ($5.02 in chips)
Seat 2: 3747d311 ($5 in chips)
Seat 3: ef7b5599 ($15.08 in chips)
Seat 4: Hero ($6.21 in chips)
Seat 5: 41720de0 ($19.49 in chips)
Seat 6: 65964033 ($5.53 in chips)
3747d311: posts small blind $0.02
ef7b5599: posts big blind $0.05
*** HOLE CARDS ***
Dealt to 5197516b 
Dealt to 3747d311 
Dealt to ef7b5599 
Dealt to Hero [3s Jh]
Dealt to 41720de0 
Dealt to 65964033 
Hero: folds
41720de0: raises $0.06 to $0.11
65964033: folds
5197516b: folds
3747d311: folds
ef7b5599: folds
Uncalled bet ($0.06) returned to 41720de0
*** SHOWDOWN ***
41720de0 collected $0.12 from pot
*** SUMMARY ***
Total pot $0.12 | Rake $0 | Jackpot $0 | Bingo $0 | Fortune $0 | Tax $0
Seat 1: 5197516b (button) folded before Flop (didn't bet)
Seat 2: 3747d311 (small blind) folded before Flop
Seat 3: ef7b5599 (big blind) folded before Flop
Seat 4: Hero folded before Flop (didn't bet)
Seat 5: 41720de0 collected ($0.12)
Seat 6: 65964033 folded before Flop (didn't bet)


Poker Hand #RC3334442732: Hold'em No Limit ($0.02/$0.05) - 2025/02/17 20:47:41
Table 'RushAndCash607992' 6-max Seat #1 is the button
Seat 1: 60df1ea0 ($5.46 in chips)
Seat 2: dc00ecae ($5 in chips)
Seat 3: 7ac56771 ($1.47 in chips)
Seat 4: e58420c8 ($5 in chips)
Seat 5: Hero ($6.14 in chips)
Seat 6: 2b8b2921 ($8.32 in chips)
dc00ecae: posts small blind $0.02
7ac56771: posts big blind $0.05
*** HOLE CARDS ***
Dealt to 60df1ea0 
Dealt to dc00ecae 
Dealt to 7ac56771 
Dealt to e58420c8 
Dealt to Hero [As Jc]
Dealt to 2b8b2921 
e58420c8: folds
Hero: raises $0.05 to $0.1
2b8b2921: folds
60df1ea0: folds
dc00ecae: folds
7ac56771: folds
Uncalled bet ($0.05) returned to Hero
*** SHOWDOWN ***
Hero collected $0.12 from pot
*** SUMMARY ***
Total pot $0.12 | Rake $0 | Jackpot $0 | Bingo $0 | Fortune $0 | Tax $0
Seat 1: 60df1ea0 (button) folded before Flop (didn't bet)
Seat 2: dc00ecae (small blind) folded before Flop
Seat 3: 7ac56771 (big blind) folded before Flop
Seat 4: e58420c8 folded before Flop (didn't bet)
Seat 5: Hero collected ($0.12)
Seat 6: 2b8b2921 folded before Flop (didn't bet)


Poker Hand #RC3334442706: Hold'em No Limit ($0.02/$0.05) - 2025/02/17 20:47:36
Table 'RushAndCash607966' 6-max Seat #1 is the button
Seat 1: 74f9576e ($5.05 in chips)
Seat 2: 14620cce ($15.22 in chips)
Seat 3: f9d64f1a ($5.3 in chips)
Seat 4: 94c257a9 ($6.07 in chips)
Seat 5: Hero ($6.14 in chips)
Seat 6: 9dd1ff39 ($7.21 in chips)
14620cce: posts small blind $0.02
f9d64f1a: posts big blind $0.05
*** HOLE CARDS ***
Dealt to 74f9576e 
Dealt to 14620cce 
Dealt to f9d64f1a 
Dealt to 94c257a9 
Dealt to Hero [Ts 7s]
Dealt to 9dd1ff39 
94c257a9: raises $0.05 to $0.1
Hero: folds
9dd1ff39: folds
74f9576e: folds
14620cce: folds
f9d64f1a: folds
Uncalled bet ($0.05) returned to 94c257a9
*** SHOWDOWN ***
94c257a9 collected $0.12 from pot
*** SUMMARY ***
Total pot $0.12 | Rake $0 | Jackpot $0 | Bingo $0 | Fortune $0 | Tax $0
Seat 1: 74f9576e (button) folded before Flop (didn't bet)
Seat 2: 14620cce (small blind) folded before Flop
Seat 3: f9d64f1a (big blind) folded before Flop
Seat 4: 94c257a9 collected ($0.12)
Seat 5: Hero folded before Flop (didn't bet)
Seat 6: 9dd1ff39 folded before Flop (didn't bet)


Poker Hand #RC3334442547: Hold'em No Limit ($0.02/$0.05) - 2025/02/17 20:47:12
Table 'RushAndCash607807' 6-max Seat #1 is the button
Seat 1: 8023de0f ($5.79 in chips)
Seat 2: 1b0744cb ($4.95 in chips)
Seat 3: Hero ($6.24 in chips)
Seat 4: 94c257a9 ($5.96 in chips)
Seat 5: 626359de ($13.2 in chips)
Seat 6: 9564515b ($9.56 in chips)
1b0744cb: posts small blind $0.02
Hero: posts big blind $0.05
*** HOLE CARDS ***
Dealt to 8023de0f 
Dealt to 1b0744cb 
Dealt to Hero [Qs Jc]
Dealt to 94c257a9 
Dealt to 626359de 
Dealt to 9564515b 
94c257a9: raises $0.05 to $0.1
626359de: folds
9564515b: folds
8023de0f: folds
1b0744cb: folds
Hero: calls $0.05
*** FLOP *** [Tc 4s 5d]
Hero: checks
94c257a9: bets $0.11
Hero: folds
Uncalled bet ($0.11) returned to 94c257a9
*** SHOWDOWN ***
94c257a9 collected $0.21 from pot
*** SUMMARY ***
Total pot $0.22 | Rake $0.01 | Jackpot $0 | Bingo $0 | Fortune $0 | Tax $0
Board [Tc 4s 5d]
Seat 1: 8023de0f (button) folded before Flop (didn't bet)
Seat 2: 1b0744cb (small blind) folded before Flop
Seat 3: Hero (big blind) folded on the Flop
Seat 4: 94c257a9 won ($0.21)
Seat 5: 626359de folded before Flop (didn't bet)
Seat 6: 9564515b folded before Flop (didn't bet)


Poker Hand #RC3334442434: Hold'em No Limit ($0.02/$0.05) - 2025/02/17 20:46:56
Table 'RushAndCash607694' 6-max Seat #1 is the button
Seat 1: c85a0f60 ($11.57 in chips)
Seat 2: Hero ($6.19 in chips)
Seat 3: 5a53cba2 ($5.06 in chips)
Seat 4: fc9f1189 ($6.12 in chips)
Seat 5: 9f70f94d ($5.2 in chips)
Seat 6: 868521d5 ($5.17 in chips)
Hero: posts small blind $0.02
5a53cba2: posts big blind $0.05
*** HOLE CARDS ***
Dealt to c85a0f60 
Dealt to Hero [Th Qh]
Dealt to 5a53cba2 
Dealt to fc9f1189 
Dealt to 9f70f94d 
Dealt to 868521d5 
fc9f1189: folds
9f70f94d: folds
868521d5: folds
c85a0f60: folds
Hero: calls $0.03
5a53cba2: checks
*** FLOP *** [2s Ad 4h]
Hero: checks
5a53cba2: checks
*** TURN *** [2s Ad 4h] [3h]
Hero: bets $0.05
5a53cba2: folds
Uncalled bet ($0.05) returned to Hero
*** SHOWDOWN ***
Hero collected $0.1 from pot
*** SUMMARY ***
Total pot $0.1 | Rake $0 | Jackpot $0 | Bingo $0 | Fortune $0 | Tax $0
Board [2s Ad 4h 3h]
Seat 1: c85a0f60 (button) folded before Flop (didn't bet)
Seat 2: Hero (small blind) won ($0.1)
Seat 3: 5a53cba2 (big blind) folded on the Turn
Seat 4: fc9f1189 folded before Flop (didn't bet)
Seat 5: 9f70f94d folded before Flop (didn't bet)
Seat 6: 868521d5 folded before Flop (didn't bet)


Poker Hand #RC3334442412: Hold'em No Limit ($0.02/$0.05) - 2025/02/17 20:46:53
Table 'RushAndCash607672' 6-max Seat #1 is the button
Seat 1: 5466aa49 ($7.31 in chips)
Seat 2: 9babc997 ($4.87 in chips)
Seat 3: Hero ($6.24 in chips)
Seat 4: 4c5ef89 ($5.41 in chips)
Seat 5: 842d7655 ($6.74 in chips)
Seat 6: 229ec9a7 ($5.42 in chips)
9babc997: posts small blind $0.02
Hero: posts big blind $0.05
*** HOLE CARDS ***
Dealt to 5466aa49 
Dealt to 9babc997 
Dealt to Hero [4h 7c]
Dealt to 4c5ef89 
Dealt to 842d7655 
Dealt to 229ec9a7 
4c5ef89: raises $0.08 to $0.13
842d7655: raises $0.32 to $0.45
229ec9a7: folds
5466aa49: folds
9babc997: folds
Hero: folds
4c5ef89: raises $1.15 to $1.6
842d7655: raises $5.14 to $6.74 and is all-in
4c5ef89: folds
Uncalled bet ($5.14) returned to 842d7655
*** SHOWDOWN ***
842d7655 collected $3.05 from pot
*** SUMMARY ***
Total pot $3.27 | Rake $0.15 | Jackpot $0.07 | Bingo $0 | Fortune $0 | Tax $0
Seat 1: 5466aa49 (button) folded before Flop (didn't bet)
Seat 2: 9babc997 (small blind) folded before Flop
Seat 3: Hero (big blind) folded before Flop
Seat 4: 4c5ef89 folded before Flop
Seat 5: 842d7655 collected ($3.05)
Seat 6: 229ec9a7 folded before Flop (didn't bet)


Poker Hand #RC3334442385: Hold'em No Limit ($0.02/$0.05) - 2025/02/17 20:46:49
Table 'RushAndCash607645' 6-max Seat #1 is the button
Seat 1: 7e8993bd ($4.39 in chips)
Seat 2: c85a0f60 ($11.59 in chips)
Seat 3: d0df8653 ($4.94 in chips)
Seat 4: 157631a0 ($5.05 in chips)
Seat 5: Hero ($6.24 in chips)
Seat 6: 62156df3 ($5.64 in chips)
c85a0f60: posts small blind $0.02
d0df8653: posts big blind $0.05
*** HOLE CARDS ***
Dealt to 7e8993bd 
Dealt to c85a0f60 
Dealt to d0df8653 
Dealt to 157631a0 
Dealt to Hero [Td 5s]
Dealt to 62156df3 
157631a0: raises $0.06 to $0.11
Hero: folds
62156df3: folds
7e8993bd: folds
c85a0f60: folds
d0df8653: calls $0.06
*** FLOP *** [4s 3d 7c]
d0df8653: checks
157631a0: checks
*** TURN *** [4s 3d 7c] [7h]
d0df8653: checks
157631a0: checks
*** RIVER *** [4s 3d 7c 7h] [Kd]
d0df8653: checks
157631a0: bets $0.08
d0df8653: calls $0.08
157631a0: shows [Ts Ks] (Pair of Kings and Pair of Sevens)
d0df8653: shows [3h Ah] (Pair of Sevens and Pair of Treys)
*** SHOWDOWN ***
157631a0 collected $0.38 from pot
*** SUMMARY ***
Total pot $0.4 | Rake $0.02 | Jackpot $0 | Bingo $0 | Fortune $0 | Tax $0
Board [4s 3d 7c 7h Kd]
Seat 1: 7e8993bd (button) folded before Flop (didn't bet)
Seat 2: c85a0f60 (small blind) folded before Flop
Seat 3: d0df8653 (big blind) showed [3h Ah] and lost with Pair of Sevens and Pair of Treys
Seat 4: 157631a0 showed [Ts Ks] and won ($0.38) with Pair of Kings and Pair of Sevens
Seat 5: Hero folded before Flop (didn't bet)
Seat 6: 62156df3 folded before Flop (didn't bet)


Poker Hand #RC3334442301: Hold'em No Limit ($0.02/$0.05) - 2025/02/17 20:46:37
Table 'RushAndCash607561' 6-max Seat #1 is the button
Seat 1: Hero ($6.24 in chips)
Seat 2: 95fac4b9 ($8.46 in chips)
Seat 3: 860fa4c9 ($11.44 in chips)
Seat 4: 15fcb4bc ($4.32 in chips)
Seat 5: fbb9d8f2 ($4.15 in chips)
Seat 6: 66be2112 ($6.94 in chips)
95fac4b9: posts small blind $0.02
860fa4c9: posts big blind $0.05
*** HOLE CARDS ***
Dealt to Hero [Qc Tc]
Dealt to 95fac4b9 
Dealt to 860fa4c9 
Dealt to 15fcb4bc 
Dealt to fbb9d8f2 
Dealt to 66be2112 
15fcb4bc: raises $4.27 to $4.32 and is all-in
fbb9d8f2: folds
66be2112: folds
Hero: folds
95fac4b9: folds
860fa4c9: folds
Uncalled bet ($4.27) returned to 15fcb4bc
*** SHOWDOWN ***
15fcb4bc collected $0.12 from pot
*** SUMMARY ***
Total pot $0.12 | Rake $0 | Jackpot $0 | Bingo $0 | Fortune $0 | Tax $0
Seat 1: Hero (button) folded before Flop (didn't bet)
Seat 2: 95fac4b9 (small blind) folded before Flop
Seat 3: 860fa4c9 (big blind) folded before Flop
Seat 4: 15fcb4bc collected ($0.12)
Seat 5: fbb9d8f2 folded before Flop (didn't bet)
Seat 6: 66be2112 folded before Flop (didn't bet)


Poker Hand #RC3334442280: Hold'em No Limit ($0.02/$0.05) - 2025/02/17 20:46:34
Table 'RushAndCash607540' 6-max Seat #1 is the button
Seat 1: 79df293 ($5.19 in chips)
Seat 2: cf593991 ($5.07 in chips)
Seat 3: 692417ff ($5 in chips)
Seat 4: Hero ($6.24 in chips)
Seat 5: b67f7812 ($7.58 in chips)
Seat 6: 868c7021 ($3.48 in chips)
cf593991: posts small blind $0.02
692417ff: posts big blind $0.05
*** HOLE CARDS ***
Dealt to 79df293 
Dealt to cf593991 
Dealt to 692417ff 
Dealt to Hero [8h Kd]
Dealt to b67f7812 
Dealt to 868c7021 
Hero: folds
b67f7812: folds
868c7021: folds
79df293: folds
cf593991: folds
Uncalled bet ($0.03) returned to 692417ff
*** SHOWDOWN ***
692417ff collected $0.04 from pot
*** SUMMARY ***
Total pot $0.04 | Rake $0 | Jackpot $0 | Bingo $0 | Fortune $0 | Tax $0
Seat 1: 79df293 (button) folded before Flop (didn't bet)
Seat 2: cf593991 (small blind) folded before Flop
Seat 3: 692417ff (big blind) collected ($0.04)
Seat 4: Hero folded before Flop (didn't bet)
Seat 5: b67f7812 folded before Flop (didn't bet)
Seat 6: 868c7021 folded before Flop (didn't bet)


Poker Hand #RC3334442261: Hold'em No Limit ($0.02/$0.05) - 2025/02/17 20:46:31
Table 'RushAndCash607521' 6-max Seat #1 is the button
Seat 1: bce71d0e ($4.93 in chips)
Seat 2: e8e95c39 ($7.62 in chips)
Seat 3: 6a231779 ($9.08 in chips)
Seat 4: 1a54a2fc ($5.33 in chips)
Seat 5: Hero ($6.24 in chips)
Seat 6: 16f2e5ce ($5.64 in chips)
e8e95c39: posts small blind $0.02
6a231779: posts big blind $0.05
*** HOLE CARDS ***
Dealt to bce71d0e 
Dealt to e8e95c39 
Dealt to 6a231779 
Dealt to 1a54a2fc 
Dealt to Hero [8s 3s]
Dealt to 16f2e5ce 
1a54a2fc: folds
Hero: folds
16f2e5ce: folds
bce71d0e: folds
e8e95c39: folds
Uncalled bet ($0.03) returned to 6a231779
*** SHOWDOWN ***
6a231779 collected $0.04 from pot
*** SUMMARY ***
Total pot $0.04 | Rake $0 | Jackpot $0 | Bingo $0 | Fortune $0 | Tax $0
Seat 1: bce71d0e (button) folded before Flop (didn't bet)
Seat 2: e8e95c39 (small blind) folded before Flop
Seat 3: 6a231779 (big blind) collected ($0.04)
Seat 4: 1a54a2fc folded before Flop (didn't bet)
Seat 5: Hero folded before Flop (didn't bet)
Seat 6: 16f2e5ce folded before Flop (didn't bet)


Poker Hand #RC3334442181: Hold'em No Limit ($0.02/$0.05) - 2025/02/17 20:46:17
Table 'RushAndCash607441' 6-max Seat #1 is the button
Seat 1: 1f06f573 ($5.02 in chips)
Seat 2: Hero ($6.26 in chips)
Seat 3: bf2195f6 ($4.99 in chips)
Seat 4: 491e0e63 ($5.95 in chips)
Seat 5: 4b3dba4 ($4.35 in chips)
Seat 6: 54fe77bd ($11.69 in chips)
Hero: posts small blind $0.02
bf2195f6: posts big blind $0.05
*** HOLE CARDS ***
Dealt to 1f06f573 
Dealt to Hero [Ks Tc]
Dealt to bf2195f6 
Dealt to 491e0e63 
Dealt to 4b3dba4 
Dealt to 54fe77bd 
491e0e63: folds
4b3dba4: folds
54fe77bd: folds
1f06f573: raises $0.08 to $0.13
Hero: folds
bf2195f6: folds
Uncalled bet ($0.08) returned to 1f06f573
*** SHOWDOWN ***
1f06f573 collected $0.12 from pot
*** SUMMARY ***
Total pot $0.12 | Rake $0 | Jackpot $0 | Bingo $0 | Fortune $0 | Tax $0
Seat 1: 1f06f573 (button) collected ($0.12)
Seat 2: Hero (small blind) folded before Flop
Seat 3: bf2195f6 (big blind) folded before Flop
Seat 4: 491e0e63 folded before Flop (didn't bet)
Seat 5: 4b3dba4 folded before Flop (didn't bet)
Seat 6: 54fe77bd folded before Flop (didn't bet)


Poker Hand #RC3334442159: Hold'em No Limit ($0.02/$0.05) - 2025/02/17 20:46:13
Table 'RushAndCash607419' 6-max Seat #1 is the button
Seat 1: 75091df4 ($8.57 in chips)
Seat 2: c1784884 ($9.54 in chips)
Seat 3: 16f2e5ce ($5.69 in chips)
Seat 4: Hero ($6.26 in chips)
Seat 5: 76135c78 ($5.12 in chips)
Seat 6: f45ac3d0 ($5.07 in chips)
c1784884: posts small blind $0.02
16f2e5ce: posts big blind $0.05
*** HOLE CARDS ***
Dealt to 75091df4 
Dealt to c1784884 
Dealt to 16f2e5ce 
Dealt to Hero [3d 5h]
Dealt to 76135c78 
Dealt to f45ac3d0 
Hero: folds
76135c78: folds
f45ac3d0: calls $0.05
75091df4: folds
c1784884: raises $0.08 to $0.13
16f2e5ce: folds
f45ac3d0: raises $0.37 to $0.5
c1784884: calls $0.37
*** FLOP *** [8h Qh 2c]
c1784884: checks
f45ac3d0: bets $0.05
c1784884: calls $0.05
*** TURN *** [8h Qh 2c] [4c]
c1784884: checks
f45ac3d0: bets $1.15
c1784884: folds
Uncalled bet ($1.15) returned to f45ac3d0
*** SHOWDOWN ***
f45ac3d0 collected $1.1 from pot
*** SUMMARY ***
Total pot $1.15 | Rake $0.05 | Jackpot $0 | Bingo $0 | Fortune $0 | Tax $0
Board [8h Qh 2c 4c]
Seat 1: 75091df4 (button) folded before Flop (didn't bet)
Seat 2: c1784884 (small blind) folded on the Turn
Seat 3: 16f2e5ce (big blind) folded before Flop
Seat 4: Hero folded before Flop (didn't bet)
Seat 5: 76135c78 folded before Flop (didn't bet)
Seat 6: f45ac3d0 won ($1.1)


Poker Hand #RC3334442136: Hold'em No Limit ($0.02/$0.05) - 2025/02/17 20:46:10
Table 'RushAndCash607396' 6-max Seat #1 is the button
Seat 1: c1784884 ($9.54 in chips)
Seat 2: 187f2194 ($11.32 in chips)
Seat 3: d58b99ca ($22.06 in chips)
Seat 4: Hero ($6.26 in chips)
Seat 5: cd1f87c8 ($8.27 in chips)
Seat 6: f45ac3d0 ($5.07 in chips)
187f2194: posts small blind $0.02
d58b99ca: posts big blind $0.05
*** HOLE CARDS ***
Dealt to c1784884 
Dealt to 187f2194 
Dealt to d58b99ca 
Dealt to Hero [8s 6c]
Dealt to cd1f87c8 
Dealt to f45ac3d0 
Hero: folds
cd1f87c8: raises $0.05 to $0.1
f45ac3d0: folds
c1784884: folds
187f2194: folds
d58b99ca: folds
Uncalled bet ($0.05) returned to cd1f87c8
*** SHOWDOWN ***
cd1f87c8 collected $0.12 from pot
*** SUMMARY ***
Total pot $0.12 | Rake $0 | Jackpot $0 | Bingo $0 | Fortune $0 | Tax $0
Seat 1: c1784884 (button) folded before Flop (didn't bet)
Seat 2: 187f2194 (small blind) folded before Flop
Seat 3: d58b99ca (big blind) folded before Flop
Seat 4: Hero folded before Flop (didn't bet)
Seat 5: cd1f87c8 collected ($0.12)
Seat 6: f45ac3d0 folded before Flop (didn't bet)


Poker Hand #RC3334442116: Hold'em No Limit ($0.02/$0.05) - 2025/02/17 20:46:07
Table 'RushAndCash607376' 6-max Seat #1 is the button
Seat 1: Hero ($6.26 in chips)
Seat 2: ded3640 ($5 in chips)
Seat 3: a2794999 ($8.32 in chips)
Seat 4: f2a32196 ($5 in chips)
Seat 5: c11c2441 ($5.07 in chips)
Seat 6: 1157f85d ($2.88 in chips)
ded3640: posts small blind $0.02
a2794999: posts big blind $0.05
*** HOLE CARDS ***
Dealt to Hero [3c 5h]
Dealt to ded3640 
Dealt to a2794999 
Dealt to f2a32196 
Dealt to c11c2441 
Dealt to 1157f85d 
f2a32196: folds
c11c2441: folds
1157f85d: raises $0.1 to $0.15
Hero: folds
ded3640: folds
a2794999: calls $0.1
*** FLOP *** [3h 5d 7h]
a2794999: checks
1157f85d: checks
*** TURN *** [3h 5d 7h] [Ad]
a2794999: checks
1157f85d: bets $0.24
a2794999: calls $0.24
*** RIVER *** [3h 5d 7h Ad] [Qh]
a2794999: checks
1157f85d: bets $0.27
a2794999: folds
Uncalled bet ($0.27) returned to 1157f85d
*** SHOWDOWN ***
1157f85d collected $0.76 from pot
*** SUMMARY ***
Total pot $0.8 | Rake $0.04 | Jackpot $0 | Bingo $0 | Fortune $0 | Tax $0
Board [3h 5d 7h Ad Qh]
Seat 1: Hero (button) folded before Flop (didn't bet)
Seat 2: ded3640 (small blind) folded before Flop
Seat 3: a2794999 (big blind) folded on the River
Seat 4: f2a32196 folded before Flop (didn't bet)
Seat 5: c11c2441 folded before Flop (didn't bet)
Seat 6: 1157f85d won ($0.76)


Poker Hand #RC3334442094: Hold'em No Limit ($0.02/$0.05) - 2025/02/17 20:46:04
Table 'RushAndCash607354' 6-max Seat #1 is the button
Seat 1: 191b60c1 ($13.1 in chips)
Seat 2: Hero ($6.28 in chips)
Seat 3: 9564515b ($10.01 in chips)
Seat 4: 6e885b98 ($5.17 in chips)
Seat 5: 5ef88743 ($5.57 in chips)
Seat 6: 6a231779 ($9.03 in chips)
Hero: posts small blind $0.02
9564515b: posts big blind $0.05
*** HOLE CARDS ***
Dealt to 191b60c1 
Dealt to Hero [9h Qd]
Dealt to 9564515b 
Dealt to 6e885b98 
Dealt to 5ef88743 
Dealt to 6a231779 
6e885b98: folds
5ef88743: folds
6a231779: raises $0.05 to $0.1
191b60c1: folds
Hero: folds
9564515b: folds
Uncalled bet ($0.05) returned to 6a231779
*** SHOWDOWN ***
6a231779 collected $0.12 from pot
*** SUMMARY ***
Total pot $0.12 | Rake $0 | Jackpot $0 | Bingo $0 | Fortune $0 | Tax $0
Seat 1: 191b60c1 (button) folded before Flop (didn't bet)
Seat 2: Hero (small blind) folded before Flop
Seat 3: 9564515b (big blind) folded before Flop
Seat 4: 6e885b98 folded before Flop (didn't bet)
Seat 5: 5ef88743 folded before Flop (didn't bet)
Seat 6: 6a231779 collected ($0.12)


Poker Hand #RC3334442075: Hold'em No Limit ($0.02/$0.05) - 2025/02/17 20:46:00
Table 'RushAndCash607335' 6-max Seat #1 is the button
Seat 1: eed867f5 ($5.05 in chips)
Seat 2: 3469fa26 ($5.61 in chips)
Seat 3: c7d7e6aa ($12.7 in chips)
Seat 4: 1e76a4d8 ($6.15 in chips)
Seat 5: 50053f22 ($5.1 in chips)
Seat 6: Hero ($6.21 in chips)
3469fa26: posts small blind $0.02
c7d7e6aa: posts big blind $0.05
*** HOLE CARDS ***
Dealt to eed867f5 
Dealt to 3469fa26 
Dealt to c7d7e6aa 
Dealt to 1e76a4d8 
Dealt to 50053f22 
Dealt to Hero [8h Kd]
1e76a4d8: folds
50053f22: folds
Hero: folds
eed867f5: folds
3469fa26: raises $0.05 to $0.1
c7d7e6aa: raises $0.2 to $0.3
3469fa26: calls $0.2
*** FLOP *** [Ad 4s 5h]
3469fa26: checks
c7d7e6aa: bets $0.2
3469fa26: calls $0.2
*** TURN *** [Ad 4s 5h] [Ac]
3469fa26: checks
c7d7e6aa: bets $0.75
3469fa26: calls $0.75
*** RIVER *** [Ad 4s 5h Ac] [Kc]
3469fa26: checks
c7d7e6aa: bets $11.45 and is all-in
3469fa26: calls $4.36 and is all-in
Uncalled bet ($7.09) returned to c7d7e6aa
c7d7e6aa: shows [5s As] (Aces Full over Fives)
3469fa26: shows [5c Jc] (Pair of Aces and Pair of Fives)
*** SHOWDOWN ***
c7d7e6aa collected $11 from pot
*** SUMMARY ***
Total pot $11.22 | Rake $0.15 | Jackpot $0.07 | Bingo $0 | Fortune $0 | Tax $0
Board [Ad 4s 5h Ac Kc]
Seat 1: eed867f5 (button) folded before Flop (didn't bet)
Seat 2: 3469fa26 (small blind) showed [5c Jc] and lost with Pair of Aces and Pair of Fives
Seat 3: c7d7e6aa (big blind) showed [5s As] and won ($11) with Aces Full over Fives
Seat 4: 1e76a4d8 folded before Flop (didn't bet)
Seat 5: 50053f22 folded before Flop (didn't bet)
Seat 6: Hero folded before Flop (didn't bet)


Poker Hand #RC3334442052: Hold'em No Limit ($0.02/$0.05) - 2025/02/17 20:45:57
Table 'RushAndCash607312' 6-max Seat #1 is the button
Seat 1: 45d33c76 ($8.59 in chips)
Seat 2: 18cb11a ($6.37 in chips)
Seat 3: Hero ($6.26 in chips)
Seat 4: 82656056 ($6.35 in chips)
Seat 5: f739af93 ($12.48 in chips)
Seat 6: e390e48e ($7.12 in chips)
18cb11a: posts small blind $0.02
Hero: posts big blind $0.05
*** HOLE CARDS ***
Dealt to 45d33c76 
Dealt to 18cb11a 
Dealt to Hero [Ks 6c]
Dealt to 82656056 
Dealt to f739af93 
Dealt to e390e48e 
82656056: folds
f739af93: raises $0.05 to $0.1
e390e48e: raises $0.21 to $0.31
45d33c76: folds
18cb11a: folds
Hero: folds
f739af93: calls $0.21
*** FLOP *** [6h 4s Qc]
f739af93: checks
e390e48e: bets $0.23
f739af93: folds
Uncalled bet ($0.23) returned to e390e48e
*** SHOWDOWN ***
e390e48e collected $0.66 from pot
*** SUMMARY ***
Total pot $0.69 | Rake $0.03 | Jackpot $0 | Bingo $0 | Fortune $0 | Tax $0
Board [6h 4s Qc]
Seat 1: 45d33c76 (button) folded before Flop (didn't bet)
Seat 2: 18cb11a (small blind) folded before Flop
Seat 3: Hero (big blind) folded before Flop
Seat 4: 82656056 folded before Flop (didn't bet)
Seat 5: f739af93 folded on the Flop
Seat 6: e390e48e won ($0.66)


Poker Hand #RC3334442022: Hold'em No Limit ($0.02/$0.05) - 2025/02/17 20:45:52
Table 'RushAndCash607282' 6-max Seat #1 is the button
Seat 1: Hero ($6.26 in chips)
Seat 2: 3b2a8270 ($5.18 in chips)
Seat 3: 9ccadbb5 ($13.27 in chips)
Seat 4: 85a41100 ($5.33 in chips)
Seat 5: dbb7a28 ($11.58 in chips)
Seat 6: 14d966a6 ($5.1 in chips)
3b2a8270: posts small blind $0.02
9ccadbb5: posts big blind $0.05
*** HOLE CARDS ***
Dealt to Hero [7h Kd]
Dealt to 3b2a8270 
Dealt to 9ccadbb5 
Dealt to 85a41100 
Dealt to dbb7a28 
Dealt to 14d966a6 
85a41100: folds
dbb7a28: folds
14d966a6: folds
Hero: folds
3b2a8270: raises $0.08 to $0.13
9ccadbb5: folds
Uncalled bet ($0.08) returned to 3b2a8270
*** SHOWDOWN ***
3b2a8270 collected $0.1 from pot
*** SUMMARY ***
Total pot $0.1 | Rake $0 | Jackpot $0 | Bingo $0 | Fortune $0 | Tax $0
Seat 1: Hero (button) folded before Flop (didn't bet)
Seat 2: 3b2a8270 (small blind) collected ($0.1)
Seat 3: 9ccadbb5 (big blind) folded before Flop
Seat 4: 85a41100 folded before Flop (didn't bet)
Seat 5: dbb7a28 folded before Flop (didn't bet)
Seat 6: 14d966a6 folded before Flop (didn't bet)


Poker Hand #RC3334441998: Hold'em No Limit ($0.02/$0.05) - 2025/02/17 20:45:49
Table 'RushAndCash607258' 6-max Seat #1 is the button
Seat 1: ada87216 ($7.98 in chips)
Seat 2: 14d966a6 ($5.12 in chips)
Seat 3: 656af102 ($6.59 in chips)
Seat 4: 5f1cdd27 ($5.15 in chips)
Seat 5: e3b51b04 ($7.75 in chips)
Seat 6: Hero ($6.26 in chips)
14d966a6: posts small blind $0.02
656af102: posts big blind $0.05
*** HOLE CARDS ***
Dealt to ada87216 
Dealt to 14d966a6 
Dealt to 656af102 
Dealt to 5f1cdd27 
Dealt to e3b51b04 
Dealt to Hero [5h 4s]
5f1cdd27: folds
e3b51b04: folds
Hero: folds
ada87216: raises $0.1 to $0.15
14d966a6: folds
656af102: folds
Uncalled bet ($0.1) returned to ada87216
*** SHOWDOWN ***
ada87216 collected $0.12 from pot
*** SUMMARY ***
Total pot $0.12 | Rake $0 | Jackpot $0 | Bingo $0 | Fortune $0 | Tax $0
Seat 1: ada87216 (button) collected ($0.12)
Seat 2: 14d966a6 (small blind) folded before Flop
Seat 3: 656af102 (big blind) folded before Flop
Seat 4: 5f1cdd27 folded before Flop (didn't bet)
Seat 5: e3b51b04 folded before Flop (didn't bet)
Seat 6: Hero folded before Flop (didn't bet)


Poker Hand #RC3334441967: Hold'em No Limit ($0.02/$0.05) - 2025/02/17 20:45:44
Table 'RushAndCash607227' 6-max Seat #1 is the button
Seat 1: 945593bf ($16.58 in chips)
Seat 2: 9013f95e ($12.03 in chips)
Seat 3: 9a69a3a0 ($6.96 in chips)
Seat 4: 73c2df1f ($15.65 in chips)
Seat 5: Hero ($6.26 in chips)
Seat 6: f0600331 ($5.07 in chips)
9013f95e: posts small blind $0.02
9a69a3a0: posts big blind $0.05
*** HOLE CARDS ***
Dealt to 945593bf 
Dealt to 9013f95e 
Dealt to 9a69a3a0 
Dealt to 73c2df1f 
Dealt to Hero [6d Td]
Dealt to f0600331 
73c2df1f: folds
Hero: folds
f0600331: folds
945593bf: raises $0.08 to $0.13
9013f95e: calls $0.11
9a69a3a0: folds
*** FLOP *** [Qs As 5s]
9013f95e: checks
945593bf: bets $0.11
9013f95e: calls $0.11
*** TURN *** [Qs As 5s] [6h]
9013f95e: checks
945593bf: checks
*** RIVER *** [Qs As 5s 6h] [2h]
9013f95e: bets $0.27
945593bf: folds
Uncalled bet ($0.27) returned to 9013f95e
*** SHOWDOWN ***
9013f95e collected $0.51 from pot
*** SUMMARY ***
Total pot $0.53 | Rake $0.02 | Jackpot $0 | Bingo $0 | Fortune $0 | Tax $0
Board [Qs As 5s 6h 2h]
Seat 1: 945593bf (button) folded on the River
Seat 2: 9013f95e (small blind) won ($0.51)
Seat 3: 9a69a3a0 (big blind) folded before Flop
Seat 4: 73c2df1f folded before Flop (didn't bet)
Seat 5: Hero folded before Flop (didn't bet)
Seat 6: f0600331 folded before Flop (didn't bet)


Poker Hand #RC3334441945: Hold'em No Limit ($0.02/$0.05) - 2025/02/17 20:45:41
Table 'RushAndCash607205' 6-max Seat #1 is the button
Seat 1: Hero ($6.26 in chips)
Seat 2: bfef046a ($17.77 in chips)
Seat 3: 3b2a8270 ($5.23 in chips)
Seat 4: e97b3270 ($5.29 in chips)
Seat 5: 85a41100 ($5.26 in chips)
Seat 6: e2e9e4d1 ($8.38 in chips)
bfef046a: posts small blind $0.02
3b2a8270: posts big blind $0.05
*** HOLE CARDS ***
Dealt to Hero [6s 3h]
Dealt to bfef046a 
Dealt to 3b2a8270 
Dealt to e97b3270 
Dealt to 85a41100 
Dealt to e2e9e4d1 
e97b3270: folds
85a41100: raises $0.08 to $0.13
e2e9e4d1: folds
Hero: folds
bfef046a: folds
3b2a8270: folds
Uncalled bet ($0.08) returned to 85a41100
*** SHOWDOWN ***
85a41100 collected $0.12 from pot
*** SUMMARY ***
Total pot $0.12 | Rake $0 | Jackpot $0 | Bingo $0 | Fortune $0 | Tax $0
Seat 1: Hero (button) folded before Flop (didn't bet)
Seat 2: bfef046a (small blind) folded before Flop
Seat 3: 3b2a8270 (big blind) folded before Flop
Seat 4: e97b3270 folded before Flop (didn't bet)
Seat 5: 85a41100 collected ($0.12)
Seat 6: e2e9e4d1 folded before Flop (didn't bet)


Poker Hand #RC3334441919: Hold'em No Limit ($0.02/$0.05) - 2025/02/17 20:45:37
Table 'RushAndCash607179' 6-max Seat #1 is the button
Seat 1: 6e885b98 ($5.19 in chips)
Seat 2: Hero ($6.28 in chips)
Seat 3: d201e5fe ($7.52 in chips)
Seat 4: e2e9e4d1 ($8.38 in chips)
Seat 5: 1ac52efc ($5 in chips)
Seat 6: fa40c39c ($3 in chips)
Hero: posts small blind $0.02
d201e5fe: posts big blind $0.05
*** HOLE CARDS ***
Dealt to 6e885b98 
Dealt to Hero [7c 8d]
Dealt to d201e5fe 
Dealt to e2e9e4d1 
Dealt to 1ac52efc 
Dealt to fa40c39c 
e2e9e4d1: folds
1ac52efc: folds
fa40c39c: folds
6e885b98: folds
Hero: folds
Uncalled bet ($0.03) returned to d201e5fe
*** SHOWDOWN ***
d201e5fe collected $0.04 from pot
*** SUMMARY ***
Total pot $0.04 | Rake $0 | Jackpot $0 | Bingo $0 | Fortune $0 | Tax $0
Seat 1: 6e885b98 (button) folded before Flop (didn't bet)
Seat 2: Hero (small blind) folded before Flop
Seat 3: d201e5fe (big blind) collected ($0.04)
Seat 4: e2e9e4d1 folded before Flop (didn't bet)
Seat 5: 1ac52efc folded before Flop (didn't bet)
Seat 6: fa40c39c folded before Flop (didn't bet)


Poker Hand #RC3334441898: Hold'em No Limit ($0.02/$0.05) - 2025/02/17 20:45:33
Table 'RushAndCash607158' 6-max Seat #1 is the button
Seat 1: cea9730b ($5.07 in chips)
Seat 2: 675a7b76 ($4.17 in chips)
Seat 3: 8e5db286 ($7.24 in chips)
Seat 4: Hero ($6.28 in chips)
Seat 5: ef7b5599 ($15.33 in chips)
Seat 6: 554a29a7 ($11.16 in chips)
675a7b76: posts small blind $0.02
8e5db286: posts big blind $0.05
*** HOLE CARDS ***
Dealt to cea9730b 
Dealt to 675a7b76 
Dealt to 8e5db286 
Dealt to Hero [Qh 4h]
Dealt to ef7b5599 
Dealt to 554a29a7 
Hero: folds
ef7b5599: folds
554a29a7: raises $0.05 to $0.1
cea9730b: calls $0.1
675a7b76: calls $0.08
8e5db286: folds
*** FLOP *** [6s Ks 7s]
675a7b76: checks
554a29a7: checks
cea9730b: checks
*** TURN *** [6s Ks 7s] [3c]
675a7b76: checks
554a29a7: checks
cea9730b: checks
*** RIVER *** [6s Ks 7s 3c] [9c]
675a7b76: checks
554a29a7: checks
cea9730b: checks
675a7b76: shows [Jd Td] (King-High)
554a29a7: shows [Jh Ah] (Ace-High)
cea9730b: shows [2c Ac] (Ace-High)
*** SHOWDOWN ***
554a29a7 collected $0.34 from pot
*** SUMMARY ***
Total pot $0.35 | Rake $0.01 | Jackpot $0 | Bingo $0 | Fortune $0 | Tax $0
Board [6s Ks 7s 3c 9c]
Seat 1: cea9730b (button) showed [2c Ac] and lost with Ace-High
Seat 2: 675a7b76 (small blind) showed [Jd Td] and lost with King-High
Seat 3: 8e5db286 (big blind) folded before Flop
Seat 4: Hero folded before Flop (didn't bet)
Seat 5: ef7b5599 folded before Flop (didn't bet)
Seat 6: 554a29a7 showed [Jh Ah] and won ($0.34) with Ace-High


Poker Hand #RC3334441823: Hold'em No Limit ($0.02/$0.05) - 2025/02/17 20:45:22
Table 'RushAndCash607083' 6-max Seat #1 is the button
Seat 1: d88bd80a ($5 in chips)
Seat 2: 7df4712d ($7.53 in chips)
Seat 3: Hero ($6.26 in chips)
Seat 4: f43eaf15 ($7.42 in chips)
Seat 5: 54ca1f06 ($6.12 in chips)
Seat 6: 7fe74cc5 ($5.05 in chips)
7df4712d: posts small blind $0.02
Hero: posts big blind $0.05
*** HOLE CARDS ***
Dealt to d88bd80a 
Dealt to 7df4712d 
Dealt to Hero [Qh Ac]
Dealt to f43eaf15 
Dealt to 54ca1f06 
Dealt to 7fe74cc5 
f43eaf15: folds
54ca1f06: folds
7fe74cc5: folds
d88bd80a: folds
7df4712d: folds
Uncalled bet ($0.03) returned to Hero
*** SHOWDOWN ***
Hero collected $0.04 from pot
*** SUMMARY ***
Total pot $0.04 | Rake $0 | Jackpot $0 | Bingo $0 | Fortune $0 | Tax $0
Seat 1: d88bd80a (button) folded before Flop (didn't bet)
Seat 2: 7df4712d (small blind) folded before Flop
Seat 3: Hero (big blind) collected ($0.04)
Seat 4: f43eaf15 folded before Flop (didn't bet)
Seat 5: 54ca1f06 folded before Flop (didn't bet)
Seat 6: 7fe74cc5 folded before Flop (didn't bet)


Poker Hand #RC3334441801: Hold'em No Limit ($0.02/$0.05) - 2025/02/17 20:45:19
Table 'RushAndCash607061' 6-max Seat #1 is the button
Seat 1: 15125d65 ($11.2 in chips)
Seat 2: Hero ($6.28 in chips)
Seat 3: 7b1c045a ($4.4 in chips)
Seat 4: 6f8bb9d1 ($5.31 in chips)
Seat 5: a63aa4b7 ($5.46 in chips)
Seat 6: ef7b5599 ($15.35 in chips)
Hero: posts small blind $0.02
7b1c045a: posts big blind $0.05
*** HOLE CARDS ***
Dealt to 15125d65 
Dealt to Hero [9s 2c]
Dealt to 7b1c045a 
Dealt to 6f8bb9d1 
Dealt to a63aa4b7 
Dealt to ef7b5599 
6f8bb9d1: folds
a63aa4b7: folds
ef7b5599: folds
15125d65: folds
Hero: folds
Uncalled bet ($0.03) returned to 7b1c045a
*** SHOWDOWN ***
7b1c045a collected $0.04 from pot
*** SUMMARY ***
Total pot $0.04 | Rake $0 | Jackpot $0 | Bingo $0 | Fortune $0 | Tax $0
Seat 1: 15125d65 (button) folded before Flop (didn't bet)
Seat 2: Hero (small blind) folded before Flop
Seat 3: 7b1c045a (big blind) collected ($0.04)
Seat 4: 6f8bb9d1 folded before Flop (didn't bet)
Seat 5: a63aa4b7 folded before Flop (didn't bet)
Seat 6: ef7b5599 folded before Flop (didn't bet)


Poker Hand #RC3334441779: Hold'em No Limit ($0.02/$0.05) - 2025/02/17 20:45:15
Table 'RushAndCash607039' 6-max Seat #1 is the button
Seat 1: 8dbd0a2d ($9.45 in chips)
Seat 2: 9604af2 ($5.49 in chips)
Seat 3: e8e95c39 ($7.57 in chips)
Seat 4: ee3fdfd8 ($6.31 in chips)
Seat 5: Hero ($6.28 in chips)
Seat 6: d1cd1071 ($14.47 in chips)
9604af2: posts small blind $0.02
e8e95c39: posts big blind $0.05
*** HOLE CARDS ***
Dealt to 8dbd0a2d 
Dealt to 9604af2 
Dealt to e8e95c39 
Dealt to ee3fdfd8 
Dealt to Hero [6c 3h]
Dealt to d1cd1071 
ee3fdfd8: folds
Hero: folds
d1cd1071: folds
8dbd0a2d: folds
9604af2: raises $0.08 to $0.13
e8e95c39: raises $0.26 to $0.39
9604af2: folds
Uncalled bet ($0.26) returned to e8e95c39
*** SHOWDOWN ***
e8e95c39 collected $0.25 from pot
*** SUMMARY ***
Total pot $0.26 | Rake $0.01 | Jackpot $0 | Bingo $0 | Fortune $0 | Tax $0
Seat 1: 8dbd0a2d (button) folded before Flop (didn't bet)
Seat 2: 9604af2 (small blind) folded before Flop
Seat 3: e8e95c39 (big blind) collected ($0.25)
Seat 4: ee3fdfd8 folded before Flop (didn't bet)
Seat 5: Hero folded before Flop (didn't bet)
Seat 6: d1cd1071 folded before Flop (didn't bet)


Poker Hand #RC3334441754: Hold'em No Limit ($0.02/$0.05) - 2025/02/17 20:45:12
Table 'RushAndCash607014' 6-max Seat #1 is the button
Seat 1: Hero ($6.28 in chips)
Seat 2: 29ffb7d5 ($5.69 in chips)
Seat 3: 5197516b ($5.4 in chips)
Seat 4: 1a54a2fc ($5 in chips)
Seat 5: c7e9103c ($20.16 in chips)
Seat 6: 651cc52f ($2.55 in chips)
29ffb7d5: posts small blind $0.02
5197516b: posts big blind $0.05
*** HOLE CARDS ***
Dealt to Hero [3s Ts]
Dealt to 29ffb7d5 
Dealt to 5197516b 
Dealt to 1a54a2fc 
Dealt to c7e9103c 
Dealt to 651cc52f 
1a54a2fc: raises $0.08 to $0.13
c7e9103c: folds
651cc52f: folds
Hero: folds
29ffb7d5: folds
5197516b: folds
Uncalled bet ($0.08) returned to 1a54a2fc
*** SHOWDOWN ***
1a54a2fc collected $0.12 from pot
*** SUMMARY ***
Total pot $0.12 | Rake $0 | Jackpot $0 | Bingo $0 | Fortune $0 | Tax $0
Seat 1: Hero (button) folded before Flop (didn't bet)
Seat 2: 29ffb7d5 (small blind) folded before Flop
Seat 3: 5197516b (big blind) folded before Flop
Seat 4: 1a54a2fc collected ($0.12)
Seat 5: c7e9103c folded before Flop (didn't bet)
Seat 6: 651cc52f folded before Flop (didn't bet)


Poker Hand #RC3334441731: Hold'em No Limit ($0.02/$0.05) - 2025/02/17 20:45:08
Table 'RushAndCash606991' 6-max Seat #1 is the button
Seat 1: 14d966a6 ($5.27 in chips)
Seat 2: 93735ac4 ($3.49 in chips)
Seat 3: Hero ($6.33 in chips)
Seat 4: 651cc52f ($2.55 in chips)
Seat 5: 72fa4c0f ($3.57 in chips)
Seat 6: dc9e794c ($5.05 in chips)
93735ac4: posts small blind $0.02
Hero: posts big blind $0.05
*** HOLE CARDS ***
Dealt to 14d966a6 
Dealt to 93735ac4 
Dealt to Hero [6c As]
Dealt to 651cc52f 
Dealt to 72fa4c0f 
Dealt to dc9e794c 
651cc52f: folds
72fa4c0f: folds
dc9e794c: folds
14d966a6: folds
93735ac4: folds
Uncalled bet ($0.03) returned to Hero
*** SHOWDOWN ***
Hero collected $0.04 from pot
*** SUMMARY ***
Total pot $0.04 | Rake $0 | Jackpot $0 | Bingo $0 | Fortune $0 | Tax $0
Seat 1: 14d966a6 (button) folded before Flop (didn't bet)
Seat 2: 93735ac4 (small blind) folded before Flop
Seat 3: Hero (big blind) collected ($0.04)
Seat 4: 651cc52f folded before Flop (didn't bet)
Seat 5: 72fa4c0f folded before Flop (didn't bet)
Seat 6: dc9e794c folded before Flop (didn't bet)


Poker Hand #RC3334441691: Hold'em No Limit ($0.02/$0.05) - 2025/02/17 20:45:03
Table 'RushAndCash606951' 6-max Seat #1 is the button
Seat 1: 77936ad9 ($6.75 in chips)
Seat 2: 842d7655 ($5.45 in chips)
Seat 3: 6571f81e ($4.82 in chips)
Seat 4: b67f7812 ($7.48 in chips)
Seat 5: Hero ($6.33 in chips)
Seat 6: 187f2194 ($11.54 in chips)
842d7655: posts small blind $0.02
6571f81e: posts big blind $0.05
*** HOLE CARDS ***
Dealt to 77936ad9 
Dealt to 842d7655 
Dealt to 6571f81e 
Dealt to b67f7812 
Dealt to Hero [Qc 2c]
Dealt to 187f2194 
b67f7812: folds
Hero: folds
187f2194: folds
77936ad9: raises $0.05 to $0.1
842d7655: raises $0.35 to $0.45
6571f81e: folds
77936ad9: calls $0.35
*** FLOP *** [5d 7c 7s]
842d7655: bets $0.32
77936ad9: raises $0.52 to $0.84
842d7655: raises $1.56 to $2.4
77936ad9: folds
Uncalled bet ($1.56) returned to 842d7655
*** SHOWDOWN ***
842d7655 collected $2.44 from pot
*** SUMMARY ***
Total pot $2.63 | Rake $0.12 | Jackpot $0.07 | Bingo $0 | Fortune $0 | Tax $0
Board [5d 7c 7s]
Seat 1: 77936ad9 (button) folded on the Flop
Seat 2: 842d7655 (small blind) won ($2.44)
Seat 3: 6571f81e (big blind) folded before Flop
Seat 4: b67f7812 folded before Flop (didn't bet)
Seat 5: Hero folded before Flop (didn't bet)
Seat 6: 187f2194 folded before Flop (didn't bet)


Poker Hand #RC3334441665: Hold'em No Limit ($0.02/$0.05) - 2025/02/17 20:45:00
Table 'RushAndCash606925' 6-max Seat #1 is the button
Seat 1: fdbac393 ($5.77 in chips)
Seat 2: 1754e33c ($5.3 in chips)
Seat 3: 2eb4439f ($11.49 in chips)
Seat 4: 100d4f9e ($6.2 in chips)
Seat 5: d88bd80a ($5 in chips)
Seat 6: Hero ($6.33 in chips)
1754e33c: posts small blind $0.02
2eb4439f: posts big blind $0.05
*** HOLE CARDS ***
Dealt to fdbac393 
Dealt to 1754e33c 
Dealt to 2eb4439f 
Dealt to 100d4f9e 
Dealt to d88bd80a 
Dealt to Hero [4c 4h]
100d4f9e: folds
d88bd80a: folds
Hero: folds
fdbac393: folds
1754e33c: folds
Uncalled bet ($0.03) returned to 2eb4439f
*** SHOWDOWN ***
2eb4439f collected $0.04 from pot
*** SUMMARY ***
Total pot $0.04 | Rake $0 | Jackpot $0 | Bingo $0 | Fortune $0 | Tax $0
Seat 1: fdbac393 (button) folded before Flop (didn't bet)
Seat 2: 1754e33c (small blind) folded before Flop
Seat 3: 2eb4439f (big blind) collected ($0.04)
Seat 4: 100d4f9e folded before Flop (didn't bet)
Seat 5: d88bd80a folded before Flop (didn't bet)
Seat 6: Hero folded before Flop (didn't bet)


Poker Hand #RC3334441643: Hold'em No Limit ($0.02/$0.05) - 2025/02/17 20:44:56
Table 'RushAndCash606903' 6-max Seat #1 is the button
Seat 1: 85a41100 ($5 in chips)
Seat 2: 65964033 ($5.07 in chips)
Seat 3: fa10c7e2 ($5.39 in chips)
Seat 4: Hero ($6.33 in chips)
Seat 5: b6df9c9 ($5.05 in chips)
Seat 6: 35fb946f ($5.57 in chips)
65964033: posts small blind $0.02
fa10c7e2: posts big blind $0.05
*** HOLE CARDS ***
Dealt to 85a41100 
Dealt to 65964033 
Dealt to fa10c7e2 
Dealt to Hero [3s 8h]
Dealt to b6df9c9 
Dealt to 35fb946f 
Hero: folds
b6df9c9: folds
35fb946f: folds
85a41100: raises $0.08 to $0.13
65964033: folds
fa10c7e2: calls $0.08
*** FLOP *** [8c 4h Qd]
fa10c7e2: bets $0.05
85a41100: raises $0.57 to $0.62
fa10c7e2: folds
Uncalled bet ($0.57) returned to 85a41100
*** SHOWDOWN ***
85a41100 collected $0.37 from pot
*** SUMMARY ***
Total pot $0.38 | Rake $0.01 | Jackpot $0 | Bingo $0 | Fortune $0 | Tax $0
Board [8c 4h Qd]
Seat 1: 85a41100 (button) won ($0.37)
Seat 2: 65964033 (small blind) folded before Flop
Seat 3: fa10c7e2 (big blind) folded on the Flop
Seat 4: Hero folded before Flop (didn't bet)
Seat 5: b6df9c9 folded before Flop (didn't bet)
Seat 6: 35fb946f folded before Flop (didn't bet)


Poker Hand #RC3334441621: Hold'em No Limit ($0.02/$0.05) - 2025/02/17 20:44:53
Table 'RushAndCash606881' 6-max Seat #1 is the button
Seat 1: f18b40b7 ($5.16 in chips)
Seat 2: 151b0c91 ($5.02 in chips)
Seat 3: Hero ($6.38 in chips)
Seat 4: cbfd6c92 ($5.35 in chips)
Seat 5: a2794999 ($8.48 in chips)
Seat 6: 651cc52f ($2.6 in chips)
151b0c91: posts small blind $0.02
Hero: posts big blind $0.05
*** HOLE CARDS ***
Dealt to f18b40b7 
Dealt to 151b0c91 
Dealt to Hero [3s 7c]
Dealt to cbfd6c92 
Dealt to a2794999 
Dealt to 651cc52f 
cbfd6c92: raises $0.05 to $0.1
a2794999: folds
651cc52f: folds
f18b40b7: folds
151b0c91: folds
Hero: folds
Uncalled bet ($0.05) returned to cbfd6c92
*** SHOWDOWN ***
cbfd6c92 collected $0.12 from pot
*** SUMMARY ***
Total pot $0.12 | Rake $0 | Jackpot $0 | Bingo $0 | Fortune $0 | Tax $0
Seat 1: f18b40b7 (button) folded before Flop (didn't bet)
Seat 2: 151b0c91 (small blind) folded before Flop
Seat 3: Hero (big blind) folded before Flop
Seat 4: cbfd6c92 collected ($0.12)
Seat 5: a2794999 folded before Flop (didn't bet)
Seat 6: 651cc52f folded before Flop (didn't bet)


Poker Hand #RC3334441549: Hold'em No Limit ($0.02/$0.05) - 2025/02/17 20:44:42
Table 'RushAndCash606809' 6-max Seat #1 is the button
Seat 1: 99af2b58 ($13.45 in chips)
Seat 2: 6da96b4d ($6.5 in chips)
Seat 3: 6a231779 ($9.64 in chips)
Seat 4: Hero ($6.31 in chips)
Seat 5: 95096c6a ($5 in chips)
Seat 6: 651cc52f ($2.62 in chips)
6da96b4d: posts small blind $0.02
6a231779: posts big blind $0.05
*** HOLE CARDS ***
Dealt to 99af2b58 
Dealt to 6da96b4d 
Dealt to 6a231779 
Dealt to Hero [Ah Th]
Dealt to 95096c6a 
Dealt to 651cc52f 
Hero: raises $0.05 to $0.1
95096c6a: folds
651cc52f: folds
99af2b58: folds
6da96b4d: folds
6a231779: folds
Uncalled bet ($0.05) returned to Hero
*** SHOWDOWN ***
Hero collected $0.12 from pot
*** SUMMARY ***
Total pot $0.12 | Rake $0 | Jackpot $0 | Bingo $0 | Fortune $0 | Tax $0
Seat 1: 99af2b58 (button) folded before Flop (didn't bet)
Seat 2: 6da96b4d (small blind) folded before Flop
Seat 3: 6a231779 (big blind) folded before Flop
Seat 4: Hero collected ($0.12)
Seat 5: 95096c6a folded before Flop (didn't bet)
Seat 6: 651cc52f folded before Flop (didn't bet)


Poker Hand #RC3334441530: Hold'em No Limit ($0.02/$0.05) - 2025/02/17 20:44:40
Table 'RushAndCash606790' 6-max Seat #1 is the button
Seat 1: Hero ($6.31 in chips)
Seat 2: da41ab59 ($8.15 in chips)
Seat 3: 9ad74e07 ($5 in chips)
Seat 4: d0df8653 ($5.15 in chips)
Seat 5: 23c0dcf ($5.29 in chips)
Seat 6: c85a0f60 ($11.62 in chips)
da41ab59: posts small blind $0.02
9ad74e07: posts big blind $0.05
*** HOLE CARDS ***
Dealt to Hero [6h 2s]
Dealt to da41ab59 
Dealt to 9ad74e07 
Dealt to d0df8653 
Dealt to 23c0dcf 
Dealt to c85a0f60 
d0df8653: raises $0.05 to $0.1
23c0dcf: folds
c85a0f60: folds
Hero: folds
da41ab59: folds
9ad74e07: folds
Uncalled bet ($0.05) returned to d0df8653
*** SHOWDOWN ***
d0df8653 collected $0.12 from pot
*** SUMMARY ***
Total pot $0.12 | Rake $0 | Jackpot $0 | Bingo $0 | Fortune $0 | Tax $0
Seat 1: Hero (button) folded before Flop (didn't bet)
Seat 2: da41ab59 (small blind) folded before Flop
Seat 3: 9ad74e07 (big blind) folded before Flop
Seat 4: d0df8653 collected ($0.12)
Seat 5: 23c0dcf folded before Flop (didn't bet)
Seat 6: c85a0f60 folded before Flop (didn't bet)


Poker Hand #RC3334441492: Hold'em No Limit ($0.02/$0.05) - 2025/02/17 20:44:34
Table 'RushAndCash606752' 6-max Seat #1 is the button
Seat 1: 63499226 ($3.25 in chips)
Seat 2: Hero ($6.33 in chips)
Seat 3: 32d40ce0 ($5 in chips)
Seat 4: 41720de0 ($19.71 in chips)
Seat 5: 9eb2937a ($5.81 in chips)
Seat 6: f4cb4fd0 ($5.18 in chips)
Hero: posts small blind $0.02
32d40ce0: posts big blind $0.05
*** HOLE CARDS ***
Dealt to 63499226 
Dealt to Hero [Tc 3d]
Dealt to 32d40ce0 
Dealt to 41720de0 
Dealt to 9eb2937a 
Dealt to f4cb4fd0 
41720de0: folds
9eb2937a: folds
f4cb4fd0: folds
63499226: folds
Hero: folds
Uncalled bet ($0.03) returned to 32d40ce0
*** SHOWDOWN ***
32d40ce0 collected $0.04 from pot
*** SUMMARY ***
Total pot $0.04 | Rake $0 | Jackpot $0 | Bingo $0 | Fortune $0 | Tax $0
Seat 1: 63499226 (button) folded before Flop (didn't bet)
Seat 2: Hero (small blind) folded before Flop
Seat 3: 32d40ce0 (big blind) collected ($0.04)
Seat 4: 41720de0 folded before Flop (didn't bet)
Seat 5: 9eb2937a folded before Flop (didn't bet)
Seat 6: f4cb4fd0 folded before Flop (didn't bet)


Poker Hand #RC3334441468: Hold'em No Limit ($0.02/$0.05) - 2025/02/17 20:44:31
Table 'RushAndCash606728' 6-max Seat #1 is the button
Seat 1: 9264a873 ($5.18 in chips)
Seat 2: cf593991 ($5 in chips)
Seat 3: b282789b ($5 in chips)
Seat 4: 8b76c8c6 ($5.15 in chips)
Seat 5: Hero ($6.33 in chips)
Seat 6: 1b6c31ec ($5.9 in chips)
cf593991: posts small blind $0.02
b282789b: posts big blind $0.05
*** HOLE CARDS ***
Dealt to 9264a873 
Dealt to cf593991 
Dealt to b282789b 
Dealt to 8b76c8c6 
Dealt to Hero [6s Qs]
Dealt to 1b6c31ec 
8b76c8c6: folds
Hero: folds
1b6c31ec: folds
9264a873: folds
cf593991: folds
Uncalled bet ($0.03) returned to b282789b
*** SHOWDOWN ***
b282789b collected $0.04 from pot
*** SUMMARY ***
Total pot $0.04 | Rake $0 | Jackpot $0 | Bingo $0 | Fortune $0 | Tax $0
Seat 1: 9264a873 (button) folded before Flop (didn't bet)
Seat 2: cf593991 (small blind) folded before Flop
Seat 3: b282789b (big blind) collected ($0.04)
Seat 4: 8b76c8c6 folded before Flop (didn't bet)
Seat 5: Hero folded before Flop (didn't bet)
Seat 6: 1b6c31ec folded before Flop (didn't bet)


Poker Hand #RC3334441081: Hold'em No Limit ($0.02/$0.05) - 2025/02/17 20:43:39
Table 'RushAndCash606341' 6-max Seat #1 is the button
Seat 1: fa10c7e2 ($5 in chips)
Seat 2: bfef046a ($17.7 in chips)
Seat 3: 6c8cb957 ($5.07 in chips)
Seat 4: f20f94d9 ($5 in chips)
Seat 5: Hero ($5.87 in chips)
Seat 6: 28d3343b ($6.59 in chips)
bfef046a: posts small blind $0.02
6c8cb957: posts big blind $0.05
*** HOLE CARDS ***
Dealt to fa10c7e2 
Dealt to bfef046a 
Dealt to 6c8cb957 
Dealt to f20f94d9 
Dealt to Hero [Jh Th]
Dealt to 28d3343b 
f20f94d9: raises $0.05 to $0.1
Hero: calls $0.1
28d3343b: folds
fa10c7e2: folds
bfef046a: folds
6c8cb957: folds
*** FLOP *** [4s Kd 9s]
f20f94d9: bets $0.14
Hero: calls $0.14
*** TURN *** [4s Kd 9s] [2s]
f20f94d9: checks
Hero: checks
*** RIVER *** [4s Kd 9s 2s] [Qd]
f20f94d9: bets $0.19
Hero: calls $0.19
f20f94d9: shows [Qc Jd] (Pair of Queens)
Hero: shows [Jh Th] (Kings-High Straight)
*** SHOWDOWN ***
Hero collected $0.89 from pot
*** SUMMARY ***
Total pot $0.93 | Rake $0.04 | Jackpot $0 | Bingo $0 | Fortune $0 | Tax $0
Board [4s Kd 9s 2s Qd]
Seat 1: fa10c7e2 (button) folded before Flop (didn't bet)
Seat 2: bfef046a (small blind) folded before Flop
Seat 3: 6c8cb957 (big blind) folded before Flop
Seat 4: f20f94d9 showed [Qc Jd] and lost with Pair of Queens
Seat 5: Hero showed [Jh Th] and won ($0.89) with Kings-High Straight
Seat 6: 28d3343b folded before Flop (didn't bet)


Poker Hand #RC3334441058: Hold'em No Limit ($0.02/$0.05) - 2025/02/17 20:43:36
Table 'RushAndCash606318' 6-max Seat #1 is the button
Seat 1: f71f9fc0 ($4.53 in chips)
Seat 2: 4ea8e2e ($15.1 in chips)
Seat 3: 194ee370 ($6.55 in chips)
Seat 4: 5abd227b ($5.42 in chips)
Seat 5: Hero ($5.87 in chips)
Seat 6: 84b68722 ($19.16 in chips)
4ea8e2e: posts small blind $0.02
194ee370: posts big blind $0.05
*** HOLE CARDS ***
Dealt to f71f9fc0 
Dealt to 4ea8e2e 
Dealt to 194ee370 
Dealt to 5abd227b 
Dealt to Hero [7h 6s]
Dealt to 84b68722 
5abd227b: folds
Hero: folds
84b68722: raises $0.06 to $0.11
f71f9fc0: folds
4ea8e2e: folds
194ee370: calls $0.06
*** FLOP *** [9s 4c 7c]
194ee370: checks
84b68722: checks
*** TURN *** [9s 4c 7c] [6d]
194ee370: bets $0.12
84b68722: calls $0.12
*** RIVER *** [9s 4c 7c 6d] [2s]
194ee370: bets $0.24
84b68722: folds
Uncalled bet ($0.24) returned to 194ee370
*** SHOWDOWN ***
194ee370 collected $0.46 from pot
*** SUMMARY ***
Total pot $0.48 | Rake $0.02 | Jackpot $0 | Bingo $0 | Fortune $0 | Tax $0
Board [9s 4c 7c 6d 2s]
Seat 1: f71f9fc0 (button) folded before Flop (didn't bet)
Seat 2: 4ea8e2e (small blind) folded before Flop
Seat 3: 194ee370 (big blind) won ($0.46)
Seat 4: 5abd227b folded before Flop (didn't bet)
Seat 5: Hero folded before Flop (didn't bet)
Seat 6: 84b68722 folded on the River


Poker Hand #RC3334441036: Hold'em No Limit ($0.02/$0.05) - 2025/02/17 20:43:33
Table 'RushAndCash606296' 6-max Seat #1 is the button
Seat 1: ea7a7ae0 ($7.68 in chips)
Seat 2: 21bff972 ($5.07 in chips)
Seat 3: 6be17d4e ($5.87 in chips)
Seat 4: Hero ($5.87 in chips)
Seat 5: 83cc7f46 ($2 in chips)
Seat 6: f2a32196 ($5 in chips)
21bff972: posts small blind $0.02
6be17d4e: posts big blind $0.05
*** HOLE CARDS ***
Dealt to ea7a7ae0 
Dealt to 21bff972 
Dealt to 6be17d4e 
Dealt to Hero [5s 9h]
Dealt to 83cc7f46 
Dealt to f2a32196 
Hero: folds
83cc7f46: raises $0.1 to $0.15
f2a32196: folds
ea7a7ae0: folds
21bff972: folds
6be17d4e: calls $0.1
*** FLOP *** [8d 8c Ts]
6be17d4e: checks
83cc7f46: bets $0.11
6be17d4e: calls $0.11
*** TURN *** [8d 8c Ts] [7c]
6be17d4e: checks
83cc7f46: bets $0.18
6be17d4e: calls $0.18
*** RIVER *** [8d 8c Ts 7c] [Qs]
6be17d4e: checks
83cc7f46: checks
6be17d4e: shows [9c 9d] (Pair of Nines and Pair of Eights)
83cc7f46: shows [Tc Js] (Pair of Tens and Pair of Eights)
*** SHOWDOWN ***
83cc7f46 collected $0.85 from pot
*** SUMMARY ***
Total pot $0.9 | Rake $0.05 | Jackpot $0 | Bingo $0 | Fortune $0 | Tax $0
Board [8d 8c Ts 7c Qs]
Seat 1: ea7a7ae0 (button) folded before Flop (didn't bet)
Seat 2: 21bff972 (small blind) folded before Flop
Seat 3: 6be17d4e (big blind) showed [9c 9d] and lost with Pair of Nines and Pair of Eights
Seat 4: Hero folded before Flop (didn't bet)
Seat 5: 83cc7f46 showed [Tc Js] and won ($0.85) with Pair of Tens and Pair of Eights
Seat 6: f2a32196 folded before Flop (didn't bet)


Poker Hand #RC3334440899: Hold'em No Limit ($0.02/$0.05) - 2025/02/17 20:43:16
Table 'RushAndCash606159' 6-max Seat #1 is the button
Seat 1: c24b20b9 ($18.75 in chips)
Seat 2: Hero ($5.82 in chips)
Seat 3: d51a15ca ($6.37 in chips)
Seat 4: 9dd1ff39 ($7.01 in chips)
Seat 5: b144f063 ($12.75 in chips)
Seat 6: e2777133 ($8.88 in chips)
Hero: posts small blind $0.02
d51a15ca: posts big blind $0.05
*** HOLE CARDS ***
Dealt to c24b20b9 
Dealt to Hero [Qd Ah]
Dealt to d51a15ca 
Dealt to 9dd1ff39 
Dealt to b144f063 
Dealt to e2777133 
9dd1ff39: folds
b144f063: raises $0.05 to $0.1
e2777133: folds
c24b20b9: raises $0.25 to $0.35
Hero: folds
d51a15ca: folds
b144f063: folds
Uncalled bet ($0.25) returned to c24b20b9
*** SHOWDOWN ***
c24b20b9 collected $0.26 from pot
*** SUMMARY ***
Total pot $0.27 | Rake $0.01 | Jackpot $0 | Bingo $0 | Fortune $0 | Tax $0
Seat 1: c24b20b9 (button) collected ($0.26)
Seat 2: Hero (small blind) folded before Flop
Seat 3: d51a15ca (big blind) folded before Flop
Seat 4: 9dd1ff39 folded before Flop (didn't bet)
Seat 5: b144f063 folded before Flop
Seat 6: e2777133 folded before Flop (didn't bet)


Poker Hand #RC3334440873: Hold'em No Limit ($0.02/$0.05) - 2025/02/17 20:43:12
Table 'RushAndCash606133' 6-max Seat #1 is the button
Seat 1: f8db84a ($5.94 in chips)
Seat 2: da25c79c ($5.7 in chips)
Seat 3: Hero ($5.87 in chips)
Seat 4: c8e834fc ($8.99 in chips)
Seat 5: f1821143 ($5.36 in chips)
Seat 6: 1157f85d ($5.47 in chips)
da25c79c: posts small blind $0.02
Hero: posts big blind $0.05
*** HOLE CARDS ***
Dealt to f8db84a 
Dealt to da25c79c 
Dealt to Hero [2h Th]
Dealt to c8e834fc 
Dealt to f1821143 
Dealt to 1157f85d 
c8e834fc: folds
f1821143: folds
1157f85d: folds
f8db84a: folds
da25c79c: folds
Uncalled bet ($0.03) returned to Hero
*** SHOWDOWN ***
Hero collected $0.04 from pot
*** SUMMARY ***
Total pot $0.04 | Rake $0 | Jackpot $0 | Bingo $0 | Fortune $0 | Tax $0
Seat 1: f8db84a (button) folded before Flop (didn't bet)
Seat 2: da25c79c (small blind) folded before Flop
Seat 3: Hero (big blind) collected ($0.04)
Seat 4: c8e834fc folded before Flop (didn't bet)
Seat 5: f1821143 folded before Flop (didn't bet)
Seat 6: 1157f85d folded before Flop (didn't bet)


Poker Hand #RC3334440850: Hold'em No Limit ($0.02/$0.05) - 2025/02/17 20:43:09
Table 'RushAndCash606110' 6-max Seat #1 is the button
Seat 1: Hero ($5.87 in chips)
Seat 2: 5466aa49 ($6.84 in chips)
Seat 3: f23e7bad ($8.9 in chips)
Seat 4: 5f1cdd27 ($5 in chips)
Seat 5: cf6b193c ($5.25 in chips)
Seat 6: c8e834fc ($8.99 in chips)
5466aa49: posts small blind $0.02
f23e7bad: posts big blind $0.05
*** HOLE CARDS ***
Dealt to Hero [3d 9d]
Dealt to 5466aa49 
Dealt to f23e7bad 
Dealt to 5f1cdd27 
Dealt to cf6b193c 
Dealt to c8e834fc 
5f1cdd27: folds
cf6b193c: folds
c8e834fc: folds
Hero: folds
5466aa49: folds
Uncalled bet ($0.03) returned to f23e7bad
*** SHOWDOWN ***
f23e7bad collected $0.04 from pot
*** SUMMARY ***
Total pot $0.04 | Rake $0 | Jackpot $0 | Bingo $0 | Fortune $0 | Tax $0
Seat 1: Hero (button) folded before Flop (didn't bet)
Seat 2: 5466aa49 (small blind) folded before Flop
Seat 3: f23e7bad (big blind) collected ($0.04)
Seat 4: 5f1cdd27 folded before Flop (didn't bet)
Seat 5: cf6b193c folded before Flop (didn't bet)
Seat 6: c8e834fc folded before Flop (didn't bet)


Poker Hand #RC3334440794: Hold'em No Limit ($0.02/$0.05) - 2025/02/17 20:43:02
Table 'RushAndCash606054' 6-max Seat #1 is the button
Seat 1: d201e5fe ($7.36 in chips)
Seat 2: Hero ($5.89 in chips)
Seat 3: 64e5de41 ($5.19 in chips)
Seat 4: d1cd1071 ($14.63 in chips)
Seat 5: e6ee1d7f ($7.95 in chips)
Seat 6: 84667b37 ($4.72 in chips)
Hero: posts small blind $0.02
64e5de41: posts big blind $0.05
*** HOLE CARDS ***
Dealt to d201e5fe 
Dealt to Hero [3h 2h]
Dealt to 64e5de41 
Dealt to d1cd1071 
Dealt to e6ee1d7f 
Dealt to 84667b37 
d1cd1071: raises $0.06 to $0.11
e6ee1d7f: folds
84667b37: folds
d201e5fe: folds
Hero: folds
64e5de41: calls $0.06
*** FLOP *** [Ks 5h 7c]
64e5de41: checks
d1cd1071: bets $0.09
64e5de41: calls $0.09
*** TURN *** [Ks 5h 7c] [8d]
64e5de41: checks
d1cd1071: checks
*** RIVER *** [Ks 5h 7c 8d] [2d]
64e5de41: bets $0.32
d1cd1071: folds
Uncalled bet ($0.32) returned to 64e5de41
*** SHOWDOWN ***
64e5de41 collected $0.4 from pot
*** SUMMARY ***
Total pot $0.42 | Rake $0.02 | Jackpot $0 | Bingo $0 | Fortune $0 | Tax $0
Board [Ks 5h 7c 8d 2d]
Seat 1: d201e5fe (button) folded before Flop (didn't bet)
Seat 2: Hero (small blind) folded before Flop
Seat 3: 64e5de41 (big blind) won ($0.4)
Seat 4: d1cd1071 folded on the River
Seat 5: e6ee1d7f folded before Flop (didn't bet)
Seat 6: 84667b37 folded before Flop (didn't bet)


Poker Hand #RC3334440517: Hold'em No Limit ($0.02/$0.05) - 2025/02/17 20:42:25
Table 'RushAndCash605777' 6-max Seat #1 is the button
Seat 1: Hero ($6.02 in chips)
Seat 2: c806dd25 ($5.35 in chips)
Seat 3: 76135c78 ($5.68 in chips)
Seat 4: 64e5de41 ($5 in chips)
Seat 5: 82656056 ($5 in chips)
Seat 6: 656af102 ($7.07 in chips)
c806dd25: posts small blind $0.02
76135c78: posts big blind $0.05
*** HOLE CARDS ***
Dealt to Hero [Td Jd]
Dealt to c806dd25 
Dealt to 76135c78 
Dealt to 64e5de41 
Dealt to 82656056 
Dealt to 656af102 
64e5de41: raises $0.08 to $0.13
82656056: folds
656af102: folds
Hero: calls $0.13
c806dd25: folds
76135c78: folds
*** FLOP *** [2h 5h Kh]
64e5de41: checks
Hero: checks
*** TURN *** [2h 5h Kh] [Tc]
64e5de41: checks
Hero: checks
*** RIVER *** [2h 5h Kh Tc] [8h]
64e5de41: bets $0.05
Hero: folds
Uncalled bet ($0.05) returned to 64e5de41
*** SHOWDOWN ***
64e5de41 collected $0.32 from pot
*** SUMMARY ***
Total pot $0.33 | Rake $0.01 | Jackpot $0 | Bingo $0 | Fortune $0 | Tax $0
Board [2h 5h Kh Tc 8h]
Seat 1: Hero (button) folded on the River
Seat 2: c806dd25 (small blind) folded before Flop
Seat 3: 76135c78 (big blind) folded before Flop
Seat 4: 64e5de41 won ($0.32)
Seat 5: 82656056 folded before Flop (didn't bet)
Seat 6: 656af102 folded before Flop (didn't bet)


Poker Hand #RC3334440387: Hold'em No Limit ($0.02/$0.05) - 2025/02/17 20:42:07
Table 'RushAndCash605647' 6-max Seat #1 is the button
Seat 1: f3614ba1 ($5.42 in chips)
Seat 2: 9a69a3a0 ($6.04 in chips)
Seat 3: Hero ($6.07 in chips)
Seat 4: 1b6c31ec ($5.86 in chips)
Seat 5: 39bc2366 ($5.21 in chips)
Seat 6: 8ec32764 ($5.05 in chips)
9a69a3a0: posts small blind $0.02
Hero: posts big blind $0.05
*** HOLE CARDS ***
Dealt to f3614ba1 
Dealt to 9a69a3a0 
Dealt to Hero [As 9d]
Dealt to 1b6c31ec 
Dealt to 39bc2366 
Dealt to 8ec32764 
1b6c31ec: folds
39bc2366: raises $0.08 to $0.13
8ec32764: raises $0.25 to $0.38
f3614ba1: folds
9a69a3a0: calls $0.36
Hero: folds
39bc2366: calls $0.25
*** FLOP *** [Td 9s Kd]
9a69a3a0: checks
39bc2366: checks
8ec32764: checks
*** TURN *** [Td 9s Kd] [4h]
9a69a3a0: bets $0.96
39bc2366: folds
8ec32764: folds
Uncalled bet ($0.96) returned to 9a69a3a0
*** SHOWDOWN ***
9a69a3a0 collected $1.13 from pot
*** SUMMARY ***
Total pot $1.19 | Rake $0.06 | Jackpot $0 | Bingo $0 | Fortune $0 | Tax $0
Board [Td 9s Kd 4h]
Seat 1: f3614ba1 (button) folded before Flop (didn't bet)
Seat 2: 9a69a3a0 (small blind) won ($1.13)
Seat 3: Hero (big blind) folded before Flop
Seat 4: 1b6c31ec folded before Flop (didn't bet)
Seat 5: 39bc2366 folded on the Turn
Seat 6: 8ec32764 folded on the Turn


Poker Hand #RC3334440363: Hold'em No Limit ($0.02/$0.05) - 2025/02/17 20:42:03
Table 'RushAndCash605623' 6-max Seat #1 is the button
Seat 1: 69407b3a ($9.89 in chips)
Seat 2: 95003d9e ($4.98 in chips)
Seat 3: 127f997c ($8.04 in chips)
Seat 4: eaafe260 ($11.71 in chips)
Seat 5: 9f09d482 ($7.57 in chips)
Seat 6: Hero ($6.07 in chips)
95003d9e: posts small blind $0.02
127f997c: posts big blind $0.05
*** HOLE CARDS ***
Dealt to 69407b3a 
Dealt to 95003d9e 
Dealt to 127f997c 
Dealt to eaafe260 
Dealt to 9f09d482 
Dealt to Hero [4s 8h]
eaafe260: raises $0.05 to $0.1
9f09d482: folds
Hero: folds
69407b3a: folds
95003d9e: folds
127f997c: folds
Uncalled bet ($0.05) returned to eaafe260
*** SHOWDOWN ***
eaafe260 collected $0.12 from pot
*** SUMMARY ***
Total pot $0.12 | Rake $0 | Jackpot $0 | Bingo $0 | Fortune $0 | Tax $0
Seat 1: 69407b3a (button) folded before Flop (didn't bet)
Seat 2: 95003d9e (small blind) folded before Flop
Seat 3: 127f997c (big blind) folded before Flop
Seat 4: eaafe260 collected ($0.12)
Seat 5: 9f09d482 folded before Flop (didn't bet)
Seat 6: Hero folded before Flop (didn't bet)


Poker Hand #RC3334440339: Hold'em No Limit ($0.02/$0.05) - 2025/02/17 20:42:00
Table 'RushAndCash605599' 6-max Seat #1 is the button
Seat 1: b144f063 ($11.79 in chips)
Seat 2: 803e9f05 ($6.94 in chips)
Seat 3: 7570303b ($11.22 in chips)
Seat 4: Hero ($6.07 in chips)
Seat 5: 1e4e1a58 ($6.91 in chips)
Seat 6: 577aa3d3 ($3.76 in chips)
803e9f05: posts small blind $0.02
7570303b: posts big blind $0.05
*** HOLE CARDS ***
Dealt to b144f063 
Dealt to 803e9f05 
Dealt to 7570303b 
Dealt to Hero [Qd 6h]
Dealt to 1e4e1a58 
Dealt to 577aa3d3 
Hero: folds
1e4e1a58: folds
577aa3d3: folds
b144f063: raises $0.05 to $0.1
803e9f05: folds
7570303b: calls $0.05
*** FLOP *** [Jd Tc 2d]
7570303b: checks
b144f063: checks
*** TURN *** [Jd Tc 2d] [Kd]
7570303b: checks
b144f063: bets $0.1
7570303b: calls $0.1
*** RIVER *** [Jd Tc 2d Kd] [Ac]
7570303b: checks
b144f063: checks
7570303b: shows [8d 8c] (Pair of Eights)
b144f063: shows [Kc 7c] (Pair of Kings)
*** SHOWDOWN ***
b144f063 collected $0.4 from pot
*** SUMMARY ***
Total pot $0.42 | Rake $0.02 | Jackpot $0 | Bingo $0 | Fortune $0 | Tax $0
Board [Jd Tc 2d Kd Ac]
Seat 1: b144f063 (button) showed [Kc 7c] and won ($0.4) with Pair of Kings
Seat 2: 803e9f05 (small blind) folded before Flop
Seat 3: 7570303b (big blind) showed [8d 8c] and lost with Pair of Eights
Seat 4: Hero folded before Flop (didn't bet)
Seat 5: 1e4e1a58 folded before Flop (didn't bet)
Seat 6: 577aa3d3 folded before Flop (didn't bet)


Poker Hand #RC3334440272: Hold'em No Limit ($0.02/$0.05) - 2025/02/17 20:41:50
Table 'RushAndCash605532' 6-max Seat #1 is the button
Seat 1: e183d966 ($6.7 in chips)
Seat 2: 7dd18ea7 ($7.74 in chips)
Seat 3: fa30bfa7 ($5.07 in chips)
Seat 4: Hero ($6.07 in chips)
Seat 5: 33bc9b8e ($5.91 in chips)
Seat 6: 9013f95e ($12.69 in chips)
7dd18ea7: posts small blind $0.02
fa30bfa7: posts big blind $0.05
*** HOLE CARDS ***
Dealt to e183d966 
Dealt to 7dd18ea7 
Dealt to fa30bfa7 
Dealt to Hero [Tc Qs]
Dealt to 33bc9b8e 
Dealt to 9013f95e 
Hero: folds
33bc9b8e: folds
9013f95e: calls $0.05
e183d966: folds
7dd18ea7: folds
fa30bfa7: checks
*** FLOP *** [3h 5c 9h]
fa30bfa7: checks
9013f95e: checks
*** TURN *** [3h 5c 9h] [Ah]
fa30bfa7: checks
9013f95e: bets $0.09
fa30bfa7: calls $0.09
*** RIVER *** [3h 5c 9h Ah] [4c]
fa30bfa7: checks
9013f95e: bets $0.23
fa30bfa7: folds
Uncalled bet ($0.23) returned to 9013f95e
*** SHOWDOWN ***
9013f95e collected $0.29 from pot
*** SUMMARY ***
Total pot $0.3 | Rake $0.01 | Jackpot $0 | Bingo $0 | Fortune $0 | Tax $0
Board [3h 5c 9h Ah 4c]
Seat 1: e183d966 (button) folded before Flop (didn't bet)
Seat 2: 7dd18ea7 (small blind) folded before Flop
Seat 3: fa30bfa7 (big blind) folded on the River
Seat 4: Hero folded before Flop (didn't bet)
Seat 5: 33bc9b8e folded before Flop (didn't bet)
Seat 6: 9013f95e won ($0.29)


Poker Hand #RC3334440156: Hold'em No Limit ($0.02/$0.05) - 2025/02/17 20:41:35
Table 'RushAndCash605416' 6-max Seat #1 is the button
Seat 1: Hero ($5.91 in chips)
Seat 2: 945593bf ($16.65 in chips)
Seat 3: b44ff266 ($5.97 in chips)
Seat 4: f0d238ad ($8.61 in chips)
Seat 5: 9864109b ($5.73 in chips)
Seat 6: af9df96 ($5.3 in chips)
945593bf: posts small blind $0.02
b44ff266: posts big blind $0.05
*** HOLE CARDS ***
Dealt to Hero [Qd Ad]
Dealt to 945593bf 
Dealt to b44ff266 
Dealt to f0d238ad 
Dealt to 9864109b 
Dealt to af9df96 
f0d238ad: folds
9864109b: raises $0.05 to $0.1
af9df96: folds
Hero: raises $0.22 to $0.32
945593bf: folds
b44ff266: folds
9864109b: folds
Uncalled bet ($0.22) returned to Hero
*** SHOWDOWN ***
Hero collected $0.26 from pot
*** SUMMARY ***
Total pot $0.27 | Rake $0.01 | Jackpot $0 | Bingo $0 | Fortune $0 | Tax $0
Seat 1: Hero (button) collected ($0.26)
Seat 2: 945593bf (small blind) folded before Flop
Seat 3: b44ff266 (big blind) folded before Flop
Seat 4: f0d238ad folded before Flop (didn't bet)
Seat 5: 9864109b folded before Flop
Seat 6: af9df96 folded before Flop (didn't bet)


Poker Hand #RC3334440122: Hold'em No Limit ($0.02/$0.05) - 2025/02/17 20:41:30
Table 'RushAndCash605382' 6-max Seat #1 is the button
Seat 1: 4d9372d1 ($5 in chips)
Seat 2: Hero ($5.93 in chips)
Seat 3: 730098b8 ($7.86 in chips)
Seat 4: 69492ace ($4.22 in chips)
Seat 5: 71e00d83 ($10.38 in chips)
Seat 6: 709ac205 ($14.39 in chips)
Hero: posts small blind $0.02
730098b8: posts big blind $0.05
*** HOLE CARDS ***
Dealt to 4d9372d1 
Dealt to Hero [5d Jh]
Dealt to 730098b8 
Dealt to 69492ace 
Dealt to 71e00d83 
Dealt to 709ac205 
69492ace: raises $0.05 to $0.1
71e00d83: folds
709ac205: folds
4d9372d1: folds
Hero: folds
730098b8: folds
Uncalled bet ($0.05) returned to 69492ace
*** SHOWDOWN ***
69492ace collected $0.12 from pot
*** SUMMARY ***
Total pot $0.12 | Rake $0 | Jackpot $0 | Bingo $0 | Fortune $0 | Tax $0
Seat 1: 4d9372d1 (button) folded before Flop (didn't bet)
Seat 2: Hero (small blind) folded before Flop
Seat 3: 730098b8 (big blind) folded before Flop
Seat 4: 69492ace collected ($0.12)
Seat 5: 71e00d83 folded before Flop (didn't bet)
Seat 6: 709ac205 folded before Flop (didn't bet)


Poker Hand #RC3334440101: Hold'em No Limit ($0.02/$0.05) - 2025/02/17 20:41:27
Table 'RushAndCash605361' 6-max Seat #1 is the button
Seat 1: fad7078a ($5.16 in chips)
Seat 2: c585480d ($5.59 in chips)
Seat 3: Hero ($5.98 in chips)
Seat 4: f898e827 ($5.02 in chips)
Seat 5: fc9f1189 ($5 in chips)
Seat 6: 54884390 ($5.24 in chips)
c585480d: posts small blind $0.02
Hero: posts big blind $0.05
*** HOLE CARDS ***
Dealt to fad7078a 
Dealt to c585480d 
Dealt to Hero [6h 4c]
Dealt to f898e827 
Dealt to fc9f1189 
Dealt to 54884390 
f898e827: raises $0.05 to $0.1
fc9f1189: folds
54884390: raises $0.27 to $0.37
fad7078a: folds
c585480d: folds
Hero: folds
f898e827: calls $0.27
*** FLOP *** [4d 3d Ah]
f898e827: checks
54884390: bets $0.27
f898e827: raises $0.45 to $0.72
54884390: folds
Uncalled bet ($0.45) returned to f898e827
*** SHOWDOWN ***
f898e827 collected $1.29 from pot
*** SUMMARY ***
Total pot $1.35 | Rake $0.06 | Jackpot $0 | Bingo $0 | Fortune $0 | Tax $0
Board [4d 3d Ah]
Seat 1: fad7078a (button) folded before Flop (didn't bet)
Seat 2: c585480d (small blind) folded before Flop
Seat 3: Hero (big blind) folded before Flop
Seat 4: f898e827 won ($1.29)
Seat 5: fc9f1189 folded before Flop (didn't bet)
Seat 6: 54884390 folded on the Flop


Poker Hand #RC3334440079: Hold'em No Limit ($0.02/$0.05) - 2025/02/17 20:41:24
Table 'RushAndCash605339' 6-max Seat #1 is the button
Seat 1: fc9f1189 ($5 in chips)
Seat 2: ac6a1821 ($5 in chips)
Seat 3: 6fefd514 ($4.91 in chips)
Seat 4: Hero ($5.98 in chips)
Seat 5: ef7b5599 ($15.48 in chips)
Seat 6: 730098b8 ($7.86 in chips)
ac6a1821: posts small blind $0.02
6fefd514: posts big blind $0.05
*** HOLE CARDS ***
Dealt to fc9f1189 
Dealt to ac6a1821 
Dealt to 6fefd514 
Dealt to Hero [3d 8s]
Dealt to ef7b5599 
Dealt to 730098b8 
Hero: folds
ef7b5599: folds
730098b8: folds
fc9f1189: folds
ac6a1821: folds
Uncalled bet ($0.03) returned to 6fefd514
*** SHOWDOWN ***
6fefd514 collected $0.04 from pot
*** SUMMARY ***
Total pot $0.04 | Rake $0 | Jackpot $0 | Bingo $0 | Fortune $0 | Tax $0
Seat 1: fc9f1189 (button) folded before Flop (didn't bet)
Seat 2: ac6a1821 (small blind) folded before Flop
Seat 3: 6fefd514 (big blind) collected ($0.04)
Seat 4: Hero folded before Flop (didn't bet)
Seat 5: ef7b5599 folded before Flop (didn't bet)
Seat 6: 730098b8 folded before Flop (didn't bet)


Poker Hand #RC3334440037: Hold'em No Limit ($0.02/$0.05) - 2025/02/17 20:41:17
Table 'RushAndCash605297' 6-max Seat #1 is the button
Seat 1: 7a5bf293 ($6.34 in chips)
Seat 2: 66be2112 ($6.27 in chips)
Seat 3: e6ee1d7f ($7.88 in chips)
Seat 4: Hero ($5.98 in chips)
Seat 5: 1e290a15 ($9.5 in chips)
Seat 6: 50d9f656 ($6.73 in chips)
66be2112: posts small blind $0.02
e6ee1d7f: posts big blind $0.05
*** HOLE CARDS ***
Dealt to 7a5bf293 
Dealt to 66be2112 
Dealt to e6ee1d7f 
Dealt to Hero [Ac 4s]
Dealt to 1e290a15 
Dealt to 50d9f656 
Hero: folds
1e290a15: folds
50d9f656: folds
7a5bf293: folds
66be2112: raises $0.1 to $0.15
e6ee1d7f: raises $0.3 to $0.45
66be2112: folds
Uncalled bet ($0.3) returned to e6ee1d7f
*** SHOWDOWN ***
e6ee1d7f collected $0.29 from pot
*** SUMMARY ***
Total pot $0.3 | Rake $0.01 | Jackpot $0 | Bingo $0 | Fortune $0 | Tax $0
Seat 1: 7a5bf293 (button) folded before Flop (didn't bet)
Seat 2: 66be2112 (small blind) folded before Flop
Seat 3: e6ee1d7f (big blind) collected ($0.29)
Seat 4: Hero folded before Flop (didn't bet)
Seat 5: 1e290a15 folded before Flop (didn't bet)
Seat 6: 50d9f656 folded before Flop (didn't bet)


Poker Hand #RC3334440013: Hold'em No Limit ($0.02/$0.05) - 2025/02/17 20:41:14
Table 'RushAndCash605273' 6-max Seat #1 is the button
Seat 1: 82656056 ($5.58 in chips)
Seat 2: Hero ($6 in chips)
Seat 3: fe0566a4 ($9.83 in chips)
Seat 4: 4264790d ($5.52 in chips)
Seat 5: 52f43d28 ($7.49 in chips)
Seat 6: 1e232769 ($5.08 in chips)
Hero: posts small blind $0.02
fe0566a4: posts big blind $0.05
*** HOLE CARDS ***
Dealt to 82656056 
Dealt to Hero [6c 7s]
Dealt to fe0566a4 
Dealt to 4264790d 
Dealt to 52f43d28 
Dealt to 1e232769 
4264790d: folds
52f43d28: folds
1e232769: folds
82656056: folds
Hero: folds
Uncalled bet ($0.03) returned to fe0566a4
*** SHOWDOWN ***
fe0566a4 collected $0.04 from pot
*** SUMMARY ***
Total pot $0.04 | Rake $0 | Jackpot $0 | Bingo $0 | Fortune $0 | Tax $0
Seat 1: 82656056 (button) folded before Flop (didn't bet)
Seat 2: Hero (small blind) folded before Flop
Seat 3: fe0566a4 (big blind) collected ($0.04)
Seat 4: 4264790d folded before Flop (didn't bet)
Seat 5: 52f43d28 folded before Flop (didn't bet)
Seat 6: 1e232769 folded before Flop (didn't bet)


Poker Hand #RC3334439993: Hold'em No Limit ($0.02/$0.05) - 2025/02/17 20:41:11
Table 'RushAndCash605253' 6-max Seat #1 is the button
Seat 1: 1dbfd698 ($7.57 in chips)
Seat 2: 8c1b0cdf ($3.01 in chips)
Seat 3: 82656056 ($5.63 in chips)
Seat 4: f6013c83 ($7.01 in chips)
Seat 5: fdbac393 ($5 in chips)
Seat 6: Hero ($6 in chips)
8c1b0cdf: posts small blind $0.02
82656056: posts big blind $0.05
*** HOLE CARDS ***
Dealt to 1dbfd698 
Dealt to 8c1b0cdf 
Dealt to 82656056 
Dealt to f6013c83 
Dealt to fdbac393 
Dealt to Hero [5d 5h]
f6013c83: folds
fdbac393: raises $0.05 to $0.1
Hero: folds
1dbfd698: folds
8c1b0cdf: raises $0.21 to $0.31
82656056: folds
fdbac393: folds
Uncalled bet ($0.21) returned to 8c1b0cdf
*** SHOWDOWN ***
8c1b0cdf collected $0.24 from pot
*** SUMMARY ***
Total pot $0.25 | Rake $0.01 | Jackpot $0 | Bingo $0 | Fortune $0 | Tax $0
Seat 1: 1dbfd698 (button) folded before Flop (didn't bet)
Seat 2: 8c1b0cdf (small blind) collected ($0.24)
Seat 3: 82656056 (big blind) folded before Flop
Seat 4: f6013c83 folded before Flop (didn't bet)
Seat 5: fdbac393 folded before Flop
Seat 6: Hero folded before Flop (didn't bet)


Poker Hand #RC3334439794: Hold'em No Limit ($0.02/$0.05) - 2025/02/17 20:40:42
Table 'RushAndCash605054' 6-max Seat #1 is the button
Seat 1: 98ea32b ($5.13 in chips)
Seat 2: 76fdb5a1 ($5.16 in chips)
Seat 3: Hero ($5.86 in chips)
Seat 4: 87d5083b ($16.87 in chips)
Seat 5: 65ca9276 ($7.41 in chips)
Seat 6: c1784884 ($9.49 in chips)
76fdb5a1: posts small blind $0.02
Hero: posts big blind $0.05
*** HOLE CARDS ***
Dealt to 98ea32b 
Dealt to 76fdb5a1 
Dealt to Hero [7d Td]
Dealt to 87d5083b 
Dealt to 65ca9276 
Dealt to c1784884 
87d5083b: folds
65ca9276: folds
c1784884: folds
98ea32b: folds
76fdb5a1: raises $0.1 to $0.15
Hero: calls $0.1
*** FLOP *** [8h 2h 6s]
76fdb5a1: checks
Hero: checks
*** TURN *** [8h 2h 6s] [Ts]
76fdb5a1: checks
Hero: bets $0.16
76fdb5a1: folds
Uncalled bet ($0.16) returned to Hero
*** SHOWDOWN ***
Hero collected $0.29 from pot
*** SUMMARY ***
Total pot $0.3 | Rake $0.01 | Jackpot $0 | Bingo $0 | Fortune $0 | Tax $0
Board [8h 2h 6s Ts]
Seat 1: 98ea32b (button) folded before Flop (didn't bet)
Seat 2: 76fdb5a1 (small blind) folded on the Turn
Seat 3: Hero (big blind) won ($0.29)
Seat 4: 87d5083b folded before Flop (didn't bet)
Seat 5: 65ca9276 folded before Flop (didn't bet)
Seat 6: c1784884 folded before Flop (didn't bet)


Poker Hand #RC3334439763: Hold'em No Limit ($0.02/$0.05) - 2025/02/17 20:40:39
Table 'RushAndCash605023' 6-max Seat #1 is the button
Seat 1: Hero ($5.86 in chips)
Seat 2: 3ffd6491 ($5 in chips)
Seat 3: 99af2b58 ($15.08 in chips)
Seat 4: f43eaf15 ($8.05 in chips)
Seat 5: d201e5fe ($7.97 in chips)
Seat 6: 16f2e5ce ($6.42 in chips)
3ffd6491: posts small blind $0.02
99af2b58: posts big blind $0.05
*** HOLE CARDS ***
Dealt to Hero [Qh 6d]
Dealt to 3ffd6491 
Dealt to 99af2b58 
Dealt to f43eaf15 
Dealt to d201e5fe 
Dealt to 16f2e5ce 
f43eaf15: folds
d201e5fe: folds
16f2e5ce: folds
Hero: folds
3ffd6491: folds
Uncalled bet ($0.03) returned to 99af2b58
*** SHOWDOWN ***
99af2b58 collected $0.04 from pot
*** SUMMARY ***
Total pot $0.04 | Rake $0 | Jackpot $0 | Bingo $0 | Fortune $0 | Tax $0
Seat 1: Hero (button) folded before Flop (didn't bet)
Seat 2: 3ffd6491 (small blind) folded before Flop
Seat 3: 99af2b58 (big blind) collected ($0.04)
Seat 4: f43eaf15 folded before Flop (didn't bet)
Seat 5: d201e5fe folded before Flop (didn't bet)
Seat 6: 16f2e5ce folded before Flop (didn't bet)


Poker Hand #RC3334439723: Hold'em No Limit ($0.02/$0.05) - 2025/02/17 20:40:33
Table 'RushAndCash604983' 6-max Seat #1 is the button
Seat 1: 59b37309 ($3.97 in chips)
Seat 2: 51e16546 ($4.89 in chips)
Seat 3: 1d2427ef ($5.11 in chips)
Seat 4: fcc3c3cc ($8.13 in chips)
Seat 5: 7af747dc ($14.15 in chips)
Seat 6: Hero ($5.86 in chips)
51e16546: posts small blind $0.02
1d2427ef: posts big blind $0.05
*** HOLE CARDS ***
Dealt to 59b37309 
Dealt to 51e16546 
Dealt to 1d2427ef 
Dealt to fcc3c3cc 
Dealt to 7af747dc 
Dealt to Hero [Qc Jc]
fcc3c3cc: raises $0.08 to $0.13
7af747dc: folds
Hero: folds
59b37309: folds
51e16546: calls $0.11
1d2427ef: folds
*** FLOP *** [6c 5d 5s]
51e16546: checks
fcc3c3cc: bets $0.24
51e16546: folds
Uncalled bet ($0.24) returned to fcc3c3cc
*** SHOWDOWN ***
fcc3c3cc collected $0.3 from pot
*** SUMMARY ***
Total pot $0.31 | Rake $0.01 | Jackpot $0 | Bingo $0 | Fortune $0 | Tax $0
Board [6c 5d 5s]
Seat 1: 59b37309 (button) folded before Flop (didn't bet)
Seat 2: 51e16546 (small blind) folded on the Flop
Seat 3: 1d2427ef (big blind) folded before Flop
Seat 4: fcc3c3cc won ($0.3)
Seat 5: 7af747dc folded before Flop (didn't bet)
Seat 6: Hero folded before Flop (didn't bet)


Poker Hand #RC3334439695: Hold'em No Limit ($0.02/$0.05) - 2025/02/17 20:40:30
Table 'RushAndCash604955' 6-max Seat #1 is the button
Seat 1: b7d97ee0 ($5.47 in chips)
Seat 2: 731e166b ($5.02 in chips)
Seat 3: e95b4a35 ($4.12 in chips)
Seat 4: Hero ($5.86 in chips)
Seat 5: 1fa8537 ($5 in chips)
Seat 6: b282789b ($5 in chips)
731e166b: posts small blind $0.02
e95b4a35: posts big blind $0.05
*** HOLE CARDS ***
Dealt to b7d97ee0 
Dealt to 731e166b 
Dealt to e95b4a35 
Dealt to Hero [7h 8c]
Dealt to 1fa8537 
Dealt to b282789b 
Hero: folds
1fa8537: folds
b282789b: folds
b7d97ee0: raises $0.07 to $0.12
731e166b: folds
e95b4a35: raises $0.33 to $0.45
b7d97ee0: folds
Uncalled bet ($0.33) returned to e95b4a35
*** SHOWDOWN ***
e95b4a35 collected $0.25 from pot
*** SUMMARY ***
Total pot $0.26 | Rake $0.01 | Jackpot $0 | Bingo $0 | Fortune $0 | Tax $0
Seat 1: b7d97ee0 (button) folded before Flop
Seat 2: 731e166b (small blind) folded before Flop
Seat 3: e95b4a35 (big blind) collected ($0.25)
Seat 4: Hero folded before Flop (didn't bet)
Seat 5: 1fa8537 folded before Flop (didn't bet)
Seat 6: b282789b folded before Flop (didn't bet)


Poker Hand #RC3334439672: Hold'em No Limit ($0.02/$0.05) - 2025/02/17 20:40:27
Table 'RushAndCash604932' 6-max Seat #1 is the button
Seat 1: 21657810 ($6.12 in chips)
Seat 2: f898e827 ($5.04 in chips)
Seat 3: d738c756 ($2.68 in chips)
Seat 4: 19bb03b5 ($12.27 in chips)
Seat 5: Hero ($5.86 in chips)
Seat 6: 9564515b ($5.28 in chips)
f898e827: posts small blind $0.02
d738c756: posts big blind $0.05
*** HOLE CARDS ***
Dealt to 21657810 
Dealt to f898e827 
Dealt to d738c756 
Dealt to 19bb03b5 
Dealt to Hero [4d 9c]
Dealt to 9564515b 
19bb03b5: folds
Hero: folds
9564515b: folds
21657810: folds
f898e827: folds
Uncalled bet ($0.03) returned to d738c756
*** SHOWDOWN ***
d738c756 collected $0.04 from pot
*** SUMMARY ***
Total pot $0.04 | Rake $0 | Jackpot $0 | Bingo $0 | Fortune $0 | Tax $0
Seat 1: 21657810 (button) folded before Flop (didn't bet)
Seat 2: f898e827 (small blind) folded before Flop
Seat 3: d738c756 (big blind) collected ($0.04)
Seat 4: 19bb03b5 folded before Flop (didn't bet)
Seat 5: Hero folded before Flop (didn't bet)
Seat 6: 9564515b folded before Flop (didn't bet)


Poker Hand #RC3334439415: Hold'em No Limit ($0.02/$0.05) - 2025/02/17 20:39:50
Table 'RushAndCash604675' 6-max Seat #1 is the button
Seat 1: 9564515b ($5.12 in chips)
Seat 2: 5197516b ($5.17 in chips)
Seat 3: 64e5de41 ($5.22 in chips)
Seat 4: 1bc9d557 ($6.85 in chips)
Seat 5: 187f2194 ($11.17 in chips)
Seat 6: Hero ($5.96 in chips)
5197516b: posts small blind $0.02
64e5de41: posts big blind $0.05
*** HOLE CARDS ***
Dealt to 9564515b 
Dealt to 5197516b 
Dealt to 64e5de41 
Dealt to 1bc9d557 
Dealt to 187f2194 
Dealt to Hero [Kc Jd]
1bc9d557: folds
187f2194: folds
Hero: raises $0.05 to $0.1
9564515b: calls $0.1
5197516b: folds
64e5de41: folds
*** FLOP *** [9s Ad 9d]
Hero: checks
9564515b: bets $0.14
Hero: folds
Uncalled bet ($0.14) returned to 9564515b
*** SHOWDOWN ***
9564515b collected $0.26 from pot
*** SUMMARY ***
Total pot $0.27 | Rake $0.01 | Jackpot $0 | Bingo $0 | Fortune $0 | Tax $0
Board [9s Ad 9d]
Seat 1: 9564515b (button) won ($0.26)
Seat 2: 5197516b (small blind) folded before Flop
Seat 3: 64e5de41 (big blind) folded before Flop
Seat 4: 1bc9d557 folded before Flop (didn't bet)
Seat 5: 187f2194 folded before Flop (didn't bet)
Seat 6: Hero folded on the Flop


Poker Hand #RC3334439374: Hold'em No Limit ($0.02/$0.05) - 2025/02/17 20:39:44
Table 'RushAndCash604634' 6-max Seat #1 is the button
Seat 1: 8dbd0a2d ($5.12 in chips)
Seat 2: 9babc997 ($5.98 in chips)
Seat 3: 8f3a3c0a ($5.69 in chips)
Seat 4: 4d8ae83 ($5.18 in chips)
Seat 5: Hero ($5.96 in chips)
Seat 6: 7dd18ea7 ($7.72 in chips)
9babc997: posts small blind $0.02
8f3a3c0a: posts big blind $0.05
*** HOLE CARDS ***
Dealt to 8dbd0a2d 
Dealt to 9babc997 
Dealt to 8f3a3c0a 
Dealt to 4d8ae83 
Dealt to Hero [Qs 7h]
Dealt to 7dd18ea7 
4d8ae83: folds
Hero: folds
7dd18ea7: folds
8dbd0a2d: folds
9babc997: folds
Uncalled bet ($0.03) returned to 8f3a3c0a
*** SHOWDOWN ***
8f3a3c0a collected $0.04 from pot
*** SUMMARY ***
Total pot $0.04 | Rake $0 | Jackpot $0 | Bingo $0 | Fortune $0 | Tax $0
Seat 1: 8dbd0a2d (button) folded before Flop (didn't bet)
Seat 2: 9babc997 (small blind) folded before Flop
Seat 3: 8f3a3c0a (big blind) collected ($0.04)
Seat 4: 4d8ae83 folded before Flop (didn't bet)
Seat 5: Hero folded before Flop (didn't bet)
Seat 6: 7dd18ea7 folded before Flop (didn't bet)


Poker Hand #RC3334439258: Hold'em No Limit ($0.02/$0.05) - 2025/02/17 20:39:28
Table 'RushAndCash604518' 6-max Seat #1 is the button
Seat 1: Hero ($5.96 in chips)
Seat 2: 9ed6ffbf ($5.66 in chips)
Seat 3: 200ba768 ($3.66 in chips)
Seat 4: eb09e492 ($5.85 in chips)
Seat 5: bb702030 ($6.34 in chips)
Seat 6: cf593991 ($5.77 in chips)
9ed6ffbf: posts small blind $0.02
200ba768: posts big blind $0.05
*** HOLE CARDS ***
Dealt to Hero [Js 5d]
Dealt to 9ed6ffbf 
Dealt to 200ba768 
Dealt to eb09e492 
Dealt to bb702030 
Dealt to cf593991 
eb09e492: raises $0.05 to $0.1
bb702030: folds
cf593991: folds
Hero: folds
9ed6ffbf: calls $0.08
200ba768: calls $0.05
*** FLOP *** [4s 3s Jc]
9ed6ffbf: checks
200ba768: checks
eb09e492: checks
*** TURN *** [4s 3s Jc] [8d]
9ed6ffbf: bets $0.23
200ba768: calls $0.23
eb09e492: calls $0.23
*** RIVER *** [4s 3s Jc 8d] [7s]
9ed6ffbf: bets $0.6
200ba768: folds
eb09e492: folds
Uncalled bet ($0.6) returned to 9ed6ffbf
*** SHOWDOWN ***
9ed6ffbf collected $0.94 from pot
*** SUMMARY ***
Total pot $0.99 | Rake $0.05 | Jackpot $0 | Bingo $0 | Fortune $0 | Tax $0
Board [4s 3s Jc 8d 7s]
Seat 1: Hero (button) folded before Flop (didn't bet)
Seat 2: 9ed6ffbf (small blind) won ($0.94)
Seat 3: 200ba768 (big blind) folded on the River
Seat 4: eb09e492 folded on the River
Seat 5: bb702030 folded before Flop (didn't bet)
Seat 6: cf593991 folded before Flop (didn't bet)


Poker Hand #RC3334438685: Hold'em No Limit ($0.02/$0.05) - 2025/02/17 20:38:15
Table 'RushAndCash603945' 6-max Seat #1 is the button
Seat 1: 200ba768 ($4.01 in chips)
Seat 2: 16f2e5ce ($6.11 in chips)
Seat 3: Hero ($5.5 in chips)
Seat 4: c8e834fc ($9.66 in chips)
Seat 5: 45d33c76 ($8.98 in chips)
Seat 6: fad7078a ($5.14 in chips)
16f2e5ce: posts small blind $0.02
Hero: posts big blind $0.05
*** HOLE CARDS ***
Dealt to 200ba768 
Dealt to 16f2e5ce 
Dealt to Hero [3d 4d]
Dealt to c8e834fc 
Dealt to 45d33c76 
Dealt to fad7078a 
c8e834fc: folds
45d33c76: raises $0.08 to $0.13
fad7078a: folds
200ba768: calls $0.13
16f2e5ce: folds
Hero: calls $0.08
*** FLOP *** [2s 9d Ac]
Hero: checks
45d33c76: checks
200ba768: checks
*** TURN *** [2s 9d Ac] [9h]
Hero: checks
45d33c76: checks
200ba768: checks
*** RIVER *** [2s 9d Ac 9h] [5h]
Hero: bets $0.22
45d33c76: folds
200ba768: calls $0.22
Hero: shows [3d 4d] (Fives-High Straight)
200ba768: shows [Ad Td] (Pair of Aces and Pair of Nines)
*** SHOWDOWN ***
Hero collected $0.81 from pot
*** SUMMARY ***
Total pot $0.85 | Rake $0.04 | Jackpot $0 | Bingo $0 | Fortune $0 | Tax $0
Board [2s 9d Ac 9h 5h]
Seat 1: 200ba768 (button) showed [Ad Td] and lost with Pair of Aces and Pair of Nines
Seat 2: 16f2e5ce (small blind) folded before Flop
Seat 3: Hero (big blind) showed [3d 4d] and won ($0.81) with Fives-High Straight
Seat 4: c8e834fc folded before Flop (didn't bet)
Seat 5: 45d33c76 folded on the River
Seat 6: fad7078a folded before Flop (didn't bet)


Poker Hand #RC3334438663: Hold'em No Limit ($0.02/$0.05) - 2025/02/17 20:38:11
Table 'RushAndCash603923' 6-max Seat #1 is the button
Seat 1: c8e834fc ($9.66 in chips)
Seat 2: Hero ($5.52 in chips)
Seat 3: f2e82cf4 ($5.32 in chips)
Seat 4: f739af93 ($12.92 in chips)
Seat 5: e8f41d33 ($3.76 in chips)
Seat 6: 7b6a3077 ($7.7 in chips)
Hero: posts small blind $0.02
f2e82cf4: posts big blind $0.05
*** HOLE CARDS ***
Dealt to c8e834fc 
Dealt to Hero [4c Ks]
Dealt to f2e82cf4 
Dealt to f739af93 
Dealt to e8f41d33 
Dealt to 7b6a3077 
f739af93: folds
e8f41d33: folds
7b6a3077: raises $0.1 to $0.15
c8e834fc: folds
Hero: folds
f2e82cf4: calls $0.1
*** FLOP *** [5d 3h 7s]
f2e82cf4: bets $0.15
7b6a3077: folds
Uncalled bet ($0.15) returned to f2e82cf4
*** SHOWDOWN ***
f2e82cf4 collected $0.31 from pot
*** SUMMARY ***
Total pot $0.32 | Rake $0.01 | Jackpot $0 | Bingo $0 | Fortune $0 | Tax $0
Board [5d 3h 7s]
Seat 1: c8e834fc (button) folded before Flop (didn't bet)
Seat 2: Hero (small blind) folded before Flop
Seat 3: f2e82cf4 (big blind) won ($0.31)
Seat 4: f739af93 folded before Flop (didn't bet)
Seat 5: e8f41d33 folded before Flop (didn't bet)
Seat 6: 7b6a3077 folded on the Flop


Poker Hand #RC3334438634: Hold'em No Limit ($0.02/$0.05) - 2025/02/17 20:38:07
Table 'RushAndCash603894' 6-max Seat #1 is the button
Seat 1: c7d7e6aa ($12.43 in chips)
Seat 2: 735c4afd ($5 in chips)
Seat 3: 64e5de41 ($5 in chips)
Seat 4: 8a220c5 ($2.83 in chips)
Seat 5: Hero ($5.52 in chips)
Seat 6: 1d2427ef ($5.04 in chips)
735c4afd: posts small blind $0.02
64e5de41: posts big blind $0.05
*** HOLE CARDS ***
Dealt to c7d7e6aa 
Dealt to 735c4afd 
Dealt to 64e5de41 
Dealt to 8a220c5 
Dealt to Hero [9d Qh]
Dealt to 1d2427ef 
8a220c5: raises $0.07 to $0.12
Hero: folds
1d2427ef: folds
c7d7e6aa: folds
735c4afd: folds
64e5de41: folds
Uncalled bet ($0.07) returned to 8a220c5
*** SHOWDOWN ***
8a220c5 collected $0.12 from pot
*** SUMMARY ***
Total pot $0.12 | Rake $0 | Jackpot $0 | Bingo $0 | Fortune $0 | Tax $0
Seat 1: c7d7e6aa (button) folded before Flop (didn't bet)
Seat 2: 735c4afd (small blind) folded before Flop
Seat 3: 64e5de41 (big blind) folded before Flop
Seat 4: 8a220c5 collected ($0.12)
Seat 5: Hero folded before Flop (didn't bet)
Seat 6: 1d2427ef folded before Flop (didn't bet)


Poker Hand #RC3334438610: Hold'em No Limit ($0.02/$0.05) - 2025/02/17 20:38:04
Table 'RushAndCash603870' 6-max Seat #1 is the button
Seat 1: e8f41d33 ($3.76 in chips)
Seat 2: 2f12456d ($5 in chips)
Seat 3: 6aa0c391 ($5.56 in chips)
Seat 4: Hero ($5.52 in chips)
Seat 5: 7f79d927 ($9.22 in chips)
Seat 6: 81e1b438 ($5.05 in chips)
2f12456d: posts small blind $0.02
6aa0c391: posts big blind $0.05
*** HOLE CARDS ***
Dealt to e8f41d33 
Dealt to 2f12456d 
Dealt to 6aa0c391 
Dealt to Hero [7d 9d]
Dealt to 7f79d927 
Dealt to 81e1b438 
Hero: folds
7f79d927: folds
81e1b438: folds
e8f41d33: folds
2f12456d: folds
Uncalled bet ($0.03) returned to 6aa0c391
*** SHOWDOWN ***
6aa0c391 collected $0.04 from pot
*** SUMMARY ***
Total pot $0.04 | Rake $0 | Jackpot $0 | Bingo $0 | Fortune $0 | Tax $0
Seat 1: e8f41d33 (button) folded before Flop (didn't bet)
Seat 2: 2f12456d (small blind) folded before Flop
Seat 3: 6aa0c391 (big blind) collected ($0.04)
Seat 4: Hero folded before Flop (didn't bet)
Seat 5: 7f79d927 folded before Flop (didn't bet)
Seat 6: 81e1b438 folded before Flop (didn't bet)


Poker Hand #RC3334438586: Hold'em No Limit ($0.02/$0.05) - 2025/02/17 20:38:01
Table 'RushAndCash603846' 6-max Seat #1 is the button
Seat 1: Hero ($5.52 in chips)
Seat 2: fcc3c3cc ($8.37 in chips)
Seat 3: 6d5fa70b ($5.22 in chips)
Seat 4: 87cdcefe ($2.16 in chips)
Seat 5: b45daa8e ($4.03 in chips)
Seat 6: 72fa4c0f ($1.95 in chips)
fcc3c3cc: posts small blind $0.02
6d5fa70b: posts big blind $0.05
*** HOLE CARDS ***
Dealt to Hero [6c Jc]
Dealt to fcc3c3cc 
Dealt to 6d5fa70b 
Dealt to 87cdcefe 
Dealt to b45daa8e 
Dealt to 72fa4c0f 
87cdcefe: folds
b45daa8e: folds
72fa4c0f: raises $0.1 to $0.15
Hero: folds
fcc3c3cc: folds
6d5fa70b: folds
Uncalled bet ($0.1) returned to 72fa4c0f
*** SHOWDOWN ***
72fa4c0f collected $0.12 from pot
*** SUMMARY ***
Total pot $0.12 | Rake $0 | Jackpot $0 | Bingo $0 | Fortune $0 | Tax $0
Seat 1: Hero (button) folded before Flop (didn't bet)
Seat 2: fcc3c3cc (small blind) folded before Flop
Seat 3: 6d5fa70b (big blind) folded before Flop
Seat 4: 87cdcefe folded before Flop (didn't bet)
Seat 5: b45daa8e folded before Flop (didn't bet)
Seat 6: 72fa4c0f collected ($0.12)


Poker Hand #RC3334438563: Hold'em No Limit ($0.02/$0.05) - 2025/02/17 20:37:58
Table 'RushAndCash603823' 6-max Seat #1 is the button
Seat 1: b00c4f8 ($15.74 in chips)
Seat 2: b3aefb75 ($10.58 in chips)
Seat 3: 75145cfe ($9.35 in chips)
Seat 4: d916afa1 ($5.12 in chips)
Seat 5: Hero ($5.52 in chips)
Seat 6: db83c16e ($4.72 in chips)
b3aefb75: posts small blind $0.02
75145cfe: posts big blind $0.05
*** HOLE CARDS ***
Dealt to b00c4f8 
Dealt to b3aefb75 
Dealt to 75145cfe 
Dealt to d916afa1 
Dealt to Hero [3h Ks]
Dealt to db83c16e 
d916afa1: folds
Hero: folds
db83c16e: folds
b00c4f8: folds
b3aefb75: raises $0.08 to $0.13
75145cfe: folds
Uncalled bet ($0.08) returned to b3aefb75
*** SHOWDOWN ***
b3aefb75 collected $0.1 from pot
*** SUMMARY ***
Total pot $0.1 | Rake $0 | Jackpot $0 | Bingo $0 | Fortune $0 | Tax $0
Seat 1: b00c4f8 (button) folded before Flop (didn't bet)
Seat 2: b3aefb75 (small blind) collected ($0.1)
Seat 3: 75145cfe (big blind) folded before Flop
Seat 4: d916afa1 folded before Flop (didn't bet)
Seat 5: Hero folded before Flop (didn't bet)
Seat 6: db83c16e folded before Flop (didn't bet)


Poker Hand #RC3334438530: Hold'em No Limit ($0.02/$0.05) - 2025/02/17 20:37:53
Table 'RushAndCash603790' 6-max Seat #1 is the button
Seat 1: 71e00d83 ($11.67 in chips)
Seat 2: 902b47de ($5 in chips)
Seat 3: Hero ($5.57 in chips)
Seat 4: 7fc44808 ($10.42 in chips)
Seat 5: 64e5de41 ($5 in chips)
Seat 6: 27baaa05 ($7.31 in chips)
902b47de: posts small blind $0.02
Hero: posts big blind $0.05
*** HOLE CARDS ***
Dealt to 71e00d83 
Dealt to 902b47de 
Dealt to Hero [Qh 8c]
Dealt to 7fc44808 
Dealt to 64e5de41 
Dealt to 27baaa05 
7fc44808: folds
64e5de41: folds
27baaa05: folds
71e00d83: raises $0.05 to $0.1
902b47de: folds
Hero: folds
Uncalled bet ($0.05) returned to 71e00d83
*** SHOWDOWN ***
71e00d83 collected $0.12 from pot
*** SUMMARY ***
Total pot $0.12 | Rake $0 | Jackpot $0 | Bingo $0 | Fortune $0 | Tax $0
Seat 1: 71e00d83 (button) collected ($0.12)
Seat 2: 902b47de (small blind) folded before Flop
Seat 3: Hero (big blind) folded before Flop
Seat 4: 7fc44808 folded before Flop (didn't bet)
Seat 5: 64e5de41 folded before Flop (didn't bet)
Seat 6: 27baaa05 folded before Flop (didn't bet)


Poker Hand #RC3334438510: Hold'em No Limit ($0.02/$0.05) - 2025/02/17 20:37:50
Table 'RushAndCash603770' 6-max Seat #1 is the button
Seat 1: 2353ba72 ($11.59 in chips)
Seat 2: b45daa8e ($4.05 in chips)
Seat 3: 98fa8579 ($5.59 in chips)
Seat 4: 6d5fa70b ($5.22 in chips)
Seat 5: 6b62a9a6 ($5.27 in chips)
Seat 6: Hero ($5.57 in chips)
b45daa8e: posts small blind $0.02
98fa8579: posts big blind $0.05
*** HOLE CARDS ***
Dealt to 2353ba72 
Dealt to b45daa8e 
Dealt to 98fa8579 
Dealt to 6d5fa70b 
Dealt to 6b62a9a6 
Dealt to Hero [5h 2h]
6d5fa70b: folds
6b62a9a6: raises $0.07 to $0.12
Hero: folds
2353ba72: calls $0.12
b45daa8e: folds
98fa8579: folds
*** FLOP *** [7s 9s 8d]
6b62a9a6: checks
2353ba72: bets $0.16
6b62a9a6: folds
Uncalled bet ($0.16) returned to 2353ba72
*** SHOWDOWN ***
2353ba72 collected $0.3 from pot
*** SUMMARY ***
Total pot $0.31 | Rake $0.01 | Jackpot $0 | Bingo $0 | Fortune $0 | Tax $0
Board [7s 9s 8d]
Seat 1: 2353ba72 (button) won ($0.3)
Seat 2: b45daa8e (small blind) folded before Flop
Seat 3: 98fa8579 (big blind) folded before Flop
Seat 4: 6d5fa70b folded before Flop (didn't bet)
Seat 5: 6b62a9a6 folded on the Flop
Seat 6: Hero folded before Flop (didn't bet)


Poker Hand #RC3334438489: Hold'em No Limit ($0.02/$0.05) - 2025/02/17 20:37:47
Table 'RushAndCash603749' 6-max Seat #1 is the button
Seat 1: 942cbe70 ($5.07 in chips)
Seat 2: Hero ($5.59 in chips)
Seat 3: b9d877b0 ($6.74 in chips)
Seat 4: 554a29a7 ($5.88 in chips)
Seat 5: 574ecb68 ($5.52 in chips)
Seat 6: 7fe74cc5 ($5.16 in chips)
Hero: posts small blind $0.02
b9d877b0: posts big blind $0.05
*** HOLE CARDS ***
Dealt to 942cbe70 
Dealt to Hero [4d Ac]
Dealt to b9d877b0 
Dealt to 554a29a7 
Dealt to 574ecb68 
Dealt to 7fe74cc5 
554a29a7: folds
574ecb68: raises $0.05 to $0.1
7fe74cc5: folds
942cbe70: folds
Hero: folds
b9d877b0: folds
Uncalled bet ($0.05) returned to 574ecb68
*** SHOWDOWN ***
574ecb68 collected $0.12 from pot
*** SUMMARY ***
Total pot $0.12 | Rake $0 | Jackpot $0 | Bingo $0 | Fortune $0 | Tax $0
Seat 1: 942cbe70 (button) folded before Flop (didn't bet)
Seat 2: Hero (small blind) folded before Flop
Seat 3: b9d877b0 (big blind) folded before Flop
Seat 4: 554a29a7 folded before Flop (didn't bet)
Seat 5: 574ecb68 collected ($0.12)
Seat 6: 7fe74cc5 folded before Flop (didn't bet)


Poker Hand #RC3334438470: Hold'em No Limit ($0.02/$0.05) - 2025/02/17 20:37:44
Table 'RushAndCash603730' 6-max Seat #1 is the button
Seat 1: 8d378f31 ($5.23 in chips)
Seat 2: 69407b3a ($10.23 in chips)
Seat 3: 84667b37 ($5 in chips)
Seat 4: 3469fa26 ($3.48 in chips)
Seat 5: Hero ($5.59 in chips)
Seat 6: 6de2662f ($5.16 in chips)
69407b3a: posts small blind $0.02
84667b37: posts big blind $0.05
*** HOLE CARDS ***
Dealt to 8d378f31 
Dealt to 69407b3a 
Dealt to 84667b37 
Dealt to 3469fa26 
Dealt to Hero [2h Jd]
Dealt to 6de2662f 
3469fa26: raises $0.05 to $0.1
Hero: folds
6de2662f: folds
8d378f31: folds
69407b3a: folds
84667b37: folds
Uncalled bet ($0.05) returned to 3469fa26
*** SHOWDOWN ***
3469fa26 collected $0.12 from pot
*** SUMMARY ***
Total pot $0.12 | Rake $0 | Jackpot $0 | Bingo $0 | Fortune $0 | Tax $0
Seat 1: 8d378f31 (button) folded before Flop (didn't bet)
Seat 2: 69407b3a (small blind) folded before Flop
Seat 3: 84667b37 (big blind) folded before Flop
Seat 4: 3469fa26 collected ($0.12)
Seat 5: Hero folded before Flop (didn't bet)
Seat 6: 6de2662f folded before Flop (didn't bet)


Poker Hand #RC3334438157: Hold'em No Limit ($0.02/$0.05) - 2025/02/17 20:37:01
Table 'RushAndCash603417' 6-max Seat #1 is the button
Seat 1: 9eb2937a ($5 in chips)
Seat 2: 8d378f31 ($5 in chips)
Seat 3: f43eaf15 ($7.43 in chips)
Seat 4: 7fa51053 ($5.09 in chips)
Seat 5: 32d40ce0 ($7.61 in chips)
Seat 6: Hero ($5.79 in chips)
8d378f31: posts small blind $0.02
f43eaf15: posts big blind $0.05
*** HOLE CARDS ***
Dealt to 9eb2937a 
Dealt to 8d378f31 
Dealt to f43eaf15 
Dealt to 7fa51053 
Dealt to 32d40ce0 
Dealt to Hero [Tc Ts]
7fa51053: folds
32d40ce0: folds
Hero: raises $0.05 to $0.1
9eb2937a: folds
8d378f31: calls $0.08
f43eaf15: folds
*** FLOP *** [Ac Js 2d]
8d378f31: checks
Hero: bets $0.1
8d378f31: calls $0.1
*** TURN *** [Ac Js 2d] [5c]
8d378f31: checks
Hero: checks
*** RIVER *** [Ac Js 2d 5c] [As]
8d378f31: checks
Hero: checks
8d378f31: shows [Ad 6d] (Three Aces)
Hero: shows [Tc Ts] (Pair of Aces and Pair of Tens)
*** SHOWDOWN ***
8d378f31 collected $0.43 from pot
*** SUMMARY ***
Total pot $0.45 | Rake $0.02 | Jackpot $0 | Bingo $0 | Fortune $0 | Tax $0
Board [Ac Js 2d 5c As]
Seat 1: 9eb2937a (button) folded before Flop (didn't bet)
Seat 2: 8d378f31 (small blind) showed [Ad 6d] and won ($0.43) with Three Aces
Seat 3: f43eaf15 (big blind) folded before Flop
Seat 4: 7fa51053 folded before Flop (didn't bet)
Seat 5: 32d40ce0 folded before Flop (didn't bet)
Seat 6: Hero showed [Tc Ts] and lost with Pair of Aces and Pair of Tens


Poker Hand #RC3334438049: Hold'em No Limit ($0.02/$0.05) - 2025/02/17 20:36:47
Table 'RushAndCash603309' 6-max Seat #1 is the button
Seat 1: 9684e9f0 ($5.31 in chips)
Seat 2: a61adcf2 ($4.95 in chips)
Seat 3: 742ccfee ($4.02 in chips)
Seat 4: Hero ($5.72 in chips)
Seat 5: 6ebc3323 ($12.05 in chips)
Seat 6: 22a3f0e8 ($5.28 in chips)
a61adcf2: posts small blind $0.02
742ccfee: posts big blind $0.05
*** HOLE CARDS ***
Dealt to 9684e9f0 
Dealt to a61adcf2 
Dealt to 742ccfee 
Dealt to Hero [Ks Ad]
Dealt to 6ebc3323 
Dealt to 22a3f0e8 
Hero: raises $0.05 to $0.1
6ebc3323: folds
22a3f0e8: folds
9684e9f0: folds
a61adcf2: folds
742ccfee: folds
Uncalled bet ($0.05) returned to Hero
*** SHOWDOWN ***
Hero collected $0.12 from pot
*** SUMMARY ***
Total pot $0.12 | Rake $0 | Jackpot $0 | Bingo $0 | Fortune $0 | Tax $0
Seat 1: 9684e9f0 (button) folded before Flop (didn't bet)
Seat 2: a61adcf2 (small blind) folded before Flop
Seat 3: 742ccfee (big blind) folded before Flop
Seat 4: Hero collected ($0.12)
Seat 5: 6ebc3323 folded before Flop (didn't bet)
Seat 6: 22a3f0e8 folded before Flop (didn't bet)


Poker Hand #RC3334437989: Hold'em No Limit ($0.02/$0.05) - 2025/02/17 20:36:39
Table 'RushAndCash603249' 6-max Seat #1 is the button
Seat 1: 803e9f05 ($6.61 in chips)
Seat 2: 1b8b89c1 ($5.4 in chips)
Seat 3: Hero ($5.77 in chips)
Seat 4: d97dda86 ($8.51 in chips)
Seat 5: c096c24 ($5 in chips)
Seat 6: ef7e6107 ($5 in chips)
1b8b89c1: posts small blind $0.02
Hero: posts big blind $0.05
*** HOLE CARDS ***
Dealt to 803e9f05 
Dealt to 1b8b89c1 
Dealt to Hero [7s Kd]
Dealt to d97dda86 
Dealt to c096c24 
Dealt to ef7e6107 
d97dda86: folds
c096c24: folds
ef7e6107: folds
803e9f05: raises $0.05 to $0.1
1b8b89c1: folds
Hero: folds
Uncalled bet ($0.05) returned to 803e9f05
*** SHOWDOWN ***
803e9f05 collected $0.12 from pot
*** SUMMARY ***
Total pot $0.12 | Rake $0 | Jackpot $0 | Bingo $0 | Fortune $0 | Tax $0
Seat 1: 803e9f05 (button) collected ($0.12)
Seat 2: 1b8b89c1 (small blind) folded before Flop
Seat 3: Hero (big blind) folded before Flop
Seat 4: d97dda86 folded before Flop (didn't bet)
Seat 5: c096c24 folded before Flop (didn't bet)
Seat 6: ef7e6107 folded before Flop (didn't bet)


Poker Hand #RC3334437962: Hold'em No Limit ($0.02/$0.05) - 2025/02/17 20:36:36
Table 'RushAndCash603222' 6-max Seat #1 is the button
Seat 1: Hero ($5.77 in chips)
Seat 2: fcad3124 ($11.39 in chips)
Seat 3: 4d8ae83 ($5 in chips)
Seat 4: 6ab8e60e ($15.98 in chips)
Seat 5: 53c3b7da ($4.95 in chips)
Seat 6: 38ef00 ($4.22 in chips)
fcad3124: posts small blind $0.02
4d8ae83: posts big blind $0.05
*** HOLE CARDS ***
Dealt to Hero [Qd 2c]
Dealt to fcad3124 
Dealt to 4d8ae83 
Dealt to 6ab8e60e 
Dealt to 53c3b7da 
Dealt to 38ef00 
6ab8e60e: folds
53c3b7da: folds
38ef00: folds
Hero: folds
fcad3124: folds
Uncalled bet ($0.03) returned to 4d8ae83
*** SHOWDOWN ***
4d8ae83 collected $0.04 from pot
*** SUMMARY ***
Total pot $0.04 | Rake $0 | Jackpot $0 | Bingo $0 | Fortune $0 | Tax $0
Seat 1: Hero (button) folded before Flop (didn't bet)
Seat 2: fcad3124 (small blind) folded before Flop
Seat 3: 4d8ae83 (big blind) collected ($0.04)
Seat 4: 6ab8e60e folded before Flop (didn't bet)
Seat 5: 53c3b7da folded before Flop (didn't bet)
Seat 6: 38ef00 folded before Flop (didn't bet)


Poker Hand #RC3334437925: Hold'em No Limit ($0.02/$0.05) - 2025/02/17 20:36:31
Table 'RushAndCash603185' 6-max Seat #1 is the button
Seat 1: f0d238ad ($9.79 in chips)
Seat 2: ef7e6107 ($5.02 in chips)
Seat 3: a9af8bb8 ($5.43 in chips)
Seat 4: 1e474bac ($5.62 in chips)
Seat 5: 191b60c1 ($10.95 in chips)
Seat 6: Hero ($5.77 in chips)
ef7e6107: posts small blind $0.02
a9af8bb8: posts big blind $0.05
*** HOLE CARDS ***
Dealt to f0d238ad 
Dealt to ef7e6107 
Dealt to a9af8bb8 
Dealt to 1e474bac 
Dealt to 191b60c1 
Dealt to Hero [Jc 9h]
1e474bac: folds
191b60c1: folds
Hero: folds
f0d238ad: folds
ef7e6107: folds
Uncalled bet ($0.03) returned to a9af8bb8
*** SHOWDOWN ***
a9af8bb8 collected $0.04 from pot
*** SUMMARY ***
Total pot $0.04 | Rake $0 | Jackpot $0 | Bingo $0 | Fortune $0 | Tax $0
Seat 1: f0d238ad (button) folded before Flop (didn't bet)
Seat 2: ef7e6107 (small blind) folded before Flop
Seat 3: a9af8bb8 (big blind) collected ($0.04)
Seat 4: 1e474bac folded before Flop (didn't bet)
Seat 5: 191b60c1 folded before Flop (didn't bet)
Seat 6: Hero folded before Flop (didn't bet)


Poker Hand #RC3334437904: Hold'em No Limit ($0.02/$0.05) - 2025/02/17 20:36:28
Table 'RushAndCash603164' 6-max Seat #1 is the button
Seat 1: bfef046a ($6.75 in chips)
Seat 2: Hero ($5.79 in chips)
Seat 3: 7af747dc ($13.96 in chips)
Seat 4: e2a2e9b3 ($5.19 in chips)
Seat 5: 4e55fa29 ($4.45 in chips)
Seat 6: c8e834fc ($9.51 in chips)
Hero: posts small blind $0.02
7af747dc: posts big blind $0.05
*** HOLE CARDS ***
Dealt to bfef046a 
Dealt to Hero [Kh 6c]
Dealt to 7af747dc 
Dealt to e2a2e9b3 
Dealt to 4e55fa29 
Dealt to c8e834fc 
e2a2e9b3: raises $0.05 to $0.1
4e55fa29: folds
c8e834fc: folds
bfef046a: calls $0.1
Hero: folds
7af747dc: folds
*** FLOP *** [7c 4d 4h]
e2a2e9b3: checks
bfef046a: checks
*** TURN *** [7c 4d 4h] [3h]
e2a2e9b3: bets $0.21
bfef046a: calls $0.21
*** RIVER *** [7c 4d 4h 3h] [9h]
e2a2e9b3: checks
bfef046a: checks
e2a2e9b3: shows [8s 8c] (Pair of Eights and Pair of Fours)
bfef046a: shows [Jd Qs] (Pair of Fours)
*** SHOWDOWN ***
e2a2e9b3 collected $0.66 from pot
*** SUMMARY ***
Total pot $0.69 | Rake $0.03 | Jackpot $0 | Bingo $0 | Fortune $0 | Tax $0
Board [7c 4d 4h 3h 9h]
Seat 1: bfef046a (button) showed [Jd Qs] and lost with Pair of Fours
Seat 2: Hero (small blind) folded before Flop
Seat 3: 7af747dc (big blind) folded before Flop
Seat 4: e2a2e9b3 showed [8s 8c] and won ($0.66) with Pair of Eights and Pair of Fours
Seat 5: 4e55fa29 folded before Flop (didn't bet)
Seat 6: c8e834fc folded before Flop (didn't bet)


Poker Hand #RC3334437883: Hold'em No Limit ($0.02/$0.05) - 2025/02/17 20:36:25
Table 'RushAndCash603143' 6-max Seat #1 is the button
Seat 1: 1d0217bc ($5.48 in chips)
Seat 2: a28ca95c ($19.08 in chips)
Seat 3: 23cd2f90 ($2.79 in chips)
Seat 4: Hero ($5.79 in chips)
Seat 5: 9b1a3dd2 ($7.87 in chips)
Seat 6: 709ac205 ($12.91 in chips)
a28ca95c: posts small blind $0.02
23cd2f90: posts big blind $0.05
*** HOLE CARDS ***
Dealt to 1d0217bc 
Dealt to a28ca95c 
Dealt to 23cd2f90 
Dealt to Hero [Td 6d]
Dealt to 9b1a3dd2 
Dealt to 709ac205 
Hero: folds
9b1a3dd2: folds
709ac205: folds
1d0217bc: folds
a28ca95c: folds
Uncalled bet ($0.03) returned to 23cd2f90
*** SHOWDOWN ***
23cd2f90 collected $0.04 from pot
*** SUMMARY ***
Total pot $0.04 | Rake $0 | Jackpot $0 | Bingo $0 | Fortune $0 | Tax $0
Seat 1: 1d0217bc (button) folded before Flop (didn't bet)
Seat 2: a28ca95c (small blind) folded before Flop
Seat 3: 23cd2f90 (big blind) collected ($0.04)
Seat 4: Hero folded before Flop (didn't bet)
Seat 5: 9b1a3dd2 folded before Flop (didn't bet)
Seat 6: 709ac205 folded before Flop (didn't bet)


Poker Hand #RC3334437859: Hold'em No Limit ($0.02/$0.05) - 2025/02/17 20:36:21
Table 'RushAndCash603119' 6-max Seat #1 is the button
Seat 1: f3fc119a ($6.27 in chips)
Seat 2: 5db4cca ($5.46 in chips)
Seat 3: 5265b128 ($5.12 in chips)
Seat 4: Hero ($5.79 in chips)
Seat 5: 9f70f94d ($5 in chips)
Seat 6: 192a8fb5 ($4.86 in chips)
5db4cca: posts small blind $0.02
5265b128: posts big blind $0.05
*** HOLE CARDS ***
Dealt to f3fc119a 
Dealt to 5db4cca 
Dealt to 5265b128 
Dealt to Hero [Kc 8d]
Dealt to 9f70f94d 
Dealt to 192a8fb5 
Hero: folds
9f70f94d: raises $0.05 to $0.1
192a8fb5: folds
f3fc119a: folds
5db4cca: calls $0.08
5265b128: folds
*** FLOP *** [7h 5d Js]
5db4cca: checks
9f70f94d: bets $0.07
5db4cca: calls $0.07
*** TURN *** [7h 5d Js] [Ah]
5db4cca: checks
9f70f94d: bets $0.3
5db4cca: calls $0.3
*** RIVER *** [7h 5d Js Ah] [6c]
5db4cca: checks
9f70f94d: bets $0.52
5db4cca: calls $0.52
9f70f94d: shows [Jh Ac] (Pair of Aces and Pair of Jacks)
5db4cca: shows [9d Ad] (Pair of Aces)
*** SHOWDOWN ***
9f70f94d collected $1.87 from pot
*** SUMMARY ***
Total pot $2.03 | Rake $0.09 | Jackpot $0.07 | Bingo $0 | Fortune $0 | Tax $0
Board [7h 5d Js Ah 6c]
Seat 1: f3fc119a (button) folded before Flop (didn't bet)
Seat 2: 5db4cca (small blind) showed [9d Ad] and lost with Pair of Aces
Seat 3: 5265b128 (big blind) folded before Flop
Seat 4: Hero folded before Flop (didn't bet)
Seat 5: 9f70f94d showed [Jh Ac] and won ($1.87) with Pair of Aces and Pair of Jacks
Seat 6: 192a8fb5 folded before Flop (didn't bet)


Poker Hand #RC3334437770: Hold'em No Limit ($0.02/$0.05) - 2025/02/17 20:36:08
Table 'RushAndCash603030' 6-max Seat #1 is the button
Seat 1: Hero ($5.72 in chips)
Seat 2: e2a2e9b3 ($5.21 in chips)
Seat 3: b9d877b0 ($6.5 in chips)
Seat 4: ef7e6107 ($5.02 in chips)
Seat 5: 76f4e455 ($4.86 in chips)
Seat 6: 94c257a9 ($4.98 in chips)
e2a2e9b3: posts small blind $0.02
b9d877b0: posts big blind $0.05
*** HOLE CARDS ***
Dealt to Hero [Jh Qh]
Dealt to e2a2e9b3 
Dealt to b9d877b0 
Dealt to ef7e6107 
Dealt to 76f4e455 
Dealt to 94c257a9 
ef7e6107: folds
76f4e455: folds
94c257a9: folds
Hero: raises $0.05 to $0.1
e2a2e9b3: folds
b9d877b0: folds
Uncalled bet ($0.05) returned to Hero
*** SHOWDOWN ***
Hero collected $0.12 from pot
*** SUMMARY ***
Total pot $0.12 | Rake $0 | Jackpot $0 | Bingo $0 | Fortune $0 | Tax $0
Seat 1: Hero (button) collected ($0.12)
Seat 2: e2a2e9b3 (small blind) folded before Flop
Seat 3: b9d877b0 (big blind) folded before Flop
Seat 4: ef7e6107 folded before Flop (didn't bet)
Seat 5: 76f4e455 folded before Flop (didn't bet)
Seat 6: 94c257a9 folded before Flop (didn't bet)


Poker Hand #RC3334437711: Hold'em No Limit ($0.02/$0.05) - 2025/02/17 20:36:00
Table 'RushAndCash602971' 6-max Seat #1 is the button
Seat 1: d0316f8a ($5.07 in chips)
Seat 2: b144f063 ($12.18 in chips)
Seat 3: Hero ($5.77 in chips)
Seat 4: e877c9db ($5.07 in chips)
Seat 5: 93735ac4 ($2.55 in chips)
Seat 6: cf593991 ($5.04 in chips)
b144f063: posts small blind $0.02
Hero: posts big blind $0.05
*** HOLE CARDS ***
Dealt to d0316f8a 
Dealt to b144f063 
Dealt to Hero [Kh 2c]
Dealt to e877c9db 
Dealt to 93735ac4 
Dealt to cf593991 
e877c9db: folds
93735ac4: folds
cf593991: folds
d0316f8a: folds
b144f063: raises $0.1 to $0.15
Hero: folds
Uncalled bet ($0.1) returned to b144f063
*** SHOWDOWN ***
b144f063 collected $0.1 from pot
*** SUMMARY ***
Total pot $0.1 | Rake $0 | Jackpot $0 | Bingo $0 | Fortune $0 | Tax $0
Seat 1: d0316f8a (button) folded before Flop (didn't bet)
Seat 2: b144f063 (small blind) collected ($0.1)
Seat 3: Hero (big blind) folded before Flop
Seat 4: e877c9db folded before Flop (didn't bet)
Seat 5: 93735ac4 folded before Flop (didn't bet)
Seat 6: cf593991 folded before Flop (didn't bet)


Poker Hand #RC3334437688: Hold'em No Limit ($0.02/$0.05) - 2025/02/17 20:35:57
Table 'RushAndCash602948' 6-max Seat #1 is the button
Seat 1: 656af102 ($7.5 in chips)
Seat 2: 200ba768 ($4.63 in chips)
Seat 3: Hero ($5.82 in chips)
Seat 4: b64a83d ($7.72 in chips)
Seat 5: e390e48e ($6.51 in chips)
Seat 6: 4509bd14 ($5.37 in chips)
200ba768: posts small blind $0.02
Hero: posts big blind $0.05
*** HOLE CARDS ***
Dealt to 656af102 
Dealt to 200ba768 
Dealt to Hero [5d Jc]
Dealt to b64a83d 
Dealt to e390e48e 
Dealt to 4509bd14 
b64a83d: folds
e390e48e: folds
4509bd14: folds
656af102: raises $0.08 to $0.13
200ba768: folds
Hero: folds
Uncalled bet ($0.08) returned to 656af102
*** SHOWDOWN ***
656af102 collected $0.12 from pot
*** SUMMARY ***
Total pot $0.12 | Rake $0 | Jackpot $0 | Bingo $0 | Fortune $0 | Tax $0
Seat 1: 656af102 (button) collected ($0.12)
Seat 2: 200ba768 (small blind) folded before Flop
Seat 3: Hero (big blind) folded before Flop
Seat 4: b64a83d folded before Flop (didn't bet)
Seat 5: e390e48e folded before Flop (didn't bet)
Seat 6: 4509bd14 folded before Flop (didn't bet)


Poker Hand #RC3334437668: Hold'em No Limit ($0.02/$0.05) - 2025/02/17 20:35:54
Table 'RushAndCash602928' 6-max Seat #1 is the button
Seat 1: e4d8df1d ($8.05 in chips)
Seat 2: Hero ($5.84 in chips)
Seat 3: 78b1f985 ($5 in chips)
Seat 4: b0d0d63c ($7.97 in chips)
Seat 5: 902b47de ($5.14 in chips)
Seat 6: f71f9fc0 ($4.82 in chips)
Hero: posts small blind $0.02
78b1f985: posts big blind $0.05
*** HOLE CARDS ***
Dealt to e4d8df1d 
Dealt to Hero [3d Td]
Dealt to 78b1f985 
Dealt to b0d0d63c 
Dealt to 902b47de 
Dealt to f71f9fc0 
b0d0d63c: folds
902b47de: folds
f71f9fc0: folds
e4d8df1d: raises $0.05 to $0.1
Hero: folds
78b1f985: folds
Uncalled bet ($0.05) returned to e4d8df1d
*** SHOWDOWN ***
e4d8df1d collected $0.12 from pot
*** SUMMARY ***
Total pot $0.12 | Rake $0 | Jackpot $0 | Bingo $0 | Fortune $0 | Tax $0
Seat 1: e4d8df1d (button) collected ($0.12)
Seat 2: Hero (small blind) folded before Flop
Seat 3: 78b1f985 (big blind) folded before Flop
Seat 4: b0d0d63c folded before Flop (didn't bet)
Seat 5: 902b47de folded before Flop (didn't bet)
Seat 6: f71f9fc0 folded before Flop (didn't bet)


Poker Hand #RC3334437645: Hold'em No Limit ($0.02/$0.05) - 2025/02/17 20:35:51
Table 'RushAndCash602905' 6-max Seat #1 is the button
Seat 1: 5197516b ($5.12 in chips)
Seat 2: 186b316a ($5.04 in chips)
Seat 3: 6ccee5c1 ($5.45 in chips)
Seat 4: Hero ($5.84 in chips)
Seat 5: 8282d87b ($5.64 in chips)
Seat 6: 8508a44f ($5 in chips)
186b316a: posts small blind $0.02
6ccee5c1: posts big blind $0.05
*** HOLE CARDS ***
Dealt to 5197516b 
Dealt to 186b316a 
Dealt to 6ccee5c1 
Dealt to Hero [Ks 2s]
Dealt to 8282d87b 
Dealt to 8508a44f 
Hero: folds
8282d87b: folds
8508a44f: folds
5197516b: folds
186b316a: folds
Uncalled bet ($0.03) returned to 6ccee5c1
*** SHOWDOWN ***
6ccee5c1 collected $0.04 from pot
*** SUMMARY ***
Total pot $0.04 | Rake $0 | Jackpot $0 | Bingo $0 | Fortune $0 | Tax $0
Seat 1: 5197516b (button) folded before Flop (didn't bet)
Seat 2: 186b316a (small blind) folded before Flop
Seat 3: 6ccee5c1 (big blind) collected ($0.04)
Seat 4: Hero folded before Flop (didn't bet)
Seat 5: 8282d87b folded before Flop (didn't bet)
Seat 6: 8508a44f folded before Flop (didn't bet)


Poker Hand #RC3334437367: Hold'em No Limit ($0.02/$0.05) - 2025/02/17 20:35:13
Table 'RushAndCash602627' 6-max Seat #1 is the button
Seat 1: 7f79d927 ($9.63 in chips)
Seat 2: 92fa3d91 ($3.01 in chips)
Seat 3: ead6cfaf ($5.42 in chips)
Seat 4: fa40c39c ($5.38 in chips)
Seat 5: 6b62a9a6 ($5.28 in chips)
Seat 6: Hero ($5.4 in chips)
92fa3d91: posts small blind $0.02
ead6cfaf: posts big blind $0.05
*** HOLE CARDS ***
Dealt to 7f79d927 
Dealt to 92fa3d91 
Dealt to ead6cfaf 
Dealt to fa40c39c 
Dealt to 6b62a9a6 
Dealt to Hero [Td Ks]
fa40c39c: folds
6b62a9a6: folds
Hero: raises $0.05 to $0.1
7f79d927: folds
92fa3d91: folds
ead6cfaf: calls $0.05
*** FLOP *** [Tc Kd Th]
ead6cfaf: checks
Hero: checks
*** TURN *** [Tc Kd Th] [2h]
ead6cfaf: checks
Hero: bets $0.12
ead6cfaf: calls $0.12
*** RIVER *** [Tc Kd Th 2h] [2c]
ead6cfaf: checks
Hero: bets $0.24
ead6cfaf: calls $0.24
Hero: shows [Td Ks] (Tens Full over Kings)
ead6cfaf: shows [Kc Qh] (Pair of Kings and Pair of Tens)
*** SHOWDOWN ***
Hero collected $0.9 from pot
*** SUMMARY ***
Total pot $0.94 | Rake $0.04 | Jackpot $0 | Bingo $0 | Fortune $0 | Tax $0
Board [Tc Kd Th 2h 2c]
Seat 1: 7f79d927 (button) folded before Flop (didn't bet)
Seat 2: 92fa3d91 (small blind) folded before Flop
Seat 3: ead6cfaf (big blind) showed [Kc Qh] and lost with Pair of Kings and Pair of Tens
Seat 4: fa40c39c folded before Flop (didn't bet)
Seat 5: 6b62a9a6 folded before Flop (didn't bet)
Seat 6: Hero showed [Td Ks] and won ($0.9) with Tens Full over Kings


Poker Hand #RC3334437347: Hold'em No Limit ($0.02/$0.05) - 2025/02/17 20:35:10
Table 'RushAndCash602607' 6-max Seat #1 is the button
Seat 1: f2e82cf4 ($5.53 in chips)
Seat 2: f171b990 ($7.14 in chips)
Seat 3: 4264790d ($5 in chips)
Seat 4: 7f79d927 ($9.63 in chips)
Seat 5: Hero ($5.4 in chips)
Seat 6: b45daa8e ($3.62 in chips)
f171b990: posts small blind $0.02
4264790d: posts big blind $0.05
*** HOLE CARDS ***
Dealt to f2e82cf4 
Dealt to f171b990 
Dealt to 4264790d 
Dealt to 7f79d927 
Dealt to Hero [2s Tc]
Dealt to b45daa8e 
7f79d927: folds
Hero: folds
b45daa8e: raises $0.07 to $0.12
f2e82cf4: folds
f171b990: folds
4264790d: calls $0.07
*** FLOP *** [Jc 4h Qh]
4264790d: checks
b45daa8e: checks
*** TURN *** [Jc 4h Qh] [Qd]
4264790d: bets $0.2
b45daa8e: calls $0.2
*** RIVER *** [Jc 4h Qh Qd] [Td]
4264790d: bets $0.52
b45daa8e: folds
Uncalled bet ($0.52) returned to 4264790d
*** SHOWDOWN ***
4264790d collected $0.63 from pot
*** SUMMARY ***
Total pot $0.66 | Rake $0.03 | Jackpot $0 | Bingo $0 | Fortune $0 | Tax $0
Board [Jc 4h Qh Qd Td]
Seat 1: f2e82cf4 (button) folded before Flop (didn't bet)
Seat 2: f171b990 (small blind) folded before Flop
Seat 3: 4264790d (big blind) won ($0.63)
Seat 4: 7f79d927 folded before Flop (didn't bet)
Seat 5: Hero folded before Flop (didn't bet)
Seat 6: b45daa8e folded on the River


Poker Hand #RC3334437296: Hold'em No Limit ($0.02/$0.05) - 2025/02/17 20:35:03
Table 'RushAndCash602556' 6-max Seat #1 is the button
Seat 1: 93735ac4 ($2.62 in chips)
Seat 2: Hero ($5.42 in chips)
Seat 3: 5db4cca ($5.89 in chips)
Seat 4: 1b8b89c1 ($5.48 in chips)
Seat 5: ef1a0dc2 ($5 in chips)
Seat 6: 3d2a56c8 ($5.91 in chips)
Hero: posts small blind $0.02
5db4cca: posts big blind $0.05
*** HOLE CARDS ***
Dealt to 93735ac4 
Dealt to Hero [3d 7d]
Dealt to 5db4cca 
Dealt to 1b8b89c1 
Dealt to ef1a0dc2 
Dealt to 3d2a56c8 
1b8b89c1: folds
ef1a0dc2: folds
3d2a56c8: folds
93735ac4: folds
Hero: folds
Uncalled bet ($0.03) returned to 5db4cca
*** SHOWDOWN ***
5db4cca collected $0.04 from pot
*** SUMMARY ***
Total pot $0.04 | Rake $0 | Jackpot $0 | Bingo $0 | Fortune $0 | Tax $0
Seat 1: 93735ac4 (button) folded before Flop (didn't bet)
Seat 2: Hero (small blind) folded before Flop
Seat 3: 5db4cca (big blind) collected ($0.04)
Seat 4: 1b8b89c1 folded before Flop (didn't bet)
Seat 5: ef1a0dc2 folded before Flop (didn't bet)
Seat 6: 3d2a56c8 folded before Flop (didn't bet)


Poker Hand #RC3334437257: Hold'em No Limit ($0.02/$0.05) - 2025/02/17 20:34:57
Table 'RushAndCash602517' 6-max Seat #1 is the button
Seat 1: 107b7bb3 ($6.37 in chips)
Seat 2: 93dfef8b ($11.68 in chips)
Seat 3: 9f974160 ($5 in chips)
Seat 4: Hero ($5.42 in chips)
Seat 5: f18b40b7 ($5 in chips)
Seat 6: 87d5083b ($17.11 in chips)
93dfef8b: posts small blind $0.02
9f974160: posts big blind $0.05
*** HOLE CARDS ***
Dealt to 107b7bb3 
Dealt to 93dfef8b 
Dealt to 9f974160 
Dealt to Hero [Jd 6s]
Dealt to f18b40b7 
Dealt to 87d5083b 
Hero: folds
f18b40b7: folds
87d5083b: folds
107b7bb3: folds
93dfef8b: folds
Uncalled bet ($0.03) returned to 9f974160
*** SHOWDOWN ***
9f974160 collected $0.04 from pot
*** SUMMARY ***
Total pot $0.04 | Rake $0 | Jackpot $0 | Bingo $0 | Fortune $0 | Tax $0
Seat 1: 107b7bb3 (button) folded before Flop (didn't bet)
Seat 2: 93dfef8b (small blind) folded before Flop
Seat 3: 9f974160 (big blind) collected ($0.04)
Seat 4: Hero folded before Flop (didn't bet)
Seat 5: f18b40b7 folded before Flop (didn't bet)
Seat 6: 87d5083b folded before Flop (didn't bet)


Poker Hand #RC3334437199: Hold'em No Limit ($0.02/$0.05) - 2025/02/17 20:34:48
Table 'RushAndCash602459' 6-max Seat #1 is the button
Seat 1: Hero ($5.42 in chips)
Seat 2: 12cda2e0 ($16.97 in chips)
Seat 3: 6c0f6dbf ($14.41 in chips)
Seat 4: eed867f5 ($4.68 in chips)
Seat 5: 8f9fd8b1 ($6.01 in chips)
Seat 6: e390e48e ($6.47 in chips)
12cda2e0: posts small blind $0.02
6c0f6dbf: posts big blind $0.05
*** HOLE CARDS ***
Dealt to Hero [3s Jc]
Dealt to 12cda2e0 
Dealt to 6c0f6dbf 
Dealt to eed867f5 
Dealt to 8f9fd8b1 
Dealt to e390e48e 
eed867f5: raises $0.05 to $0.1
8f9fd8b1: raises $0.21 to $0.31
e390e48e: folds
Hero: folds
12cda2e0: folds
6c0f6dbf: folds
eed867f5: folds
Uncalled bet ($0.21) returned to 8f9fd8b1
*** SHOWDOWN ***
8f9fd8b1 collected $0.26 from pot
*** SUMMARY ***
Total pot $0.27 | Rake $0.01 | Jackpot $0 | Bingo $0 | Fortune $0 | Tax $0
Seat 1: Hero (button) folded before Flop (didn't bet)
Seat 2: 12cda2e0 (small blind) folded before Flop
Seat 3: 6c0f6dbf (big blind) folded before Flop
Seat 4: eed867f5 folded before Flop
Seat 5: 8f9fd8b1 collected ($0.26)
Seat 6: e390e48e folded before Flop (didn't bet)


Poker Hand #RC3334437166: Hold'em No Limit ($0.02/$0.05) - 2025/02/17 20:34:43
Table 'RushAndCash602426' 6-max Seat #1 is the button
Seat 1: 7381628 ($5 in chips)
Seat 2: 13bdf34b ($3.26 in chips)
Seat 3: bbdadd69 ($5 in chips)
Seat 4: 428a90d4 ($4.38 in chips)
Seat 5: Hero ($5.42 in chips)
Seat 6: dbb7a28 ($12.51 in chips)
13bdf34b: posts small blind $0.02
bbdadd69: posts big blind $0.05
*** HOLE CARDS ***
Dealt to 7381628 
Dealt to 13bdf34b 
Dealt to bbdadd69 
Dealt to 428a90d4 
Dealt to Hero [3c Ac]
Dealt to dbb7a28 
428a90d4: folds
Hero: folds
dbb7a28: folds
7381628: folds
13bdf34b: folds
Uncalled bet ($0.03) returned to bbdadd69
*** SHOWDOWN ***
bbdadd69 collected $0.04 from pot
*** SUMMARY ***
Total pot $0.04 | Rake $0 | Jackpot $0 | Bingo $0 | Fortune $0 | Tax $0
Seat 1: 7381628 (button) folded before Flop (didn't bet)
Seat 2: 13bdf34b (small blind) folded before Flop
Seat 3: bbdadd69 (big blind) collected ($0.04)
Seat 4: 428a90d4 folded before Flop (didn't bet)
Seat 5: Hero folded before Flop (didn't bet)
Seat 6: dbb7a28 folded before Flop (didn't bet)


Poker Hand #RC3334436945: Hold'em No Limit ($0.02/$0.05) - 2025/02/17 20:34:12
Table 'RushAndCash602205' 6-max Seat #1 is the button
Seat 1: 14620cce ($16.02 in chips)
Seat 2: Hero ($5.28 in chips)
Seat 3: 13bdf34b ($3.41 in chips)
Seat 4: bb702030 ($7.09 in chips)
Seat 5: 742ccfee ($4.09 in chips)
Seat 6: 835df346 ($13.93 in chips)
Hero: posts small blind $0.02
13bdf34b: posts big blind $0.05
*** HOLE CARDS ***
Dealt to 14620cce 
Dealt to Hero [Qc Kh]
Dealt to 13bdf34b 
Dealt to bb702030 
Dealt to 742ccfee 
Dealt to 835df346 
bb702030: folds
742ccfee: folds
835df346: folds
14620cce: folds
Hero: raises $0.1 to $0.15
13bdf34b: calls $0.1
*** FLOP *** [5s 8h 7c]
Hero: checks
13bdf34b: checks
*** TURN *** [5s 8h 7c] [Th]
Hero: checks
13bdf34b: checks
*** RIVER *** [5s 8h 7c Th] [5c]
Hero: checks
13bdf34b: checks
Hero: shows [Qc Kh] (Pair of Fives)
13bdf34b: shows [Jd 4d] (Pair of Fives)
*** SHOWDOWN ***
Hero collected $0.29 from pot
*** SUMMARY ***
Total pot $0.3 | Rake $0.01 | Jackpot $0 | Bingo $0 | Fortune $0 | Tax $0
Board [5s 8h 7c Th 5c]
Seat 1: 14620cce (button) folded before Flop (didn't bet)
Seat 2: Hero (small blind) showed [Qc Kh] and won ($0.29) with Pair of Fives
Seat 3: 13bdf34b (big blind) showed [Jd 4d] and lost with Pair of Fives
Seat 4: bb702030 folded before Flop (didn't bet)
Seat 5: 742ccfee folded before Flop (didn't bet)
Seat 6: 835df346 folded before Flop (didn't bet)


Poker Hand #RC3334436869: Hold'em No Limit ($0.02/$0.05) - 2025/02/17 20:34:01
Table 'RushAndCash602129' 6-max Seat #1 is the button
Seat 1: 1dbfd698 ($7.95 in chips)
Seat 2: 1d2427ef ($5.47 in chips)
Seat 3: c5f53436 ($6.45 in chips)
Seat 4: 653af57c ($5.55 in chips)
Seat 5: a2794999 ($8.07 in chips)
Seat 6: Hero ($5.38 in chips)
1d2427ef: posts small blind $0.02
c5f53436: posts big blind $0.05
*** HOLE CARDS ***
Dealt to 1dbfd698 
Dealt to 1d2427ef 
Dealt to c5f53436 
Dealt to 653af57c 
Dealt to a2794999 
Dealt to Hero [3c 4c]
653af57c: folds
a2794999: folds
Hero: raises $0.05 to $0.1
1dbfd698: raises $0.17 to $0.27
1d2427ef: folds
c5f53436: folds
Hero: folds
Uncalled bet ($0.17) returned to 1dbfd698
*** SHOWDOWN ***
1dbfd698 collected $0.26 from pot
*** SUMMARY ***
Total pot $0.27 | Rake $0.01 | Jackpot $0 | Bingo $0 | Fortune $0 | Tax $0
Seat 1: 1dbfd698 (button) collected ($0.26)
Seat 2: 1d2427ef (small blind) folded before Flop
Seat 3: c5f53436 (big blind) folded before Flop
Seat 4: 653af57c folded before Flop (didn't bet)
Seat 5: a2794999 folded before Flop (didn't bet)
Seat 6: Hero folded before Flop


Poker Hand #RC3334436847: Hold'em No Limit ($0.02/$0.05) - 2025/02/17 20:33:58
Table 'RushAndCash602107' 6-max Seat #1 is the button
Seat 1: Hero ($5.38 in chips)
Seat 2: 72fa4c0f ($2.95 in chips)
Seat 3: 85ef1c62 ($5.9 in chips)
Seat 4: c4375e01 ($5 in chips)
Seat 5: 860b5247 ($8.06 in chips)
Seat 6: 3ffd6491 ($5 in chips)
72fa4c0f: posts small blind $0.02
85ef1c62: posts big blind $0.05
*** HOLE CARDS ***
Dealt to Hero [6s Qh]
Dealt to 72fa4c0f 
Dealt to 85ef1c62 
Dealt to c4375e01 
Dealt to 860b5247 
Dealt to 3ffd6491 
c4375e01: folds
860b5247: folds
3ffd6491: raises $0.07 to $0.12
Hero: folds
72fa4c0f: folds
85ef1c62: folds
Uncalled bet ($0.07) returned to 3ffd6491
*** SHOWDOWN ***
3ffd6491 collected $0.12 from pot
*** SUMMARY ***
Total pot $0.12 | Rake $0 | Jackpot $0 | Bingo $0 | Fortune $0 | Tax $0
Seat 1: Hero (button) folded before Flop (didn't bet)
Seat 2: 72fa4c0f (small blind) folded before Flop
Seat 3: 85ef1c62 (big blind) folded before Flop
Seat 4: c4375e01 folded before Flop (didn't bet)
Seat 5: 860b5247 folded before Flop (didn't bet)
Seat 6: 3ffd6491 collected ($0.12)


Poker Hand #RC3334436634: Hold'em No Limit ($0.02/$0.05) - 2025/02/17 20:33:26
Table 'RushAndCash601894' 6-max Seat #1 is the button
Seat 1: 1ea0f381 ($5.35 in chips)
Seat 2: 6c8cb957 ($5.37 in chips)
Seat 3: Hero ($5.49 in chips)
Seat 4: 16f2e5ce ($6.44 in chips)
Seat 5: 24c4874c ($4.96 in chips)
Seat 6: 38a4c833 ($14.38 in chips)
6c8cb957: posts small blind $0.02
Hero: posts big blind $0.05
*** HOLE CARDS ***
Dealt to 1ea0f381 
Dealt to 6c8cb957 
Dealt to Hero [8d Js]
Dealt to 16f2e5ce 
Dealt to 24c4874c 
Dealt to 38a4c833 
16f2e5ce: folds
24c4874c: raises $0.06 to $0.11
38a4c833: calls $0.11
1ea0f381: calls $0.11
6c8cb957: folds
Hero: calls $0.06
*** FLOP *** [Td 3s 6d]
Hero: checks
24c4874c: checks
38a4c833: bets $0.23
1ea0f381: calls $0.23
Hero: folds
24c4874c: raises $0.58 to $0.81
38a4c833: calls $0.58
1ea0f381: folds
*** TURN *** [Td 3s 6d] [3c]
24c4874c: bets $1.74
38a4c833: calls $1.74
*** RIVER *** [Td 3s 6d 3c] [9d]
24c4874c: bets $2.3 and is all-in
38a4c833: folds
Uncalled bet ($2.3) returned to 24c4874c
*** SHOWDOWN ***
24c4874c collected $5.57 from pot
*** SUMMARY ***
Total pot $5.79 | Rake $0.15 | Jackpot $0.07 | Bingo $0 | Fortune $0 | Tax $0
Board [Td 3s 6d 3c 9d]
Seat 1: 1ea0f381 (button) folded on the Flop
Seat 2: 6c8cb957 (small blind) folded before Flop
Seat 3: Hero (big blind) folded on the Flop
Seat 4: 16f2e5ce folded before Flop (didn't bet)
Seat 5: 24c4874c won ($5.57)
Seat 6: 38a4c833 folded on the River


Poker Hand #RC3334436607: Hold'em No Limit ($0.02/$0.05) - 2025/02/17 20:33:22
Table 'RushAndCash601867' 6-max Seat #1 is the button
Seat 1: 735c4afd ($5 in chips)
Seat 2: 59b37309 ($1.85 in chips)
Seat 3: a9af8bb8 ($5.25 in chips)
Seat 4: Hero ($5.49 in chips)
Seat 5: f1ef2c72 ($9.71 in chips)
Seat 6: 50053f22 ($6.17 in chips)
59b37309: posts small blind $0.02
a9af8bb8: posts big blind $0.05
*** HOLE CARDS ***
Dealt to 735c4afd 
Dealt to 59b37309 
Dealt to a9af8bb8 
Dealt to Hero [5c Th]
Dealt to f1ef2c72 
Dealt to 50053f22 
Hero: folds
f1ef2c72: raises $0.05 to $0.1
50053f22: folds
735c4afd: folds
59b37309: folds
a9af8bb8: folds
Uncalled bet ($0.05) returned to f1ef2c72
*** SHOWDOWN ***
f1ef2c72 collected $0.12 from pot
*** SUMMARY ***
Total pot $0.12 | Rake $0 | Jackpot $0 | Bingo $0 | Fortune $0 | Tax $0
Seat 1: 735c4afd (button) folded before Flop (didn't bet)
Seat 2: 59b37309 (small blind) folded before Flop
Seat 3: a9af8bb8 (big blind) folded before Flop
Seat 4: Hero folded before Flop (didn't bet)
Seat 5: f1ef2c72 collected ($0.12)
Seat 6: 50053f22 folded before Flop (didn't bet)


Poker Hand #RC3334436543: Hold'em No Limit ($0.02/$0.05) - 2025/02/17 20:33:13
Table 'RushAndCash601803' 6-max Seat #1 is the button
Seat 1: 7c6398ab ($2 in chips)
Seat 2: 7f3dcda7 ($9.16 in chips)
Seat 3: 31bef4 ($4.42 in chips)
Seat 4: 9c13950e ($2.8 in chips)
Seat 5: 722fd48f ($5 in chips)
Seat 6: Hero ($5.35 in chips)
7f3dcda7: posts small blind $0.02
31bef4: posts big blind $0.05
*** HOLE CARDS ***
Dealt to 7c6398ab 
Dealt to 7f3dcda7 
Dealt to 31bef4 
Dealt to 9c13950e 
Dealt to 722fd48f 
Dealt to Hero [Ac Jh]
9c13950e: folds
722fd48f: folds
Hero: raises $0.05 to $0.1
7c6398ab: folds
7f3dcda7: folds
31bef4: folds
Uncalled bet ($0.05) returned to Hero
*** SHOWDOWN ***
Hero collected $0.12 from pot
*** SUMMARY ***
Total pot $0.12 | Rake $0 | Jackpot $0 | Bingo $0 | Fortune $0 | Tax $0
Seat 1: 7c6398ab (button) folded before Flop (didn't bet)
Seat 2: 7f3dcda7 (small blind) folded before Flop
Seat 3: 31bef4 (big blind) folded before Flop
Seat 4: 9c13950e folded before Flop (didn't bet)
Seat 5: 722fd48f folded before Flop (didn't bet)
Seat 6: Hero collected ($0.12)


Poker Hand #RC3334436511: Hold'em No Limit ($0.02/$0.05) - 2025/02/17 20:33:09
Table 'RushAndCash601771' 6-max Seat #1 is the button
Seat 1: 11fb4d12 ($9.33 in chips)
Seat 2: cd1f87c8 ($3.7 in chips)
Seat 3: Hero ($5.4 in chips)
Seat 4: eed867f5 ($4.61 in chips)
Seat 5: 730098b8 ($7.45 in chips)
Seat 6: bbdadd69 ($5.55 in chips)
cd1f87c8: posts small blind $0.02
Hero: posts big blind $0.05
*** HOLE CARDS ***
Dealt to 11fb4d12 
Dealt to cd1f87c8 
Dealt to Hero [9c Td]
Dealt to eed867f5 
Dealt to 730098b8 
Dealt to bbdadd69 
eed867f5: folds
730098b8: folds
bbdadd69: folds
11fb4d12: folds
cd1f87c8: folds
Uncalled bet ($0.03) returned to Hero
*** SHOWDOWN ***
Hero collected $0.04 from pot
*** SUMMARY ***
Total pot $0.04 | Rake $0 | Jackpot $0 | Bingo $0 | Fortune $0 | Tax $0
Seat 1: 11fb4d12 (button) folded before Flop (didn't bet)
Seat 2: cd1f87c8 (small blind) folded before Flop
Seat 3: Hero (big blind) collected ($0.04)
Seat 4: eed867f5 folded before Flop (didn't bet)
Seat 5: 730098b8 folded before Flop (didn't bet)
Seat 6: bbdadd69 folded before Flop (didn't bet)


Poker Hand #RC3334436489: Hold'em No Limit ($0.02/$0.05) - 2025/02/17 20:33:06
Table 'RushAndCash601749' 6-max Seat #1 is the button
Seat 1: d201e5fe ($7.29 in chips)
Seat 2: bbdadd69 ($5.57 in chips)
Seat 3: 7b0e5cb2 ($5 in chips)
Seat 4: 3b85f8e6 ($12.72 in chips)
Seat 5: Hero ($5.4 in chips)
Seat 6: 742ccfee ($4.02 in chips)
bbdadd69: posts small blind $0.02
7b0e5cb2: posts big blind $0.05
*** HOLE CARDS ***
Dealt to d201e5fe 
Dealt to bbdadd69 
Dealt to 7b0e5cb2 
Dealt to 3b85f8e6 
Dealt to Hero [9s 2h]
Dealt to 742ccfee 
3b85f8e6: folds
Hero: folds
742ccfee: folds
d201e5fe: raises $0.08 to $0.13
bbdadd69: folds
7b0e5cb2: raises $0.28 to $0.41
d201e5fe: folds
Uncalled bet ($0.28) returned to 7b0e5cb2
*** SHOWDOWN ***
7b0e5cb2 collected $0.27 from pot
*** SUMMARY ***
Total pot $0.28 | Rake $0.01 | Jackpot $0 | Bingo $0 | Fortune $0 | Tax $0
Seat 1: d201e5fe (button) folded before Flop
Seat 2: bbdadd69 (small blind) folded before Flop
Seat 3: 7b0e5cb2 (big blind) collected ($0.27)
Seat 4: 3b85f8e6 folded before Flop (didn't bet)
Seat 5: Hero folded before Flop (didn't bet)
Seat 6: 742ccfee folded before Flop (didn't bet)


Poker Hand #RC3334436458: Hold'em No Limit ($0.02/$0.05) - 2025/02/17 20:33:02
Table 'RushAndCash601718' 6-max Seat #1 is the button
Seat 1: f6655046 ($5.12 in chips)
Seat 2: 62156df3 ($5.02 in chips)
Seat 3: 835df346 ($14.25 in chips)
Seat 4: 42fca4f9 ($9.95 in chips)
Seat 5: bb702030 ($7.62 in chips)
Seat 6: Hero ($5.4 in chips)
62156df3: posts small blind $0.02
835df346: posts big blind $0.05
*** HOLE CARDS ***
Dealt to f6655046 
Dealt to 62156df3 
Dealt to 835df346 
Dealt to 42fca4f9 
Dealt to bb702030 
Dealt to Hero [4c 6d]
42fca4f9: folds
bb702030: folds
Hero: folds
f6655046: raises $0.08 to $0.13
62156df3: folds
835df346: folds
Uncalled bet ($0.08) returned to f6655046
*** SHOWDOWN ***
f6655046 collected $0.12 from pot
*** SUMMARY ***
Total pot $0.12 | Rake $0 | Jackpot $0 | Bingo $0 | Fortune $0 | Tax $0
Seat 1: f6655046 (button) collected ($0.12)
Seat 2: 62156df3 (small blind) folded before Flop
Seat 3: 835df346 (big blind) folded before Flop
Seat 4: 42fca4f9 folded before Flop (didn't bet)
Seat 5: bb702030 folded before Flop (didn't bet)
Seat 6: Hero folded before Flop (didn't bet)


Poker Hand #RC3334436433: Hold'em No Limit ($0.02/$0.05) - 2025/02/17 20:32:58
Table 'RushAndCash601693' 6-max Seat #1 is the button
Seat 1: 2d2e416 ($1.93 in chips)
Seat 2: Hero ($5.42 in chips)
Seat 3: 731e166b ($5.59 in chips)
Seat 4: 653af57c ($5.29 in chips)
Seat 5: d738c756 ($3.51 in chips)
Seat 6: 5cfc658c ($4.54 in chips)
Hero: posts small blind $0.02
731e166b: posts big blind $0.05
*** HOLE CARDS ***
Dealt to 2d2e416 
Dealt to Hero [Ac 4s]
Dealt to 731e166b 
Dealt to 653af57c 
Dealt to d738c756 
Dealt to 5cfc658c 
653af57c: folds
d738c756: folds
5cfc658c: raises $0.07 to $0.12
2d2e416: folds
Hero: folds
731e166b: folds
Uncalled bet ($0.07) returned to 5cfc658c
*** SHOWDOWN ***
5cfc658c collected $0.12 from pot
*** SUMMARY ***
Total pot $0.12 | Rake $0 | Jackpot $0 | Bingo $0 | Fortune $0 | Tax $0
Seat 1: 2d2e416 (button) folded before Flop (didn't bet)
Seat 2: Hero (small blind) folded before Flop
Seat 3: 731e166b (big blind) folded before Flop
Seat 4: 653af57c folded before Flop (didn't bet)
Seat 5: d738c756 folded before Flop (didn't bet)
Seat 6: 5cfc658c collected ($0.12)


Poker Hand #RC3334436406: Hold'em No Limit ($0.02/$0.05) - 2025/02/17 20:32:54
Table 'RushAndCash601666' 6-max Seat #1 is the button
Seat 1: 872a76d3 ($5.32 in chips)
Seat 2: 11fb4d12 ($9.35 in chips)
Seat 3: 62156df3 ($5 in chips)
Seat 4: f1f26d78 ($9.71 in chips)
Seat 5: Hero ($5.42 in chips)
Seat 6: e4fd27d ($4.46 in chips)
11fb4d12: posts small blind $0.02
62156df3: posts big blind $0.05
*** HOLE CARDS ***
Dealt to 872a76d3 
Dealt to 11fb4d12 
Dealt to 62156df3 
Dealt to f1f26d78 
Dealt to Hero [Js Th]
Dealt to e4fd27d 
f1f26d78: folds
Hero: folds
e4fd27d: folds
872a76d3: folds
11fb4d12: folds
Uncalled bet ($0.03) returned to 62156df3
*** SHOWDOWN ***
62156df3 collected $0.04 from pot
*** SUMMARY ***
Total pot $0.04 | Rake $0 | Jackpot $0 | Bingo $0 | Fortune $0 | Tax $0
Seat 1: 872a76d3 (button) folded before Flop (didn't bet)
Seat 2: 11fb4d12 (small blind) folded before Flop
Seat 3: 62156df3 (big blind) collected ($0.04)
Seat 4: f1f26d78 folded before Flop (didn't bet)
Seat 5: Hero folded before Flop (didn't bet)
Seat 6: e4fd27d folded before Flop (didn't bet)


Poker Hand #RC3334436383: Hold'em No Limit ($0.02/$0.05) - 2025/02/17 20:32:50
Table 'RushAndCash601643' 6-max Seat #1 is the button
Seat 1: Hero ($5.42 in chips)
Seat 2: cbfd6c92 ($4.92 in chips)
Seat 3: 188c8947 ($4.06 in chips)
Seat 4: 872a76d3 ($5.32 in chips)
Seat 5: 88f21ca8 ($5.65 in chips)
Seat 6: e4fd27d ($4.46 in chips)
cbfd6c92: posts small blind $0.02
188c8947: posts big blind $0.05
*** HOLE CARDS ***
Dealt to Hero [Qh 7d]
Dealt to cbfd6c92 
Dealt to 188c8947 
Dealt to 872a76d3 
Dealt to 88f21ca8 
Dealt to e4fd27d 
872a76d3: folds
88f21ca8: folds
e4fd27d: folds
Hero: folds
cbfd6c92: raises $0.08 to $0.13
188c8947: calls $0.08
*** FLOP *** [Ks Qd 6h]
cbfd6c92: bets $0.09
188c8947: folds
Uncalled bet ($0.09) returned to cbfd6c92
*** SHOWDOWN ***
cbfd6c92 collected $0.25 from pot
*** SUMMARY ***
Total pot $0.26 | Rake $0.01 | Jackpot $0 | Bingo $0 | Fortune $0 | Tax $0
Board [Ks Qd 6h]
Seat 1: Hero (button) folded before Flop (didn't bet)
Seat 2: cbfd6c92 (small blind) won ($0.25)
Seat 3: 188c8947 (big blind) folded on the Flop
Seat 4: 872a76d3 folded before Flop (didn't bet)
Seat 5: 88f21ca8 folded before Flop (didn't bet)
Seat 6: e4fd27d folded before Flop (didn't bet)


Poker Hand #RC3334436355: Hold'em No Limit ($0.02/$0.05) - 2025/02/17 20:32:46
Table 'RushAndCash601615' 6-max Seat #1 is the button
Seat 1: bb702030 ($7.6 in chips)
Seat 2: 4e55fa29 ($4.75 in chips)
Seat 3: f20f94d9 ($5.93 in chips)
Seat 4: Hero ($5.42 in chips)
Seat 5: 1f187ba0 ($6.41 in chips)
Seat 6: ce479ad2 ($5 in chips)
4e55fa29: posts small blind $0.02
f20f94d9: posts big blind $0.05
*** HOLE CARDS ***
Dealt to bb702030 
Dealt to 4e55fa29 
Dealt to f20f94d9 
Dealt to Hero [Qd 4c]
Dealt to 1f187ba0 
Dealt to ce479ad2 
Hero: folds
1f187ba0: folds
ce479ad2: folds
bb702030: raises $0.07 to $0.12
4e55fa29: folds
f20f94d9: folds
Uncalled bet ($0.07) returned to bb702030
*** SHOWDOWN ***
bb702030 collected $0.12 from pot
*** SUMMARY ***
Total pot $0.12 | Rake $0 | Jackpot $0 | Bingo $0 | Fortune $0 | Tax $0
Seat 1: bb702030 (button) collected ($0.12)
Seat 2: 4e55fa29 (small blind) folded before Flop
Seat 3: f20f94d9 (big blind) folded before Flop
Seat 4: Hero folded before Flop (didn't bet)
Seat 5: 1f187ba0 folded before Flop (didn't bet)
Seat 6: ce479ad2 folded before Flop (didn't bet)


Poker Hand #RC3334436332: Hold'em No Limit ($0.02/$0.05) - 2025/02/17 20:32:43
Table 'RushAndCash601592' 6-max Seat #1 is the button
Seat 1: 6c6b017a ($6.15 in chips)
Seat 2: d0316f8a ($5 in chips)
Seat 3: Hero ($5.47 in chips)
Seat 4: c92a5ecb ($5.16 in chips)
Seat 5: 886c894a ($9.27 in chips)
Seat 6: 200ba768 ($4.27 in chips)
d0316f8a: posts small blind $0.02
Hero: posts big blind $0.05
*** HOLE CARDS ***
Dealt to 6c6b017a 
Dealt to d0316f8a 
Dealt to Hero [6h Kd]
Dealt to c92a5ecb 
Dealt to 886c894a 
Dealt to 200ba768 
c92a5ecb: raises $0.05 to $0.1
886c894a: folds
200ba768: folds
6c6b017a: folds
d0316f8a: calls $0.08
Hero: folds
*** FLOP *** [6c 8h 4h]
d0316f8a: checks
c92a5ecb: checks
*** TURN *** [6c 8h 4h] [Kh]
d0316f8a: checks
c92a5ecb: checks
*** RIVER *** [6c 8h 4h Kh] [Jh]
d0316f8a: checks
c92a5ecb: checks
d0316f8a: shows [2c Ac] (Ace-High)
c92a5ecb: shows [7s 7d] (Pair of Sevens)
*** SHOWDOWN ***
c92a5ecb collected $0.24 from pot
*** SUMMARY ***
Total pot $0.25 | Rake $0.01 | Jackpot $0 | Bingo $0 | Fortune $0 | Tax $0
Board [6c 8h 4h Kh Jh]
Seat 1: 6c6b017a (button) folded before Flop (didn't bet)
Seat 2: d0316f8a (small blind) showed [2c Ac] and lost with Ace-High
Seat 3: Hero (big blind) folded before Flop
Seat 4: c92a5ecb showed [7s 7d] and won ($0.24) with Pair of Sevens
Seat 5: 886c894a folded before Flop (didn't bet)
Seat 6: 200ba768 folded before Flop (didn't bet)


Poker Hand #RC3334436307: Hold'em No Limit ($0.02/$0.05) - 2025/02/17 20:32:40
Table 'RushAndCash601567' 6-max Seat #1 is the button
Seat 1: Hero ($5.47 in chips)
Seat 2: 491e0e63 ($5 in chips)
Seat 3: bbdadd69 ($5.57 in chips)
Seat 4: fcad3124 ($5.76 in chips)
Seat 5: 3952cabf ($5 in chips)
Seat 6: bda9ba33 ($4.59 in chips)
491e0e63: posts small blind $0.02
bbdadd69: posts big blind $0.05
*** HOLE CARDS ***
Dealt to Hero [8s Tc]
Dealt to 491e0e63 
Dealt to bbdadd69 
Dealt to fcad3124 
Dealt to 3952cabf 
Dealt to bda9ba33 
fcad3124: folds
3952cabf: folds
bda9ba33: folds
Hero: folds
491e0e63: folds
Uncalled bet ($0.03) returned to bbdadd69
*** SHOWDOWN ***
bbdadd69 collected $0.04 from pot
*** SUMMARY ***
Total pot $0.04 | Rake $0 | Jackpot $0 | Bingo $0 | Fortune $0 | Tax $0
Seat 1: Hero (button) folded before Flop (didn't bet)
Seat 2: 491e0e63 (small blind) folded before Flop
Seat 3: bbdadd69 (big blind) collected ($0.04)
Seat 4: fcad3124 folded before Flop (didn't bet)
Seat 5: 3952cabf folded before Flop (didn't bet)
Seat 6: bda9ba33 folded before Flop (didn't bet)


Poker Hand #RC3334436187: Hold'em No Limit ($0.02/$0.05) - 2025/02/17 20:32:24
Table 'RushAndCash601447' 6-max Seat #1 is the button
Seat 1: 727998e7 ($7.62 in chips)
Seat 2: Hero ($5.6 in chips)
Seat 3: f1f26d78 ($9.47 in chips)
Seat 4: 692e3a83 ($12.66 in chips)
Seat 5: 55d86a7e ($8.33 in chips)
Seat 6: 9eb2937a ($4.9 in chips)
Hero: posts small blind $0.02
f1f26d78: posts big blind $0.05
*** HOLE CARDS ***
Dealt to 727998e7 
Dealt to Hero [Ts Ac]
Dealt to f1f26d78 
Dealt to 692e3a83 
Dealt to 55d86a7e 
Dealt to 9eb2937a 
692e3a83: folds
55d86a7e: folds
9eb2937a: raises $0.08 to $0.13
727998e7: folds
Hero: calls $0.11
f1f26d78: raises $0.48 to $0.61
9eb2937a: folds
Hero: folds
Uncalled bet ($0.48) returned to f1f26d78
*** SHOWDOWN ***
f1f26d78 collected $0.37 from pot
*** SUMMARY ***
Total pot $0.39 | Rake $0.02 | Jackpot $0 | Bingo $0 | Fortune $0 | Tax $0
Seat 1: 727998e7 (button) folded before Flop (didn't bet)
Seat 2: Hero (small blind) folded before Flop
Seat 3: f1f26d78 (big blind) collected ($0.37)
Seat 4: 692e3a83 folded before Flop (didn't bet)
Seat 5: 55d86a7e folded before Flop (didn't bet)
Seat 6: 9eb2937a folded before Flop


Poker Hand #RC3334436166: Hold'em No Limit ($0.02/$0.05) - 2025/02/17 20:32:21
Table 'RushAndCash601426' 6-max Seat #1 is the button
Seat 1: 3c1ddc3a ($6.69 in chips)
Seat 2: 87d5083b ($18.31 in chips)
Seat 3: 79df293 ($5.05 in chips)
Seat 4: Hero ($5.6 in chips)
Seat 5: 144ea2b0 ($10.72 in chips)
Seat 6: c585480d ($5.33 in chips)
87d5083b: posts small blind $0.02
79df293: posts big blind $0.05
*** HOLE CARDS ***
Dealt to 3c1ddc3a 
Dealt to 87d5083b 
Dealt to 79df293 
Dealt to Hero [4h 3d]
Dealt to 144ea2b0 
Dealt to c585480d 
Hero: folds
144ea2b0: folds
c585480d: folds
3c1ddc3a: folds
87d5083b: raises $0.08 to $0.13
79df293: raises $0.31 to $0.44
87d5083b: raises $0.66 to $1.1
79df293: calls $0.66
*** FLOP *** [5d Qs 7h]
87d5083b: checks
79df293: checks
*** TURN *** [5d Qs 7h] [6d]
87d5083b: checks
79df293: bets $1.1
87d5083b: folds
Uncalled bet ($1.1) returned to 79df293
*** SHOWDOWN ***
79df293 collected $2.03 from pot
*** SUMMARY ***
Total pot $2.2 | Rake $0.1 | Jackpot $0.07 | Bingo $0 | Fortune $0 | Tax $0
Board [5d Qs 7h 6d]
Seat 1: 3c1ddc3a (button) folded before Flop (didn't bet)
Seat 2: 87d5083b (small blind) folded on the Turn
Seat 3: 79df293 (big blind) won ($2.03)
Seat 4: Hero folded before Flop (didn't bet)
Seat 5: 144ea2b0 folded before Flop (didn't bet)
Seat 6: c585480d folded before Flop (didn't bet)


Poker Hand #RC3334436137: Hold'em No Limit ($0.02/$0.05) - 2025/02/17 20:32:17
Table 'RushAndCash601397' 6-max Seat #1 is the button
Seat 1: 14d03752 ($5 in chips)
Seat 2: 7da1f29c ($5.38 in chips)
Seat 3: 5ef88743 ($5 in chips)
Seat 4: 650e9dc7 ($5.59 in chips)
Seat 5: 3100dcf0 ($6.06 in chips)
Seat 6: Hero ($5.6 in chips)
7da1f29c: posts small blind $0.02
5ef88743: posts big blind $0.05
*** HOLE CARDS ***
Dealt to 14d03752 
Dealt to 7da1f29c 
Dealt to 5ef88743 
Dealt to 650e9dc7 
Dealt to 3100dcf0 
Dealt to Hero [3d 8c]
650e9dc7: folds
3100dcf0: raises $0.06 to $0.11
Hero: folds
14d03752: folds
7da1f29c: calls $0.09
5ef88743: folds
*** FLOP *** [2d 4c Jh]
7da1f29c: checks
3100dcf0: checks
*** TURN *** [2d 4c Jh] [Jd]
7da1f29c: bets $0.19
3100dcf0: folds
Uncalled bet ($0.19) returned to 7da1f29c
*** SHOWDOWN ***
7da1f29c collected $0.26 from pot
*** SUMMARY ***
Total pot $0.27 | Rake $0.01 | Jackpot $0 | Bingo $0 | Fortune $0 | Tax $0
Board [2d 4c Jh Jd]
Seat 1: 14d03752 (button) folded before Flop (didn't bet)
Seat 2: 7da1f29c (small blind) won ($0.26)
Seat 3: 5ef88743 (big blind) folded before Flop
Seat 4: 650e9dc7 folded before Flop (didn't bet)
Seat 5: 3100dcf0 folded on the Turn
Seat 6: Hero folded before Flop (didn't bet)


Poker Hand #RC3334436003: Hold'em No Limit ($0.02/$0.05) - 2025/02/17 20:31:57
Table 'RushAndCash601263' 6-max Seat #1 is the button
Seat 1: 1696890b ($4.44 in chips)
Seat 2: Hero ($5.65 in chips)
Seat 3: 186b316a ($5.2 in chips)
Seat 4: d58b99ca ($6.85 in chips)
Seat 5: 45833808 ($6.53 in chips)
Seat 6: a1fd9df7 ($6.52 in chips)
Hero: posts small blind $0.02
186b316a: posts big blind $0.05
*** HOLE CARDS ***
Dealt to 1696890b 
Dealt to Hero [Qd Jh]
Dealt to 186b316a 
Dealt to d58b99ca 
Dealt to 45833808 
Dealt to a1fd9df7 
d58b99ca: folds
45833808: folds
a1fd9df7: folds
1696890b: folds
Hero: calls $0.03
186b316a: checks
*** FLOP *** [7h 5d 3d]
Hero: checks
186b316a: bets $0.06
Hero: folds
Uncalled bet ($0.06) returned to 186b316a
*** SHOWDOWN ***
186b316a collected $0.1 from pot
*** SUMMARY ***
Total pot $0.1 | Rake $0 | Jackpot $0 | Bingo $0 | Fortune $0 | Tax $0
Board [7h 5d 3d]
Seat 1: 1696890b (button) folded before Flop (didn't bet)
Seat 2: Hero (small blind) folded on the Flop
Seat 3: 186b316a (big blind) won ($0.1)
Seat 4: d58b99ca folded before Flop (didn't bet)
Seat 5: 45833808 folded before Flop (didn't bet)
Seat 6: a1fd9df7 folded before Flop (didn't bet)


Poker Hand #RC3334435967: Hold'em No Limit ($0.02/$0.05) - 2025/02/17 20:31:52
Table 'RushAndCash601227' 6-max Seat #1 is the button
Seat 1: 7da1f29c ($5.38 in chips)
Seat 2: 573eb753 ($5.72 in chips)
Seat 3: Hero ($5.7 in chips)
Seat 4: d201e5fe ($7.17 in chips)
Seat 5: dbb7a28 ($7.75 in chips)
Seat 6: cd1f87c8 ($4.45 in chips)
573eb753: posts small blind $0.02
Hero: posts big blind $0.05
*** HOLE CARDS ***
Dealt to 7da1f29c 
Dealt to 573eb753 
Dealt to Hero [3d Js]
Dealt to d201e5fe 
Dealt to dbb7a28 
Dealt to cd1f87c8 
d201e5fe: folds
dbb7a28: folds
cd1f87c8: folds
7da1f29c: folds
573eb753: raises $0.08 to $0.13
Hero: folds
Uncalled bet ($0.08) returned to 573eb753
*** SHOWDOWN ***
573eb753 collected $0.1 from pot
*** SUMMARY ***
Total pot $0.1 | Rake $0 | Jackpot $0 | Bingo $0 | Fortune $0 | Tax $0
Seat 1: 7da1f29c (button) folded before Flop (didn't bet)
Seat 2: 573eb753 (small blind) collected ($0.1)
Seat 3: Hero (big blind) folded before Flop
Seat 4: d201e5fe folded before Flop (didn't bet)
Seat 5: dbb7a28 folded before Flop (didn't bet)
Seat 6: cd1f87c8 folded before Flop (didn't bet)


Poker Hand #RC3334435740: Hold'em No Limit ($0.02/$0.05) - 2025/02/17 20:31:15
Table 'RushAndCash601000' 6-max Seat #1 is the button
Seat 1: Hero ($5.88 in chips)
Seat 2: 6c6b017a ($6.34 in chips)
Seat 3: 7da1f29c ($5.19 in chips)
Seat 4: 6c8cb957 ($5.27 in chips)
Seat 5: 28e11496 ($13.13 in chips)
Seat 6: 45d33c76 ($8.22 in chips)
6c6b017a: posts small blind $0.02
7da1f29c: posts big blind $0.05
*** HOLE CARDS ***
Dealt to Hero [Qh Th]
Dealt to 6c6b017a 
Dealt to 7da1f29c 
Dealt to 6c8cb957 
Dealt to 28e11496 
Dealt to 45d33c76 
6c8cb957: folds
28e11496: folds
45d33c76: folds
Hero: raises $0.05 to $0.1
6c6b017a: folds
7da1f29c: calls $0.05
*** FLOP *** [Td 2s Ad]
7da1f29c: checks
Hero: checks
*** TURN *** [Td 2s Ad] [8d]
7da1f29c: bets $0.08
Hero: calls $0.08
*** RIVER *** [Td 2s Ad 8d] [Kc]
7da1f29c: bets $0.13
Hero: folds
Uncalled bet ($0.13) returned to 7da1f29c
*** SHOWDOWN ***
7da1f29c collected $0.37 from pot
*** SUMMARY ***
Total pot $0.38 | Rake $0.01 | Jackpot $0 | Bingo $0 | Fortune $0 | Tax $0
Board [Td 2s Ad 8d Kc]
Seat 1: Hero (button) folded on the River
Seat 2: 6c6b017a (small blind) folded before Flop
Seat 3: 7da1f29c (big blind) won ($0.37)
Seat 4: 6c8cb957 folded before Flop (didn't bet)
Seat 5: 28e11496 folded before Flop (didn't bet)
Seat 6: 45d33c76 folded before Flop (didn't bet)


Poker Hand #RC3334435708: Hold'em No Limit ($0.02/$0.05) - 2025/02/17 20:31:10
Table 'RushAndCash600968' 6-max Seat #1 is the button
Seat 1: e4d8df1d ($7.25 in chips)
Seat 2: 4ea8e2e ($13.18 in chips)
Seat 3: 1165d8f0 ($5.24 in chips)
Seat 4: b3aefb75 ($10.61 in chips)
Seat 5: Hero ($5.88 in chips)
Seat 6: 428a90d4 ($5 in chips)
4ea8e2e: posts small blind $0.02
1165d8f0: posts big blind $0.05
*** HOLE CARDS ***
Dealt to e4d8df1d 
Dealt to 4ea8e2e 
Dealt to 1165d8f0 
Dealt to b3aefb75 
Dealt to Hero [5h Kd]
Dealt to 428a90d4 
b3aefb75: raises $0.08 to $0.13
Hero: folds
428a90d4: folds
e4d8df1d: folds
4ea8e2e: folds
1165d8f0: folds
Uncalled bet ($0.08) returned to b3aefb75
*** SHOWDOWN ***
b3aefb75 collected $0.12 from pot
*** SUMMARY ***
Total pot $0.12 | Rake $0 | Jackpot $0 | Bingo $0 | Fortune $0 | Tax $0
Seat 1: e4d8df1d (button) folded before Flop (didn't bet)
Seat 2: 4ea8e2e (small blind) folded before Flop
Seat 3: 1165d8f0 (big blind) folded before Flop
Seat 4: b3aefb75 collected ($0.12)
Seat 5: Hero folded before Flop (didn't bet)
Seat 6: 428a90d4 folded before Flop (didn't bet)


Poker Hand #RC3334435689: Hold'em No Limit ($0.02/$0.05) - 2025/02/17 20:31:07
Table 'RushAndCash600949' 6-max Seat #1 is the button
Seat 1: ae49e9c ($5.01 in chips)
Seat 2: fc8b0177 ($6.54 in chips)
Seat 3: 65ca9276 ($7.57 in chips)
Seat 4: Hero ($5.88 in chips)
Seat 5: b4c33f6c ($5.07 in chips)
Seat 6: e4fd27d ($4.34 in chips)
fc8b0177: posts small blind $0.02
65ca9276: posts big blind $0.05
*** HOLE CARDS ***
Dealt to ae49e9c 
Dealt to fc8b0177 
Dealt to 65ca9276 
Dealt to Hero [Jh 2h]
Dealt to b4c33f6c 
Dealt to e4fd27d 
Hero: folds
b4c33f6c: folds
e4fd27d: folds
ae49e9c: folds
fc8b0177: folds
Uncalled bet ($0.03) returned to 65ca9276
*** SHOWDOWN ***
65ca9276 collected $0.04 from pot
*** SUMMARY ***
Total pot $0.04 | Rake $0 | Jackpot $0 | Bingo $0 | Fortune $0 | Tax $0
Seat 1: ae49e9c (button) folded before Flop (didn't bet)
Seat 2: fc8b0177 (small blind) folded before Flop
Seat 3: 65ca9276 (big blind) collected ($0.04)
Seat 4: Hero folded before Flop (didn't bet)
Seat 5: b4c33f6c folded before Flop (didn't bet)
Seat 6: e4fd27d folded before Flop (didn't bet)


Poker Hand #RC3334435668: Hold'em No Limit ($0.02/$0.05) - 2025/02/17 20:31:04
Table 'RushAndCash600928' 6-max Seat #1 is the button
Seat 1: 1640de52 ($16.9 in chips)
Seat 2: 9b4fbe63 ($6.51 in chips)
Seat 3: c1784884 ($5.71 in chips)
Seat 4: 88f21ca8 ($5.18 in chips)
Seat 5: 7da1f29c ($5.21 in chips)
Seat 6: Hero ($5.88 in chips)
9b4fbe63: posts small blind $0.02
c1784884: posts big blind $0.05
*** HOLE CARDS ***
Dealt to 1640de52 
Dealt to 9b4fbe63 
Dealt to c1784884 
Dealt to 88f21ca8 
Dealt to 7da1f29c 
Dealt to Hero [7h 5s]
88f21ca8: folds
7da1f29c: folds
Hero: folds
1640de52: folds
9b4fbe63: folds
Uncalled bet ($0.03) returned to c1784884
*** SHOWDOWN ***
c1784884 collected $0.04 from pot
*** SUMMARY ***
Total pot $0.04 | Rake $0 | Jackpot $0 | Bingo $0 | Fortune $0 | Tax $0
Seat 1: 1640de52 (button) folded before Flop (didn't bet)
Seat 2: 9b4fbe63 (small blind) folded before Flop
Seat 3: c1784884 (big blind) collected ($0.04)
Seat 4: 88f21ca8 folded before Flop (didn't bet)
Seat 5: 7da1f29c folded before Flop (didn't bet)
Seat 6: Hero folded before Flop (didn't bet)


Poker Hand #RC3334435621: Hold'em No Limit ($0.02/$0.05) - 2025/02/17 20:30:57
Table 'RushAndCash600881' 6-max Seat #1 is the button
Seat 1: Hero ($5.88 in chips)
Seat 2: 9b1a3dd2 ($7.49 in chips)
Seat 3: 9564515b ($5.6 in chips)
Seat 4: cbfd6c92 ($4.74 in chips)
Seat 5: 7381628 ($5 in chips)
Seat 6: eaafe260 ($6.52 in chips)
9b1a3dd2: posts small blind $0.02
9564515b: posts big blind $0.05
*** HOLE CARDS ***
Dealt to Hero [Th Jc]
Dealt to 9b1a3dd2 
Dealt to 9564515b 
Dealt to cbfd6c92 
Dealt to 7381628 
Dealt to eaafe260 
cbfd6c92: raises $0.05 to $0.1
7381628: calls $0.1
eaafe260: folds
Hero: folds
9b1a3dd2: folds
9564515b: folds
*** FLOP *** [2s 6h Qc]
cbfd6c92: checks
7381628: checks
*** TURN *** [2s 6h Qc] [8c]
cbfd6c92: bets $0.14
7381628: folds
Uncalled bet ($0.14) returned to cbfd6c92
*** SHOWDOWN ***
cbfd6c92 collected $0.26 from pot
*** SUMMARY ***
Total pot $0.27 | Rake $0.01 | Jackpot $0 | Bingo $0 | Fortune $0 | Tax $0
Board [2s 6h Qc 8c]
Seat 1: Hero (button) folded before Flop (didn't bet)
Seat 2: 9b1a3dd2 (small blind) folded before Flop
Seat 3: 9564515b (big blind) folded before Flop
Seat 4: cbfd6c92 won ($0.26)
Seat 5: 7381628 folded on the Turn
Seat 6: eaafe260 folded before Flop (didn't bet)


Poker Hand #RC3334435598: Hold'em No Limit ($0.02/$0.05) - 2025/02/17 20:30:54
Table 'RushAndCash600858' 6-max Seat #1 is the button
Seat 1: 61b789ce ($5 in chips)
Seat 2: 573eb753 ($5.72 in chips)
Seat 3: Hero ($5.93 in chips)
Seat 4: e2777133 ($7.42 in chips)
Seat 5: 3c1ddc3a ($6.89 in chips)
Seat 6: 54ca1f06 ($5.88 in chips)
573eb753: posts small blind $0.02
Hero: posts big blind $0.05
*** HOLE CARDS ***
Dealt to 61b789ce 
Dealt to 573eb753 
Dealt to Hero [4h 3c]
Dealt to e2777133 
Dealt to 3c1ddc3a 
Dealt to 54ca1f06 
e2777133: folds
3c1ddc3a: folds
54ca1f06: folds
61b789ce: folds
573eb753: raises $0.08 to $0.13
Hero: folds
Uncalled bet ($0.08) returned to 573eb753
*** SHOWDOWN ***
573eb753 collected $0.1 from pot
*** SUMMARY ***
Total pot $0.1 | Rake $0 | Jackpot $0 | Bingo $0 | Fortune $0 | Tax $0
Seat 1: 61b789ce (button) folded before Flop (didn't bet)
Seat 2: 573eb753 (small blind) collected ($0.1)
Seat 3: Hero (big blind) folded before Flop
Seat 4: e2777133 folded before Flop (didn't bet)
Seat 5: 3c1ddc3a folded before Flop (didn't bet)
Seat 6: 54ca1f06 folded before Flop (didn't bet)


Poker Hand #RC3334435562: Hold'em No Limit ($0.02/$0.05) - 2025/02/17 20:30:48
Table 'RushAndCash600822' 6-max Seat #1 is the button
Seat 1: 677c4b25 ($5 in chips)
Seat 2: f724ee99 ($5.02 in chips)
Seat 3: 16081ce9 ($10.51 in chips)
Seat 4: 767730bd ($5 in chips)
Seat 5: b9d877b0 ($5.16 in chips)
Seat 6: Hero ($5.93 in chips)
f724ee99: posts small blind $0.02
16081ce9: posts big blind $0.05
*** HOLE CARDS ***
Dealt to 677c4b25 
Dealt to f724ee99 
Dealt to 16081ce9 
Dealt to 767730bd 
Dealt to b9d877b0 
Dealt to Hero [7d 4d]
767730bd: folds
b9d877b0: folds
Hero: folds
677c4b25: raises $0.08 to $0.13
f724ee99: folds
16081ce9: folds
Uncalled bet ($0.08) returned to 677c4b25
*** SHOWDOWN ***
677c4b25 collected $0.12 from pot
*** SUMMARY ***
Total pot $0.12 | Rake $0 | Jackpot $0 | Bingo $0 | Fortune $0 | Tax $0
Seat 1: 677c4b25 (button) collected ($0.12)
Seat 2: f724ee99 (small blind) folded before Flop
Seat 3: 16081ce9 (big blind) folded before Flop
Seat 4: 767730bd folded before Flop (didn't bet)
Seat 5: b9d877b0 folded before Flop (didn't bet)
Seat 6: Hero folded before Flop (didn't bet)


Poker Hand #RC3334435541: Hold'em No Limit ($0.02/$0.05) - 2025/02/17 20:30:45
Table 'RushAndCash600801' 6-max Seat #1 is the button
Seat 1: 656af102 ($5.66 in chips)
Seat 2: Hero ($5.95 in chips)
Seat 3: 886c894a ($9.36 in chips)
Seat 4: d738c756 ($3.09 in chips)
Seat 5: 71e00d83 ($12.86 in chips)
Seat 6: 88c03c05 ($5 in chips)
Hero: posts small blind $0.02
886c894a: posts big blind $0.05
*** HOLE CARDS ***
Dealt to 656af102 
Dealt to Hero [2c 2h]
Dealt to 886c894a 
Dealt to d738c756 
Dealt to 71e00d83 
Dealt to 88c03c05 
d738c756: folds
71e00d83: raises $0.05 to $0.1
88c03c05: folds
656af102: raises $0.22 to $0.32
Hero: folds
886c894a: folds
71e00d83: calls $0.22
*** FLOP *** [6d 9c Qc]
71e00d83: checks
656af102: bets $0.2
71e00d83: calls $0.2
*** TURN *** [6d 9c Qc] [Tc]
71e00d83: checks
656af102: checks
*** RIVER *** [6d 9c Qc Tc] [Ts]
71e00d83: checks
656af102: checks
71e00d83: shows [Ah 9h] (Pair of Tens and Pair of Nines)
656af102: shows [As Qd] (Pair of Queens and Pair of Tens)
*** SHOWDOWN ***
656af102 collected $1.06 from pot
*** SUMMARY ***
Total pot $1.11 | Rake $0.05 | Jackpot $0 | Bingo $0 | Fortune $0 | Tax $0
Board [6d 9c Qc Tc Ts]
Seat 1: 656af102 (button) showed [As Qd] and won ($1.06) with Pair of Queens and Pair of Tens
Seat 2: Hero (small blind) folded before Flop
Seat 3: 886c894a (big blind) folded before Flop
Seat 4: d738c756 folded before Flop (didn't bet)
Seat 5: 71e00d83 showed [Ah 9h] and lost with Pair of Tens and Pair of Nines
Seat 6: 88c03c05 folded before Flop (didn't bet)


Poker Hand #RC3334435520: Hold'em No Limit ($0.02/$0.05) - 2025/02/17 20:30:42
Table 'RushAndCash600780' 6-max Seat #1 is the button
Seat 1: 71e00d83 ($12.86 in chips)
Seat 2: 4e3c3196 ($23.14 in chips)
Seat 3: f739af93 ($7.91 in chips)
Seat 4: 63d707c4 ($5.45 in chips)
Seat 5: Hero ($5.95 in chips)
Seat 6: e632d40b ($7.04 in chips)
4e3c3196: posts small blind $0.02
f739af93: posts big blind $0.05
*** HOLE CARDS ***
Dealt to 71e00d83 
Dealt to 4e3c3196 
Dealt to f739af93 
Dealt to 63d707c4 
Dealt to Hero [6d 8c]
Dealt to e632d40b 
63d707c4: folds
Hero: folds
e632d40b: folds
71e00d83: folds
4e3c3196: folds
Uncalled bet ($0.03) returned to f739af93
*** SHOWDOWN ***
f739af93 collected $0.04 from pot
*** SUMMARY ***
Total pot $0.04 | Rake $0 | Jackpot $0 | Bingo $0 | Fortune $0 | Tax $0
Seat 1: 71e00d83 (button) folded before Flop (didn't bet)
Seat 2: 4e3c3196 (small blind) folded before Flop
Seat 3: f739af93 (big blind) collected ($0.04)
Seat 4: 63d707c4 folded before Flop (didn't bet)
Seat 5: Hero folded before Flop (didn't bet)
Seat 6: e632d40b folded before Flop (didn't bet)


Poker Hand #RC3334435480: Hold'em No Limit ($0.02/$0.05) - 2025/02/17 20:30:36
Table 'RushAndCash600740' 6-max Seat #1 is the button
Seat 1: 692e3a83 ($12.78 in chips)
Seat 2: a1fd9df7 ($6.37 in chips)
Seat 3: f724ee99 ($5 in chips)
Seat 4: 45833808 ($6.18 in chips)
Seat 5: 1a54a2fc ($5 in chips)
Seat 6: Hero ($5.95 in chips)
a1fd9df7: posts small blind $0.02
f724ee99: posts big blind $0.05
*** HOLE CARDS ***
Dealt to 692e3a83 
Dealt to a1fd9df7 
Dealt to f724ee99 
Dealt to 45833808 
Dealt to 1a54a2fc 
Dealt to Hero [3s Jc]
45833808: folds
1a54a2fc: folds
Hero: folds
692e3a83: folds
a1fd9df7: folds
Uncalled bet ($0.03) returned to f724ee99
*** SHOWDOWN ***
f724ee99 collected $0.04 from pot
*** SUMMARY ***
Total pot $0.04 | Rake $0 | Jackpot $0 | Bingo $0 | Fortune $0 | Tax $0
Seat 1: 692e3a83 (button) folded before Flop (didn't bet)
Seat 2: a1fd9df7 (small blind) folded before Flop
Seat 3: f724ee99 (big blind) collected ($0.04)
Seat 4: 45833808 folded before Flop (didn't bet)
Seat 5: 1a54a2fc folded before Flop (didn't bet)
Seat 6: Hero folded before Flop (didn't bet)


Poker Hand #RC3334435045: Hold'em No Limit ($0.02/$0.05) - 2025/02/17 20:29:30
Table 'RushAndCash600305' 6-max Seat #1 is the button
Seat 1: Hero ($5.74 in chips)
Seat 2: 19bb03b5 ($13.17 in chips)
Seat 3: a1fd9df7 ($6.47 in chips)
Seat 4: bb702030 ($7.9 in chips)
Seat 5: 68e67dc8 ($5.16 in chips)
Seat 6: cf85f0e5 ($5.34 in chips)
19bb03b5: posts small blind $0.02
a1fd9df7: posts big blind $0.05
*** HOLE CARDS ***
Dealt to Hero [Qd Kh]
Dealt to 19bb03b5 
Dealt to a1fd9df7 
Dealt to bb702030 
Dealt to 68e67dc8 
Dealt to cf85f0e5 
bb702030: raises $0.05 to $0.1
68e67dc8: folds
cf85f0e5: folds
Hero: calls $0.1
19bb03b5: folds
a1fd9df7: calls $0.05
*** FLOP *** [Qc Kc 3d]
a1fd9df7: checks
bb702030: checks
Hero: bets $0.24
a1fd9df7: folds
bb702030: folds
Uncalled bet ($0.24) returned to Hero
*** SHOWDOWN ***
Hero collected $0.31 from pot
*** SUMMARY ***
Total pot $0.32 | Rake $0.01 | Jackpot $0 | Bingo $0 | Fortune $0 | Tax $0
Board [Qc Kc 3d]
Seat 1: Hero (button) won ($0.31)
Seat 2: 19bb03b5 (small blind) folded before Flop
Seat 3: a1fd9df7 (big blind) folded on the Flop
Seat 4: bb702030 folded on the Flop
Seat 5: 68e67dc8 folded before Flop (didn't bet)
Seat 6: cf85f0e5 folded before Flop (didn't bet)


Poker Hand #RC3334434994: Hold'em No Limit ($0.02/$0.05) - 2025/02/17 20:29:22
Table 'RushAndCash600254' 6-max Seat #1 is the button
Seat 1: 290b880 ($6.57 in chips)
Seat 2: 100d4f9e ($5.51 in chips)
Seat 3: Hero ($5.72 in chips)
Seat 4: 1696890b ($5.37 in chips)
Seat 5: 1ce64dd8 ($4.07 in chips)
Seat 6: 6c122cb5 ($6.93 in chips)
100d4f9e: posts small blind $0.02
Hero: posts big blind $0.05
*** HOLE CARDS ***
Dealt to 290b880 
Dealt to 100d4f9e 
Dealt to Hero [Qh 9c]
Dealt to 1696890b 
Dealt to 1ce64dd8 
Dealt to 6c122cb5 
1696890b: folds
1ce64dd8: folds
6c122cb5: folds
290b880: folds
100d4f9e: folds
Uncalled bet ($0.03) returned to Hero
*** SHOWDOWN ***
Hero collected $0.04 from pot
*** SUMMARY ***
Total pot $0.04 | Rake $0 | Jackpot $0 | Bingo $0 | Fortune $0 | Tax $0
Seat 1: 290b880 (button) folded before Flop (didn't bet)
Seat 2: 100d4f9e (small blind) folded before Flop
Seat 3: Hero (big blind) collected ($0.04)
Seat 4: 1696890b folded before Flop (didn't bet)
Seat 5: 1ce64dd8 folded before Flop (didn't bet)
Seat 6: 6c122cb5 folded before Flop (didn't bet)


Poker Hand #RC3334434925: Hold'em No Limit ($0.02/$0.05) - 2025/02/17 20:29:10
Table 'RushAndCash600185' 6-max Seat #1 is the button
Seat 1: 84f270f8 ($5.91 in chips)
Seat 2: Hero ($5.74 in chips)
Seat 3: 187f2194 ($10.01 in chips)
Seat 4: 626359de ($5.88 in chips)
Seat 5: a28ca95c ($18.82 in chips)
Seat 6: 491e0e63 ($5.03 in chips)
Hero: posts small blind $0.02
187f2194: posts big blind $0.05
*** HOLE CARDS ***
Dealt to 84f270f8 
Dealt to Hero [Qh 8h]
Dealt to 187f2194 
Dealt to 626359de 
Dealt to a28ca95c 
Dealt to 491e0e63 
626359de: folds
a28ca95c: folds
491e0e63: folds
84f270f8: raises $0.1 to $0.15
Hero: folds
187f2194: folds
Uncalled bet ($0.1) returned to 84f270f8
*** SHOWDOWN ***
84f270f8 collected $0.12 from pot
*** SUMMARY ***
Total pot $0.12 | Rake $0 | Jackpot $0 | Bingo $0 | Fortune $0 | Tax $0
Seat 1: 84f270f8 (button) collected ($0.12)
Seat 2: Hero (small blind) folded before Flop
Seat 3: 187f2194 (big blind) folded before Flop
Seat 4: 626359de folded before Flop (didn't bet)
Seat 5: a28ca95c folded before Flop (didn't bet)
Seat 6: 491e0e63 folded before Flop (didn't bet)


Poker Hand #RC3334434890: Hold'em No Limit ($0.02/$0.05) - 2025/02/17 20:29:04
Table 'RushAndCash600150' 6-max Seat #1 is the button
Seat 1: f108945f ($5 in chips)
Seat 2: 8282d87b ($5 in chips)
Seat 3: 26e655d0 ($6.22 in chips)
Seat 4: Hero ($5.74 in chips)
Seat 5: ef7e6107 ($5.27 in chips)
Seat 6: 4052bb6f ($7.23 in chips)
8282d87b: posts small blind $0.02
26e655d0: posts big blind $0.05
*** HOLE CARDS ***
Dealt to f108945f 
Dealt to 8282d87b 
Dealt to 26e655d0 
Dealt to Hero [Ac 8d]
Dealt to ef7e6107 
Dealt to 4052bb6f 
Hero: folds
ef7e6107: folds
4052bb6f: folds
f108945f: folds
8282d87b: raises $0.09 to $0.14
26e655d0: folds
Uncalled bet ($0.09) returned to 8282d87b
*** SHOWDOWN ***
8282d87b collected $0.1 from pot
*** SUMMARY ***
Total pot $0.1 | Rake $0 | Jackpot $0 | Bingo $0 | Fortune $0 | Tax $0
Seat 1: f108945f (button) folded before Flop (didn't bet)
Seat 2: 8282d87b (small blind) collected ($0.1)
Seat 3: 26e655d0 (big blind) folded before Flop
Seat 4: Hero folded before Flop (didn't bet)
Seat 5: ef7e6107 folded before Flop (didn't bet)
Seat 6: 4052bb6f folded before Flop (didn't bet)


Poker Hand #RC3334374735: Hold'em No Limit ($0.02/$0.05) - 2025/02/17 20:28:42
Table 'RushAndCash599995' 6-max Seat #1 is the button
Seat 1: 54fe77bd ($6.8 in chips)
Seat 2: 8d7c8253 ($5 in chips)
Seat 3: df0ebddc ($5.07 in chips)
Seat 4: ef7e6107 ($5.11 in chips)
Seat 5: a21d255c ($5 in chips)
Seat 6: Hero ($5.84 in chips)
8d7c8253: posts small blind $0.02
df0ebddc: posts big blind $0.05
*** HOLE CARDS ***
Dealt to 54fe77bd 
Dealt to 8d7c8253 
Dealt to df0ebddc 
Dealt to ef7e6107 
Dealt to a21d255c 
Dealt to Hero [Th 9h]
ef7e6107: raises $0.05 to $0.1
a21d255c: folds
Hero: calls $0.1
54fe77bd: folds
8d7c8253: folds
df0ebddc: folds
*** FLOP *** [5d Jh 3s]
ef7e6107: bets $0.14
Hero: folds
Uncalled bet ($0.14) returned to ef7e6107
*** SHOWDOWN ***
ef7e6107 collected $0.26 from pot
*** SUMMARY ***
Total pot $0.27 | Rake $0.01 | Jackpot $0 | Bingo $0 | Fortune $0 | Tax $0
Board [5d Jh 3s]
Seat 1: 54fe77bd (button) folded before Flop (didn't bet)
Seat 2: 8d7c8253 (small blind) folded before Flop
Seat 3: df0ebddc (big blind) folded before Flop
Seat 4: ef7e6107 won ($0.26)
Seat 5: a21d255c folded before Flop (didn't bet)
Seat 6: Hero folded on the Flop


Poker Hand #RC3334374715: Hold'em No Limit ($0.02/$0.05) - 2025/02/17 20:28:39
Table 'RushAndCash599975' 6-max Seat #1 is the button
Seat 1: b66d20fa ($18.65 in chips)
Seat 2: e8e95c39 ($6.13 in chips)
Seat 3: 8ec32764 ($5.59 in chips)
Seat 4: 86768906 ($8.88 in chips)
Seat 5: Hero ($5.84 in chips)
Seat 6: e2a2e9b3 ($5.07 in chips)
e8e95c39: posts small blind $0.02
8ec32764: posts big blind $0.05
*** HOLE CARDS ***
Dealt to b66d20fa 
Dealt to e8e95c39 
Dealt to 8ec32764 
Dealt to 86768906 
Dealt to Hero [2c 6h]
Dealt to e2a2e9b3 
86768906: folds
Hero: folds
e2a2e9b3: folds
b66d20fa: folds
e8e95c39: folds
Uncalled bet ($0.03) returned to 8ec32764
*** SHOWDOWN ***
8ec32764 collected $0.04 from pot
*** SUMMARY ***
Total pot $0.04 | Rake $0 | Jackpot $0 | Bingo $0 | Fortune $0 | Tax $0
Seat 1: b66d20fa (button) folded before Flop (didn't bet)
Seat 2: e8e95c39 (small blind) folded before Flop
Seat 3: 8ec32764 (big blind) collected ($0.04)
Seat 4: 86768906 folded before Flop (didn't bet)
Seat 5: Hero folded before Flop (didn't bet)
Seat 6: e2a2e9b3 folded before Flop (didn't bet)


Poker Hand #RC3334374690: Hold'em No Limit ($0.02/$0.05) - 2025/02/17 20:28:36
Table 'RushAndCash599950' 6-max Seat #1 is the button
Seat 1: Hero ($5.84 in chips)
Seat 2: 6aa0c391 ($5 in chips)
Seat 3: 5acd5e40 ($5.23 in chips)
Seat 4: 8cbee864 ($5.21 in chips)
Seat 5: 860fa4c9 ($5.23 in chips)
Seat 6: 5c8c19b7 ($5.23 in chips)
6aa0c391: posts small blind $0.02
5acd5e40: posts big blind $0.05
*** HOLE CARDS ***
Dealt to Hero [8s Qc]
Dealt to 6aa0c391 
Dealt to 5acd5e40 
Dealt to 8cbee864 
Dealt to 860fa4c9 
Dealt to 5c8c19b7 
8cbee864: folds
860fa4c9: folds
5c8c19b7: raises $0.07 to $0.12
Hero: folds
6aa0c391: folds
5acd5e40: folds
Uncalled bet ($0.07) returned to 5c8c19b7
*** SHOWDOWN ***
5c8c19b7 collected $0.12 from pot
*** SUMMARY ***
Total pot $0.12 | Rake $0 | Jackpot $0 | Bingo $0 | Fortune $0 | Tax $0
Seat 1: Hero (button) folded before Flop (didn't bet)
Seat 2: 6aa0c391 (small blind) folded before Flop
Seat 3: 5acd5e40 (big blind) folded before Flop
Seat 4: 8cbee864 folded before Flop (didn't bet)
Seat 5: 860fa4c9 folded before Flop (didn't bet)
Seat 6: 5c8c19b7 collected ($0.12)


Poker Hand #RC3334374665: Hold'em No Limit ($0.02/$0.05) - 2025/02/17 20:28:32
Table 'RushAndCash599925' 6-max Seat #1 is the button
Seat 1: 1dc39fc2 ($5 in chips)
Seat 2: 491e0e63 ($5.07 in chips)
Seat 3: 157631a0 ($7.14 in chips)
Seat 4: Hero ($5.84 in chips)
Seat 5: b9e511a ($23.98 in chips)
Seat 6: f739af93 ($8 in chips)
491e0e63: posts small blind $0.02
157631a0: posts big blind $0.05
*** HOLE CARDS ***
Dealt to 1dc39fc2 
Dealt to 491e0e63 
Dealt to 157631a0 
Dealt to Hero [Qs 2d]
Dealt to b9e511a 
Dealt to f739af93 
Hero: folds
b9e511a: raises $0.1 to $0.15
f739af93: folds
1dc39fc2: raises $0.31 to $0.46
491e0e63: folds
157631a0: folds
b9e511a: folds
Uncalled bet ($0.31) returned to 1dc39fc2
*** SHOWDOWN ***
1dc39fc2 collected $0.36 from pot
*** SUMMARY ***
Total pot $0.37 | Rake $0.01 | Jackpot $0 | Bingo $0 | Fortune $0 | Tax $0
Seat 1: 1dc39fc2 (button) collected ($0.36)
Seat 2: 491e0e63 (small blind) folded before Flop
Seat 3: 157631a0 (big blind) folded before Flop
Seat 4: Hero folded before Flop (didn't bet)
Seat 5: b9e511a folded before Flop
Seat 6: f739af93 folded before Flop (didn't bet)


Poker Hand #RC3334374634: Hold'em No Limit ($0.02/$0.05) - 2025/02/17 20:28:28
Table 'RushAndCash599894' 6-max Seat #1 is the button
Seat 1: 7da1f29c ($5 in chips)
Seat 2: Hero ($5.86 in chips)
Seat 3: b112bc0b ($6.65 in chips)
Seat 4: 1063406 ($6.67 in chips)
Seat 5: d9a113f2 ($5.83 in chips)
Seat 6: 5db4cca ($4.98 in chips)
Hero: posts small blind $0.02
b112bc0b: posts big blind $0.05
*** HOLE CARDS ***
Dealt to 7da1f29c 
Dealt to Hero [6h Tc]
Dealt to b112bc0b 
Dealt to 1063406 
Dealt to d9a113f2 
Dealt to 5db4cca 
1063406: folds
d9a113f2: folds
5db4cca: raises $0.1 to $0.15
7da1f29c: calls $0.15
Hero: folds
b112bc0b: folds
*** FLOP *** [As 9c 4s]
5db4cca: bets $0.37
7da1f29c: calls $0.37
*** TURN *** [As 9c 4s] [2d]
5db4cca: checks
7da1f29c: checks
*** RIVER *** [As 9c 4s 2d] [8h]
5db4cca: bets $0.84
7da1f29c: folds
Uncalled bet ($0.84) returned to 5db4cca
*** SHOWDOWN ***
5db4cca collected $1.06 from pot
*** SUMMARY ***
Total pot $1.11 | Rake $0.05 | Jackpot $0 | Bingo $0 | Fortune $0 | Tax $0
Board [As 9c 4s 2d 8h]
Seat 1: 7da1f29c (button) folded on the River
Seat 2: Hero (small blind) folded before Flop
Seat 3: b112bc0b (big blind) folded before Flop
Seat 4: 1063406 folded before Flop (didn't bet)
Seat 5: d9a113f2 folded before Flop (didn't bet)
Seat 6: 5db4cca showed [Td] and won ($1.06)


Poker Hand #RC3334374412: Hold'em No Limit ($0.02/$0.05) - 2025/02/17 20:27:53
Table 'RushAndCash599672' 6-max Seat #1 is the button
Seat 1: 573eb753 ($5.32 in chips)
Seat 2: ae7aea10 ($8.47 in chips)
Seat 3: Hero ($5.72 in chips)
Seat 4: 4e3196ec ($6.47 in chips)
Seat 5: 54ca1f06 ($6.11 in chips)
Seat 6: 7fe74cc5 ($5 in chips)
ae7aea10: posts small blind $0.02
Hero: posts big blind $0.05
*** HOLE CARDS ***
Dealt to 573eb753 
Dealt to ae7aea10 
Dealt to Hero [9c 7c]
Dealt to 4e3196ec 
Dealt to 54ca1f06 
Dealt to 7fe74cc5 
4e3196ec: folds
54ca1f06: folds
7fe74cc5: folds
573eb753: folds
ae7aea10: raises $0.1 to $0.15
Hero: calls $0.1
*** FLOP *** [8h 5c 5s]
ae7aea10: checks
Hero: checks
*** TURN *** [8h 5c 5s] [6h]
ae7aea10: checks
Hero: bets $0.24
ae7aea10: folds
Uncalled bet ($0.24) returned to Hero
*** SHOWDOWN ***
Hero collected $0.29 from pot
*** SUMMARY ***
Total pot $0.3 | Rake $0.01 | Jackpot $0 | Bingo $0 | Fortune $0 | Tax $0
Board [8h 5c 5s 6h]
Seat 1: 573eb753 (button) folded before Flop (didn't bet)
Seat 2: ae7aea10 (small blind) folded on the Turn
Seat 3: Hero (big blind) won ($0.29)
Seat 4: 4e3196ec folded before Flop (didn't bet)
Seat 5: 54ca1f06 folded before Flop (didn't bet)
Seat 6: 7fe74cc5 folded before Flop (didn't bet)


Poker Hand #RC3334374383: Hold'em No Limit ($0.02/$0.05) - 2025/02/17 20:27:49
Table 'RushAndCash599643' 6-max Seat #1 is the button
Seat 1: 92099542 ($9.64 in chips)
Seat 2: 144ea2b0 ($10.57 in chips)
Seat 3: 568ca15f ($5 in chips)
Seat 4: f25a1768 ($9.74 in chips)
Seat 5: ef63200d ($7.71 in chips)
Seat 6: Hero ($5.72 in chips)
144ea2b0: posts small blind $0.02
568ca15f: posts big blind $0.05
*** HOLE CARDS ***
Dealt to 92099542 
Dealt to 144ea2b0 
Dealt to 568ca15f 
Dealt to f25a1768 
Dealt to ef63200d 
Dealt to Hero [5h Jh]
f25a1768: raises $0.08 to $0.13
ef63200d: folds
Hero: folds
92099542: folds
144ea2b0: folds
568ca15f: calls $0.08
*** FLOP *** [7s 5c 8s]
568ca15f: checks
f25a1768: bets $0.21
568ca15f: calls $0.21
*** TURN *** [7s 5c 8s] [6h]
568ca15f: checks
f25a1768: checks
*** RIVER *** [7s 5c 8s 6h] [Qh]
568ca15f: bets $0.55
f25a1768: folds
Uncalled bet ($0.55) returned to 568ca15f
*** SHOWDOWN ***
568ca15f collected $0.67 from pot
*** SUMMARY ***
Total pot $0.7 | Rake $0.03 | Jackpot $0 | Bingo $0 | Fortune $0 | Tax $0
Board [7s 5c 8s 6h Qh]
Seat 1: 92099542 (button) folded before Flop (didn't bet)
Seat 2: 144ea2b0 (small blind) folded before Flop
Seat 3: 568ca15f (big blind) won ($0.67)
Seat 4: f25a1768 folded on the River
Seat 5: ef63200d folded before Flop (didn't bet)
Seat 6: Hero folded before Flop (didn't bet)


Poker Hand #RC3334374341: Hold'em No Limit ($0.02/$0.05) - 2025/02/17 20:27:42
Table 'RushAndCash599601' 6-max Seat #1 is the button
Seat 1: Hero ($5.72 in chips)
Seat 2: 1e290a15 ($9.55 in chips)
Seat 3: 7381628 ($5.33 in chips)
Seat 4: a9af8bb8 ($5 in chips)
Seat 5: df0ebddc ($5.16 in chips)
Seat 6: a3df4f6b ($5.11 in chips)
1e290a15: posts small blind $0.02
7381628: posts big blind $0.05
*** HOLE CARDS ***
Dealt to Hero [Qd 6s]
Dealt to 1e290a15 
Dealt to 7381628 
Dealt to a9af8bb8 
Dealt to df0ebddc 
Dealt to a3df4f6b 
a9af8bb8: folds
df0ebddc: folds
a3df4f6b: folds
Hero: folds
1e290a15: raises $0.1 to $0.15
7381628: folds
Uncalled bet ($0.1) returned to 1e290a15
*** SHOWDOWN ***
1e290a15 collected $0.1 from pot
*** SUMMARY ***
Total pot $0.1 | Rake $0 | Jackpot $0 | Bingo $0 | Fortune $0 | Tax $0
Seat 1: Hero (button) folded before Flop (didn't bet)
Seat 2: 1e290a15 (small blind) collected ($0.1)
Seat 3: 7381628 (big blind) folded before Flop
Seat 4: a9af8bb8 folded before Flop (didn't bet)
Seat 5: df0ebddc folded before Flop (didn't bet)
Seat 6: a3df4f6b folded before Flop (didn't bet)


Poker Hand #RC3334374319: Hold'em No Limit ($0.02/$0.05) - 2025/02/17 20:27:38
Table 'RushAndCash599579' 6-max Seat #1 is the button
Seat 1: 735c4afd ($5.29 in chips)
Seat 2: Hero ($5.74 in chips)
Seat 3: eb09e492 ($4.62 in chips)
Seat 4: 8cbee864 ($5.21 in chips)
Seat 5: 52f43d28 ($7.1 in chips)
Seat 6: 94b22b92 ($5.96 in chips)
Hero: posts small blind $0.02
eb09e492: posts big blind $0.05
*** HOLE CARDS ***
Dealt to 735c4afd 
Dealt to Hero [5d Ks]
Dealt to eb09e492 
Dealt to 8cbee864 
Dealt to 52f43d28 
Dealt to 94b22b92 
8cbee864: folds
52f43d28: folds
94b22b92: raises $0.05 to $0.1
735c4afd: folds
Hero: folds
eb09e492: folds
Uncalled bet ($0.05) returned to 94b22b92
*** SHOWDOWN ***
94b22b92 collected $0.12 from pot
*** SUMMARY ***
Total pot $0.12 | Rake $0 | Jackpot $0 | Bingo $0 | Fortune $0 | Tax $0
Seat 1: 735c4afd (button) folded before Flop (didn't bet)
Seat 2: Hero (small blind) folded before Flop
Seat 3: eb09e492 (big blind) folded before Flop
Seat 4: 8cbee864 folded before Flop (didn't bet)
Seat 5: 52f43d28 folded before Flop (didn't bet)
Seat 6: 94b22b92 collected ($0.12)


Poker Hand #RC3334374300: Hold'em No Limit ($0.02/$0.05) - 2025/02/17 20:27:35
Table 'RushAndCash599560' 6-max Seat #1 is the button
Seat 1: d9a113f2 ($5.71 in chips)
Seat 2: 68e67dc8 ($5.54 in chips)
Seat 3: 1aca371e ($8.01 in chips)
Seat 4: 803e9f05 ($6.46 in chips)
Seat 5: Hero ($5.74 in chips)
Seat 6: bc6bd004 ($5.51 in chips)
68e67dc8: posts small blind $0.02
1aca371e: posts big blind $0.05
*** HOLE CARDS ***
Dealt to d9a113f2 
Dealt to 68e67dc8 
Dealt to 1aca371e 
Dealt to 803e9f05 
Dealt to Hero [Kh 3s]
Dealt to bc6bd004 
803e9f05: folds
Hero: folds
bc6bd004: folds
d9a113f2: folds
68e67dc8: calls $0.03
1aca371e: checks
*** FLOP *** [7d As Td]
68e67dc8: bets $0.05
1aca371e: calls $0.05
*** TURN *** [7d As Td] [6c]
68e67dc8: bets $0.15
1aca371e: folds
Uncalled bet ($0.15) returned to 68e67dc8
*** SHOWDOWN ***
68e67dc8 collected $0.19 from pot
*** SUMMARY ***
Total pot $0.2 | Rake $0.01 | Jackpot $0 | Bingo $0 | Fortune $0 | Tax $0
Board [7d As Td 6c]
Seat 1: d9a113f2 (button) folded before Flop (didn't bet)
Seat 2: 68e67dc8 (small blind) won ($0.19)
Seat 3: 1aca371e (big blind) folded on the Turn
Seat 4: 803e9f05 folded before Flop (didn't bet)
Seat 5: Hero folded before Flop (didn't bet)
Seat 6: bc6bd004 folded before Flop (didn't bet)


Poker Hand #RC3334374279: Hold'em No Limit ($0.02/$0.05) - 2025/02/17 20:27:32
Table 'RushAndCash599539' 6-max Seat #1 is the button
Seat 1: 63a77bff ($5.33 in chips)
Seat 2: 25f30dbe ($5.37 in chips)
Seat 3: Hero ($5.79 in chips)
Seat 4: 7cfb455f ($5.82 in chips)
Seat 5: e352a329 ($5.26 in chips)
Seat 6: 87205baf ($9.34 in chips)
25f30dbe: posts small blind $0.02
Hero: posts big blind $0.05
*** HOLE CARDS ***
Dealt to 63a77bff 
Dealt to 25f30dbe 
Dealt to Hero [5s Jh]
Dealt to 7cfb455f 
Dealt to e352a329 
Dealt to 87205baf 
7cfb455f: folds
e352a329: folds
87205baf: folds
63a77bff: raises $0.06 to $0.11
25f30dbe: folds
Hero: folds
Uncalled bet ($0.06) returned to 63a77bff
*** SHOWDOWN ***
63a77bff collected $0.12 from pot
*** SUMMARY ***
Total pot $0.12 | Rake $0 | Jackpot $0 | Bingo $0 | Fortune $0 | Tax $0
Seat 1: 63a77bff (button) collected ($0.12)
Seat 2: 25f30dbe (small blind) folded before Flop
Seat 3: Hero (big blind) folded before Flop
Seat 4: 7cfb455f folded before Flop (didn't bet)
Seat 5: e352a329 folded before Flop (didn't bet)
Seat 6: 87205baf folded before Flop (didn't bet)


Poker Hand #RC3334374260: Hold'em No Limit ($0.02/$0.05) - 2025/02/17 20:27:29
Table 'RushAndCash599520' 6-max Seat #1 is the button
Seat 1: 56cefdc9 ($2.78 in chips)
Seat 2: 33527257 ($5.63 in chips)
Seat 3: 842d7655 ($5.86 in chips)
Seat 4: c7e9103c ($20.09 in chips)
Seat 5: Hero ($5.79 in chips)
Seat 6: 18cb11a ($6.13 in chips)
33527257: posts small blind $0.02
842d7655: posts big blind $0.05
*** HOLE CARDS ***
Dealt to 56cefdc9 
Dealt to 33527257 
Dealt to 842d7655 
Dealt to c7e9103c 
Dealt to Hero [Ts 8d]
Dealt to 18cb11a 
c7e9103c: folds
Hero: folds
18cb11a: raises $0.08 to $0.13
56cefdc9: folds
33527257: folds
842d7655: folds
Uncalled bet ($0.08) returned to 18cb11a
*** SHOWDOWN ***
18cb11a collected $0.12 from pot
*** SUMMARY ***
Total pot $0.12 | Rake $0 | Jackpot $0 | Bingo $0 | Fortune $0 | Tax $0
Seat 1: 56cefdc9 (button) folded before Flop (didn't bet)
Seat 2: 33527257 (small blind) folded before Flop
Seat 3: 842d7655 (big blind) folded before Flop
Seat 4: c7e9103c folded before Flop (didn't bet)
Seat 5: Hero folded before Flop (didn't bet)
Seat 6: 18cb11a collected ($0.12)


Poker Hand #RC3334374240: Hold'em No Limit ($0.02/$0.05) - 2025/02/17 20:27:25
Table 'RushAndCash599500' 6-max Seat #1 is the button
Seat 1: 5265b128 ($5.03 in chips)
Seat 2: bda9ba33 ($2.25 in chips)
Seat 3: ae7aea10 ($8.54 in chips)
Seat 4: fff52c3e ($6.12 in chips)
Seat 5: 9885e0a0 ($5.68 in chips)
Seat 6: Hero ($5.79 in chips)
bda9ba33: posts small blind $0.02
ae7aea10: posts big blind $0.05
*** HOLE CARDS ***
Dealt to 5265b128 
Dealt to bda9ba33 
Dealt to ae7aea10 
Dealt to fff52c3e 
Dealt to 9885e0a0 
Dealt to Hero [4s Kd]
fff52c3e: raises $0.08 to $0.13
9885e0a0: folds
Hero: folds
5265b128: folds
bda9ba33: folds
ae7aea10: folds
Uncalled bet ($0.08) returned to fff52c3e
*** SHOWDOWN ***
fff52c3e collected $0.12 from pot
*** SUMMARY ***
Total pot $0.12 | Rake $0 | Jackpot $0 | Bingo $0 | Fortune $0 | Tax $0
Seat 1: 5265b128 (button) folded before Flop (didn't bet)
Seat 2: bda9ba33 (small blind) folded before Flop
Seat 3: ae7aea10 (big blind) folded before Flop
Seat 4: fff52c3e collected ($0.12)
Seat 5: 9885e0a0 folded before Flop (didn't bet)
Seat 6: Hero folded before Flop (didn't bet)


Poker Hand #RC3334373991: Hold'em No Limit ($0.02/$0.05) - 2025/02/17 20:26:49
Table 'RushAndCash599251' 6-max Seat #1 is the button
Seat 1: 74b25a0c ($5 in chips)
Seat 2: ca93b3ea ($5 in chips)
Seat 3: 5265b128 ($5.21 in chips)
Seat 4: Hero ($5.6 in chips)
Seat 5: 8be10cd0 ($12.14 in chips)
Seat 6: 130fc8d7 ($10.72 in chips)
ca93b3ea: posts small blind $0.02
5265b128: posts big blind $0.05
*** HOLE CARDS ***
Dealt to 74b25a0c 
Dealt to ca93b3ea 
Dealt to 5265b128 
Dealt to Hero [Th As]
Dealt to 8be10cd0 
Dealt to 130fc8d7 
Hero: raises $0.05 to $0.1
8be10cd0: folds
130fc8d7: folds
74b25a0c: folds
ca93b3ea: folds
5265b128: calls $0.05
*** FLOP *** [7h Ah 4h]
5265b128: checks
Hero: bets $0.08
5265b128: calls $0.08
*** TURN *** [7h Ah 4h] [2d]
5265b128: checks
Hero: bets $0.2
5265b128: folds
Uncalled bet ($0.2) returned to Hero
*** SHOWDOWN ***
Hero collected $0.37 from pot
*** SUMMARY ***
Total pot $0.38 | Rake $0.01 | Jackpot $0 | Bingo $0 | Fortune $0 | Tax $0
Board [7h Ah 4h 2d]
Seat 1: 74b25a0c (button) folded before Flop (didn't bet)
Seat 2: ca93b3ea (small blind) folded before Flop
Seat 3: 5265b128 (big blind) folded on the Turn
Seat 4: Hero won ($0.37)
Seat 5: 8be10cd0 folded before Flop (didn't bet)
Seat 6: 130fc8d7 folded before Flop (didn't bet)


Poker Hand #RC3334373969: Hold'em No Limit ($0.02/$0.05) - 2025/02/17 20:26:46
Table 'RushAndCash599229' 6-max Seat #1 is the button
Seat 1: 130fc8d7 ($10.72 in chips)
Seat 2: f71f9fc0 ($4.41 in chips)
Seat 3: Hero ($5.65 in chips)
Seat 4: 90fb5891 ($15.63 in chips)
Seat 5: 904f2b1b ($5.66 in chips)
Seat 6: 32a238cd ($4.07 in chips)
f71f9fc0: posts small blind $0.02
Hero: posts big blind $0.05
*** HOLE CARDS ***
Dealt to 130fc8d7 
Dealt to f71f9fc0 
Dealt to Hero [6s Ac]
Dealt to 90fb5891 
Dealt to 904f2b1b 
Dealt to 32a238cd 
90fb5891: folds
904f2b1b: raises $0.05 to $0.1
32a238cd: folds
130fc8d7: folds
f71f9fc0: folds
Hero: folds
Uncalled bet ($0.05) returned to 904f2b1b
*** SHOWDOWN ***
904f2b1b collected $0.12 from pot
*** SUMMARY ***
Total pot $0.12 | Rake $0 | Jackpot $0 | Bingo $0 | Fortune $0 | Tax $0
Seat 1: 130fc8d7 (button) folded before Flop (didn't bet)
Seat 2: f71f9fc0 (small blind) folded before Flop
Seat 3: Hero (big blind) folded before Flop
Seat 4: 90fb5891 folded before Flop (didn't bet)
Seat 5: 904f2b1b collected ($0.12)
Seat 6: 32a238cd folded before Flop (didn't bet)


Poker Hand #RC3334373948: Hold'em No Limit ($0.02/$0.05) - 2025/02/17 20:26:42
Table 'RushAndCash599208' 6-max Seat #1 is the button
Seat 1: 3f079db6 ($21.52 in chips)
Seat 2: Hero ($5.67 in chips)
Seat 3: 21effd0c ($5.91 in chips)
Seat 4: 32a238cd ($4.07 in chips)
Seat 5: 8a2a3713 ($4.39 in chips)
Seat 6: fc8b0177 ($6.52 in chips)
Hero: posts small blind $0.02
21effd0c: posts big blind $0.05
*** HOLE CARDS ***
Dealt to 3f079db6 
Dealt to Hero [3s Js]
Dealt to 21effd0c 
Dealt to 32a238cd 
Dealt to 8a2a3713 
Dealt to fc8b0177 
32a238cd: folds
8a2a3713: folds
fc8b0177: folds
3f079db6: folds
Hero: folds
Uncalled bet ($0.03) returned to 21effd0c
*** SHOWDOWN ***
21effd0c collected $0.04 from pot
*** SUMMARY ***
Total pot $0.04 | Rake $0 | Jackpot $0 | Bingo $0 | Fortune $0 | Tax $0
Seat 1: 3f079db6 (button) folded before Flop (didn't bet)
Seat 2: Hero (small blind) folded before Flop
Seat 3: 21effd0c (big blind) collected ($0.04)
Seat 4: 32a238cd folded before Flop (didn't bet)
Seat 5: 8a2a3713 folded before Flop (didn't bet)
Seat 6: fc8b0177 folded before Flop (didn't bet)


Poker Hand #RC3334373928: Hold'em No Limit ($0.02/$0.05) - 2025/02/17 20:26:39
Table 'RushAndCash599188' 6-max Seat #1 is the button
Seat 1: 90fb5891 ($15.63 in chips)
Seat 2: 18cb11a ($6.39 in chips)
Seat 3: 2486dbda ($1.95 in chips)
Seat 4: 6dcd0788 ($5.07 in chips)
Seat 5: 8c6d38f2 ($5 in chips)
Seat 6: Hero ($5.67 in chips)
18cb11a: posts small blind $0.02
2486dbda: posts big blind $0.05
*** HOLE CARDS ***
Dealt to 90fb5891 
Dealt to 18cb11a 
Dealt to 2486dbda 
Dealt to 6dcd0788 
Dealt to 8c6d38f2 
Dealt to Hero [7c 2d]
6dcd0788: folds
8c6d38f2: folds
Hero: folds
90fb5891: folds
18cb11a: raises $0.08 to $0.13
2486dbda: calls $0.08
*** FLOP *** [6h 8c 8s]
18cb11a: checks
2486dbda: bets $0.13
18cb11a: calls $0.13
*** TURN *** [6h 8c 8s] [3c]
18cb11a: checks
2486dbda: checks
*** RIVER *** [6h 8c 8s 3c] [6c]
18cb11a: checks
2486dbda: checks
18cb11a: shows [Kh Tc] (Pair of Eights and Pair of Sixes)
2486dbda: shows [4h As] (Pair of Eights and Pair of Sixes)
*** SHOWDOWN ***
2486dbda collected $0.5 from pot
*** SUMMARY ***
Total pot $0.52 | Rake $0.02 | Jackpot $0 | Bingo $0 | Fortune $0 | Tax $0
Board [6h 8c 8s 3c 6c]
Seat 1: 90fb5891 (button) folded before Flop (didn't bet)
Seat 2: 18cb11a (small blind) showed [Kh Tc] and lost with Pair of Eights and Pair of Sixes
Seat 3: 2486dbda (big blind) showed [4h As] and won ($0.5) with Pair of Eights and Pair of Sixes
Seat 4: 6dcd0788 folded before Flop (didn't bet)
Seat 5: 8c6d38f2 folded before Flop (didn't bet)
Seat 6: Hero folded before Flop (didn't bet)


Poker Hand #RC3334373896: Hold'em No Limit ($0.02/$0.05) - 2025/02/17 20:26:35
Table 'RushAndCash599156' 6-max Seat #1 is the button
Seat 1: Hero ($5.67 in chips)
Seat 2: 63a77bff ($5.26 in chips)
Seat 3: 7b6a3077 ($6.31 in chips)
Seat 4: 93735ac4 ($3.2 in chips)
Seat 5: 130fc8d7 ($10.65 in chips)
Seat 6: bbdadd69 ($5.42 in chips)
63a77bff: posts small blind $0.02
7b6a3077: posts big blind $0.05
*** HOLE CARDS ***
Dealt to Hero [3h Ts]
Dealt to 63a77bff 
Dealt to 7b6a3077 
Dealt to 93735ac4 
Dealt to 130fc8d7 
Dealt to bbdadd69 
93735ac4: folds
130fc8d7: raises $0.08 to $0.13
bbdadd69: folds
Hero: folds
63a77bff: folds
7b6a3077: folds
Uncalled bet ($0.08) returned to 130fc8d7
*** SHOWDOWN ***
130fc8d7 collected $0.12 from pot
*** SUMMARY ***
Total pot $0.12 | Rake $0 | Jackpot $0 | Bingo $0 | Fortune $0 | Tax $0
Seat 1: Hero (button) folded before Flop (didn't bet)
Seat 2: 63a77bff (small blind) folded before Flop
Seat 3: 7b6a3077 (big blind) folded before Flop
Seat 4: 93735ac4 folded before Flop (didn't bet)
Seat 5: 130fc8d7 collected ($0.12)
Seat 6: bbdadd69 folded before Flop (didn't bet)


Poker Hand #RC3334373873: Hold'em No Limit ($0.02/$0.05) - 2025/02/17 20:26:31
Table 'RushAndCash599133' 6-max Seat #1 is the button
Seat 1: 731e166b ($5.83 in chips)
Seat 2: 3b2a8270 ($8.93 in chips)
Seat 3: ab8d5924 ($5 in chips)
Seat 4: 7fc44808 ($11.26 in chips)
Seat 5: e4d8df1d ($6.24 in chips)
Seat 6: Hero ($5.67 in chips)
3b2a8270: posts small blind $0.02
ab8d5924: posts big blind $0.05
*** HOLE CARDS ***
Dealt to 731e166b 
Dealt to 3b2a8270 
Dealt to ab8d5924 
Dealt to 7fc44808 
Dealt to e4d8df1d 
Dealt to Hero [Ts 6d]
7fc44808: folds
e4d8df1d: raises $0.05 to $0.1
Hero: folds
731e166b: folds
3b2a8270: folds
ab8d5924: calls $0.05
*** FLOP *** [8d 9c 3h]
ab8d5924: checks
e4d8df1d: checks
*** TURN *** [8d 9c 3h] [9s]
ab8d5924: bets $0.2
e4d8df1d: folds
Uncalled bet ($0.2) returned to ab8d5924
*** SHOWDOWN ***
ab8d5924 collected $0.21 from pot
*** SUMMARY ***
Total pot $0.22 | Rake $0.01 | Jackpot $0 | Bingo $0 | Fortune $0 | Tax $0
Board [8d 9c 3h 9s]
Seat 1: 731e166b (button) folded before Flop (didn't bet)
Seat 2: 3b2a8270 (small blind) folded before Flop
Seat 3: ab8d5924 (big blind) won ($0.21)
Seat 4: 7fc44808 folded before Flop (didn't bet)
Seat 5: e4d8df1d folded on the Turn
Seat 6: Hero folded before Flop (didn't bet)


Poker Hand #RC3334373848: Hold'em No Limit ($0.02/$0.05) - 2025/02/17 20:26:27
Table 'RushAndCash599108' 6-max Seat #1 is the button
Seat 1: 581575fb ($4.95 in chips)
Seat 2: 5ebadbd5 ($4.93 in chips)
Seat 3: 6191b99d ($2.43 in chips)
Seat 4: 651cc52f ($5.18 in chips)
Seat 5: f1ef2c72 ($9.52 in chips)
Seat 6: Hero ($5.67 in chips)
5ebadbd5: posts small blind $0.02
6191b99d: posts big blind $0.05
*** HOLE CARDS ***
Dealt to 581575fb 
Dealt to 5ebadbd5 
Dealt to 6191b99d 
Dealt to 651cc52f 
Dealt to f1ef2c72 
Dealt to Hero [9h 2c]
651cc52f: folds
f1ef2c72: raises $0.05 to $0.1
Hero: folds
581575fb: raises $0.25 to $0.35
5ebadbd5: folds
6191b99d: folds
f1ef2c72: calls $0.25
*** FLOP *** [3c 6s 5c]
f1ef2c72: checks
581575fb: bets $0.58
f1ef2c72: folds
Uncalled bet ($0.58) returned to 581575fb
*** SHOWDOWN ***
581575fb collected $0.74 from pot
*** SUMMARY ***
Total pot $0.77 | Rake $0.03 | Jackpot $0 | Bingo $0 | Fortune $0 | Tax $0
Board [3c 6s 5c]
Seat 1: 581575fb (button) won ($0.74)
Seat 2: 5ebadbd5 (small blind) folded before Flop
Seat 3: 6191b99d (big blind) folded before Flop
Seat 4: 651cc52f folded before Flop (didn't bet)
Seat 5: f1ef2c72 folded on the Flop
Seat 6: Hero folded before Flop (didn't bet)


Poker Hand #RC3334373826: Hold'em No Limit ($0.02/$0.05) - 2025/02/17 20:26:24
Table 'RushAndCash599086' 6-max Seat #1 is the button
Seat 1: f1ef2c72 ($9.52 in chips)
Seat 2: 5c8c19b7 ($5.09 in chips)
Seat 3: 63a77bff ($5.31 in chips)
Seat 4: d738c756 ($3.24 in chips)
Seat 5: d58b99ca ($6.44 in chips)
Seat 6: Hero ($5.67 in chips)
5c8c19b7: posts small blind $0.02
63a77bff: posts big blind $0.05
*** HOLE CARDS ***
Dealt to f1ef2c72 
Dealt to 5c8c19b7 
Dealt to 63a77bff 
Dealt to d738c756 
Dealt to d58b99ca 
Dealt to Hero [3c Js]
d738c756: raises $0.05 to $0.1
d58b99ca: folds
Hero: folds
f1ef2c72: folds
5c8c19b7: folds
63a77bff: folds
Uncalled bet ($0.05) returned to d738c756
*** SHOWDOWN ***
d738c756 collected $0.12 from pot
*** SUMMARY ***
Total pot $0.12 | Rake $0 | Jackpot $0 | Bingo $0 | Fortune $0 | Tax $0
Seat 1: f1ef2c72 (button) folded before Flop (didn't bet)
Seat 2: 5c8c19b7 (small blind) folded before Flop
Seat 3: 63a77bff (big blind) folded before Flop
Seat 4: d738c756 collected ($0.12)
Seat 5: d58b99ca folded before Flop (didn't bet)
Seat 6: Hero folded before Flop (didn't bet)


Poker Hand #RC3334373806: Hold'em No Limit ($0.02/$0.05) - 2025/02/17 20:26:21
Table 'RushAndCash599066' 6-max Seat #1 is the button
Seat 1: Hero ($5.67 in chips)
Seat 2: ef63200d ($7.76 in chips)
Seat 3: 287f8174 ($5.18 in chips)
Seat 4: 4abcea5e ($4.45 in chips)
Seat 5: 8c3789e ($6.83 in chips)
Seat 6: 65ca9276 ($8.7 in chips)
ef63200d: posts small blind $0.02
287f8174: posts big blind $0.05
*** HOLE CARDS ***
Dealt to Hero [Td 7h]
Dealt to ef63200d 
Dealt to 287f8174 
Dealt to 4abcea5e 
Dealt to 8c3789e 
Dealt to 65ca9276 
4abcea5e: folds
8c3789e: folds
65ca9276: folds
Hero: folds
ef63200d: calls $0.03
287f8174: raises $0.1 to $0.15
ef63200d: calls $0.1
*** FLOP *** [5s Th 5d]
ef63200d: checks
287f8174: bets $0.3
ef63200d: folds
Uncalled bet ($0.3) returned to 287f8174
*** SHOWDOWN ***
287f8174 collected $0.29 from pot
*** SUMMARY ***
Total pot $0.3 | Rake $0.01 | Jackpot $0 | Bingo $0 | Fortune $0 | Tax $0
Board [5s Th 5d]
Seat 1: Hero (button) folded before Flop (didn't bet)
Seat 2: ef63200d (small blind) folded on the Flop
Seat 3: 287f8174 (big blind) won ($0.29)
Seat 4: 4abcea5e folded before Flop (didn't bet)
Seat 5: 8c3789e folded before Flop (didn't bet)
Seat 6: 65ca9276 folded before Flop (didn't bet)


Poker Hand #RC3334373764: Hold'em No Limit ($0.02/$0.05) - 2025/02/17 20:26:15
Table 'RushAndCash599024' 6-max Seat #1 is the button
Seat 1: e26361cd ($7.93 in chips)
Seat 2: e352a329 ($5.43 in chips)
Seat 3: Hero ($5.72 in chips)
Seat 4: 8b8c31e1 ($5.46 in chips)
Seat 5: c182b1a3 ($5.02 in chips)
Seat 6: 93735ac4 ($3.13 in chips)
e352a329: posts small blind $0.02
Hero: posts big blind $0.05
*** HOLE CARDS ***
Dealt to e26361cd 
Dealt to e352a329 
Dealt to Hero [2c Kd]
Dealt to 8b8c31e1 
Dealt to c182b1a3 
Dealt to 93735ac4 
8b8c31e1: raises $0.05 to $0.1
c182b1a3: calls $0.1
93735ac4: folds
e26361cd: folds
e352a329: folds
Hero: folds
*** FLOP *** [8s 5s Qs]
8b8c31e1: bets $0.09
c182b1a3: calls $0.09
*** TURN *** [8s 5s Qs] [5h]
8b8c31e1: bets $0.34
c182b1a3: folds
Uncalled bet ($0.34) returned to 8b8c31e1
*** SHOWDOWN ***
8b8c31e1 collected $0.43 from pot
*** SUMMARY ***
Total pot $0.45 | Rake $0.02 | Jackpot $0 | Bingo $0 | Fortune $0 | Tax $0
Board [8s 5s Qs 5h]
Seat 1: e26361cd (button) folded before Flop (didn't bet)
Seat 2: e352a329 (small blind) folded before Flop
Seat 3: Hero (big blind) folded before Flop
Seat 4: 8b8c31e1 won ($0.43)
Seat 5: c182b1a3 folded on the Turn
Seat 6: 93735ac4 folded before Flop (didn't bet)


Poker Hand #RC3334373744: Hold'em No Limit ($0.02/$0.05) - 2025/02/17 20:26:11
Table 'RushAndCash599004' 6-max Seat #1 is the button
Seat 1: e6ee1d7f ($5.14 in chips)
Seat 2: Hero ($5.74 in chips)
Seat 3: 1f187ba0 ($4.25 in chips)
Seat 4: d58b99ca ($6.58 in chips)
Seat 5: bbdadd69 ($5.24 in chips)
Seat 6: 581575fb ($4.95 in chips)
Hero: posts small blind $0.02
1f187ba0: posts big blind $0.05
*** HOLE CARDS ***
Dealt to e6ee1d7f 
Dealt to Hero [7d Ts]
Dealt to 1f187ba0 
Dealt to d58b99ca 
Dealt to bbdadd69 
Dealt to 581575fb 
d58b99ca: raises $0.07 to $0.12
bbdadd69: raises $0.31 to $0.43
581575fb: folds
e6ee1d7f: folds
Hero: folds
1f187ba0: folds
d58b99ca: folds
Uncalled bet ($0.31) returned to bbdadd69
*** SHOWDOWN ***
bbdadd69 collected $0.3 from pot
*** SUMMARY ***
Total pot $0.31 | Rake $0.01 | Jackpot $0 | Bingo $0 | Fortune $0 | Tax $0
Seat 1: e6ee1d7f (button) folded before Flop (didn't bet)
Seat 2: Hero (small blind) folded before Flop
Seat 3: 1f187ba0 (big blind) folded before Flop
Seat 4: d58b99ca folded before Flop
Seat 5: bbdadd69 collected ($0.3)
Seat 6: 581575fb folded before Flop (didn't bet)


Poker Hand #RC3334373696: Hold'em No Limit ($0.02/$0.05) - 2025/02/17 20:26:04
Table 'RushAndCash598956' 6-max Seat #1 is the button
Seat 1: c9ea832 ($7.07 in chips)
Seat 2: 6008538 ($3.97 in chips)
Seat 3: 1a2d8f33 ($5.47 in chips)
Seat 4: 16081ce9 ($11.28 in chips)
Seat 5: 9885e0a0 ($5.51 in chips)
Seat 6: Hero ($5.74 in chips)
6008538: posts small blind $0.02
1a2d8f33: posts big blind $0.05
*** HOLE CARDS ***
Dealt to c9ea832 
Dealt to 6008538 
Dealt to 1a2d8f33 
Dealt to 16081ce9 
Dealt to 9885e0a0 
Dealt to Hero [Th As]
16081ce9: raises $0.05 to $0.1
9885e0a0: raises $0.21 to $0.31
Hero: folds
c9ea832: folds
6008538: folds
1a2d8f33: folds
16081ce9: calls $0.21
*** FLOP *** [Kc 3d 5s]
16081ce9: checks
9885e0a0: bets $0.23
16081ce9: folds
Uncalled bet ($0.23) returned to 9885e0a0
*** SHOWDOWN ***
9885e0a0 collected $0.66 from pot
*** SUMMARY ***
Total pot $0.69 | Rake $0.03 | Jackpot $0 | Bingo $0 | Fortune $0 | Tax $0
Board [Kc 3d 5s]
Seat 1: c9ea832 (button) folded before Flop (didn't bet)
Seat 2: 6008538 (small blind) folded before Flop
Seat 3: 1a2d8f33 (big blind) folded before Flop
Seat 4: 16081ce9 folded on the Flop
Seat 5: 9885e0a0 won ($0.66)
Seat 6: Hero folded before Flop (didn't bet)


Poker Hand #RC3334373675: Hold'em No Limit ($0.02/$0.05) - 2025/02/17 20:26:01
Table 'RushAndCash598935' 6-max Seat #1 is the button
Seat 1: f898e827 ($5.14 in chips)
Seat 2: cd1f87c8 ($2.73 in chips)
Seat 3: 6aa0c391 ($5 in chips)
Seat 4: 92fa3d91 ($3.13 in chips)
Seat 5: 7af747dc ($14.97 in chips)
Seat 6: Hero ($5.74 in chips)
cd1f87c8: posts small blind $0.02
6aa0c391: posts big blind $0.05
*** HOLE CARDS ***
Dealt to f898e827 
Dealt to cd1f87c8 
Dealt to 6aa0c391 
Dealt to 92fa3d91 
Dealt to 7af747dc 
Dealt to Hero [7c Qh]
92fa3d91: folds
7af747dc: folds
Hero: folds
f898e827: folds
cd1f87c8: folds
Uncalled bet ($0.03) returned to 6aa0c391
*** SHOWDOWN ***
6aa0c391 collected $0.04 from pot
*** SUMMARY ***
Total pot $0.04 | Rake $0 | Jackpot $0 | Bingo $0 | Fortune $0 | Tax $0
Seat 1: f898e827 (button) folded before Flop (didn't bet)
Seat 2: cd1f87c8 (small blind) folded before Flop
Seat 3: 6aa0c391 (big blind) collected ($0.04)
Seat 4: 92fa3d91 folded before Flop (didn't bet)
Seat 5: 7af747dc folded before Flop (didn't bet)
Seat 6: Hero folded before Flop (didn't bet)


Poker Hand #RC3334373650: Hold'em No Limit ($0.02/$0.05) - 2025/02/17 20:25:57
Table 'RushAndCash598910' 6-max Seat #1 is the button
Seat 1: 886c894a ($9.37 in chips)
Seat 2: Hero ($5.76 in chips)
Seat 3: bb702030 ($7.54 in chips)
Seat 4: c95c6ae6 ($14.51 in chips)
Seat 5: 5db4cca ($5.4 in chips)
Seat 6: 1a2d8f33 ($5.47 in chips)
Hero: posts small blind $0.02
bb702030: posts big blind $0.05
*** HOLE CARDS ***
Dealt to 886c894a 
Dealt to Hero [Tc 3d]
Dealt to bb702030 
Dealt to c95c6ae6 
Dealt to 5db4cca 
Dealt to 1a2d8f33 
c95c6ae6: raises $0.05 to $0.1
5db4cca: folds
1a2d8f33: folds
886c894a: folds
Hero: folds
bb702030: folds
Uncalled bet ($0.05) returned to c95c6ae6
*** SHOWDOWN ***
c95c6ae6 collected $0.12 from pot
*** SUMMARY ***
Total pot $0.12 | Rake $0 | Jackpot $0 | Bingo $0 | Fortune $0 | Tax $0
Seat 1: 886c894a (button) folded before Flop (didn't bet)
Seat 2: Hero (small blind) folded before Flop
Seat 3: bb702030 (big blind) folded before Flop
Seat 4: c95c6ae6 collected ($0.12)
Seat 5: 5db4cca folded before Flop (didn't bet)
Seat 6: 1a2d8f33 folded before Flop (didn't bet)


Poker Hand #RC3334373630: Hold'em No Limit ($0.02/$0.05) - 2025/02/17 20:25:54
Table 'RushAndCash598890' 6-max Seat #1 is the button
Seat 1: ad22f70a ($7.27 in chips)
Seat 2: 4dd12e47 ($4.62 in chips)
Seat 3: Hero ($5.81 in chips)
Seat 4: 3469fa26 ($5.95 in chips)
Seat 5: 6e73d15 ($5.5 in chips)
Seat 6: 51f33dae ($16.98 in chips)
4dd12e47: posts small blind $0.02
Hero: posts big blind $0.05
*** HOLE CARDS ***
Dealt to ad22f70a 
Dealt to 4dd12e47 
Dealt to Hero [4s Qc]
Dealt to 3469fa26 
Dealt to 6e73d15 
Dealt to 51f33dae 
3469fa26: raises $0.05 to $0.1
6e73d15: folds
51f33dae: folds
ad22f70a: folds
4dd12e47: folds
Hero: folds
Uncalled bet ($0.05) returned to 3469fa26
*** SHOWDOWN ***
3469fa26 collected $0.12 from pot
*** SUMMARY ***
Total pot $0.12 | Rake $0 | Jackpot $0 | Bingo $0 | Fortune $0 | Tax $0
Seat 1: ad22f70a (button) folded before Flop (didn't bet)
Seat 2: 4dd12e47 (small blind) folded before Flop
Seat 3: Hero (big blind) folded before Flop
Seat 4: 3469fa26 collected ($0.12)
Seat 5: 6e73d15 folded before Flop (didn't bet)
Seat 6: 51f33dae folded before Flop (didn't bet)


Poker Hand #RC3334373611: Hold'em No Limit ($0.02/$0.05) - 2025/02/17 20:25:51
Table 'RushAndCash598871' 6-max Seat #1 is the button
Seat 1: f553bfb4 ($5.52 in chips)
Seat 2: 1754e33c ($5 in chips)
Seat 3: a0c50ee7 ($5.71 in chips)
Seat 4: Hero ($5.81 in chips)
Seat 5: 61b789ce ($5.14 in chips)
Seat 6: 5db4cca ($5.42 in chips)
1754e33c: posts small blind $0.02
a0c50ee7: posts big blind $0.05
*** HOLE CARDS ***
Dealt to f553bfb4 
Dealt to 1754e33c 
Dealt to a0c50ee7 
Dealt to Hero [6d 7d]
Dealt to 61b789ce 
Dealt to 5db4cca 
Hero: folds
61b789ce: folds
5db4cca: folds
f553bfb4: raises $0.08 to $0.13
1754e33c: calls $0.11
a0c50ee7: folds
*** FLOP *** [As 6s Jc]
1754e33c: checks
f553bfb4: bets $0.11
1754e33c: raises $0.59 to $0.7
f553bfb4: calls $0.59
*** TURN *** [As 6s Jc] [Ks]
1754e33c: checks
f553bfb4: bets $0.86
1754e33c: calls $0.86
*** RIVER *** [As 6s Jc Ks] [Qd]
1754e33c: checks
f553bfb4: checks
1754e33c: shows [6c Ac] (Pair of Aces and Pair of Sixes)
f553bfb4: shows [Jh Jd] (Three Jacks)
*** SHOWDOWN ***
f553bfb4 collected $3.21 from pot
*** SUMMARY ***
Total pot $3.43 | Rake $0.15 | Jackpot $0.07 | Bingo $0 | Fortune $0 | Tax $0
Board [As 6s Jc Ks Qd]
Seat 1: f553bfb4 (button) showed [Jh Jd] and won ($3.21) with Three Jacks
Seat 2: 1754e33c (small blind) showed [6c Ac] and lost with Pair of Aces and Pair of Sixes
Seat 3: a0c50ee7 (big blind) folded before Flop
Seat 4: Hero folded before Flop (didn't bet)
Seat 5: 61b789ce folded before Flop (didn't bet)
Seat 6: 5db4cca folded before Flop (didn't bet)


Poker Hand #RC3334373589: Hold'em No Limit ($0.02/$0.05) - 2025/02/17 20:25:48
Table 'RushAndCash598849' 6-max Seat #1 is the button
Seat 1: 28e11496 ($8.98 in chips)
Seat 2: 61b789ce ($5.16 in chips)
Seat 3: 1d0217bc ($5.78 in chips)
Seat 4: Hero ($5.81 in chips)
Seat 5: 7381628 ($5 in chips)
Seat 6: d913286e ($6.21 in chips)
61b789ce: posts small blind $0.02
1d0217bc: posts big blind $0.05
*** HOLE CARDS ***
Dealt to 28e11496 
Dealt to 61b789ce 
Dealt to 1d0217bc 
Dealt to Hero [4d 7s]
Dealt to 7381628 
Dealt to d913286e 
Hero: folds
7381628: folds
d913286e: folds
28e11496: folds
61b789ce: folds
Uncalled bet ($0.03) returned to 1d0217bc
*** SHOWDOWN ***
1d0217bc collected $0.04 from pot
*** SUMMARY ***
Total pot $0.04 | Rake $0 | Jackpot $0 | Bingo $0 | Fortune $0 | Tax $0
Seat 1: 28e11496 (button) folded before Flop (didn't bet)
Seat 2: 61b789ce (small blind) folded before Flop
Seat 3: 1d0217bc (big blind) collected ($0.04)
Seat 4: Hero folded before Flop (didn't bet)
Seat 5: 7381628 folded before Flop (didn't bet)
Seat 6: d913286e folded before Flop (didn't bet)


Poker Hand #RC3334373569: Hold'em No Limit ($0.02/$0.05) - 2025/02/17 20:25:45
Table 'RushAndCash598829' 6-max Seat #1 is the button
Seat 1: Hero ($5.81 in chips)
Seat 2: 36753d76 ($5 in chips)
Seat 3: 3b85f8e6 ($14.5 in chips)
Seat 4: e68a71ba ($4.36 in chips)
Seat 5: 78b1f985 ($4.78 in chips)
Seat 6: b61b14d7 ($5.28 in chips)
36753d76: posts small blind $0.02
3b85f8e6: posts big blind $0.05
*** HOLE CARDS ***
Dealt to Hero [8h Kd]
Dealt to 36753d76 
Dealt to 3b85f8e6 
Dealt to e68a71ba 
Dealt to 78b1f985 
Dealt to b61b14d7 
e68a71ba: folds
78b1f985: folds
b61b14d7: folds
Hero: folds
36753d76: raises $0.1 to $0.15
3b85f8e6: folds
Uncalled bet ($0.1) returned to 36753d76
*** SHOWDOWN ***
36753d76 collected $0.1 from pot
*** SUMMARY ***
Total pot $0.1 | Rake $0 | Jackpot $0 | Bingo $0 | Fortune $0 | Tax $0
Seat 1: Hero (button) folded before Flop (didn't bet)
Seat 2: 36753d76 (small blind) collected ($0.1)
Seat 3: 3b85f8e6 (big blind) folded before Flop
Seat 4: e68a71ba folded before Flop (didn't bet)
Seat 5: 78b1f985 folded before Flop (didn't bet)
Seat 6: b61b14d7 folded before Flop (didn't bet)


Poker Hand #RC3334373545: Hold'em No Limit ($0.02/$0.05) - 2025/02/17 20:25:42
Table 'RushAndCash598805' 6-max Seat #1 is the button
Seat 1: 95fac4b9 ($9.5 in chips)
Seat 2: 42eefc11 ($9.4 in chips)
Seat 3: 3b2a8270 ($8.91 in chips)
Seat 4: Hero ($5.81 in chips)
Seat 5: 1d0217bc ($5.78 in chips)
Seat 6: 626359de ($6.23 in chips)
42eefc11: posts small blind $0.02
3b2a8270: posts big blind $0.05
*** HOLE CARDS ***
Dealt to 95fac4b9 
Dealt to 42eefc11 
Dealt to 3b2a8270 
Dealt to Hero [7h 3h]
Dealt to 1d0217bc 
Dealt to 626359de 
Hero: folds
1d0217bc: folds
626359de: raises $0.08 to $0.13
95fac4b9: folds
42eefc11: folds
3b2a8270: folds
Uncalled bet ($0.08) returned to 626359de
*** SHOWDOWN ***
626359de collected $0.12 from pot
*** SUMMARY ***
Total pot $0.12 | Rake $0 | Jackpot $0 | Bingo $0 | Fortune $0 | Tax $0
Seat 1: 95fac4b9 (button) folded before Flop (didn't bet)
Seat 2: 42eefc11 (small blind) folded before Flop
Seat 3: 3b2a8270 (big blind) folded before Flop
Seat 4: Hero folded before Flop (didn't bet)
Seat 5: 1d0217bc folded before Flop (didn't bet)
Seat 6: 626359de collected ($0.12)


Poker Hand #RC3334373524: Hold'em No Limit ($0.02/$0.05) - 2025/02/17 20:25:39
Table 'RushAndCash598784' 6-max Seat #1 is the button
Seat 1: a2794999 ($6.48 in chips)
Seat 2: Hero ($5.83 in chips)
Seat 3: 2eb4439f ($7.28 in chips)
Seat 4: ead6cfaf ($5 in chips)
Seat 5: ba18b75e ($9.79 in chips)
Seat 6: faba3abb ($5 in chips)
Hero: posts small blind $0.02
2eb4439f: posts big blind $0.05
*** HOLE CARDS ***
Dealt to a2794999 
Dealt to Hero [4h Kh]
Dealt to 2eb4439f 
Dealt to ead6cfaf 
Dealt to ba18b75e 
Dealt to faba3abb 
ead6cfaf: folds
ba18b75e: folds
faba3abb: folds
a2794999: folds
Hero: folds
Uncalled bet ($0.03) returned to 2eb4439f
*** SHOWDOWN ***
2eb4439f collected $0.04 from pot
*** SUMMARY ***
Total pot $0.04 | Rake $0 | Jackpot $0 | Bingo $0 | Fortune $0 | Tax $0
Seat 1: a2794999 (button) folded before Flop (didn't bet)
Seat 2: Hero (small blind) folded before Flop
Seat 3: 2eb4439f (big blind) collected ($0.04)
Seat 4: ead6cfaf folded before Flop (didn't bet)
Seat 5: ba18b75e folded before Flop (didn't bet)
Seat 6: faba3abb folded before Flop (didn't bet)


Poker Hand #RC3334373504: Hold'em No Limit ($0.02/$0.05) - 2025/02/17 20:25:36
Table 'RushAndCash598764' 6-max Seat #1 is the button
Seat 1: c1784884 ($5.16 in chips)
Seat 2: e5f214e5 ($8.29 in chips)
Seat 3: Hero ($5.88 in chips)
Seat 4: af002596 ($6.15 in chips)
Seat 5: bc6bd004 ($5.57 in chips)
Seat 6: 860b5247 ($7.95 in chips)
e5f214e5: posts small blind $0.02
Hero: posts big blind $0.05
*** HOLE CARDS ***
Dealt to c1784884 
Dealt to e5f214e5 
Dealt to Hero [7h Td]
Dealt to af002596 
Dealt to bc6bd004 
Dealt to 860b5247 
af002596: folds
bc6bd004: folds
860b5247: raises $0.07 to $0.12
c1784884: folds
e5f214e5: folds
Hero: folds
Uncalled bet ($0.07) returned to 860b5247
*** SHOWDOWN ***
860b5247 collected $0.12 from pot
*** SUMMARY ***
Total pot $0.12 | Rake $0 | Jackpot $0 | Bingo $0 | Fortune $0 | Tax $0
Seat 1: c1784884 (button) folded before Flop (didn't bet)
Seat 2: e5f214e5 (small blind) folded before Flop
Seat 3: Hero (big blind) folded before Flop
Seat 4: af002596 folded before Flop (didn't bet)
Seat 5: bc6bd004 folded before Flop (didn't bet)
Seat 6: 860b5247 collected ($0.12)


Poker Hand #RC3334373112: Hold'em No Limit ($0.02/$0.05) - 2025/02/17 20:24:34
Table 'RushAndCash598372' 6-max Seat #1 is the button
Seat 1: Hero ($6.26 in chips)
Seat 2: c812cddb ($13.73 in chips)
Seat 3: 817f21da ($4.63 in chips)
Seat 4: ee5bb31d ($5.32 in chips)
Seat 5: f0d238ad ($9.93 in chips)
Seat 6: 5db4cca ($5.71 in chips)
c812cddb: posts small blind $0.02
817f21da: posts big blind $0.05
*** HOLE CARDS ***
Dealt to Hero [Kc 8c]
Dealt to c812cddb 
Dealt to 817f21da 
Dealt to ee5bb31d 
Dealt to f0d238ad 
Dealt to 5db4cca 
ee5bb31d: folds
f0d238ad: folds
5db4cca: folds
Hero: raises $0.05 to $0.1
c812cddb: folds
817f21da: calls $0.05
*** FLOP *** [7h Qs Kh]
817f21da: checks
Hero: bets $0.08
817f21da: calls $0.08
*** TURN *** [7h Qs Kh] [7s]
817f21da: checks
Hero: bets $0.2
817f21da: calls $0.2
*** RIVER *** [7h Qs Kh 7s] [Ts]
817f21da: checks
Hero: checks
817f21da: shows [8s Ks] (King High Flush)
Hero: shows [Kc 8c] (Pair of Kings and Pair of Sevens)
*** SHOWDOWN ***
817f21da collected $0.75 from pot
*** SUMMARY ***
Total pot $0.78 | Rake $0.03 | Jackpot $0 | Bingo $0 | Fortune $0 | Tax $0
Board [7h Qs Kh 7s Ts]
Seat 1: Hero (button) showed [Kc 8c] and lost with Pair of Kings and Pair of Sevens
Seat 2: c812cddb (small blind) folded before Flop
Seat 3: 817f21da (big blind) showed [8s Ks] and won ($0.75) with King High Flush
Seat 4: ee5bb31d folded before Flop (didn't bet)
Seat 5: f0d238ad folded before Flop (didn't bet)
Seat 6: 5db4cca folded before Flop (didn't bet)


Poker Hand #RC3334372917: Hold'em No Limit ($0.02/$0.05) - 2025/02/17 20:24:04
Table 'RushAndCash598177' 6-max Seat #1 is the button
Seat 1: 287f8174 ($5 in chips)
Seat 2: b66d20fa ($19.85 in chips)
Seat 3: f5fcc522 ($10.53 in chips)
Seat 4: 711af4a4 ($4.55 in chips)
Seat 5: 83a70a61 ($5 in chips)
Seat 6: Hero ($5.9 in chips)
b66d20fa: posts small blind $0.02
f5fcc522: posts big blind $0.05
*** HOLE CARDS ***
Dealt to 287f8174 
Dealt to b66d20fa 
Dealt to f5fcc522 
Dealt to 711af4a4 
Dealt to 83a70a61 
Dealt to Hero [Qd Ad]
711af4a4: raises $0.05 to $0.1
83a70a61: folds
Hero: raises $0.22 to $0.32
287f8174: folds
b66d20fa: folds
f5fcc522: folds
711af4a4: calls $0.22
*** FLOP *** [Kd Qh 6s]
711af4a4: checks
Hero: bets $0.24
711af4a4: folds
Uncalled bet ($0.24) returned to Hero
*** SHOWDOWN ***
Hero collected $0.68 from pot
*** SUMMARY ***
Total pot $0.71 | Rake $0.03 | Jackpot $0 | Bingo $0 | Fortune $0 | Tax $0
Board [Kd Qh 6s]
Seat 1: 287f8174 (button) folded before Flop (didn't bet)
Seat 2: b66d20fa (small blind) folded before Flop
Seat 3: f5fcc522 (big blind) folded before Flop
Seat 4: 711af4a4 folded on the Flop
Seat 5: 83a70a61 folded before Flop (didn't bet)
Seat 6: Hero won ($0.68)


Poker Hand #RC3334372486: Hold'em No Limit ($0.02/$0.05) - 2025/02/17 20:22:54
Table 'RushAndCash597746' 6-max Seat #1 is the button
Seat 1: 42fca4f9 ($4.83 in chips)
Seat 2: 6801c5e5 ($5 in chips)
Seat 3: 902b47de ($5 in chips)
Seat 4: Hero ($5.24 in chips)
Seat 5: 3d9dea9b ($6.45 in chips)
Seat 6: 8ffbb474 ($10.1 in chips)
6801c5e5: posts small blind $0.02
902b47de: posts big blind $0.05
*** HOLE CARDS ***
Dealt to 42fca4f9 
Dealt to 6801c5e5 
Dealt to 902b47de 
Dealt to Hero [Ks Qs]
Dealt to 3d9dea9b 
Dealt to 8ffbb474 
Hero: raises $0.05 to $0.1
3d9dea9b: folds
8ffbb474: folds
42fca4f9: folds
6801c5e5: folds
902b47de: calls $0.05
*** FLOP *** [As Qd 6s]
902b47de: checks
Hero: bets $0.08
902b47de: calls $0.08
*** TURN *** [As Qd 6s] [Qc]
902b47de: checks
Hero: bets $0.2
902b47de: calls $0.2
*** RIVER *** [As Qd 6s Qc] [5d]
902b47de: checks
Hero: bets $0.4
902b47de: calls $0.4
Hero: shows [Ks Qs] (Three Queens)
902b47de: shows [Ad Js] (Pair of Aces and Pair of Queens)
*** SHOWDOWN ***
Hero collected $1.44 from pot
*** SUMMARY ***
Total pot $1.58 | Rake $0.07 | Jackpot $0.07 | Bingo $0 | Fortune $0 | Tax $0
Board [As Qd 6s Qc 5d]
Seat 1: 42fca4f9 (button) folded before Flop (didn't bet)
Seat 2: 6801c5e5 (small blind) folded before Flop
Seat 3: 902b47de (big blind) showed [Ad Js] and lost with Pair of Aces and Pair of Queens
Seat 4: Hero showed [Ks Qs] and won ($1.44) with Three Queens
Seat 5: 3d9dea9b folded before Flop (didn't bet)
Seat 6: 8ffbb474 folded before Flop (didn't bet)


Poker Hand #RC3334372347: Hold'em No Limit ($0.02/$0.05) - 2025/02/17 20:22:31
Table 'RushAndCash597607' 6-max Seat #1 is the button
Seat 1: 4c8dd192 ($10.97 in chips)
Seat 2: Hero ($5.39 in chips)
Seat 3: 8ffbb474 ($9.96 in chips)
Seat 4: 14b45b97 ($9.78 in chips)
Seat 5: 93735ac4 ($4.42 in chips)
Seat 6: f25a1768 ($9.47 in chips)
Hero: posts small blind $0.02
8ffbb474: posts big blind $0.05
*** HOLE CARDS ***
Dealt to 4c8dd192 
Dealt to Hero [Ac Jd]
Dealt to 8ffbb474 
Dealt to 14b45b97 
Dealt to 93735ac4 
Dealt to f25a1768 
14b45b97: folds
93735ac4: folds
f25a1768: folds
4c8dd192: folds
Hero: raises $0.1 to $0.15
8ffbb474: calls $0.1
*** FLOP *** [4s 2s 5s]
Hero: checks
8ffbb474: bets $0.1
Hero: folds
Uncalled bet ($0.1) returned to 8ffbb474
*** SHOWDOWN ***
8ffbb474 collected $0.29 from pot
*** SUMMARY ***
Total pot $0.3 | Rake $0.01 | Jackpot $0 | Bingo $0 | Fortune $0 | Tax $0
Board [4s 2s 5s]
Seat 1: 4c8dd192 (button) folded before Flop (didn't bet)
Seat 2: Hero (small blind) folded on the Flop
Seat 3: 8ffbb474 (big blind) won ($0.29)
Seat 4: 14b45b97 folded before Flop (didn't bet)
Seat 5: 93735ac4 folded before Flop (didn't bet)
Seat 6: f25a1768 folded before Flop (didn't bet)


Poker Hand #RC3334372324: Hold'em No Limit ($0.02/$0.05) - 2025/02/17 20:22:28
Table 'RushAndCash597584' 6-max Seat #1 is the button
Seat 1: 27baaa05 ($5.67 in chips)
Seat 2: 1772d36f ($6.48 in chips)
Seat 3: 8dbd0a2d ($5.84 in chips)
Seat 4: 803e9f05 ($6.41 in chips)
Seat 5: c7e9103c ($20.51 in chips)
Seat 6: Hero ($5.39 in chips)
1772d36f: posts small blind $0.02
8dbd0a2d: posts big blind $0.05
*** HOLE CARDS ***
Dealt to 27baaa05 
Dealt to 1772d36f 
Dealt to 8dbd0a2d 
Dealt to 803e9f05 
Dealt to c7e9103c 
Dealt to Hero [5c 3s]
803e9f05: folds
c7e9103c: folds
Hero: folds
27baaa05: raises $0.08 to $0.13
1772d36f: folds
8dbd0a2d: folds
Uncalled bet ($0.08) returned to 27baaa05
*** SHOWDOWN ***
27baaa05 collected $0.12 from pot
*** SUMMARY ***
Total pot $0.12 | Rake $0 | Jackpot $0 | Bingo $0 | Fortune $0 | Tax $0
Seat 1: 27baaa05 (button) collected ($0.12)
Seat 2: 1772d36f (small blind) folded before Flop
Seat 3: 8dbd0a2d (big blind) folded before Flop
Seat 4: 803e9f05 folded before Flop (didn't bet)
Seat 5: c7e9103c folded before Flop (didn't bet)
Seat 6: Hero folded before Flop (didn't bet)


Poker Hand #RC3334372297: Hold'em No Limit ($0.02/$0.05) - 2025/02/17 20:22:24
Table 'RushAndCash597557' 6-max Seat #1 is the button
Seat 1: df6ad119 ($5 in chips)
Seat 2: 7e2526f2 ($5 in chips)
Seat 3: 87d9de00 ($2.27 in chips)
Seat 4: f71f9fc0 ($4.93 in chips)
Seat 5: Hero ($5.39 in chips)
Seat 6: 8dbd0a2d ($5.84 in chips)
7e2526f2: posts small blind $0.02
87d9de00: posts big blind $0.05
*** HOLE CARDS ***
Dealt to df6ad119 
Dealt to 7e2526f2 
Dealt to 87d9de00 
Dealt to f71f9fc0 
Dealt to Hero [Ac 9d]
Dealt to 8dbd0a2d 
f71f9fc0: folds
Hero: folds
8dbd0a2d: folds
df6ad119: raises $0.05 to $0.1
7e2526f2: folds
87d9de00: folds
Uncalled bet ($0.05) returned to df6ad119
*** SHOWDOWN ***
df6ad119 collected $0.12 from pot
*** SUMMARY ***
Total pot $0.12 | Rake $0 | Jackpot $0 | Bingo $0 | Fortune $0 | Tax $0
Seat 1: df6ad119 (button) collected ($0.12)
Seat 2: 7e2526f2 (small blind) folded before Flop
Seat 3: 87d9de00 (big blind) folded before Flop
Seat 4: f71f9fc0 folded before Flop (didn't bet)
Seat 5: Hero folded before Flop (didn't bet)
Seat 6: 8dbd0a2d folded before Flop (didn't bet)


Poker Hand #RC3334372248: Hold'em No Limit ($0.02/$0.05) - 2025/02/17 20:22:16
Table 'RushAndCash597508' 6-max Seat #1 is the button
Seat 1: eb09e492 ($8.16 in chips)
Seat 2: 93dfef8b ($5.02 in chips)
Seat 3: Hero ($5.44 in chips)
Seat 4: 42fca4f9 ($4.95 in chips)
Seat 5: e390e48e ($6.26 in chips)
Seat 6: 187f2194 ($5.12 in chips)
93dfef8b: posts small blind $0.02
Hero: posts big blind $0.05
*** HOLE CARDS ***
Dealt to eb09e492 
Dealt to 93dfef8b 
Dealt to Hero [8h 3s]
Dealt to 42fca4f9 
Dealt to e390e48e 
Dealt to 187f2194 
42fca4f9: folds
e390e48e: folds
187f2194: raises $0.06 to $0.11
eb09e492: calls $0.11
93dfef8b: folds
Hero: folds
*** FLOP *** [Ks 8s Kh]
187f2194: bets $0.15
eb09e492: folds
Uncalled bet ($0.15) returned to 187f2194
*** SHOWDOWN ***
187f2194 collected $0.28 from pot
*** SUMMARY ***
Total pot $0.29 | Rake $0.01 | Jackpot $0 | Bingo $0 | Fortune $0 | Tax $0
Board [Ks 8s Kh]
Seat 1: eb09e492 (button) folded on the Flop
Seat 2: 93dfef8b (small blind) folded before Flop
Seat 3: Hero (big blind) folded before Flop
Seat 4: 42fca4f9 folded before Flop (didn't bet)
Seat 5: e390e48e folded before Flop (didn't bet)
Seat 6: 187f2194 won ($0.28)


Poker Hand #RC3334372230: Hold'em No Limit ($0.02/$0.05) - 2025/02/17 20:22:12
Table 'RushAndCash597490' 6-max Seat #1 is the button
Seat 1: Hero ($5.44 in chips)
Seat 2: c607d475 ($10.2 in chips)
Seat 3: 87cdcefe ($2.95 in chips)
Seat 4: 8c3789e ($7.08 in chips)
Seat 5: d58b99ca ($8.64 in chips)
Seat 6: 1dbfd698 ($8.93 in chips)
c607d475: posts small blind $0.02
87cdcefe: posts big blind $0.05
*** HOLE CARDS ***
Dealt to Hero [9h Ks]
Dealt to c607d475 
Dealt to 87cdcefe 
Dealt to 8c3789e 
Dealt to d58b99ca 
Dealt to 1dbfd698 
8c3789e: folds
d58b99ca: folds
1dbfd698: folds
Hero: folds
c607d475: folds
Uncalled bet ($0.03) returned to 87cdcefe
*** SHOWDOWN ***
87cdcefe collected $0.04 from pot
*** SUMMARY ***
Total pot $0.04 | Rake $0 | Jackpot $0 | Bingo $0 | Fortune $0 | Tax $0
Seat 1: Hero (button) folded before Flop (didn't bet)
Seat 2: c607d475 (small blind) folded before Flop
Seat 3: 87cdcefe (big blind) collected ($0.04)
Seat 4: 8c3789e folded before Flop (didn't bet)
Seat 5: d58b99ca folded before Flop (didn't bet)
Seat 6: 1dbfd698 folded before Flop (didn't bet)


Poker Hand #RC3334372104: Hold'em No Limit ($0.02/$0.05) - 2025/02/17 20:21:51
Table 'RushAndCash597364' 6-max Seat #1 is the button
Seat 1: ded3640 ($5.34 in chips)
Seat 2: ab8d5924 ($5.61 in chips)
Seat 3: 5acd5e40 ($5.15 in chips)
Seat 4: Hero ($5.37 in chips)
Seat 5: 94a63b6c ($6.38 in chips)
Seat 6: c4eb9775 ($17.25 in chips)
ab8d5924: posts small blind $0.02
5acd5e40: posts big blind $0.05
*** HOLE CARDS ***
Dealt to ded3640 
Dealt to ab8d5924 
Dealt to 5acd5e40 
Dealt to Hero [As Qs]
Dealt to 94a63b6c 
Dealt to c4eb9775 
Hero: raises $0.05 to $0.1
94a63b6c: folds
c4eb9775: folds
ded3640: folds
ab8d5924: folds
5acd5e40: folds
Uncalled bet ($0.05) returned to Hero
*** SHOWDOWN ***
Hero collected $0.12 from pot
*** SUMMARY ***
Total pot $0.12 | Rake $0 | Jackpot $0 | Bingo $0 | Fortune $0 | Tax $0
Seat 1: ded3640 (button) folded before Flop (didn't bet)
Seat 2: ab8d5924 (small blind) folded before Flop
Seat 3: 5acd5e40 (big blind) folded before Flop
Seat 4: Hero collected ($0.12)
Seat 5: 94a63b6c folded before Flop (didn't bet)
Seat 6: c4eb9775 folded before Flop (didn't bet)


Poker Hand #RC3334371899: Hold'em No Limit ($0.02/$0.05) - 2025/02/17 20:21:19
Table 'RushAndCash597159' 6-max Seat #1 is the button
Seat 1: 974683c7 ($5 in chips)
Seat 2: 436ecab0 ($2.66 in chips)
Seat 3: c4eb9775 ($17.63 in chips)
Seat 4: 9ff32da5 ($2.9 in chips)
Seat 5: Hero ($5 in chips)
Seat 6: cc01248b ($4.88 in chips)
436ecab0: posts small blind $0.02
c4eb9775: posts big blind $0.05
*** HOLE CARDS ***
Dealt to 974683c7 
Dealt to 436ecab0 
Dealt to c4eb9775 
Dealt to 9ff32da5 
Dealt to Hero [Kd Tc]
Dealt to cc01248b 
9ff32da5: folds
Hero: raises $0.05 to $0.1
cc01248b: folds
974683c7: folds
436ecab0: folds
c4eb9775: raises $0.08 to $0.18
Hero: calls $0.08
*** FLOP *** [Kc 5d 9h]
c4eb9775: checks
Hero: checks
*** TURN *** [Kc 5d 9h] [Qh]
c4eb9775: checks
Hero: bets $0.2
c4eb9775: calls $0.2
*** RIVER *** [Kc 5d 9h Qh] [7s]
c4eb9775: checks
Hero: checks
c4eb9775: shows [Ad Td] (Ace-High)
Hero: shows [Kd Tc] (Pair of Kings)
*** SHOWDOWN ***
Hero collected $0.75 from pot
*** SUMMARY ***
Total pot $0.78 | Rake $0.03 | Jackpot $0 | Bingo $0 | Fortune $0 | Tax $0
Board [Kc 5d 9h Qh 7s]
Seat 1: 974683c7 (button) folded before Flop (didn't bet)
Seat 2: 436ecab0 (small blind) folded before Flop
Seat 3: c4eb9775 (big blind) showed [Ad Td] and lost with Ace-High
Seat 4: 9ff32da5 folded before Flop (didn't bet)
Seat 5: Hero showed [Kd Tc] and won ($0.75) with Pair of Kings
Seat 6: cc01248b folded before Flop (didn't bet)


Poker Hand #RC3334371769: Hold'em No Limit ($0.02/$0.05) - 2025/02/17 20:20:57
Table 'RushAndCash597029' 6-max Seat #1 is the button
Seat 1: Hero ($5.07 in chips)
Seat 2: c812cddb ($13.02 in chips)
Seat 3: d5283567 ($13.2 in chips)
Seat 4: 8ffbb474 ($11.04 in chips)
Seat 5: b0ee20aa ($14.5 in chips)
Seat 6: 4052bb6f ($5.14 in chips)
c812cddb: posts small blind $0.02
d5283567: posts big blind $0.05
*** HOLE CARDS ***
Dealt to Hero [6d 6s]
Dealt to c812cddb 
Dealt to d5283567 
Dealt to 8ffbb474 
Dealt to b0ee20aa 
Dealt to 4052bb6f 
8ffbb474: folds
b0ee20aa: raises $0.08 to $0.13
4052bb6f: folds
Hero: calls $0.13
c812cddb: raises $0.33 to $0.46
d5283567: folds
b0ee20aa: raises $0.74 to $1.2
Hero: folds
c812cddb: folds
Uncalled bet ($0.74) returned to b0ee20aa
*** SHOWDOWN ***
b0ee20aa collected $1.05 from pot
*** SUMMARY ***
Total pot $1.1 | Rake $0.05 | Jackpot $0 | Bingo $0 | Fortune $0 | Tax $0
Seat 1: Hero (button) folded before Flop
Seat 2: c812cddb (small blind) folded before Flop
Seat 3: d5283567 (big blind) folded before Flop
Seat 4: 8ffbb474 folded before Flop (didn't bet)
Seat 5: b0ee20aa collected ($1.05)
Seat 6: 4052bb6f folded before Flop (didn't bet)


Poker Hand #RC3334371704: Hold'em No Limit ($0.02/$0.05) - 2025/02/17 20:20:46
Table 'RushAndCash596964' 6-max Seat #1 is the button
Seat 1: 5a37a767 ($5 in chips)
Seat 2: Hero ($5.09 in chips)
Seat 3: 4c8dd192 ($9.72 in chips)
Seat 4: 8012317b ($5.69 in chips)
Seat 5: ca93b3ea ($6.07 in chips)
Seat 6: ec1d0d44 ($10.23 in chips)
Hero: posts small blind $0.02
4c8dd192: posts big blind $0.05
*** HOLE CARDS ***
Dealt to 5a37a767 
Dealt to Hero [3c 7c]
Dealt to 4c8dd192 
Dealt to 8012317b 
Dealt to ca93b3ea 
Dealt to ec1d0d44 
8012317b: raises $0.07 to $0.12
ca93b3ea: folds
ec1d0d44: folds
5a37a767: folds
Hero: folds
4c8dd192: folds
Uncalled bet ($0.07) returned to 8012317b
*** SHOWDOWN ***
8012317b collected $0.12 from pot
*** SUMMARY ***
Total pot $0.12 | Rake $0 | Jackpot $0 | Bingo $0 | Fortune $0 | Tax $0
Seat 1: 5a37a767 (button) folded before Flop (didn't bet)
Seat 2: Hero (small blind) folded before Flop
Seat 3: 4c8dd192 (big blind) folded before Flop
Seat 4: 8012317b collected ($0.12)
Seat 5: ca93b3ea folded before Flop (didn't bet)
Seat 6: ec1d0d44 folded before Flop (didn't bet)


Poker Hand #RC3334371681: Hold'em No Limit ($0.02/$0.05) - 2025/02/17 20:20:43
Table 'RushAndCash596941' 6-max Seat #1 is the button
Seat 1: 15346d36 ($3.92 in chips)
Seat 2: 61b789ce ($5 in chips)
Seat 3: Hero ($5.14 in chips)
Seat 4: 9a69a3a0 ($5 in chips)
Seat 5: 7cfb455f ($6.3 in chips)
Seat 6: 3b2a8270 ($8.11 in chips)
61b789ce: posts small blind $0.02
Hero: posts big blind $0.05
*** HOLE CARDS ***
Dealt to 15346d36 
Dealt to 61b789ce 
Dealt to Hero [Jc 3s]
Dealt to 9a69a3a0 
Dealt to 7cfb455f 
Dealt to 3b2a8270 
9a69a3a0: folds
7cfb455f: folds
3b2a8270: raises $0.05 to $0.1
15346d36: folds
61b789ce: folds
Hero: folds
Uncalled bet ($0.05) returned to 3b2a8270
*** SHOWDOWN ***
3b2a8270 collected $0.12 from pot
*** SUMMARY ***
Total pot $0.12 | Rake $0 | Jackpot $0 | Bingo $0 | Fortune $0 | Tax $0
Seat 1: 15346d36 (button) folded before Flop (didn't bet)
Seat 2: 61b789ce (small blind) folded before Flop
Seat 3: Hero (big blind) folded before Flop
Seat 4: 9a69a3a0 folded before Flop (didn't bet)
Seat 5: 7cfb455f folded before Flop (didn't bet)
Seat 6: 3b2a8270 collected ($0.12)


Poker Hand #RC3334371656: Hold'em No Limit ($0.02/$0.05) - 2025/02/17 20:20:38
Table 'RushAndCash596916' 6-max Seat #1 is the button
Seat 1: 45a5085b ($2 in chips)
Seat 2: bddf8e1e ($11.33 in chips)
Seat 3: cf7f09c2 ($7.56 in chips)
Seat 4: 9ed6ffbf ($5.05 in chips)
Seat 5: e9c5dfd7 ($6.06 in chips)
Seat 6: Hero ($5.14 in chips)
bddf8e1e: posts small blind $0.02
cf7f09c2: posts big blind $0.05
*** HOLE CARDS ***
Dealt to 45a5085b 
Dealt to bddf8e1e 
Dealt to cf7f09c2 
Dealt to 9ed6ffbf 
Dealt to e9c5dfd7 
Dealt to Hero [4c Qd]
9ed6ffbf: folds
e9c5dfd7: raises $0.05 to $0.1
Hero: folds
45a5085b: folds
bddf8e1e: folds
cf7f09c2: folds
Uncalled bet ($0.05) returned to e9c5dfd7
*** SHOWDOWN ***
e9c5dfd7 collected $0.12 from pot
*** SUMMARY ***
Total pot $0.12 | Rake $0 | Jackpot $0 | Bingo $0 | Fortune $0 | Tax $0
Seat 1: 45a5085b (button) folded before Flop (didn't bet)
Seat 2: bddf8e1e (small blind) folded before Flop
Seat 3: cf7f09c2 (big blind) folded before Flop
Seat 4: 9ed6ffbf folded before Flop (didn't bet)
Seat 5: e9c5dfd7 collected ($0.12)
Seat 6: Hero folded before Flop (didn't bet)


Poker Hand #RC3334371619: Hold'em No Limit ($0.02/$0.05) - 2025/02/17 20:20:32
Table 'RushAndCash596879' 6-max Seat #1 is the button
Seat 1: e69e22e ($5 in chips)
Seat 2: 92fa3d91 ($3.74 in chips)
Seat 3: 6a5a3ab6 ($6.68 in chips)
Seat 4: 8a2a3713 ($4.51 in chips)
Seat 5: a223d3ca ($5.07 in chips)
Seat 6: Hero ($5.14 in chips)
92fa3d91: posts small blind $0.02
6a5a3ab6: posts big blind $0.05
*** HOLE CARDS ***
Dealt to e69e22e 
Dealt to 92fa3d91 
Dealt to 6a5a3ab6 
Dealt to 8a2a3713 
Dealt to a223d3ca 
Dealt to Hero [Th 5h]
8a2a3713: folds
a223d3ca: raises $0.05 to $0.1
Hero: folds
e69e22e: raises $0.21 to $0.31
92fa3d91: folds
6a5a3ab6: folds
a223d3ca: folds
Uncalled bet ($0.21) returned to e69e22e
*** SHOWDOWN ***
e69e22e collected $0.26 from pot
*** SUMMARY ***
Total pot $0.27 | Rake $0.01 | Jackpot $0 | Bingo $0 | Fortune $0 | Tax $0
Seat 1: e69e22e (button) collected ($0.26)
Seat 2: 92fa3d91 (small blind) folded before Flop
Seat 3: 6a5a3ab6 (big blind) folded before Flop
Seat 4: 8a2a3713 folded before Flop (didn't bet)
Seat 5: a223d3ca folded before Flop
Seat 6: Hero folded before Flop (didn't bet)


Poker Hand #RC3334371597: Hold'em No Limit ($0.02/$0.05) - 2025/02/17 20:20:28
Table 'RushAndCash596857' 6-max Seat #1 is the button
Seat 1: 57d6169c ($5.07 in chips)
Seat 2: f45ac3d0 ($5.17 in chips)
Seat 3: 188c8947 ($4.81 in chips)
Seat 4: Hero ($5.14 in chips)
Seat 5: 25f30dbe ($5.16 in chips)
Seat 6: 92099542 ($4.79 in chips)
f45ac3d0: posts small blind $0.02
188c8947: posts big blind $0.05
*** HOLE CARDS ***
Dealt to 57d6169c 
Dealt to f45ac3d0 
Dealt to 188c8947 
Dealt to Hero [Ah 9s]
Dealt to 25f30dbe 
Dealt to 92099542 
Hero: folds
25f30dbe: raises $0.05 to $0.1
92099542: folds
57d6169c: folds
f45ac3d0: folds
188c8947: folds
Uncalled bet ($0.05) returned to 25f30dbe
*** SHOWDOWN ***
25f30dbe collected $0.12 from pot
*** SUMMARY ***
Total pot $0.12 | Rake $0 | Jackpot $0 | Bingo $0 | Fortune $0 | Tax $0
Seat 1: 57d6169c (button) folded before Flop (didn't bet)
Seat 2: f45ac3d0 (small blind) folded before Flop
Seat 3: 188c8947 (big blind) folded before Flop
Seat 4: Hero folded before Flop (didn't bet)
Seat 5: 25f30dbe collected ($0.12)
Seat 6: 92099542 folded before Flop (didn't bet)


Poker Hand #RC3334371572: Hold'em No Limit ($0.02/$0.05) - 2025/02/17 20:20:24
Table 'RushAndCash596832' 6-max Seat #1 is the button
Seat 1: fe532acc ($5 in chips)
Seat 2: 1e232769 ($5.02 in chips)
Seat 3: 2e8ab509 ($5.3 in chips)
Seat 4: 5381eb4c ($5 in chips)
Seat 5: 9864109b ($5.51 in chips)
Seat 6: Hero ($5.14 in chips)
1e232769: posts small blind $0.02
2e8ab509: posts big blind $0.05
*** HOLE CARDS ***
Dealt to fe532acc 
Dealt to 1e232769 
Dealt to 2e8ab509 
Dealt to 5381eb4c 
Dealt to 9864109b 
Dealt to Hero [3h 3c]
5381eb4c: folds
9864109b: folds
Hero: folds
fe532acc: folds
1e232769: raises $0.1 to $0.15
2e8ab509: calls $0.1
*** FLOP *** [5d Qd 9s]
1e232769: bets $0.1
2e8ab509: calls $0.1
*** TURN *** [5d Qd 9s] [2d]
1e232769: checks
2e8ab509: checks
*** RIVER *** [5d Qd 9s 2d] [Kh]
1e232769: bets $0.17
2e8ab509: folds
Uncalled bet ($0.17) returned to 1e232769
*** SHOWDOWN ***
1e232769 collected $0.48 from pot
*** SUMMARY ***
Total pot $0.5 | Rake $0.02 | Jackpot $0 | Bingo $0 | Fortune $0 | Tax $0
Board [5d Qd 9s 2d Kh]
Seat 1: fe532acc (button) folded before Flop (didn't bet)
Seat 2: 1e232769 (small blind) won ($0.48)
Seat 3: 2e8ab509 (big blind) folded on the River
Seat 4: 5381eb4c folded before Flop (didn't bet)
Seat 5: 9864109b folded before Flop (didn't bet)
Seat 6: Hero folded before Flop (didn't bet)


Poker Hand #RC3334371543: Hold'em No Limit ($0.02/$0.05) - 2025/02/17 20:20:19
Table 'RushAndCash596803' 6-max Seat #1 is the button
Seat 1: Hero ($5.07 in chips)
Seat 2: 46997984 ($5.84 in chips)
Seat 3: 9598e06a ($7.67 in chips)
Seat 4: f02d4645 ($5.29 in chips)
Seat 5: 57d6169c ($5 in chips)
Seat 6: aa4f3313 ($5 in chips)
46997984: posts small blind $0.02
9598e06a: posts big blind $0.05
*** HOLE CARDS ***
Dealt to Hero [9c 4d]
Dealt to 46997984 
Dealt to 9598e06a 
Dealt to f02d4645 
Dealt to 57d6169c 
Dealt to aa4f3313 
f02d4645: folds
57d6169c: raises $0.08 to $0.13
aa4f3313: folds
Hero: folds
46997984: folds
9598e06a: folds
Uncalled bet ($0.08) returned to 57d6169c
*** SHOWDOWN ***
57d6169c collected $0.12 from pot
*** SUMMARY ***
Total pot $0.12 | Rake $0 | Jackpot $0 | Bingo $0 | Fortune $0 | Tax $0
Seat 1: Hero (button) folded before Flop (didn't bet)
Seat 2: 46997984 (small blind) folded before Flop
Seat 3: 9598e06a (big blind) folded before Flop
Seat 4: f02d4645 folded before Flop (didn't bet)
Seat 5: 57d6169c collected ($0.12)
Seat 6: aa4f3313 folded before Flop (didn't bet)


Poker Hand #RC3334371512: Hold'em No Limit ($0.02/$0.05) - 2025/02/17 20:20:14
Table 'RushAndCash596772' 6-max Seat #1 is the button
Seat 1: 8185d8fd ($4.2 in chips)
Seat 2: 5381eb4c ($5 in chips)
Seat 3: Hero ($5.12 in chips)
Seat 4: cedf4726 ($5.05 in chips)
Seat 5: 24c4874c ($5 in chips)
Seat 6: f45ac3d0 ($5.17 in chips)
5381eb4c: posts small blind $0.02
Hero: posts big blind $0.05
*** HOLE CARDS ***
Dealt to 8185d8fd 
Dealt to 5381eb4c 
Dealt to Hero [2s 9s]
Dealt to cedf4726 
Dealt to 24c4874c 
Dealt to f45ac3d0 
cedf4726: folds
24c4874c: folds
f45ac3d0: folds
8185d8fd: folds
5381eb4c: folds
Uncalled bet ($0.03) returned to Hero
*** SHOWDOWN ***
Hero collected $0.04 from pot
*** SUMMARY ***
Total pot $0.04 | Rake $0 | Jackpot $0 | Bingo $0 | Fortune $0 | Tax $0
Seat 1: 8185d8fd (button) folded before Flop (didn't bet)
Seat 2: 5381eb4c (small blind) folded before Flop
Seat 3: Hero (big blind) collected ($0.04)
Seat 4: cedf4726 folded before Flop (didn't bet)
Seat 5: 24c4874c folded before Flop (didn't bet)
Seat 6: f45ac3d0 folded before Flop (didn't bet)


Poker Hand #RC3334371235: Hold'em No Limit ($0.02/$0.05) - 2025/02/17 20:19:25
Table 'RushAndCash596495' 6-max Seat #1 is the button
Seat 1: 16b0b958 ($5 in chips)
Seat 2: Hero ($5.38 in chips)
Seat 3: 858b70a7 ($5.26 in chips)
Seat 4: 872a76d3 ($5.24 in chips)
Seat 5: ae7aea10 ($8.4 in chips)
Seat 6: 3d9dea9b ($3.84 in chips)
Hero: posts small blind $0.02
858b70a7: posts big blind $0.05
*** HOLE CARDS ***
Dealt to 16b0b958 
Dealt to Hero [9s 9d]
Dealt to 858b70a7 
Dealt to 872a76d3 
Dealt to ae7aea10 
Dealt to 3d9dea9b 
872a76d3: folds
ae7aea10: folds
3d9dea9b: folds
16b0b958: raises $0.08 to $0.13
Hero: calls $0.11
858b70a7: calls $0.08
*** FLOP *** [5s 5d 3c]
Hero: checks
858b70a7: bets $0.13
16b0b958: folds
Hero: calls $0.13
*** TURN *** [5s 5d 3c] [Qs]
Hero: checks
858b70a7: bets $0.33
Hero: folds
Uncalled bet ($0.33) returned to 858b70a7
*** SHOWDOWN ***
858b70a7 collected $0.62 from pot
*** SUMMARY ***
Total pot $0.65 | Rake $0.03 | Jackpot $0 | Bingo $0 | Fortune $0 | Tax $0
Board [5s 5d 3c Qs]
Seat 1: 16b0b958 (button) folded on the Flop
Seat 2: Hero (small blind) folded on the Turn
Seat 3: 858b70a7 (big blind) won ($0.62)
Seat 4: 872a76d3 folded before Flop (didn't bet)
Seat 5: ae7aea10 folded before Flop (didn't bet)
Seat 6: 3d9dea9b folded before Flop (didn't bet)


Poker Hand #RC3334371115: Hold'em No Limit ($0.02/$0.05) - 2025/02/17 20:19:05
Table 'RushAndCash596375' 6-max Seat #1 is the button
Seat 1: dbf5f543 ($7.89 in chips)
Seat 2: ef63200d ($5.78 in chips)
Seat 3: cff58cde ($5.44 in chips)
Seat 4: 1063406 ($6.27 in chips)
Seat 5: 52f43d28 ($9.87 in chips)
Seat 6: Hero ($5.38 in chips)
ef63200d: posts small blind $0.02
cff58cde: posts big blind $0.05
*** HOLE CARDS ***
Dealt to dbf5f543 
Dealt to ef63200d 
Dealt to cff58cde 
Dealt to 1063406 
Dealt to 52f43d28 
Dealt to Hero [5s Ks]
1063406: folds
52f43d28: folds
Hero: folds
dbf5f543: folds
ef63200d: folds
Uncalled bet ($0.03) returned to cff58cde
*** SHOWDOWN ***
cff58cde collected $0.04 from pot
*** SUMMARY ***
Total pot $0.04 | Rake $0 | Jackpot $0 | Bingo $0 | Fortune $0 | Tax $0
Seat 1: dbf5f543 (button) folded before Flop (didn't bet)
Seat 2: ef63200d (small blind) folded before Flop
Seat 3: cff58cde (big blind) collected ($0.04)
Seat 4: 1063406 folded before Flop (didn't bet)
Seat 5: 52f43d28 folded before Flop (didn't bet)
Seat 6: Hero folded before Flop (didn't bet)


Poker Hand #RC3334371086: Hold'em No Limit ($0.02/$0.05) - 2025/02/17 20:19:00
Table 'RushAndCash596346' 6-max Seat #1 is the button
Seat 1: f553bfb4 ($5 in chips)
Seat 2: c066ebc7 ($5.09 in chips)
Seat 3: Hero ($5.43 in chips)
Seat 4: 1dbfd698 ($8.83 in chips)
Seat 5: 6d5fa70b ($6.23 in chips)
Seat 6: 1e76a4d8 ($5.84 in chips)
c066ebc7: posts small blind $0.02
Hero: posts big blind $0.05
*** HOLE CARDS ***
Dealt to f553bfb4 
Dealt to c066ebc7 
Dealt to Hero [2c 6c]
Dealt to 1dbfd698 
Dealt to 6d5fa70b 
Dealt to 1e76a4d8 
1dbfd698: folds
6d5fa70b: folds
1e76a4d8: folds
f553bfb4: raises $0.08 to $0.13
c066ebc7: folds
Hero: folds
Uncalled bet ($0.08) returned to f553bfb4
*** SHOWDOWN ***
f553bfb4 collected $0.12 from pot
*** SUMMARY ***
Total pot $0.12 | Rake $0 | Jackpot $0 | Bingo $0 | Fortune $0 | Tax $0
Seat 1: f553bfb4 (button) collected ($0.12)
Seat 2: c066ebc7 (small blind) folded before Flop
Seat 3: Hero (big blind) folded before Flop
Seat 4: 1dbfd698 folded before Flop (didn't bet)
Seat 5: 6d5fa70b folded before Flop (didn't bet)
Seat 6: 1e76a4d8 folded before Flop (didn't bet)


Poker Hand #RC3334371067: Hold'em No Limit ($0.02/$0.05) - 2025/02/17 20:18:57
Table 'RushAndCash596327' 6-max Seat #1 is the button
Seat 1: f02d4645 ($5.21 in chips)
Seat 2: 92fa3d91 ($3.88 in chips)
Seat 3: ab8d5924 ($5.81 in chips)
Seat 4: 9c77f9cb ($5.3 in chips)
Seat 5: Hero ($5.43 in chips)
Seat 6: ee5bb31d ($5.17 in chips)
92fa3d91: posts small blind $0.02
ab8d5924: posts big blind $0.05
*** HOLE CARDS ***
Dealt to f02d4645 
Dealt to 92fa3d91 
Dealt to ab8d5924 
Dealt to 9c77f9cb 
Dealt to Hero [3s 6d]
Dealt to ee5bb31d 
9c77f9cb: folds
Hero: folds
ee5bb31d: folds
f02d4645: raises $0.07 to $0.12
92fa3d91: folds
ab8d5924: calls $0.07
*** FLOP *** [Tc Ts 6c]
ab8d5924: checks
f02d4645: checks
*** TURN *** [Tc Ts 6c] [2h]
ab8d5924: checks
f02d4645: bets $0.09
ab8d5924: folds
Uncalled bet ($0.09) returned to f02d4645
*** SHOWDOWN ***
f02d4645 collected $0.25 from pot
*** SUMMARY ***
Total pot $0.26 | Rake $0.01 | Jackpot $0 | Bingo $0 | Fortune $0 | Tax $0
Board [Tc Ts 6c 2h]
Seat 1: f02d4645 (button) won ($0.25)
Seat 2: 92fa3d91 (small blind) folded before Flop
Seat 3: ab8d5924 (big blind) folded on the Turn
Seat 4: 9c77f9cb folded before Flop (didn't bet)
Seat 5: Hero folded before Flop (didn't bet)
Seat 6: ee5bb31d folded before Flop (didn't bet)


Poker Hand #RC3334371049: Hold'em No Limit ($0.02/$0.05) - 2025/02/17 20:18:54
Table 'RushAndCash596309' 6-max Seat #1 is the button
Seat 1: 9ed6ffbf ($5.19 in chips)
Seat 2: 6c122cb5 ($6.93 in chips)
Seat 3: fb78508c ($5 in chips)
Seat 4: 6d2abfa5 ($5.45 in chips)
Seat 5: Hero ($5.43 in chips)
Seat 6: 6e73d15 ($5.07 in chips)
6c122cb5: posts small blind $0.02
fb78508c: posts big blind $0.05
*** HOLE CARDS ***
Dealt to 9ed6ffbf 
Dealt to 6c122cb5 
Dealt to fb78508c 
Dealt to 6d2abfa5 
Dealt to Hero [Ts Kh]
Dealt to 6e73d15 
6d2abfa5: folds
Hero: folds
6e73d15: raises $0.05 to $0.1
9ed6ffbf: raises $0.27 to $0.37
6c122cb5: folds
fb78508c: folds
6e73d15: raises $0.53 to $0.9
9ed6ffbf: folds
Uncalled bet ($0.53) returned to 6e73d15
*** SHOWDOWN ***
6e73d15 collected $0.77 from pot
*** SUMMARY ***
Total pot $0.81 | Rake $0.04 | Jackpot $0 | Bingo $0 | Fortune $0 | Tax $0
Seat 1: 9ed6ffbf (button) folded before Flop
Seat 2: 6c122cb5 (small blind) folded before Flop
Seat 3: fb78508c (big blind) folded before Flop
Seat 4: 6d2abfa5 folded before Flop (didn't bet)
Seat 5: Hero folded before Flop (didn't bet)
Seat 6: 6e73d15 collected ($0.77)


Poker Hand #RC3334370875: Hold'em No Limit ($0.02/$0.05) - 2025/02/17 20:18:24
Table 'RushAndCash596135' 6-max Seat #1 is the button
Seat 1: cf593991 ($5.2 in chips)
Seat 2: Hero ($5 in chips)
Seat 3: ed38df5e ($5.16 in chips)
Seat 4: 2a5d53e8 ($4.88 in chips)
Seat 5: 5d5a637e ($5 in chips)
Seat 6: 3f990854 ($5.01 in chips)
Hero: posts small blind $0.02
ed38df5e: posts big blind $0.05
*** HOLE CARDS ***
Dealt to cf593991 
Dealt to Hero [Kd Ad]
Dealt to ed38df5e 
Dealt to 2a5d53e8 
Dealt to 5d5a637e 
Dealt to 3f990854 
2a5d53e8: folds
5d5a637e: folds
3f990854: folds
cf593991: raises $0.05 to $0.1
Hero: raises $0.32 to $0.42
ed38df5e: folds
cf593991: calls $0.32
*** FLOP *** [Ah Tc Js]
Hero: checks
cf593991: checks
*** TURN *** [Ah Tc Js] [7d]
Hero: bets $0.3
cf593991: folds
Uncalled bet ($0.3) returned to Hero
*** SHOWDOWN ***
Hero collected $0.85 from pot
*** SUMMARY ***
Total pot $0.89 | Rake $0.04 | Jackpot $0 | Bingo $0 | Fortune $0 | Tax $0
Board [Ah Tc Js 7d]
Seat 1: cf593991 (button) folded on the Turn
Seat 2: Hero (small blind) won ($0.85)
Seat 3: ed38df5e (big blind) folded before Flop
Seat 4: 2a5d53e8 folded before Flop (didn't bet)
Seat 5: 5d5a637e folded before Flop (didn't bet)
Seat 6: 3f990854 folded before Flop (didn't bet)


Poker Hand #RC3334370855: Hold'em No Limit ($0.02/$0.05) - 2025/02/17 20:18:20
Table 'RushAndCash596115' 6-max Seat #1 is the button
Seat 1: Hero ($5 in chips)
Seat 2: 573eb753 ($5.63 in chips)
Seat 3: dc32cc03 ($5.41 in chips)
Seat 4: fcad3124 ($5.57 in chips)
Seat 5: c45332c4 ($5 in chips)
Seat 6: 59f12f9f ($5 in chips)
573eb753: posts small blind $0.02
dc32cc03: posts big blind $0.05
*** HOLE CARDS ***
Dealt to Hero [3s Jd]
Dealt to 573eb753 
Dealt to dc32cc03 
Dealt to fcad3124 
Dealt to c45332c4 
Dealt to 59f12f9f 
fcad3124: folds
c45332c4: raises $0.08 to $0.13
59f12f9f: folds
Hero: folds
573eb753: folds
dc32cc03: calls $0.08
*** FLOP *** [Kd 9h 3d]
dc32cc03: checks
c45332c4: bets $0.14
dc32cc03: folds
Uncalled bet ($0.14) returned to c45332c4
*** SHOWDOWN ***
c45332c4 collected $0.27 from pot
*** SUMMARY ***
Total pot $0.28 | Rake $0.01 | Jackpot $0 | Bingo $0 | Fortune $0 | Tax $0
Board [Kd 9h 3d]
Seat 1: Hero (button) folded before Flop (didn't bet)
Seat 2: 573eb753 (small blind) folded before Flop
Seat 3: dc32cc03 (big blind) folded on the Flop
Seat 4: fcad3124 folded before Flop (didn't bet)
Seat 5: c45332c4 won ($0.27)
Seat 6: 59f12f9f folded before Flop (didn't bet)


Poker Hand #RC3334370833: Hold'em No Limit ($0.02/$0.05) - 2025/02/17 20:18:17
Table 'RushAndCash596093' 6-max Seat #1 is the button
Seat 1: c45332c4 ($5 in chips)
Seat 2: b4c33f6c ($5.02 in chips)
Seat 3: ca93b3ea ($5.94 in chips)
Seat 4: fa66f3cf ($9.05 in chips)
Seat 5: Hero ($5 in chips)
Seat 6: 9864109b ($5.17 in chips)
b4c33f6c: posts small blind $0.02
ca93b3ea: posts big blind $0.05
*** HOLE CARDS ***
Dealt to c45332c4 
Dealt to b4c33f6c 
Dealt to ca93b3ea 
Dealt to fa66f3cf 
Dealt to Hero [Jh 2s]
Dealt to 9864109b 
fa66f3cf: folds
Hero: folds
9864109b: folds
c45332c4: folds
b4c33f6c: folds
Uncalled bet ($0.03) returned to ca93b3ea
*** SHOWDOWN ***
ca93b3ea collected $0.04 from pot
*** SUMMARY ***
Total pot $0.04 | Rake $0 | Jackpot $0 | Bingo $0 | Fortune $0 | Tax $0
Seat 1: c45332c4 (button) folded before Flop (didn't bet)
Seat 2: b4c33f6c (small blind) folded before Flop
Seat 3: ca93b3ea (big blind) collected ($0.04)
Seat 4: fa66f3cf folded before Flop (didn't bet)
Seat 5: Hero folded before Flop (didn't bet)
Seat 6: 9864109b folded before Flop (didn't bet)


Poker Hand #RC3334370814: Hold'em No Limit ($0.02/$0.05) - 2025/02/17 20:18:14
Table 'RushAndCash596074' 6-max Seat #1 is the button
Seat 1: 2f033106 ($7.92 in chips)
Seat 2: 872a76d3 ($5.26 in chips)
Seat 3: 8ec32764 ($5.2 in chips)
Seat 4: 95fac4b9 ($10.17 in chips)
Seat 5: 3f990854 ($5.03 in chips)
Seat 6: Hero ($5 in chips)
872a76d3: posts small blind $0.02
8ec32764: posts big blind $0.05
*** HOLE CARDS ***
Dealt to 2f033106 
Dealt to 872a76d3 
Dealt to 8ec32764 
Dealt to 95fac4b9 
Dealt to 3f990854 
Dealt to Hero [7h 3h]
95fac4b9: folds
3f990854: folds
Hero: folds
2f033106: folds
872a76d3: folds
Uncalled bet ($0.03) returned to 8ec32764
*** SHOWDOWN ***
8ec32764 collected $0.04 from pot
*** SUMMARY ***
Total pot $0.04 | Rake $0 | Jackpot $0 | Bingo $0 | Fortune $0 | Tax $0
Seat 1: 2f033106 (button) folded before Flop (didn't bet)
Seat 2: 872a76d3 (small blind) folded before Flop
Seat 3: 8ec32764 (big blind) collected ($0.04)
Seat 4: 95fac4b9 folded before Flop (didn't bet)
Seat 5: 3f990854 folded before Flop (didn't bet)
Seat 6: Hero folded before Flop (didn't bet)


Poker Hand #RC3334370744: Hold'em No Limit ($0.02/$0.05) - 2025/02/17 20:18:02
Table 'RushAndCash596004' 6-max Seat #1 is the button
Seat 1: Hero ($5 in chips)
Seat 2: c066ebc7 ($5 in chips)
Seat 3: 19bd4ba3 ($5.68 in chips)
Seat 4: b9e511a ($14.64 in chips)
Seat 5: d916afa1 ($4.88 in chips)
Seat 6: 6a5a3ab6 ($6.69 in chips)
c066ebc7: posts small blind $0.02
19bd4ba3: posts big blind $0.05
*** HOLE CARDS ***
Dealt to Hero [9d 3s]
Dealt to c066ebc7 
Dealt to 19bd4ba3 
Dealt to b9e511a 
Dealt to d916afa1 
Dealt to 6a5a3ab6 
b9e511a: folds
d916afa1: raises $0.1 to $0.15
6a5a3ab6: folds
Hero: folds
c066ebc7: folds
19bd4ba3: folds
Uncalled bet ($0.1) returned to d916afa1
*** SHOWDOWN ***
d916afa1 collected $0.12 from pot
*** SUMMARY ***
Total pot $0.12 | Rake $0 | Jackpot $0 | Bingo $0 | Fortune $0 | Tax $0
Seat 1: Hero (button) folded before Flop (didn't bet)
Seat 2: c066ebc7 (small blind) folded before Flop
Seat 3: 19bd4ba3 (big blind) folded before Flop
Seat 4: b9e511a folded before Flop (didn't bet)
Seat 5: d916afa1 collected ($0.12)
Seat 6: 6a5a3ab6 folded before Flop (didn't bet)


Poker Hand #RC3334370677: Hold'em No Limit ($0.02/$0.05) - 2025/02/17 20:17:49
Table 'RushAndCash595937' 6-max Seat #1 is the button
Seat 1: c24b20b9 ($11.77 in chips)
Seat 2: 858b70a7 ($5.15 in chips)
Seat 3: Hero ($5.02 in chips)
Seat 4: 3936a67a ($5.16 in chips)
Seat 5: b5fbac7c ($5 in chips)
Seat 6: 692e3a83 ($12.95 in chips)
858b70a7: posts small blind $0.02
Hero: posts big blind $0.05
*** HOLE CARDS ***
Dealt to c24b20b9 
Dealt to 858b70a7 
Dealt to Hero [2h 6s]
Dealt to 3936a67a 
Dealt to b5fbac7c 
Dealt to 692e3a83 
3936a67a: folds
b5fbac7c: folds
692e3a83: raises $0.07 to $0.12
c24b20b9: calls $0.12
858b70a7: folds
Hero: folds
*** FLOP *** [Kc Qh 7d]
692e3a83: bets $0.15
c24b20b9: raises $0.31 to $0.46
692e3a83: folds
Uncalled bet ($0.31) returned to c24b20b9
*** SHOWDOWN ***
c24b20b9 collected $0.58 from pot
*** SUMMARY ***
Total pot $0.61 | Rake $0.03 | Jackpot $0 | Bingo $0 | Fortune $0 | Tax $0
Board [Kc Qh 7d]
Seat 1: c24b20b9 (button) won ($0.58)
Seat 2: 858b70a7 (small blind) folded before Flop
Seat 3: Hero (big blind) folded before Flop
Seat 4: 3936a67a folded before Flop (didn't bet)
Seat 5: b5fbac7c folded before Flop (didn't bet)
Seat 6: 692e3a83 folded on the Flop


Poker Hand #RC3334370558: Hold'em No Limit ($0.02/$0.05) - 2025/02/17 20:17:28
Table 'RushAndCash595818' 6-max Seat #1 is the button
Seat 1: 3f990854 ($5.11 in chips)
Seat 2: Hero ($5.07 in chips)
Seat 3: 858b70a7 ($5.1 in chips)
Seat 4: 132366a9 ($14.98 in chips)
Seat 5: 90fb5891 ($11.28 in chips)
Seat 6: 93dfef8b ($5 in chips)
Hero: posts small blind $0.02
858b70a7: posts big blind $0.05
*** HOLE CARDS ***
Dealt to 3f990854 
Dealt to Hero [7h 4h]
Dealt to 858b70a7 
Dealt to 132366a9 
Dealt to 90fb5891 
Dealt to 93dfef8b 
132366a9: folds
90fb5891: folds
93dfef8b: folds
3f990854: folds
Hero: calls $0.03
858b70a7: raises $0.15 to $0.2
Hero: folds
Uncalled bet ($0.15) returned to 858b70a7
*** SHOWDOWN ***
858b70a7 collected $0.1 from pot
*** SUMMARY ***
Total pot $0.1 | Rake $0 | Jackpot $0 | Bingo $0 | Fortune $0 | Tax $0
Seat 1: 3f990854 (button) folded before Flop (didn't bet)
Seat 2: Hero (small blind) folded before Flop
Seat 3: 858b70a7 (big blind) collected ($0.1)
Seat 4: 132366a9 folded before Flop (didn't bet)
Seat 5: 90fb5891 folded before Flop (didn't bet)
Seat 6: 93dfef8b folded before Flop (didn't bet)


Poker Hand #RC3334370454: Hold'em No Limit ($0.02/$0.05) - 2025/02/17 20:17:10
Table 'RushAndCash595714' 6-max Seat #1 is the button
Seat 1: 187f2194 ($5 in chips)
Seat 2: 97fe2676 ($9.53 in chips)
Seat 3: 3c1ddc3a ($6.75 in chips)
Seat 4: 4c7728b5 ($5.07 in chips)
Seat 5: 87205baf ($5 in chips)
Seat 6: Hero ($5.07 in chips)
Cash Drop to Pot : total $0.5 
97fe2676: posts small blind $0.02
3c1ddc3a: posts big blind $0.05
*** HOLE CARDS ***
Dealt to 187f2194 
Dealt to 97fe2676 
Dealt to 3c1ddc3a 
Dealt to 4c7728b5 
Dealt to 87205baf 
Dealt to Hero [8s 6d]
4c7728b5: raises $0.55 to $0.6
87205baf: folds
Hero: folds
187f2194: folds
97fe2676: folds
3c1ddc3a: calls $0.55
*** FLOP *** [Ks Kc Ad]
3c1ddc3a: checks
4c7728b5: checks
*** TURN *** [Ks Kc Ad] [8h]
3c1ddc3a: checks
4c7728b5: checks
*** RIVER *** [Ks Kc Ad 8h] [7s]
3c1ddc3a: checks
4c7728b5: checks
3c1ddc3a: shows [4d 4c] (Pair of Kings and Pair of Fours)
4c7728b5: shows [Jd 7h] (Pair of Kings and Pair of Sevens)
*** SHOWDOWN ***
4c7728b5 collected $1.57 from pot
*** SUMMARY ***
Total pot $1.72 | Rake $0.08 | Jackpot $0.07 | Bingo $0 | Fortune $0 | Tax $0
Board [Ks Kc Ad 8h 7s]
Seat 1: 187f2194 (button) folded before Flop (didn't bet)
Seat 2: 97fe2676 (small blind) folded before Flop
Seat 3: 3c1ddc3a (big blind) showed [4d 4c] and lost with Pair of Kings and Pair of Fours
Seat 4: 4c7728b5 showed [Jd 7h] and won ($1.57) with Pair of Kings and Pair of Sevens
Seat 5: 87205baf folded before Flop (didn't bet)
Seat 6: Hero folded before Flop (didn't bet)


Poker Hand #RC3334370433: Hold'em No Limit ($0.02/$0.05) - 2025/02/17 20:17:06
Table 'RushAndCash595693' 6-max Seat #1 is the button
Seat 1: 3922b684 ($13.45 in chips)
Seat 2: 7aa85a40 ($4.8 in chips)
Seat 3: 25f30dbe ($6.15 in chips)
Seat 4: 6c0f6dbf ($6.89 in chips)
Seat 5: Hero ($5.07 in chips)
Seat 6: 48dc6454 ($5.07 in chips)
7aa85a40: posts small blind $0.02
25f30dbe: posts big blind $0.05
*** HOLE CARDS ***
Dealt to 3922b684 
Dealt to 7aa85a40 
Dealt to 25f30dbe 
Dealt to 6c0f6dbf 
Dealt to Hero [8s Kh]
Dealt to 48dc6454 
6c0f6dbf: folds
Hero: folds
48dc6454: folds
3922b684: folds
7aa85a40: raises $0.05 to $0.1
25f30dbe: folds
Uncalled bet ($0.05) returned to 7aa85a40
*** SHOWDOWN ***
7aa85a40 collected $0.1 from pot
*** SUMMARY ***
Total pot $0.1 | Rake $0 | Jackpot $0 | Bingo $0 | Fortune $0 | Tax $0
Seat 1: 3922b684 (button) folded before Flop (didn't bet)
Seat 2: 7aa85a40 (small blind) collected ($0.1)
Seat 3: 25f30dbe (big blind) folded before Flop
Seat 4: 6c0f6dbf folded before Flop (didn't bet)
Seat 5: Hero folded before Flop (didn't bet)
Seat 6: 48dc6454 folded before Flop (didn't bet)


Poker Hand #RC3334370360: Hold'em No Limit ($0.02/$0.05) - 2025/02/17 20:16:54
Table 'RushAndCash595620' 6-max Seat #1 is the button
Seat 1: aea62364 ($0.8 in chips)
Seat 2: 9b1a3dd2 ($7.12 in chips)
Seat 3: bbdadd69 ($7.56 in chips)
Seat 4: 207d9345 ($16.59 in chips)
Seat 5: 1937cebf ($5.33 in chips)
Seat 6: Hero ($5 in chips)
9b1a3dd2: posts small blind $0.02
bbdadd69: posts big blind $0.05
*** HOLE CARDS ***
Dealt to aea62364 
Dealt to 9b1a3dd2 
Dealt to bbdadd69 
Dealt to 207d9345 
Dealt to 1937cebf 
Dealt to Hero [8s 8d]
207d9345: folds
1937cebf: folds
Hero: raises $0.05 to $0.1
aea62364: folds
9b1a3dd2: folds
bbdadd69: folds
Uncalled bet ($0.05) returned to Hero
*** SHOWDOWN ***
Hero collected $0.12 from pot
*** SUMMARY ***
Total pot $0.12 | Rake $0 | Jackpot $0 | Bingo $0 | Fortune $0 | Tax $0
Seat 1: aea62364 (button) folded before Flop (didn't bet)
Seat 2: 9b1a3dd2 (small blind) folded before Flop
Seat 3: bbdadd69 (big blind) folded before Flop
Seat 4: 207d9345 folded before Flop (didn't bet)
Seat 5: 1937cebf folded before Flop (didn't bet)
Seat 6: Hero collected ($0.12)


Poker Hand #RC3334370342: Hold'em No Limit ($0.02/$0.05) - 2025/02/17 20:16:50
Table 'RushAndCash595602' 6-max Seat #1 is the button
Seat 1: d201e5fe ($7.13 in chips)
Seat 2: 5f1cdd27 ($5 in chips)
Seat 3: e94f5acb ($5.24 in chips)
Seat 4: 83c366a4 ($5.07 in chips)
Seat 5: dbf5f543 ($7.81 in chips)
Seat 6: Hero ($5 in chips)
5f1cdd27: posts small blind $0.02
e94f5acb: posts big blind $0.05
*** HOLE CARDS ***
Dealt to d201e5fe 
Dealt to 5f1cdd27 
Dealt to e94f5acb 
Dealt to 83c366a4 
Dealt to dbf5f543 
Dealt to Hero [2d 6d]
83c366a4: folds
dbf5f543: folds
Hero: folds
d201e5fe: folds
5f1cdd27: folds
Uncalled bet ($0.03) returned to e94f5acb
*** SHOWDOWN ***
e94f5acb collected $0.04 from pot
*** SUMMARY ***
Total pot $0.04 | Rake $0 | Jackpot $0 | Bingo $0 | Fortune $0 | Tax $0
Seat 1: d201e5fe (button) folded before Flop (didn't bet)
Seat 2: 5f1cdd27 (small blind) folded before Flop
Seat 3: e94f5acb (big blind) collected ($0.04)
Seat 4: 83c366a4 folded before Flop (didn't bet)
Seat 5: dbf5f543 folded before Flop (didn't bet)
Seat 6: Hero folded before Flop (didn't bet)


Poker Hand #RC3334370316: Hold'em No Limit ($0.02/$0.05) - 2025/02/17 20:16:46
Table 'RushAndCash595576' 6-max Seat #1 is the button
Seat 1: Hero ($5 in chips)
Seat 2: 8b64902e ($10.01 in chips)
Seat 3: f553bfb4 ($5.02 in chips)
Seat 4: b924c681 ($5 in chips)
Seat 5: ca93b3ea ($5.19 in chips)
Seat 6: 87d5083b ($13.54 in chips)
8b64902e: posts small blind $0.02
f553bfb4: posts big blind $0.05
*** HOLE CARDS ***
Dealt to Hero [3d 9s]
Dealt to 8b64902e 
Dealt to f553bfb4 
Dealt to b924c681 
Dealt to ca93b3ea 
Dealt to 87d5083b 
b924c681: folds
ca93b3ea: folds
87d5083b: folds
Hero: folds
8b64902e: raises $0.08 to $0.13
f553bfb4: raises $0.33 to $0.46
8b64902e: folds
Uncalled bet ($0.33) returned to f553bfb4
*** SHOWDOWN ***
f553bfb4 collected $0.25 from pot
*** SUMMARY ***
Total pot $0.26 | Rake $0.01 | Jackpot $0 | Bingo $0 | Fortune $0 | Tax $0
Seat 1: Hero (button) folded before Flop (didn't bet)
Seat 2: 8b64902e (small blind) folded before Flop
Seat 3: f553bfb4 (big blind) collected ($0.25)
Seat 4: b924c681 folded before Flop (didn't bet)
Seat 5: ca93b3ea folded before Flop (didn't bet)
Seat 6: 87d5083b folded before Flop (didn't bet)


Poker Hand #RC3334370254: Hold'em No Limit ($0.02/$0.05) - 2025/02/17 20:16:34
Table 'RushAndCash595514' 6-max Seat #1 is the button
Seat 1: 7f79d927 ($11.45 in chips)
Seat 2: d9a113f2 ($5.16 in chips)
Seat 3: Hero ($5 in chips)
Seat 4: dc32cc03 ($5.5 in chips)
Seat 5: 9864109b ($5.41 in chips)
Seat 6: ab13ccc6 ($8.16 in chips)
d9a113f2: posts small blind $0.02
Hero: posts big blind $0.05
*** HOLE CARDS ***
Dealt to 7f79d927 
Dealt to d9a113f2 
Dealt to Hero [8s 9c]
Dealt to dc32cc03 
Dealt to 9864109b 
Dealt to ab13ccc6 
dc32cc03: folds
9864109b: folds
ab13ccc6: folds
7f79d927: raises $0.1 to $0.15
d9a113f2: folds
Hero: folds
Uncalled bet ($0.1) returned to 7f79d927
*** SHOWDOWN ***
7f79d927 collected $0.12 from pot
*** SUMMARY ***
Total pot $0.12 | Rake $0 | Jackpot $0 | Bingo $0 | Fortune $0 | Tax $0
Seat 1: 7f79d927 (button) collected ($0.12)
Seat 2: d9a113f2 (small blind) folded before Flop
Seat 3: Hero (big blind) folded before Flop
Seat 4: dc32cc03 folded before Flop (didn't bet)
Seat 5: 9864109b folded before Flop (didn't bet)
Seat 6: ab13ccc6 folded before Flop (didn't bet)


Poker Hand #RC3334370235: Hold'em No Limit ($0.02/$0.05) - 2025/02/17 20:16:31
Table 'RushAndCash595495' 6-max Seat #1 is the button
Seat 1: 83c366a4 ($5 in chips)
Seat 2: Hero ($5 in chips)
Seat 3: ce23f617 ($5 in chips)
Seat 4: 9a633d8d ($7.51 in chips)
Seat 5: ea485a4d ($6.5 in chips)
Seat 6: 1bf2a40e ($11.37 in chips)
Hero: posts small blind $0.02
ce23f617: posts big blind $0.05
*** HOLE CARDS ***
Dealt to 83c366a4 
Dealt to Hero [As 6d]
Dealt to ce23f617 
Dealt to 9a633d8d 
Dealt to ea485a4d 
Dealt to 1bf2a40e 
9a633d8d: folds
ea485a4d: folds
1bf2a40e: raises $0.05 to $0.1
83c366a4: folds
Hero: folds
ce23f617: folds
Uncalled bet ($0.05) returned to 1bf2a40e
*** SHOWDOWN ***
1bf2a40e collected $0.12 from pot
*** SUMMARY ***
Total pot $0.12 | Rake $0 | Jackpot $0 | Bingo $0 | Fortune $0 | Tax $0
Seat 1: 83c366a4 (button) folded before Flop (didn't bet)
Seat 2: Hero (small blind) folded before Flop
Seat 3: ce23f617 (big blind) folded before Flop
Seat 4: 9a633d8d folded before Flop (didn't bet)
Seat 5: ea485a4d folded before Flop (didn't bet)
Seat 6: 1bf2a40e collected ($0.12)


Poker Hand #RC3334370202: Hold'em No Limit ($0.02/$0.05) - 2025/02/17 20:16:24
Table 'RushAndCash595462' 6-max Seat #1 is the button
Seat 1: 52f43d28 ($9.67 in chips)
Seat 2: 8be10cd0 ($5.15 in chips)
Seat 3: 4052bb6f ($5 in chips)
Seat 4: Hero ($5 in chips)
Seat 5: 5c64b878 ($6.01 in chips)
Seat 6: b9369e69 ($7.65 in chips)
8be10cd0: posts small blind $0.02
4052bb6f: posts big blind $0.05
*** HOLE CARDS ***
Dealt to 52f43d28 
Dealt to 8be10cd0 
Dealt to 4052bb6f 
Dealt to Hero [5h 7d]
Dealt to 5c64b878 
Dealt to b9369e69 
Hero: folds
5c64b878: folds
b9369e69: raises $0.15 to $0.2
52f43d28: folds
8be10cd0: folds
4052bb6f: folds
Uncalled bet ($0.15) returned to b9369e69
*** SHOWDOWN ***
b9369e69 collected $0.12 from pot
*** SUMMARY ***
Total pot $0.12 | Rake $0 | Jackpot $0 | Bingo $0 | Fortune $0 | Tax $0
Seat 1: 52f43d28 (button) folded before Flop (didn't bet)
Seat 2: 8be10cd0 (small blind) folded before Flop
Seat 3: 4052bb6f (big blind) folded before Flop
Seat 4: Hero folded before Flop (didn't bet)
Seat 5: 5c64b878 folded before Flop (didn't bet)
Seat 6: b9369e69 collected ($0.12)


Poker Hand #RC3334370185: Hold'em No Limit ($0.02/$0.05) - 2025/02/17 20:16:21
Table 'RushAndCash595445' 6-max Seat #1 is the button
Seat 1: 5c8c19b7 ($5 in chips)
Seat 2: 2809b559 ($6.35 in chips)
Seat 3: 6d5fa70b ($6.51 in chips)
Seat 4: 817f21da ($5.71 in chips)
Seat 5: 3469fa26 ($5.39 in chips)
Seat 6: Hero ($5 in chips)
2809b559: posts small blind $0.02
6d5fa70b: posts big blind $0.05
*** HOLE CARDS ***
Dealt to 5c8c19b7 
Dealt to 2809b559 
Dealt to 6d5fa70b 
Dealt to 817f21da 
Dealt to 3469fa26 
Dealt to Hero [Kh 9c]
817f21da: raises $0.07 to $0.12
3469fa26: raises $0.16 to $0.28
Hero: folds
5c8c19b7: folds
2809b559: folds
6d5fa70b: folds
817f21da: raises $0.86 to $1.14
3469fa26: calls $0.86
*** FLOP *** [3c Js 2c]
817f21da: checks
3469fa26: bets $4.25 and is all-in
817f21da: folds
Uncalled bet ($4.25) returned to 3469fa26
*** SHOWDOWN ***
3469fa26 collected $2.17 from pot
*** SUMMARY ***
Total pot $2.35 | Rake $0.11 | Jackpot $0.07 | Bingo $0 | Fortune $0 | Tax $0
Board [3c Js 2c]
Seat 1: 5c8c19b7 (button) folded before Flop (didn't bet)
Seat 2: 2809b559 (small blind) folded before Flop
Seat 3: 6d5fa70b (big blind) folded before Flop
Seat 4: 817f21da folded on the Flop
Seat 5: 3469fa26 won ($2.17)
Seat 6: Hero folded before Flop (didn't bet)


Poker Hand #RC3334370169: Hold'em No Limit ($0.02/$0.05) - 2025/02/17 20:16:18
Table 'RushAndCash595429' 6-max Seat #1 is the button
Seat 1: c85a0f60 ($11.24 in chips)
Seat 2: 6c122cb5 ($6.77 in chips)
Seat 3: c585480d ($5 in chips)
Seat 4: Hero ($5 in chips)
Seat 5: 54fe77bd ($5.83 in chips)
Seat 6: c7e9103c ($20.45 in chips)
6c122cb5: posts small blind $0.02
c585480d: posts big blind $0.05
*** HOLE CARDS ***
Dealt to c85a0f60 
Dealt to 6c122cb5 
Dealt to c585480d 
Dealt to Hero [3h Jd]
Dealt to 54fe77bd 
Dealt to c7e9103c 
Hero: folds
54fe77bd: folds
c7e9103c: raises $0.08 to $0.13
c85a0f60: folds
6c122cb5: folds
c585480d: calls $0.08
*** FLOP *** [9h 2d 9c]
c585480d: checks
c7e9103c: bets $0.1
c585480d: calls $0.1
*** TURN *** [9h 2d 9c] [Jh]
c585480d: checks
c7e9103c: checks
*** RIVER *** [9h 2d 9c Jh] [8s]
c585480d: bets $0.48
c7e9103c: folds
Uncalled bet ($0.48) returned to c585480d
*** SHOWDOWN ***
c585480d collected $0.46 from pot
*** SUMMARY ***
Total pot $0.48 | Rake $0.02 | Jackpot $0 | Bingo $0 | Fortune $0 | Tax $0
Board [9h 2d 9c Jh 8s]
Seat 1: c85a0f60 (button) folded before Flop (didn't bet)
Seat 2: 6c122cb5 (small blind) folded before Flop
Seat 3: c585480d (big blind) won ($0.46)
Seat 4: Hero folded before Flop (didn't bet)
Seat 5: 54fe77bd folded before Flop (didn't bet)
Seat 6: c7e9103c folded on the River


Poker Hand #RC3334370154: Hold'em No Limit ($0.02/$0.05) - 2025/02/17 20:16:15
Table 'RushAndCash595414' 6-max Seat #1 is the button
Seat 1: Hero ($5 in chips)
Seat 2: fa66f3cf ($9.69 in chips)
Seat 3: 742ccfee ($2.52 in chips)
Seat 4: b112bc0b ($5.78 in chips)
Seat 5: e632d40b ($5.23 in chips)
Seat 6: ed38df5e ($5 in chips)
fa66f3cf: posts small blind $0.02
742ccfee: posts big blind $0.05
*** HOLE CARDS ***
Dealt to Hero [4d 2h]
Dealt to fa66f3cf 
Dealt to 742ccfee 
Dealt to b112bc0b 
Dealt to e632d40b 
Dealt to ed38df5e 
b112bc0b: raises $0.06 to $0.11
e632d40b: folds
ed38df5e: folds
Hero: folds
fa66f3cf: folds
742ccfee: folds
Uncalled bet ($0.06) returned to b112bc0b
*** SHOWDOWN ***
b112bc0b collected $0.12 from pot
*** SUMMARY ***
Total pot $0.12 | Rake $0 | Jackpot $0 | Bingo $0 | Fortune $0 | Tax $0
Seat 1: Hero (button) folded before Flop (didn't bet)
Seat 2: fa66f3cf (small blind) folded before Flop
Seat 3: 742ccfee (big blind) folded before Flop
Seat 4: b112bc0b collected ($0.12)
Seat 5: e632d40b folded before Flop (didn't bet)
Seat 6: ed38df5e folded before Flop (didn't bet)


Poker Hand #RC3334369947: Hold'em No Limit ($0.02/$0.05) - 2025/02/17 20:15:29
Table 'RushAndCash595207' 6-max Seat #1 is the button
Seat 1: e3a10bfa ($5.42 in chips)
Seat 2: 36753d76 ($5.74 in chips)
Seat 3: Hero ($5 in chips)
Seat 4: 709ac205 ($10.66 in chips)
Seat 5: 84f270f8 ($5 in chips)
Seat 6: 9b1a3dd2 ($7.06 in chips)
36753d76: posts small blind $0.02
Hero: posts big blind $0.05
*** HOLE CARDS ***
Dealt to e3a10bfa 
Dealt to 36753d76 
Dealt to Hero [Kh Qs]
Dealt to 709ac205 
Dealt to 84f270f8 
Dealt to 9b1a3dd2 
709ac205: folds
84f270f8: folds
9b1a3dd2: raises $0.07 to $0.12
e3a10bfa: folds
36753d76: folds
Hero: calls $0.07
*** FLOP *** [5c 9h 2s]
Hero: checks
9b1a3dd2: bets $0.09
Hero: calls $0.09
*** TURN *** [5c 9h 2s] [8h]
Hero: checks
9b1a3dd2: bets $0.22
Hero: folds
Uncalled bet ($0.22) returned to 9b1a3dd2
*** SHOWDOWN ***
9b1a3dd2 collected $0.42 from pot
*** SUMMARY ***
Total pot $0.44 | Rake $0.02 | Jackpot $0 | Bingo $0 | Fortune $0 | Tax $0
Board [5c 9h 2s 8h]
Seat 1: e3a10bfa (button) folded before Flop (didn't bet)
Seat 2: 36753d76 (small blind) folded before Flop
Seat 3: Hero (big blind) folded on the Turn
Seat 4: 709ac205 folded before Flop (didn't bet)
Seat 5: 84f270f8 folded before Flop (didn't bet)
Seat 6: 9b1a3dd2 won ($0.42)


Poker Hand #RC3334369901: Hold'em No Limit ($0.02/$0.05) - 2025/02/17 20:15:20
Table 'RushAndCash595161' 6-max Seat #1 is the button
Seat 1: b42dd6b5 ($5.89 in chips)
Seat 2: Hero ($5.01 in chips)
Seat 3: 37558bf9 ($5.16 in chips)
Seat 4: 45d33c76 ($7.26 in chips)
Seat 5: c2e88c14 ($5.02 in chips)
Seat 6: f28c4031 ($5.87 in chips)
Hero: posts small blind $0.02
37558bf9: posts big blind $0.05
*** HOLE CARDS ***
Dealt to b42dd6b5 
Dealt to Hero [3s Qs]
Dealt to 37558bf9 
Dealt to 45d33c76 
Dealt to c2e88c14 
Dealt to f28c4031 
45d33c76: folds
c2e88c14: raises $0.05 to $0.1
f28c4031: folds
b42dd6b5: folds
Hero: folds
37558bf9: folds
Uncalled bet ($0.05) returned to c2e88c14
*** SHOWDOWN ***
c2e88c14 collected $0.12 from pot
*** SUMMARY ***
Total pot $0.12 | Rake $0 | Jackpot $0 | Bingo $0 | Fortune $0 | Tax $0
Seat 1: b42dd6b5 (button) folded before Flop (didn't bet)
Seat 2: Hero (small blind) folded before Flop
Seat 3: 37558bf9 (big blind) folded before Flop
Seat 4: 45d33c76 folded before Flop (didn't bet)
Seat 5: c2e88c14 collected ($0.12)
Seat 6: f28c4031 folded before Flop (didn't bet)


Poker Hand #RC3334369882: Hold'em No Limit ($0.02/$0.05) - 2025/02/17 20:15:17
Table 'RushAndCash595142' 6-max Seat #1 is the button
Seat 1: 120fe547 ($4.24 in chips)
Seat 2: f3fc119a ($6.78 in chips)
Seat 3: 2678c032 ($10.49 in chips)
Seat 4: 86768906 ($9.85 in chips)
Seat 5: Hero ($5.01 in chips)
Seat 6: b9369e69 ($7.42 in chips)
f3fc119a: posts small blind $0.02
2678c032: posts big blind $0.05
*** HOLE CARDS ***
Dealt to 120fe547 
Dealt to f3fc119a 
Dealt to 2678c032 
Dealt to 86768906 
Dealt to Hero [Ts Kh]
Dealt to b9369e69 
86768906: folds
Hero: folds
b9369e69: folds
120fe547: folds
f3fc119a: folds
Uncalled bet ($0.03) returned to 2678c032
*** SHOWDOWN ***
2678c032 collected $0.04 from pot
*** SUMMARY ***
Total pot $0.04 | Rake $0 | Jackpot $0 | Bingo $0 | Fortune $0 | Tax $0
Seat 1: 120fe547 (button) folded before Flop (didn't bet)
Seat 2: f3fc119a (small blind) folded before Flop
Seat 3: 2678c032 (big blind) collected ($0.04)
Seat 4: 86768906 folded before Flop (didn't bet)
Seat 5: Hero folded before Flop (didn't bet)
Seat 6: b9369e69 folded before Flop (didn't bet)


Poker Hand #RC3334369863: Hold'em No Limit ($0.02/$0.05) - 2025/02/17 20:15:14
Table 'RushAndCash595123' 6-max Seat #1 is the button
Seat 1: 7f832000 ($5.33 in chips)
Seat 2: 1063406 ($5.83 in chips)
Seat 3: 1d0217bc ($5.31 in chips)
Seat 4: c1784884 ($5.28 in chips)
Seat 5: 100d4f9e ($5.71 in chips)
Seat 6: Hero ($5.01 in chips)
1063406: posts small blind $0.02
1d0217bc: posts big blind $0.05
*** HOLE CARDS ***
Dealt to 7f832000 
Dealt to 1063406 
Dealt to 1d0217bc 
Dealt to c1784884 
Dealt to 100d4f9e 
Dealt to Hero [2s 7s]
c1784884: folds
100d4f9e: folds
Hero: folds
7f832000: folds
1063406: folds
Uncalled bet ($0.03) returned to 1d0217bc
*** SHOWDOWN ***
1d0217bc collected $0.04 from pot
*** SUMMARY ***
Total pot $0.04 | Rake $0 | Jackpot $0 | Bingo $0 | Fortune $0 | Tax $0
Seat 1: 7f832000 (button) folded before Flop (didn't bet)
Seat 2: 1063406 (small blind) folded before Flop
Seat 3: 1d0217bc (big blind) collected ($0.04)
Seat 4: c1784884 folded before Flop (didn't bet)
Seat 5: 100d4f9e folded before Flop (didn't bet)
Seat 6: Hero folded before Flop (didn't bet)


Poker Hand #RC3334369846: Hold'em No Limit ($0.02/$0.05) - 2025/02/17 20:15:10
Table 'RushAndCash595106' 6-max Seat #1 is the button
Seat 1: 69c3afd2 ($4.95 in chips)
Seat 2: 9013f95e ($12.06 in chips)
Seat 3: b1aa19ba ($5.01 in chips)
Seat 4: Hero ($5.01 in chips)
Seat 5: 42fca4f9 ($5.02 in chips)
Seat 6: 8c3789e ($6.93 in chips)
9013f95e: posts small blind $0.02
b1aa19ba: posts big blind $0.05
*** HOLE CARDS ***
Dealt to 69c3afd2 
Dealt to 9013f95e 
Dealt to b1aa19ba 
Dealt to Hero [Qs 7h]
Dealt to 42fca4f9 
Dealt to 8c3789e 
Hero: folds
42fca4f9: raises $0.05 to $0.1
8c3789e: raises $0.22 to $0.32
69c3afd2: folds
9013f95e: folds
b1aa19ba: folds
42fca4f9: calls $0.22
*** FLOP *** [Ks 5s Kc]
42fca4f9: checks
8c3789e: bets $0.24
42fca4f9: calls $0.24
*** TURN *** [Ks 5s Kc] [4h]
42fca4f9: checks
8c3789e: bets $0.87
42fca4f9: folds
Uncalled bet ($0.87) returned to 8c3789e
*** SHOWDOWN ***
8c3789e collected $1.13 from pot
*** SUMMARY ***
Total pot $1.19 | Rake $0.06 | Jackpot $0 | Bingo $0 | Fortune $0 | Tax $0
Board [Ks 5s Kc 4h]
Seat 1: 69c3afd2 (button) folded before Flop (didn't bet)
Seat 2: 9013f95e (small blind) folded before Flop
Seat 3: b1aa19ba (big blind) folded before Flop
Seat 4: Hero folded before Flop (didn't bet)
Seat 5: 42fca4f9 folded on the Turn
Seat 6: 8c3789e won ($1.13)


Poker Hand #RC3334369816: Hold'em No Limit ($0.02/$0.05) - 2025/02/17 20:15:05
Table 'RushAndCash595076' 6-max Seat #1 is the button
Seat 1: Hero ($5.01 in chips)
Seat 2: 5c64b878 ($6.1 in chips)
Seat 3: 17ae1a1b ($6.88 in chips)
Seat 4: fcad3124 ($5.02 in chips)
Seat 5: 18af90c ($10.27 in chips)
Seat 6: cf593991 ($6.54 in chips)
5c64b878: posts small blind $0.02
17ae1a1b: posts big blind $0.05
*** HOLE CARDS ***
Dealt to Hero [3d 8d]
Dealt to 5c64b878 
Dealt to 17ae1a1b 
Dealt to fcad3124 
Dealt to 18af90c 
Dealt to cf593991 
fcad3124: folds
18af90c: folds
cf593991: raises $0.05 to $0.1
Hero: folds
5c64b878: folds
17ae1a1b: calls $0.05
*** FLOP *** [Qs As Ts]
17ae1a1b: checks
cf593991: checks
*** TURN *** [Qs As Ts] [Jd]
17ae1a1b: bets $0.17
cf593991: calls $0.17
*** RIVER *** [Qs As Ts Jd] [4d]
17ae1a1b: bets $1.12
cf593991: calls $1.12
17ae1a1b: shows [8s Js] (Ace High Flush)
cf593991: shows [Ac Kd] (Aces-High Straight)
*** SHOWDOWN ***
17ae1a1b collected $2.6 from pot
*** SUMMARY ***
Total pot $2.8 | Rake $0.13 | Jackpot $0.07 | Bingo $0 | Fortune $0 | Tax $0
Board [Qs As Ts Jd 4d]
Seat 1: Hero (button) folded before Flop (didn't bet)
Seat 2: 5c64b878 (small blind) folded before Flop
Seat 3: 17ae1a1b (big blind) showed [8s Js] and won ($2.6) with Ace High Flush
Seat 4: fcad3124 folded before Flop (didn't bet)
Seat 5: 18af90c folded before Flop (didn't bet)
Seat 6: cf593991 showed [Ac Kd] and lost with Aces-High Straight


Poker Hand #RC3334369788: Hold'em No Limit ($0.02/$0.05) - 2025/02/17 20:15:01
Table 'RushAndCash595048' 6-max Seat #1 is the button
Seat 1: 1e232769 ($5 in chips)
Seat 2: 8047b2ca ($4.25 in chips)
Seat 3: 16a87f9d ($8.4 in chips)
Seat 4: 3b85f8e6 ($10.51 in chips)
Seat 5: 2cf2fdc6 ($5.07 in chips)
Seat 6: Hero ($5.01 in chips)
8047b2ca: posts small blind $0.02
16a87f9d: posts big blind $0.05
*** HOLE CARDS ***
Dealt to 1e232769 
Dealt to 8047b2ca 
Dealt to 16a87f9d 
Dealt to 3b85f8e6 
Dealt to 2cf2fdc6 
Dealt to Hero [Ts 5d]
3b85f8e6: raises $0.07 to $0.12
2cf2fdc6: folds
Hero: folds
1e232769: folds
8047b2ca: folds
16a87f9d: folds
Uncalled bet ($0.07) returned to 3b85f8e6
*** SHOWDOWN ***
3b85f8e6 collected $0.12 from pot
*** SUMMARY ***
Total pot $0.12 | Rake $0 | Jackpot $0 | Bingo $0 | Fortune $0 | Tax $0
Seat 1: 1e232769 (button) folded before Flop (didn't bet)
Seat 2: 8047b2ca (small blind) folded before Flop
Seat 3: 16a87f9d (big blind) folded before Flop
Seat 4: 3b85f8e6 collected ($0.12)
Seat 5: 2cf2fdc6 folded before Flop (didn't bet)
Seat 6: Hero folded before Flop (didn't bet)


Poker Hand #RC3334369768: Hold'em No Limit ($0.02/$0.05) - 2025/02/17 20:14:57
Table 'RushAndCash595028' 6-max Seat #1 is the button
Seat 1: f740825c ($5 in chips)
Seat 2: Hero ($5.03 in chips)
Seat 3: 5c980949 ($5.16 in chips)
Seat 4: 3b85f8e6 ($10.51 in chips)
Seat 5: 1dbfd698 ($8.92 in chips)
Seat 6: 6ad9ee5e ($7.2 in chips)
Hero: posts small blind $0.02
5c980949: posts big blind $0.05
*** HOLE CARDS ***
Dealt to f740825c 
Dealt to Hero [Kc 2c]
Dealt to 5c980949 
Dealt to 3b85f8e6 
Dealt to 1dbfd698 
Dealt to 6ad9ee5e 
3b85f8e6: folds
1dbfd698: folds
6ad9ee5e: raises $0.05 to $0.1
f740825c: folds
Hero: folds
5c980949: calls $0.05
*** FLOP *** [Qd Js Tc]
5c980949: checks
6ad9ee5e: checks
*** TURN *** [Qd Js Tc] [8h]
5c980949: bets $0.14
6ad9ee5e: folds
Uncalled bet ($0.14) returned to 5c980949
*** SHOWDOWN ***
5c980949 collected $0.21 from pot
*** SUMMARY ***
Total pot $0.22 | Rake $0.01 | Jackpot $0 | Bingo $0 | Fortune $0 | Tax $0
Board [Qd Js Tc 8h]
Seat 1: f740825c (button) folded before Flop (didn't bet)
Seat 2: Hero (small blind) folded before Flop
Seat 3: 5c980949 (big blind) won ($0.21)
Seat 4: 3b85f8e6 folded before Flop (didn't bet)
Seat 5: 1dbfd698 folded before Flop (didn't bet)
Seat 6: 6ad9ee5e folded on the Turn


Poker Hand #RC3334369517: Hold'em No Limit ($0.02/$0.05) - 2025/02/17 20:14:15
Table 'RushAndCash594777' 6-max Seat #1 is the button
Seat 1: fa84cc2d ($14.13 in chips)
Seat 2: 50d9f656 ($6.35 in chips)
Seat 3: Hero ($5.14 in chips)
Seat 4: 4e3c3196 ($21.37 in chips)
Seat 5: ef82d036 ($23.71 in chips)
Seat 6: 727998e7 ($6.01 in chips)
50d9f656: posts small blind $0.02
Hero: posts big blind $0.05
*** HOLE CARDS ***
Dealt to fa84cc2d 
Dealt to 50d9f656 
Dealt to Hero [Ah Jc]
Dealt to 4e3c3196 
Dealt to ef82d036 
Dealt to 727998e7 
4e3c3196: folds
ef82d036: raises $0.06 to $0.11
727998e7: folds
fa84cc2d: folds
50d9f656: calls $0.09
Hero: calls $0.06
*** FLOP *** [Kh 7h 7d]
50d9f656: checks
Hero: checks
ef82d036: checks
*** TURN *** [Kh 7h 7d] [9d]
50d9f656: bets $0.17
Hero: folds
ef82d036: folds
Uncalled bet ($0.17) returned to 50d9f656
*** SHOWDOWN ***
50d9f656 collected $0.32 from pot
*** SUMMARY ***
Total pot $0.33 | Rake $0.01 | Jackpot $0 | Bingo $0 | Fortune $0 | Tax $0
Board [Kh 7h 7d 9d]
Seat 1: fa84cc2d (button) folded before Flop (didn't bet)
Seat 2: 50d9f656 (small blind) won ($0.32)
Seat 3: Hero (big blind) folded on the Turn
Seat 4: 4e3c3196 folded before Flop (didn't bet)
Seat 5: ef82d036 folded on the Turn
Seat 6: 727998e7 folded before Flop (didn't bet)


Poker Hand #RC3334369223: Hold'em No Limit ($0.02/$0.05) - 2025/02/17 20:13:25
Table 'RushAndCash594483' 6-max Seat #1 is the button
Seat 1: 598d859f ($5.87 in chips)
Seat 2: 6b62a9a6 ($5.23 in chips)
Seat 3: faba3abb ($5 in chips)
Seat 4: d1cd1071 ($13.97 in chips)
Seat 5: 15346d36 ($4.68 in chips)
Seat 6: Hero ($5.19 in chips)
6b62a9a6: posts small blind $0.02
faba3abb: posts big blind $0.05
*** HOLE CARDS ***
Dealt to 598d859f 
Dealt to 6b62a9a6 
Dealt to faba3abb 
Dealt to d1cd1071 
Dealt to 15346d36 
Dealt to Hero [7h 7s]
d1cd1071: folds
15346d36: calls $0.05
Hero: calls $0.05
598d859f: folds
6b62a9a6: calls $0.03
faba3abb: checks
*** FLOP *** [9h 6h 2c]
6b62a9a6: checks
faba3abb: checks
15346d36: bets $0.1
Hero: folds
6b62a9a6: folds
faba3abb: folds
Uncalled bet ($0.1) returned to 15346d36
*** SHOWDOWN ***
15346d36 collected $0.19 from pot
*** SUMMARY ***
Total pot $0.2 | Rake $0.01 | Jackpot $0 | Bingo $0 | Fortune $0 | Tax $0
Board [9h 6h 2c]
Seat 1: 598d859f (button) folded before Flop (didn't bet)
Seat 2: 6b62a9a6 (small blind) folded on the Flop
Seat 3: faba3abb (big blind) folded on the Flop
Seat 4: d1cd1071 folded before Flop (didn't bet)
Seat 5: 15346d36 won ($0.19)
Seat 6: Hero folded on the Flop


Poker Hand #RC3334369203: Hold'em No Limit ($0.02/$0.05) - 2025/02/17 20:13:22
Table 'RushAndCash594463' 6-max Seat #1 is the button
Seat 1: b9369e69 ($6.49 in chips)
Seat 2: Hero ($5.21 in chips)
Seat 3: 835df346 ($17.15 in chips)
Seat 4: c182b1a3 ($5.42 in chips)
Seat 5: 32d40ce0 ($7.19 in chips)
Seat 6: 1063406 ($5.85 in chips)
Hero: posts small blind $0.02
835df346: posts big blind $0.05
*** HOLE CARDS ***
Dealt to b9369e69 
Dealt to Hero [8s 3d]
Dealt to 835df346 
Dealt to c182b1a3 
Dealt to 32d40ce0 
Dealt to 1063406 
c182b1a3: folds
32d40ce0: folds
1063406: folds
b9369e69: folds
Hero: folds
Uncalled bet ($0.03) returned to 835df346
*** SHOWDOWN ***
835df346 collected $0.04 from pot
*** SUMMARY ***
Total pot $0.04 | Rake $0 | Jackpot $0 | Bingo $0 | Fortune $0 | Tax $0
Seat 1: b9369e69 (button) folded before Flop (didn't bet)
Seat 2: Hero (small blind) folded before Flop
Seat 3: 835df346 (big blind) collected ($0.04)
Seat 4: c182b1a3 folded before Flop (didn't bet)
Seat 5: 32d40ce0 folded before Flop (didn't bet)
Seat 6: 1063406 folded before Flop (didn't bet)


Poker Hand #RC3334369186: Hold'em No Limit ($0.02/$0.05) - 2025/02/17 20:13:19
Table 'RushAndCash594446' 6-max Seat #1 is the button
Seat 1: Hero ($5.21 in chips)
Seat 2: 19bd4ba3 ($5.41 in chips)
Seat 3: 97fe2676 ($9.72 in chips)
Seat 4: 9ccadbb5 ($12.7 in chips)
Seat 5: ac2aecf ($2.63 in chips)
Seat 6: add80e2d ($5.37 in chips)
19bd4ba3: posts small blind $0.02
97fe2676: posts big blind $0.05
*** HOLE CARDS ***
Dealt to Hero [2c 8s]
Dealt to 19bd4ba3 
Dealt to 97fe2676 
Dealt to 9ccadbb5 
Dealt to ac2aecf 
Dealt to add80e2d 
9ccadbb5: folds
ac2aecf: folds
add80e2d: folds
Hero: folds
19bd4ba3: raises $0.05 to $0.1
97fe2676: folds
Uncalled bet ($0.05) returned to 19bd4ba3
*** SHOWDOWN ***
19bd4ba3 collected $0.1 from pot
*** SUMMARY ***
Total pot $0.1 | Rake $0 | Jackpot $0 | Bingo $0 | Fortune $0 | Tax $0
Seat 1: Hero (button) folded before Flop (didn't bet)
Seat 2: 19bd4ba3 (small blind) collected ($0.1)
Seat 3: 97fe2676 (big blind) folded before Flop
Seat 4: 9ccadbb5 folded before Flop (didn't bet)
Seat 5: ac2aecf folded before Flop (didn't bet)
Seat 6: add80e2d folded before Flop (didn't bet)


Poker Hand #RC3334368935: Hold'em No Limit ($0.02/$0.05) - 2025/02/17 20:12:40
Table 'RushAndCash594195' 6-max Seat #1 is the button
Seat 1: 71e00d83 ($9.89 in chips)
Seat 2: 3a23fe14 ($2.89 in chips)
Seat 3: Hero ($5 in chips)
Seat 4: 97fe2676 ($9.82 in chips)
Seat 5: a0a16222 ($6.89 in chips)
Seat 6: a1e98d09 ($0.97 in chips)
3a23fe14: posts small blind $0.02
Hero: posts big blind $0.05
*** HOLE CARDS ***
Dealt to 71e00d83 
Dealt to 3a23fe14 
Dealt to Hero [Kc Ts]
Dealt to 97fe2676 
Dealt to a0a16222 
Dealt to a1e98d09 
97fe2676: raises $0.05 to $0.1
a0a16222: folds
a1e98d09: folds
71e00d83: calls $0.1
3a23fe14: folds
Hero: calls $0.05
*** FLOP *** [8c Jd 9h]
Hero: checks
97fe2676: checks
71e00d83: checks
*** TURN *** [8c Jd 9h] [7c]
Hero: bets $0.24
97fe2676: folds
71e00d83: folds
Uncalled bet ($0.24) returned to Hero
*** SHOWDOWN ***
Hero collected $0.31 from pot
*** SUMMARY ***
Total pot $0.32 | Rake $0.01 | Jackpot $0 | Bingo $0 | Fortune $0 | Tax $0
Board [8c Jd 9h 7c]
Seat 1: 71e00d83 (button) folded on the Turn
Seat 2: 3a23fe14 (small blind) folded before Flop
Seat 3: Hero (big blind) won ($0.31)
Seat 4: 97fe2676 folded on the Turn
Seat 5: a0a16222 folded before Flop (didn't bet)
Seat 6: a1e98d09 folded before Flop (didn't bet)


Poker Hand #RC3334368908: Hold'em No Limit ($0.02/$0.05) - 2025/02/17 20:12:36
Table 'RushAndCash594168' 6-max Seat #1 is the button
Seat 1: 835df346 ($15.64 in chips)
Seat 2: 9a3fefc8 ($6.07 in chips)
Seat 3: 3a23fe14 ($2.94 in chips)
Seat 4: 2f8cd08f ($5.19 in chips)
Seat 5: e5f214e5 ($8.55 in chips)
Seat 6: Hero ($5 in chips)
9a3fefc8: posts small blind $0.02
3a23fe14: posts big blind $0.05
*** HOLE CARDS ***
Dealt to 835df346 
Dealt to 9a3fefc8 
Dealt to 3a23fe14 
Dealt to 2f8cd08f 
Dealt to e5f214e5 
Dealt to Hero [7c 2s]
2f8cd08f: raises $0.05 to $0.1
e5f214e5: folds
Hero: folds
835df346: folds
9a3fefc8: folds
3a23fe14: folds
Uncalled bet ($0.05) returned to 2f8cd08f
*** SHOWDOWN ***
2f8cd08f collected $0.12 from pot
*** SUMMARY ***
Total pot $0.12 | Rake $0 | Jackpot $0 | Bingo $0 | Fortune $0 | Tax $0
Seat 1: 835df346 (button) folded before Flop (didn't bet)
Seat 2: 9a3fefc8 (small blind) folded before Flop
Seat 3: 3a23fe14 (big blind) folded before Flop
Seat 4: 2f8cd08f collected ($0.12)
Seat 5: e5f214e5 folded before Flop (didn't bet)
Seat 6: Hero folded before Flop (didn't bet)


Poker Hand #RC3334368884: Hold'em No Limit ($0.02/$0.05) - 2025/02/17 20:12:33
Table 'RushAndCash594144' 6-max Seat #1 is the button
Seat 1: 9a4345c8 ($23.61 in chips)
Seat 2: f1f26d78 ($10.73 in chips)
Seat 3: 7a5bf293 ($5 in chips)
Seat 4: a0c50ee7 ($5.51 in chips)
Seat 5: b0ee20aa ($14.51 in chips)
Seat 6: Hero ($5 in chips)
f1f26d78: posts small blind $0.02
7a5bf293: posts big blind $0.05
*** HOLE CARDS ***
Dealt to 9a4345c8 
Dealt to f1f26d78 
Dealt to 7a5bf293 
Dealt to a0c50ee7 
Dealt to b0ee20aa 
Dealt to Hero [Jc 4d]
a0c50ee7: folds
b0ee20aa: folds
Hero: folds
9a4345c8: raises $0.07 to $0.12
f1f26d78: folds
7a5bf293: folds
Uncalled bet ($0.07) returned to 9a4345c8
*** SHOWDOWN ***
9a4345c8 collected $0.12 from pot
*** SUMMARY ***
Total pot $0.12 | Rake $0 | Jackpot $0 | Bingo $0 | Fortune $0 | Tax $0
Seat 1: 9a4345c8 (button) collected ($0.12)
Seat 2: f1f26d78 (small blind) folded before Flop
Seat 3: 7a5bf293 (big blind) folded before Flop
Seat 4: a0c50ee7 folded before Flop (didn't bet)
Seat 5: b0ee20aa folded before Flop (didn't bet)
Seat 6: Hero folded before Flop (didn't bet)


Poker Hand #RC3334368865: Hold'em No Limit ($0.02/$0.05) - 2025/02/17 20:12:30
Table 'RushAndCash594125' 6-max Seat #1 is the button
Seat 1: 3a23fe14 ($2.94 in chips)
Seat 2: 9b63101d ($13.06 in chips)
Seat 3: 144ea2b0 ($5.48 in chips)
Seat 4: 19bd4ba3 ($5.25 in chips)
Seat 5: f5592199 ($6.12 in chips)
Seat 6: Hero ($5 in chips)
9b63101d: posts small blind $0.02
144ea2b0: posts big blind $0.05
*** HOLE CARDS ***
Dealt to 3a23fe14 
Dealt to 9b63101d 
Dealt to 144ea2b0 
Dealt to 19bd4ba3 
Dealt to f5592199 
Dealt to Hero [Qh 2c]
19bd4ba3: raises $0.05 to $0.1
f5592199: folds
Hero: folds
3a23fe14: folds
9b63101d: folds
144ea2b0: folds
Uncalled bet ($0.05) returned to 19bd4ba3
*** SHOWDOWN ***
19bd4ba3 collected $0.12 from pot
*** SUMMARY ***
Total pot $0.12 | Rake $0 | Jackpot $0 | Bingo $0 | Fortune $0 | Tax $0
Seat 1: 3a23fe14 (button) folded before Flop (didn't bet)
Seat 2: 9b63101d (small blind) folded before Flop
Seat 3: 144ea2b0 (big blind) folded before Flop
Seat 4: 19bd4ba3 collected ($0.12)
Seat 5: f5592199 folded before Flop (didn't bet)
Seat 6: Hero folded before Flop (didn't bet)


Poker Hand #RC3334368836: Hold'em No Limit ($0.02/$0.05) - 2025/02/17 20:12:24
Table 'RushAndCash594096' 6-max Seat #1 is the button
Seat 1: ef7b5599 ($7.71 in chips)
Seat 2: a1e98d09 ($0.99 in chips)
Seat 3: 89025632 ($4.6 in chips)
Seat 4: a9cbe77d ($5.36 in chips)
Seat 5: Hero ($5 in chips)
Seat 6: 9864109b ($5 in chips)
a1e98d09: posts small blind $0.02
89025632: posts big blind $0.05
*** HOLE CARDS ***
Dealt to ef7b5599 
Dealt to a1e98d09 
Dealt to 89025632 
Dealt to a9cbe77d 
Dealt to Hero [6h 6c]
Dealt to 9864109b 
a9cbe77d: raises $0.06 to $0.11
Hero: folds
9864109b: folds
ef7b5599: folds
a1e98d09: folds
89025632: raises $0.24 to $0.35
a9cbe77d: folds
Uncalled bet ($0.24) returned to 89025632
*** SHOWDOWN ***
89025632 collected $0.23 from pot
*** SUMMARY ***
Total pot $0.24 | Rake $0.01 | Jackpot $0 | Bingo $0 | Fortune $0 | Tax $0
Seat 1: ef7b5599 (button) folded before Flop (didn't bet)
Seat 2: a1e98d09 (small blind) folded before Flop
Seat 3: 89025632 (big blind) collected ($0.23)
Seat 4: a9cbe77d folded before Flop
Seat 5: Hero folded before Flop (didn't bet)
Seat 6: 9864109b folded before Flop (didn't bet)


Poker Hand #RC3334368816: Hold'em No Limit ($0.02/$0.05) - 2025/02/17 20:12:21
Table 'RushAndCash594076' 6-max Seat #1 is the button
Seat 1: bddf8e1e ($11.76 in chips)
Seat 2: 2353ba72 ($10.02 in chips)
Seat 3: 8be10cd0 ($5.41 in chips)
Seat 4: 73c2df1f ($10.25 in chips)
Seat 5: 6dcd0788 ($5.07 in chips)
Seat 6: Hero ($5 in chips)
2353ba72: posts small blind $0.02
8be10cd0: posts big blind $0.05
*** HOLE CARDS ***
Dealt to bddf8e1e 
Dealt to 2353ba72 
Dealt to 8be10cd0 
Dealt to 73c2df1f 
Dealt to 6dcd0788 
Dealt to Hero [Tc 2d]
73c2df1f: folds
6dcd0788: folds
Hero: folds
bddf8e1e: raises $0.1 to $0.15
2353ba72: folds
8be10cd0: folds
Uncalled bet ($0.1) returned to bddf8e1e
*** SHOWDOWN ***
bddf8e1e collected $0.12 from pot
*** SUMMARY ***
Total pot $0.12 | Rake $0 | Jackpot $0 | Bingo $0 | Fortune $0 | Tax $0
Seat 1: bddf8e1e (button) collected ($0.12)
Seat 2: 2353ba72 (small blind) folded before Flop
Seat 3: 8be10cd0 (big blind) folded before Flop
Seat 4: 73c2df1f folded before Flop (didn't bet)
Seat 5: 6dcd0788 folded before Flop (didn't bet)
Seat 6: Hero folded before Flop (didn't bet)


Poker Hand #RC3334368746: Hold'em No Limit ($0.02/$0.05) - 2025/02/17 20:12:10
Table 'RushAndCash594006' 6-max Seat #1 is the button
Seat 1: 79df293 ($5.14 in chips)
Seat 2: Hero ($5.02 in chips)
Seat 3: e92b360e ($8.96 in chips)
Seat 4: 25b4d6e7 ($12.07 in chips)
Seat 5: 68351d0 ($5.13 in chips)
Seat 6: 59b37309 ($7.58 in chips)
Hero: posts small blind $0.02
e92b360e: posts big blind $0.05
*** HOLE CARDS ***
Dealt to 79df293 
Dealt to Hero [5d 2c]
Dealt to e92b360e 
Dealt to 25b4d6e7 
Dealt to 68351d0 
Dealt to 59b37309 
25b4d6e7: folds
68351d0: folds
59b37309: folds
79df293: raises $0.07 to $0.12
Hero: folds
e92b360e: folds
Uncalled bet ($0.07) returned to 79df293
*** SHOWDOWN ***
79df293 collected $0.12 from pot
*** SUMMARY ***
Total pot $0.12 | Rake $0 | Jackpot $0 | Bingo $0 | Fortune $0 | Tax $0
Seat 1: 79df293 (button) collected ($0.12)
Seat 2: Hero (small blind) folded before Flop
Seat 3: e92b360e (big blind) folded before Flop
Seat 4: 25b4d6e7 folded before Flop (didn't bet)
Seat 5: 68351d0 folded before Flop (didn't bet)
Seat 6: 59b37309 folded before Flop (didn't bet)


Poker Hand #RC3334368677: Hold'em No Limit ($0.02/$0.05) - 2025/02/17 20:12:00
Table 'RushAndCash593937' 6-max Seat #1 is the button
Seat 1: 32901860 ($7.11 in chips)
Seat 2: fc02a8e8 ($9.8 in chips)
Seat 3: Hero ($5 in chips)
Seat 4: d86379c5 ($11.05 in chips)
Seat 5: 92ac71f9 ($5 in chips)
Seat 6: 27baaa05 ($5.07 in chips)
fc02a8e8: posts small blind $0.02
Hero: posts big blind $0.05
*** HOLE CARDS ***
Dealt to 32901860 
Dealt to fc02a8e8 
Dealt to Hero [Td Kh]
Dealt to d86379c5 
Dealt to 92ac71f9 
Dealt to 27baaa05 
d86379c5: folds
92ac71f9: folds
27baaa05: folds
32901860: folds
fc02a8e8: folds
Uncalled bet ($0.03) returned to Hero
*** SHOWDOWN ***
Hero collected $0.04 from pot
*** SUMMARY ***
Total pot $0.04 | Rake $0 | Jackpot $0 | Bingo $0 | Fortune $0 | Tax $0
Seat 1: 32901860 (button) folded before Flop (didn't bet)
Seat 2: fc02a8e8 (small blind) folded before Flop
Seat 3: Hero (big blind) collected ($0.04)
Seat 4: d86379c5 folded before Flop (didn't bet)
Seat 5: 92ac71f9 folded before Flop (didn't bet)
Seat 6: 27baaa05 folded before Flop (didn't bet)


Poker Hand #RC3334368627: Hold'em No Limit ($0.02/$0.05) - 2025/02/17 20:11:52
Table 'RushAndCash593887' 6-max Seat #1 is the button
Seat 1: Hero ($5 in chips)
Seat 2: ef6a71f9 ($5.97 in chips)
Seat 3: 2c0804e1 ($8.06 in chips)
Seat 4: a0c50ee7 ($5.56 in chips)
Seat 5: 7cfb455f ($5.84 in chips)
Seat 6: f6ddf5f7 ($6.13 in chips)
ef6a71f9: posts small blind $0.02
2c0804e1: posts big blind $0.05
*** HOLE CARDS ***
Dealt to Hero [Jh 8h]
Dealt to ef6a71f9 
Dealt to 2c0804e1 
Dealt to a0c50ee7 
Dealt to 7cfb455f 
Dealt to f6ddf5f7 
a0c50ee7: folds
7cfb455f: raises $0.05 to $0.1
f6ddf5f7: folds
Hero: folds
ef6a71f9: folds
2c0804e1: calls $0.05
*** FLOP *** [Jc 2c Ts]
2c0804e1: checks
7cfb455f: bets $0.11
2c0804e1: calls $0.11
*** TURN *** [Jc 2c Ts] [Kh]
2c0804e1: bets $0.15
7cfb455f: calls $0.15
*** RIVER *** [Jc 2c Ts Kh] [4d]
2c0804e1: bets $0.74
7cfb455f: folds
Uncalled bet ($0.74) returned to 2c0804e1
*** SHOWDOWN ***
2c0804e1 collected $0.71 from pot
*** SUMMARY ***
Total pot $0.74 | Rake $0.03 | Jackpot $0 | Bingo $0 | Fortune $0 | Tax $0
Board [Jc 2c Ts Kh 4d]
Seat 1: Hero (button) folded before Flop (didn't bet)
Seat 2: ef6a71f9 (small blind) folded before Flop
Seat 3: 2c0804e1 (big blind) won ($0.71)
Seat 4: a0c50ee7 folded before Flop (didn't bet)
Seat 5: 7cfb455f folded on the River
Seat 6: f6ddf5f7 folded before Flop (didn't bet)


Poker Hand #RC3334368597: Hold'em No Limit ($0.02/$0.05) - 2025/02/17 20:11:48
Table 'RushAndCash593857' 6-max Seat #1 is the button
Seat 1: c9ea832 ($6.56 in chips)
Seat 2: a223d3ca ($5 in chips)
Seat 3: c447223a ($7.47 in chips)
Seat 4: 2c0804e1 ($8.06 in chips)
Seat 5: 9864109b ($5.07 in chips)
Seat 6: Hero ($5 in chips)
a223d3ca: posts small blind $0.02
c447223a: posts big blind $0.05
*** HOLE CARDS ***
Dealt to c9ea832 
Dealt to a223d3ca 
Dealt to c447223a 
Dealt to 2c0804e1 
Dealt to 9864109b 
Dealt to Hero [3s Ks]
2c0804e1: folds
9864109b: folds
Hero: folds
c9ea832: raises $0.05 to $0.1
a223d3ca: raises $0.4 to $0.5
c447223a: folds
c9ea832: calls $0.4
*** FLOP *** [2c 7h 4c]
a223d3ca: checks
c9ea832: bets $0.54
a223d3ca: folds
Uncalled bet ($0.54) returned to c9ea832
*** SHOWDOWN ***
c9ea832 collected $1 from pot
*** SUMMARY ***
Total pot $1.05 | Rake $0.05 | Jackpot $0 | Bingo $0 | Fortune $0 | Tax $0
Board [2c 7h 4c]
Seat 1: c9ea832 (button) won ($1)
Seat 2: a223d3ca (small blind) folded on the Flop
Seat 3: c447223a (big blind) folded before Flop
Seat 4: 2c0804e1 folded before Flop (didn't bet)
Seat 5: 9864109b folded before Flop (didn't bet)
Seat 6: Hero folded before Flop (didn't bet)


Poker Hand #RC3334368576: Hold'em No Limit ($0.02/$0.05) - 2025/02/17 20:11:45
Table 'RushAndCash593836' 6-max Seat #1 is the button
Seat 1: f0deee96 ($4.08 in chips)
Seat 2: 3b2a8270 ($13.87 in chips)
Seat 3: 275443dc ($5.31 in chips)
Seat 4: b282789b ($5.16 in chips)
Seat 5: 1e86c3d2 ($5.38 in chips)
Seat 6: Hero ($5 in chips)
3b2a8270: posts small blind $0.02
275443dc: posts big blind $0.05
*** HOLE CARDS ***
Dealt to f0deee96 
Dealt to 3b2a8270 
Dealt to 275443dc 
Dealt to b282789b 
Dealt to 1e86c3d2 
Dealt to Hero [2h 5d]
b282789b: folds
1e86c3d2: folds
Hero: folds
f0deee96: folds
3b2a8270: raises $0.08 to $0.13
275443dc: raises $0.2 to $0.33
3b2a8270: folds
Uncalled bet ($0.2) returned to 275443dc
*** SHOWDOWN ***
275443dc collected $0.25 from pot
*** SUMMARY ***
Total pot $0.26 | Rake $0.01 | Jackpot $0 | Bingo $0 | Fortune $0 | Tax $0
Seat 1: f0deee96 (button) folded before Flop (didn't bet)
Seat 2: 3b2a8270 (small blind) folded before Flop
Seat 3: 275443dc (big blind) collected ($0.25)
Seat 4: b282789b folded before Flop (didn't bet)
Seat 5: 1e86c3d2 folded before Flop (didn't bet)
Seat 6: Hero folded before Flop (didn't bet)


Poker Hand #RC3334368555: Hold'em No Limit ($0.02/$0.05) - 2025/02/17 20:11:42
Table 'RushAndCash593815' 6-max Seat #1 is the button
Seat 1: Hero ($5 in chips)
Seat 2: 275443dc ($5.33 in chips)
Seat 3: dc9e794c ($5.12 in chips)
Seat 4: 1e86c3d2 ($5.38 in chips)
Seat 5: 100d4f9e ($5.99 in chips)
Seat 6: cff58cde ($5.23 in chips)
275443dc: posts small blind $0.02
dc9e794c: posts big blind $0.05
*** HOLE CARDS ***
Dealt to Hero [6s 4d]
Dealt to 275443dc 
Dealt to dc9e794c 
Dealt to 1e86c3d2 
Dealt to 100d4f9e 
Dealt to cff58cde 
1e86c3d2: folds
100d4f9e: folds
cff58cde: folds
Hero: folds
275443dc: folds
Uncalled bet ($0.03) returned to dc9e794c
*** SHOWDOWN ***
dc9e794c collected $0.04 from pot
*** SUMMARY ***
Total pot $0.04 | Rake $0 | Jackpot $0 | Bingo $0 | Fortune $0 | Tax $0
Seat 1: Hero (button) folded before Flop (didn't bet)
Seat 2: 275443dc (small blind) folded before Flop
Seat 3: dc9e794c (big blind) collected ($0.04)
Seat 4: 1e86c3d2 folded before Flop (didn't bet)
Seat 5: 100d4f9e folded before Flop (didn't bet)
Seat 6: cff58cde folded before Flop (didn't bet)


Poker Hand #RC3334368534: Hold'em No Limit ($0.02/$0.05) - 2025/02/17 20:11:39
Table 'RushAndCash593794' 6-max Seat #1 is the button
Seat 1: 275443dc ($5.33 in chips)
Seat 2: Hero ($5.02 in chips)
Seat 3: 68351d0 ($5.04 in chips)
Seat 4: fb6c913 ($6.74 in chips)
Seat 5: 130fc8d7 ($10.25 in chips)
Seat 6: b66d20fa ($15.61 in chips)
Hero: posts small blind $0.02
68351d0: posts big blind $0.05
*** HOLE CARDS ***
Dealt to 275443dc 
Dealt to Hero [5h 2c]
Dealt to 68351d0 
Dealt to fb6c913 
Dealt to 130fc8d7 
Dealt to b66d20fa 
fb6c913: folds
130fc8d7: folds
b66d20fa: folds
275443dc: folds
Hero: folds
Uncalled bet ($0.03) returned to 68351d0
*** SHOWDOWN ***
68351d0 collected $0.04 from pot
*** SUMMARY ***
Total pot $0.04 | Rake $0 | Jackpot $0 | Bingo $0 | Fortune $0 | Tax $0
Seat 1: 275443dc (button) folded before Flop (didn't bet)
Seat 2: Hero (small blind) folded before Flop
Seat 3: 68351d0 (big blind) collected ($0.04)
Seat 4: fb6c913 folded before Flop (didn't bet)
Seat 5: 130fc8d7 folded before Flop (didn't bet)
Seat 6: b66d20fa folded before Flop (didn't bet)


Poker Hand #RC3334368513: Hold'em No Limit ($0.02/$0.05) - 2025/02/17 20:11:35
Table 'RushAndCash593773' 6-max Seat #1 is the button
Seat 1: 9135e49d ($5.62 in chips)
Seat 2: 84f270f8 ($5.02 in chips)
Seat 3: Hero ($5.07 in chips)
Seat 4: ea485a4d ($5.31 in chips)
Seat 5: 8896706d ($5 in chips)
Seat 6: fb6c913 ($6.74 in chips)
84f270f8: posts small blind $0.02
Hero: posts big blind $0.05
*** HOLE CARDS ***
Dealt to 9135e49d 
Dealt to 84f270f8 
Dealt to Hero [As 5h]
Dealt to ea485a4d 
Dealt to 8896706d 
Dealt to fb6c913 
ea485a4d: folds
8896706d: raises $0.05 to $0.1
fb6c913: folds
9135e49d: folds
84f270f8: folds
Hero: folds
Uncalled bet ($0.05) returned to 8896706d
*** SHOWDOWN ***
8896706d collected $0.12 from pot
*** SUMMARY ***
Total pot $0.12 | Rake $0 | Jackpot $0 | Bingo $0 | Fortune $0 | Tax $0
Seat 1: 9135e49d (button) folded before Flop (didn't bet)
Seat 2: 84f270f8 (small blind) folded before Flop
Seat 3: Hero (big blind) folded before Flop
Seat 4: ea485a4d folded before Flop (didn't bet)
Seat 5: 8896706d collected ($0.12)
Seat 6: fb6c913 folded before Flop (didn't bet)


Poker Hand #RC3334368495: Hold'em No Limit ($0.02/$0.05) - 2025/02/17 20:11:32
Table 'RushAndCash593755' 6-max Seat #1 is the button
Seat 1: 275443dc ($5.33 in chips)
Seat 2: fc02a8e8 ($10.1 in chips)
Seat 3: 6183e175 ($17.78 in chips)
Seat 4: Hero ($5.07 in chips)
Seat 5: 32d40ce0 ($6.22 in chips)
Seat 6: a6ca20e7 ($33.3 in chips)
fc02a8e8: posts small blind $0.02
6183e175: posts big blind $0.05
*** HOLE CARDS ***
Dealt to 275443dc 
Dealt to fc02a8e8 
Dealt to 6183e175 
Dealt to Hero [9h Ac]
Dealt to 32d40ce0 
Dealt to a6ca20e7 
Hero: folds
32d40ce0: folds
a6ca20e7: folds
275443dc: folds
fc02a8e8: raises $0.05 to $0.1
6183e175: raises $0.2 to $0.3
fc02a8e8: calls $0.2
*** FLOP *** [9s 2d Qc]
fc02a8e8: checks
6183e175: bets $0.3
fc02a8e8: folds
Uncalled bet ($0.3) returned to 6183e175
*** SHOWDOWN ***
6183e175 collected $0.57 from pot
*** SUMMARY ***
Total pot $0.6 | Rake $0.03 | Jackpot $0 | Bingo $0 | Fortune $0 | Tax $0
Board [9s 2d Qc]
Seat 1: 275443dc (button) folded before Flop (didn't bet)
Seat 2: fc02a8e8 (small blind) folded on the Flop
Seat 3: 6183e175 (big blind) won ($0.57)
Seat 4: Hero folded before Flop (didn't bet)
Seat 5: 32d40ce0 folded before Flop (didn't bet)
Seat 6: a6ca20e7 folded before Flop (didn't bet)


Poker Hand #RC3334368356: Hold'em No Limit ($0.02/$0.05) - 2025/02/17 20:11:12
Table 'RushAndCash593616' 6-max Seat #1 is the button
Seat 1: d86379c5 ($11.19 in chips)
Seat 2: 15e8a442 ($5.11 in chips)
Seat 3: 1bf2a40e ($5.37 in chips)
Seat 4: 89025632 ($4.46 in chips)
Seat 5: Hero ($5 in chips)
Seat 6: e9a8e2e6 ($7.37 in chips)
15e8a442: posts small blind $0.02
1bf2a40e: posts big blind $0.05
*** HOLE CARDS ***
Dealt to d86379c5 
Dealt to 15e8a442 
Dealt to 1bf2a40e 
Dealt to 89025632 
Dealt to Hero [Qs As]
Dealt to e9a8e2e6 
89025632: folds
Hero: raises $0.05 to $0.1
e9a8e2e6: folds
d86379c5: folds
15e8a442: folds
1bf2a40e: folds
Uncalled bet ($0.05) returned to Hero
*** SHOWDOWN ***
Hero collected $0.12 from pot
*** SUMMARY ***
Total pot $0.12 | Rake $0 | Jackpot $0 | Bingo $0 | Fortune $0 | Tax $0
Seat 1: d86379c5 (button) folded before Flop (didn't bet)
Seat 2: 15e8a442 (small blind) folded before Flop
Seat 3: 1bf2a40e (big blind) folded before Flop
Seat 4: 89025632 folded before Flop (didn't bet)
Seat 5: Hero collected ($0.12)
Seat 6: e9a8e2e6 folded before Flop (didn't bet)


Poker Hand #RC3334368311: Hold'em No Limit ($0.02/$0.05) - 2025/02/17 20:11:05
Table 'RushAndCash593571' 6-max Seat #1 is the button
Seat 1: d86379c5 ($11.19 in chips)
Seat 2: fb6c4072 ($5 in chips)
Seat 3: 9864109b ($5.07 in chips)
Seat 4: Hero ($5 in chips)
Seat 5: b0d0d63c ($5 in chips)
Seat 6: 68b3fe79 ($5 in chips)
fb6c4072: posts small blind $0.02
9864109b: posts big blind $0.05
*** HOLE CARDS ***
Dealt to d86379c5 
Dealt to fb6c4072 
Dealt to 9864109b 
Dealt to Hero [9d Jh]
Dealt to b0d0d63c 
Dealt to 68b3fe79 
Hero: folds
b0d0d63c: folds
68b3fe79: raises $0.08 to $0.13
d86379c5: folds
fb6c4072: folds
9864109b: folds
Uncalled bet ($0.08) returned to 68b3fe79
*** SHOWDOWN ***
68b3fe79 collected $0.12 from pot
*** SUMMARY ***
Total pot $0.12 | Rake $0 | Jackpot $0 | Bingo $0 | Fortune $0 | Tax $0
Seat 1: d86379c5 (button) folded before Flop (didn't bet)
Seat 2: fb6c4072 (small blind) folded before Flop
Seat 3: 9864109b (big blind) folded before Flop
Seat 4: Hero folded before Flop (didn't bet)
Seat 5: b0d0d63c folded before Flop (didn't bet)
Seat 6: 68b3fe79 collected ($0.12)


Poker Hand #RC3334368291: Hold'em No Limit ($0.02/$0.05) - 2025/02/17 20:11:02
Table 'RushAndCash593551' 6-max Seat #1 is the button
Seat 1: Hero ($5 in chips)
Seat 2: af9df96 ($5 in chips)
Seat 3: 6878e82a ($5.02 in chips)
Seat 4: cf593991 ($6.62 in chips)
Seat 5: 6981f344 ($5.07 in chips)
Seat 6: b0ee20aa ($14.06 in chips)
af9df96: posts small blind $0.02
6878e82a: posts big blind $0.05
*** HOLE CARDS ***
Dealt to Hero [Jh 4d]
Dealt to af9df96 
Dealt to 6878e82a 
Dealt to cf593991 
Dealt to 6981f344 
Dealt to b0ee20aa 
cf593991: folds
6981f344: folds
b0ee20aa: folds
Hero: folds
af9df96: raises $0.07 to $0.12
6878e82a: calls $0.07
*** FLOP *** [Kc 4c 7c]
af9df96: bets $0.08
6878e82a: folds
Uncalled bet ($0.08) returned to af9df96
*** SHOWDOWN ***
af9df96 collected $0.23 from pot
*** SUMMARY ***
Total pot $0.24 | Rake $0.01 | Jackpot $0 | Bingo $0 | Fortune $0 | Tax $0
Board [Kc 4c 7c]
Seat 1: Hero (button) folded before Flop (didn't bet)
Seat 2: af9df96 (small blind) won ($0.23)
Seat 3: 6878e82a (big blind) folded on the Flop
Seat 4: cf593991 folded before Flop (didn't bet)
Seat 5: 6981f344 folded before Flop (didn't bet)
Seat 6: b0ee20aa folded before Flop (didn't bet)


Poker Hand #RC3334368260: Hold'em No Limit ($0.02/$0.05) - 2025/02/17 20:10:58
Table 'RushAndCash593520' 6-max Seat #1 is the button
Seat 1: a0a16222 ($7.14 in chips)
Seat 2: Hero ($5 in chips)
Seat 3: 491e0e63 ($5 in chips)
Seat 4: d201e5fe ($8.57 in chips)
Seat 5: f4d91738 ($3.46 in chips)
Seat 6: ef82d036 ($23.13 in chips)
Hero: posts small blind $0.02
491e0e63: posts big blind $0.05
*** HOLE CARDS ***
Dealt to a0a16222 
Dealt to Hero [3h Qh]
Dealt to 491e0e63 
Dealt to d201e5fe 
Dealt to f4d91738 
Dealt to ef82d036 
d201e5fe: folds
f4d91738: raises $0.07 to $0.12
ef82d036: folds
a0a16222: folds
Hero: folds
491e0e63: folds
Uncalled bet ($0.07) returned to f4d91738
*** SHOWDOWN ***
f4d91738 collected $0.12 from pot
*** SUMMARY ***
Total pot $0.12 | Rake $0 | Jackpot $0 | Bingo $0 | Fortune $0 | Tax $0
Seat 1: a0a16222 (button) folded before Flop (didn't bet)
Seat 2: Hero (small blind) folded before Flop
Seat 3: 491e0e63 (big blind) folded before Flop
Seat 4: d201e5fe folded before Flop (didn't bet)
Seat 5: f4d91738 collected ($0.12)
Seat 6: ef82d036 folded before Flop (didn't bet)


Poker Hand #RC3334368235: Hold'em No Limit ($0.02/$0.05) - 2025/02/17 20:10:55
Table 'RushAndCash593495' 6-max Seat #1 is the button
Seat 1: 6878e82a ($5.02 in chips)
Seat 2: b0ee20aa ($14.08 in chips)
Seat 3: Hero ($5 in chips)
Seat 4: f26bf81c ($4.93 in chips)
Seat 5: 9b2bd2a6 ($8.28 in chips)
Seat 6: 491e0e63 ($5 in chips)
b0ee20aa: posts small blind $0.02
Hero: posts big blind $0.05
*** HOLE CARDS ***
Dealt to 6878e82a 
Dealt to b0ee20aa 
Dealt to Hero [8c 4h]
Dealt to f26bf81c 
Dealt to 9b2bd2a6 
Dealt to 491e0e63 
f26bf81c: folds
9b2bd2a6: raises $0.05 to $0.1
491e0e63: folds
6878e82a: folds
b0ee20aa: folds
Hero: folds
Uncalled bet ($0.05) returned to 9b2bd2a6
*** SHOWDOWN ***
9b2bd2a6 collected $0.12 from pot
*** SUMMARY ***
Total pot $0.12 | Rake $0 | Jackpot $0 | Bingo $0 | Fortune $0 | Tax $0
Seat 1: 6878e82a (button) folded before Flop (didn't bet)
Seat 2: b0ee20aa (small blind) folded before Flop
Seat 3: Hero (big blind) folded before Flop
Seat 4: f26bf81c folded before Flop (didn't bet)
Seat 5: 9b2bd2a6 collected ($0.12)
Seat 6: 491e0e63 folded before Flop (didn't bet)


Poker Hand #RC3334368202: Hold'em No Limit ($0.02/$0.05) - 2025/02/17 20:10:50
Table 'RushAndCash593462' 6-max Seat #1 is the button
Seat 1: d16d905f ($5 in chips)
Seat 2: 3922b684 ($13.38 in chips)
Seat 3: 2d72cb67 ($5.02 in chips)
Seat 4: be95cbec ($8.58 in chips)
Seat 5: 8be10cd0 ($5.21 in chips)
Seat 6: Hero ($5 in chips)
3922b684: posts small blind $0.02
2d72cb67: posts big blind $0.05
*** HOLE CARDS ***
Dealt to d16d905f 
Dealt to 3922b684 
Dealt to 2d72cb67 
Dealt to be95cbec 
Dealt to 8be10cd0 
Dealt to Hero [2c 6s]
be95cbec: folds
8be10cd0: raises $0.05 to $0.1
Hero: folds
d16d905f: raises $0.27 to $0.37
3922b684: folds
2d72cb67: folds
8be10cd0: calls $0.27
*** FLOP *** [Qs 8c 9s]
8be10cd0: checks
d16d905f: checks
*** TURN *** [Qs 8c 9s] [3d]
8be10cd0: bets $0.28
d16d905f: folds
Uncalled bet ($0.28) returned to 8be10cd0
*** SHOWDOWN ***
8be10cd0 collected $0.77 from pot
*** SUMMARY ***
Total pot $0.81 | Rake $0.04 | Jackpot $0 | Bingo $0 | Fortune $0 | Tax $0
Board [Qs 8c 9s 3d]
Seat 1: d16d905f (button) folded on the Turn
Seat 2: 3922b684 (small blind) folded before Flop
Seat 3: 2d72cb67 (big blind) folded before Flop
Seat 4: be95cbec folded before Flop (didn't bet)
Seat 5: 8be10cd0 won ($0.77)
Seat 6: Hero folded before Flop (didn't bet)


Poker Hand #RC3334368181: Hold'em No Limit ($0.02/$0.05) - 2025/02/17 20:10:47
Table 'RushAndCash593441' 6-max Seat #1 is the button
Seat 1: 8012317b ($5.09 in chips)
Seat 2: 119f21d7 ($5.27 in chips)
Seat 3: 29d98786 ($5.68 in chips)
Seat 4: 32901860 ($7.26 in chips)
Seat 5: 766a71b7 ($7.36 in chips)
Seat 6: Hero ($5 in chips)
119f21d7: posts small blind $0.02
29d98786: posts big blind $0.05
*** HOLE CARDS ***
Dealt to 8012317b 
Dealt to 119f21d7 
Dealt to 29d98786 
Dealt to 32901860 
Dealt to 766a71b7 
Dealt to Hero [Td 3c]
32901860: folds
766a71b7: folds
Hero: folds
8012317b: folds
119f21d7: raises $0.09 to $0.14
29d98786: folds
Uncalled bet ($0.09) returned to 119f21d7
*** SHOWDOWN ***
119f21d7 collected $0.1 from pot
*** SUMMARY ***
Total pot $0.1 | Rake $0 | Jackpot $0 | Bingo $0 | Fortune $0 | Tax $0
Seat 1: 8012317b (button) folded before Flop (didn't bet)
Seat 2: 119f21d7 (small blind) collected ($0.1)
Seat 3: 29d98786 (big blind) folded before Flop
Seat 4: 32901860 folded before Flop (didn't bet)
Seat 5: 766a71b7 folded before Flop (didn't bet)
Seat 6: Hero folded before Flop (didn't bet)


Poker Hand #RC3334368021: Hold'em No Limit ($0.02/$0.05) - 2025/02/17 20:10:21
Table 'RushAndCash593281' 6-max Seat #1 is the button
Seat 1: eb09e492 ($9.39 in chips)
Seat 2: af9eb074 ($5.32 in chips)
Seat 3: 727998e7 ($5 in chips)
Seat 4: 84f270f8 ($5 in chips)
Seat 5: c10d502a ($8.4 in chips)
Seat 6: Hero ($5 in chips)
af9eb074: posts small blind $0.02
727998e7: posts big blind $0.05
*** HOLE CARDS ***
Dealt to eb09e492 
Dealt to af9eb074 
Dealt to 727998e7 
Dealt to 84f270f8 
Dealt to c10d502a 
Dealt to Hero [3c 3h]
84f270f8: folds
c10d502a: folds
Hero: raises $0.05 to $0.1
eb09e492: raises $0.19 to $0.29
af9eb074: folds
727998e7: raises $0.56 to $0.85
Hero: folds
eb09e492: folds
Uncalled bet ($0.56) returned to 727998e7
*** SHOWDOWN ***
727998e7 collected $0.67 from pot
*** SUMMARY ***
Total pot $0.7 | Rake $0.03 | Jackpot $0 | Bingo $0 | Fortune $0 | Tax $0
Seat 1: eb09e492 (button) folded before Flop
Seat 2: af9eb074 (small blind) folded before Flop
Seat 3: 727998e7 (big blind) collected ($0.67)
Seat 4: 84f270f8 folded before Flop (didn't bet)
Seat 5: c10d502a folded before Flop (didn't bet)
Seat 6: Hero folded before Flop


Poker Hand #RC3334368001: Hold'em No Limit ($0.02/$0.05) - 2025/02/17 20:10:18
Table 'RushAndCash593261' 6-max Seat #1 is the button
Seat 1: Hero ($5 in chips)
Seat 2: 5053734a ($5.17 in chips)
Seat 3: 693956f5 ($5.73 in chips)
Seat 4: 86d9f390 ($5.27 in chips)
Seat 5: 50bd9a93 ($5.68 in chips)
Seat 6: cff3c4c8 ($3.12 in chips)
5053734a: posts small blind $0.02
693956f5: posts big blind $0.05
*** HOLE CARDS ***
Dealt to Hero [6s 7d]
Dealt to 5053734a 
Dealt to 693956f5 
Dealt to 86d9f390 
Dealt to 50bd9a93 
Dealt to cff3c4c8 
86d9f390: folds
50bd9a93: folds
cff3c4c8: raises $0.1 to $0.15
Hero: folds
5053734a: calls $0.13
693956f5: folds
*** FLOP *** [Jd 2h Jc]
5053734a: checks
cff3c4c8: bets $0.18
5053734a: folds
Uncalled bet ($0.18) returned to cff3c4c8
*** SHOWDOWN ***
cff3c4c8 collected $0.33 from pot
*** SUMMARY ***
Total pot $0.35 | Rake $0.02 | Jackpot $0 | Bingo $0 | Fortune $0 | Tax $0
Board [Jd 2h Jc]
Seat 1: Hero (button) folded before Flop (didn't bet)
Seat 2: 5053734a (small blind) folded on the Flop
Seat 3: 693956f5 (big blind) folded before Flop
Seat 4: 86d9f390 folded before Flop (didn't bet)
Seat 5: 50bd9a93 folded before Flop (didn't bet)
Seat 6: cff3c4c8 won ($0.33)


Poker Hand #RC3334367977: Hold'em No Limit ($0.02/$0.05) - 2025/02/17 20:10:15
Table 'RushAndCash593237' 6-max Seat #1 is the button
Seat 1: 626511c8 ($4.79 in chips)
Seat 2: Hero ($5.02 in chips)
Seat 3: 63a77bff ($5.04 in chips)
Seat 4: f23e7bad ($10.61 in chips)
Seat 5: 130fc8d7 ($10.43 in chips)
Seat 6: 50bd9a93 ($5.68 in chips)
Hero: posts small blind $0.02
63a77bff: posts big blind $0.05
*** HOLE CARDS ***
Dealt to 626511c8 
Dealt to Hero [2d 3d]
Dealt to 63a77bff 
Dealt to f23e7bad 
Dealt to 130fc8d7 
Dealt to 50bd9a93 
f23e7bad: folds
130fc8d7: folds
50bd9a93: folds
626511c8: raises $0.05 to $0.1
Hero: folds
63a77bff: calls $0.05
*** FLOP *** [Kc 7d Jd]
63a77bff: checks
626511c8: checks
*** TURN *** [Kc 7d Jd] [5d]
63a77bff: bets $0.3
626511c8: folds
Uncalled bet ($0.3) returned to 63a77bff
*** SHOWDOWN ***
63a77bff collected $0.21 from pot
*** SUMMARY ***
Total pot $0.22 | Rake $0.01 | Jackpot $0 | Bingo $0 | Fortune $0 | Tax $0
Board [Kc 7d Jd 5d]
Seat 1: 626511c8 (button) folded on the Turn
Seat 2: Hero (small blind) folded before Flop
Seat 3: 63a77bff (big blind) won ($0.21)
Seat 4: f23e7bad folded before Flop (didn't bet)
Seat 5: 130fc8d7 folded before Flop (didn't bet)
Seat 6: 50bd9a93 folded before Flop (didn't bet)


Poker Hand #RC3334367952: Hold'em No Limit ($0.02/$0.05) - 2025/02/17 20:10:11
Table 'RushAndCash593212' 6-max Seat #1 is the button
Seat 1: 918d412c ($4.09 in chips)
Seat 2: 9a69a3a0 ($5.09 in chips)
Seat 3: Hero ($5.07 in chips)
Seat 4: 9babc997 ($5.67 in chips)
Seat 5: 94b22b92 ($5.07 in chips)
Seat 6: d9a113f2 ($5 in chips)
9a69a3a0: posts small blind $0.02
Hero: posts big blind $0.05
*** HOLE CARDS ***
Dealt to 918d412c 
Dealt to 9a69a3a0 
Dealt to Hero [Kd 9c]
Dealt to 9babc997 
Dealt to 94b22b92 
Dealt to d9a113f2 
9babc997: folds
94b22b92: raises $0.1 to $0.15
d9a113f2: folds
918d412c: folds
9a69a3a0: folds
Hero: folds
Uncalled bet ($0.1) returned to 94b22b92
*** SHOWDOWN ***
94b22b92 collected $0.12 from pot
*** SUMMARY ***
Total pot $0.12 | Rake $0 | Jackpot $0 | Bingo $0 | Fortune $0 | Tax $0
Seat 1: 918d412c (button) folded before Flop (didn't bet)
Seat 2: 9a69a3a0 (small blind) folded before Flop
Seat 3: Hero (big blind) folded before Flop
Seat 4: 9babc997 folded before Flop (didn't bet)
Seat 5: 94b22b92 collected ($0.12)
Seat 6: d9a113f2 folded before Flop (didn't bet)


Poker Hand #RC3334367928: Hold'em No Limit ($0.02/$0.05) - 2025/02/17 20:10:08
Table 'RushAndCash593188' 6-max Seat #1 is the button
Seat 1: 1165d8f0 ($5 in chips)
Seat 2: 5197516b ($5 in chips)
Seat 3: af9df96 ($5 in chips)
Seat 4: f0d238ad ($6.27 in chips)
Seat 5: b282789b ($5.42 in chips)
Seat 6: Hero ($5.07 in chips)
5197516b: posts small blind $0.02
af9df96: posts big blind $0.05
*** HOLE CARDS ***
Dealt to 1165d8f0 
Dealt to 5197516b 
Dealt to af9df96 
Dealt to f0d238ad 
Dealt to b282789b 
Dealt to Hero [Qs 4h]
f0d238ad: raises $0.05 to $0.1
b282789b: folds
Hero: folds
1165d8f0: folds
5197516b: folds
af9df96: folds
Uncalled bet ($0.05) returned to f0d238ad
*** SHOWDOWN ***
f0d238ad collected $0.12 from pot
*** SUMMARY ***
Total pot $0.12 | Rake $0 | Jackpot $0 | Bingo $0 | Fortune $0 | Tax $0
Seat 1: 1165d8f0 (button) folded before Flop (didn't bet)
Seat 2: 5197516b (small blind) folded before Flop
Seat 3: af9df96 (big blind) folded before Flop
Seat 4: f0d238ad collected ($0.12)
Seat 5: b282789b folded before Flop (didn't bet)
Seat 6: Hero folded before Flop (didn't bet)


Poker Hand #RC3334367906: Hold'em No Limit ($0.02/$0.05) - 2025/02/17 20:10:05
Table 'RushAndCash593166' 6-max Seat #1 is the button
Seat 1: 8012317b ($5 in chips)
Seat 2: 9438ae8e ($19.15 in chips)
Seat 3: f25a1768 ($6.83 in chips)
Seat 4: ed1479f ($8.18 in chips)
Seat 5: f475a277 ($2.57 in chips)
Seat 6: Hero ($5.07 in chips)
9438ae8e: posts small blind $0.02
f25a1768: posts big blind $0.05
*** HOLE CARDS ***
Dealt to 8012317b 
Dealt to 9438ae8e 
Dealt to f25a1768 
Dealt to ed1479f 
Dealt to f475a277 
Dealt to Hero [Kc 8d]
ed1479f: raises $0.08 to $0.13
f475a277: calls $0.13
Hero: folds
8012317b: folds
9438ae8e: folds
f25a1768: folds
*** FLOP *** [Tc 5d 8c]
ed1479f: checks
f475a277: checks
*** TURN *** [Tc 5d 8c] [8h]
ed1479f: checks
f475a277: checks
*** RIVER *** [Tc 5d 8c 8h] [4s]
ed1479f: checks
f475a277: checks
ed1479f: shows [7d As] (Pair of Eights)
f475a277: shows [6c 2d] (Pair of Eights)
*** SHOWDOWN ***
ed1479f collected $0.32 from pot
*** SUMMARY ***
Total pot $0.33 | Rake $0.01 | Jackpot $0 | Bingo $0 | Fortune $0 | Tax $0
Board [Tc 5d 8c 8h 4s]
Seat 1: 8012317b (button) folded before Flop (didn't bet)
Seat 2: 9438ae8e (small blind) folded before Flop
Seat 3: f25a1768 (big blind) folded before Flop
Seat 4: ed1479f showed [7d As] and won ($0.32) with Pair of Eights
Seat 5: f475a277 showed [6c 2d] and lost with Pair of Eights
Seat 6: Hero folded before Flop (didn't bet)


Poker Hand #RC3334367882: Hold'em No Limit ($0.02/$0.05) - 2025/02/17 20:10:02
Table 'RushAndCash593142' 6-max Seat #1 is the button
Seat 1: 436ecab0 ($4.66 in chips)
Seat 2: 817f21da ($5.61 in chips)
Seat 3: cf7f09c2 ($5.36 in chips)
Seat 4: a8b128fb ($14.41 in chips)
Seat 5: 945593bf ($5 in chips)
Seat 6: Hero ($5.07 in chips)
817f21da: posts small blind $0.02
cf7f09c2: posts big blind $0.05
*** HOLE CARDS ***
Dealt to 436ecab0 
Dealt to 817f21da 
Dealt to cf7f09c2 
Dealt to a8b128fb 
Dealt to 945593bf 
Dealt to Hero [4s Ah]
a8b128fb: raises $0.05 to $0.1
945593bf: folds
Hero: folds
436ecab0: folds
817f21da: folds
cf7f09c2: folds
Uncalled bet ($0.05) returned to a8b128fb
*** SHOWDOWN ***
a8b128fb collected $0.12 from pot
*** SUMMARY ***
Total pot $0.12 | Rake $0 | Jackpot $0 | Bingo $0 | Fortune $0 | Tax $0
Seat 1: 436ecab0 (button) folded before Flop (didn't bet)
Seat 2: 817f21da (small blind) folded before Flop
Seat 3: cf7f09c2 (big blind) folded before Flop
Seat 4: a8b128fb collected ($0.12)
Seat 5: 945593bf folded before Flop (didn't bet)
Seat 6: Hero folded before Flop (didn't bet)


Poker Hand #RC3334367859: Hold'em No Limit ($0.02/$0.05) - 2025/02/17 20:09:58
Table 'RushAndCash593119' 6-max Seat #1 is the button
Seat 1: fa66f3cf ($9.44 in chips)
Seat 2: 4ea8e2e ($13.81 in chips)
Seat 3: 53c3b7da ($5.49 in chips)
Seat 4: Hero ($5.07 in chips)
Seat 5: 50d9f656 ($6.05 in chips)
Seat 6: 5acd5e40 ($6.3 in chips)
4ea8e2e: posts small blind $0.02
53c3b7da: posts big blind $0.05
*** HOLE CARDS ***
Dealt to fa66f3cf 
Dealt to 4ea8e2e 
Dealt to 53c3b7da 
Dealt to Hero [Jc Qh]
Dealt to 50d9f656 
Dealt to 5acd5e40 
Hero: folds
50d9f656: folds
5acd5e40: folds
fa66f3cf: folds
4ea8e2e: raises $0.1 to $0.15
53c3b7da: folds
Uncalled bet ($0.1) returned to 4ea8e2e
*** SHOWDOWN ***
4ea8e2e collected $0.1 from pot
*** SUMMARY ***
Total pot $0.1 | Rake $0 | Jackpot $0 | Bingo $0 | Fortune $0 | Tax $0
Seat 1: fa66f3cf (button) folded before Flop (didn't bet)
Seat 2: 4ea8e2e (small blind) collected ($0.1)
Seat 3: 53c3b7da (big blind) folded before Flop
Seat 4: Hero folded before Flop (didn't bet)
Seat 5: 50d9f656 folded before Flop (didn't bet)
Seat 6: 5acd5e40 folded before Flop (didn't bet)


Poker Hand #RC3334367795: Hold'em No Limit ($0.02/$0.05) - 2025/02/17 20:09:48
Table 'RushAndCash593055' 6-max Seat #1 is the button
Seat 1: 709ac205 ($10.31 in chips)
Seat 2: 8012317b ($5.02 in chips)
Seat 3: Hero ($5.12 in chips)
Seat 4: c4eb9775 ($11.48 in chips)
Seat 5: e7b2e2aa ($5 in chips)
Seat 6: b44ff266 ($5.03 in chips)
8012317b: posts small blind $0.02
Hero: posts big blind $0.05
*** HOLE CARDS ***
Dealt to 709ac205 
Dealt to 8012317b 
Dealt to Hero [9h 2h]
Dealt to c4eb9775 
Dealt to e7b2e2aa 
Dealt to b44ff266 
c4eb9775: raises $0.05 to $0.1
e7b2e2aa: folds
b44ff266: folds
709ac205: folds
8012317b: folds
Hero: folds
Uncalled bet ($0.05) returned to c4eb9775
*** SHOWDOWN ***
c4eb9775 collected $0.12 from pot
*** SUMMARY ***
Total pot $0.12 | Rake $0 | Jackpot $0 | Bingo $0 | Fortune $0 | Tax $0
Seat 1: 709ac205 (button) folded before Flop (didn't bet)
Seat 2: 8012317b (small blind) folded before Flop
Seat 3: Hero (big blind) folded before Flop
Seat 4: c4eb9775 collected ($0.12)
Seat 5: e7b2e2aa folded before Flop (didn't bet)
Seat 6: b44ff266 folded before Flop (didn't bet)


Poker Hand #RC3334367778: Hold'em No Limit ($0.02/$0.05) - 2025/02/17 20:09:44
Table 'RushAndCash593038' 6-max Seat #1 is the button
Seat 1: c7d7e6aa ($5 in chips)
Seat 2: Hero ($5.14 in chips)
Seat 3: 69d7bf2c ($5.23 in chips)
Seat 4: 9864109b ($5.19 in chips)
Seat 5: 27baaa05 ($5.26 in chips)
Seat 6: 7c13e490 ($12.13 in chips)
Hero: posts small blind $0.02
69d7bf2c: posts big blind $0.05
*** HOLE CARDS ***
Dealt to c7d7e6aa 
Dealt to Hero [Jd 3h]
Dealt to 69d7bf2c 
Dealt to 9864109b 
Dealt to 27baaa05 
Dealt to 7c13e490 
9864109b: folds
27baaa05: raises $0.05 to $0.1
7c13e490: folds
c7d7e6aa: raises $0.21 to $0.31
Hero: folds
69d7bf2c: folds
27baaa05: calls $0.21
*** FLOP *** [Qc 8h Kc]
27baaa05: checks
c7d7e6aa: bets $0.35
27baaa05: folds
Uncalled bet ($0.35) returned to c7d7e6aa
*** SHOWDOWN ***
c7d7e6aa collected $0.66 from pot
*** SUMMARY ***
Total pot $0.69 | Rake $0.03 | Jackpot $0 | Bingo $0 | Fortune $0 | Tax $0
Board [Qc 8h Kc]
Seat 1: c7d7e6aa (button) won ($0.66)
Seat 2: Hero (small blind) folded before Flop
Seat 3: 69d7bf2c (big blind) folded before Flop
Seat 4: 9864109b folded before Flop (didn't bet)
Seat 5: 27baaa05 folded on the Flop
Seat 6: 7c13e490 folded before Flop (didn't bet)


Poker Hand #RC3334367722: Hold'em No Limit ($0.02/$0.05) - 2025/02/17 20:09:35
Table 'RushAndCash592982' 6-max Seat #1 is the button
Seat 1: Hero ($5.14 in chips)
Seat 2: 1165d8f0 ($5 in chips)
Seat 3: bd383633 ($6.4 in chips)
Seat 4: c58a51ef ($5 in chips)
Seat 5: 8e39de43 ($5 in chips)
Seat 6: 1f7fd8bc ($7.38 in chips)
1165d8f0: posts small blind $0.02
bd383633: posts big blind $0.05
*** HOLE CARDS ***
Dealt to Hero [8h 2c]
Dealt to 1165d8f0 
Dealt to bd383633 
Dealt to c58a51ef 
Dealt to 8e39de43 
Dealt to 1f7fd8bc 
c58a51ef: folds
8e39de43: folds
1f7fd8bc: folds
Hero: folds
1165d8f0: raises $0.05 to $0.1
bd383633: folds
Uncalled bet ($0.05) returned to 1165d8f0
*** SHOWDOWN ***
1165d8f0 collected $0.1 from pot
*** SUMMARY ***
Total pot $0.1 | Rake $0 | Jackpot $0 | Bingo $0 | Fortune $0 | Tax $0
Seat 1: Hero (button) folded before Flop (didn't bet)
Seat 2: 1165d8f0 (small blind) collected ($0.1)
Seat 3: bd383633 (big blind) folded before Flop
Seat 4: c58a51ef folded before Flop (didn't bet)
Seat 5: 8e39de43 folded before Flop (didn't bet)
Seat 6: 1f7fd8bc folded before Flop (didn't bet)


Poker Hand #RC3334367696: Hold'em No Limit ($0.02/$0.05) - 2025/02/17 20:09:32
Table 'RushAndCash592956' 6-max Seat #1 is the button
Seat 1: f171b990 ($5.21 in chips)
Seat 2: 573eb753 ($4.67 in chips)
Seat 3: 1209ad51 ($5 in chips)
Seat 4: Hero ($5.14 in chips)
Seat 5: 2d72cb67 ($5.4 in chips)
Seat 6: 83c366a4 ($5.39 in chips)
573eb753: posts small blind $0.02
1209ad51: posts big blind $0.05
*** HOLE CARDS ***
Dealt to f171b990 
Dealt to 573eb753 
Dealt to 1209ad51 
Dealt to Hero [5h 7s]
Dealt to 2d72cb67 
Dealt to 83c366a4 
Hero: folds
2d72cb67: folds
83c366a4: folds
f171b990: folds
573eb753: folds
Uncalled bet ($0.03) returned to 1209ad51
*** SHOWDOWN ***
1209ad51 collected $0.04 from pot
*** SUMMARY ***
Total pot $0.04 | Rake $0 | Jackpot $0 | Bingo $0 | Fortune $0 | Tax $0
Seat 1: f171b990 (button) folded before Flop (didn't bet)
Seat 2: 573eb753 (small blind) folded before Flop
Seat 3: 1209ad51 (big blind) collected ($0.04)
Seat 4: Hero folded before Flop (didn't bet)
Seat 5: 2d72cb67 folded before Flop (didn't bet)
Seat 6: 83c366a4 folded before Flop (didn't bet)


Poker Hand #RC3334367537: Hold'em No Limit ($0.02/$0.05) - 2025/02/17 20:09:05
Table 'RushAndCash592797' 6-max Seat #1 is the button
Seat 1: f25a1768 ($6.94 in chips)
Seat 2: d58b99ca ($10.07 in chips)
Seat 3: 742ccfee ($2.41 in chips)
Seat 4: Hero ($5.07 in chips)
Seat 5: c585480d ($5.78 in chips)
Seat 6: 735c4afd ($5 in chips)
d58b99ca: posts small blind $0.02
742ccfee: posts big blind $0.05
*** HOLE CARDS ***
Dealt to f25a1768 
Dealt to d58b99ca 
Dealt to 742ccfee 
Dealt to Hero [Qh Qd]
Dealt to c585480d 
Dealt to 735c4afd 
Hero: raises $0.05 to $0.1
c585480d: folds
735c4afd: folds
f25a1768: folds
d58b99ca: folds
742ccfee: folds
Uncalled bet ($0.05) returned to Hero
*** SHOWDOWN ***
Hero collected $0.12 from pot
*** SUMMARY ***
Total pot $0.12 | Rake $0 | Jackpot $0 | Bingo $0 | Fortune $0 | Tax $0
Seat 1: f25a1768 (button) folded before Flop (didn't bet)
Seat 2: d58b99ca (small blind) folded before Flop
Seat 3: 742ccfee (big blind) folded before Flop
Seat 4: Hero collected ($0.12)
Seat 5: c585480d folded before Flop (didn't bet)
Seat 6: 735c4afd folded before Flop (didn't bet)


Poker Hand #RC3334367500: Hold'em No Limit ($0.02/$0.05) - 2025/02/17 20:09:00
Table 'RushAndCash592760' 6-max Seat #1 is the button
Seat 1: Hero ($5 in chips)
Seat 2: 2f033106 ($5 in chips)
Seat 3: bbd60b52 ($16.17 in chips)
Seat 4: 8896706d ($5 in chips)
Seat 5: b1aa19ba ($5.07 in chips)
Seat 6: 4e3c3196 ($23.83 in chips)
2f033106: posts small blind $0.02
bbd60b52: posts big blind $0.05
*** HOLE CARDS ***
Dealt to Hero [6c 9c]
Dealt to 2f033106 
Dealt to bbd60b52 
Dealt to 8896706d 
Dealt to b1aa19ba 
Dealt to 4e3c3196 
8896706d: raises $0.05 to $0.1
b1aa19ba: folds
4e3c3196: folds
Hero: folds
2f033106: folds
bbd60b52: folds
Uncalled bet ($0.05) returned to 8896706d
*** SHOWDOWN ***
8896706d collected $0.12 from pot
*** SUMMARY ***
Total pot $0.12 | Rake $0 | Jackpot $0 | Bingo $0 | Fortune $0 | Tax $0
Seat 1: Hero (button) folded before Flop (didn't bet)
Seat 2: 2f033106 (small blind) folded before Flop
Seat 3: bbd60b52 (big blind) folded before Flop
Seat 4: 8896706d collected ($0.12)
Seat 5: b1aa19ba folded before Flop (didn't bet)
Seat 6: 4e3c3196 folded before Flop (didn't bet)


Poker Hand #RC3334367472: Hold'em No Limit ($0.02/$0.05) - 2025/02/17 20:08:56
Table 'RushAndCash592732' 6-max Seat #1 is the button
Seat 1: d32b2e06 ($5.67 in chips)
Seat 2: Hero ($5 in chips)
Seat 3: b9e511a ($14.6 in chips)
Seat 4: 6eba7b35 ($5.28 in chips)
Seat 5: 71e00d83 ($8.8 in chips)
Seat 6: 87b4e331 ($5.88 in chips)
Hero: posts small blind $0.02
b9e511a: posts big blind $0.05
*** HOLE CARDS ***
Dealt to d32b2e06 
Dealt to Hero [6c Jc]
Dealt to b9e511a 
Dealt to 6eba7b35 
Dealt to 71e00d83 
Dealt to 87b4e331 
6eba7b35: folds
71e00d83: folds
87b4e331: folds
d32b2e06: folds
Hero: folds
Uncalled bet ($0.03) returned to b9e511a
*** SHOWDOWN ***
b9e511a collected $0.04 from pot
*** SUMMARY ***
Total pot $0.04 | Rake $0 | Jackpot $0 | Bingo $0 | Fortune $0 | Tax $0
Seat 1: d32b2e06 (button) folded before Flop (didn't bet)
Seat 2: Hero (small blind) folded before Flop
Seat 3: b9e511a (big blind) collected ($0.04)
Seat 4: 6eba7b35 folded before Flop (didn't bet)
Seat 5: 71e00d83 folded before Flop (didn't bet)
Seat 6: 87b4e331 folded before Flop (didn't bet)


Poker Hand #RC3334367447: Hold'em No Limit ($0.02/$0.05) - 2025/02/17 20:08:52
Table 'RushAndCash592707' 6-max Seat #1 is the button
Seat 1: 709ac205 ($10.92 in chips)
Seat 2: f1f26d78 ($10.59 in chips)
Seat 3: Hero ($5 in chips)
Seat 4: 15e8a442 ($5.23 in chips)
Seat 5: 37558bf9 ($5.23 in chips)
Seat 6: 8d83fcbb ($5 in chips)
f1f26d78: posts small blind $0.02
Hero: posts big blind $0.05
*** HOLE CARDS ***
Dealt to 709ac205 
Dealt to f1f26d78 
Dealt to Hero [4d Th]
Dealt to 15e8a442 
Dealt to 37558bf9 
Dealt to 8d83fcbb 
15e8a442: folds
37558bf9: folds
8d83fcbb: folds
709ac205: folds
f1f26d78: folds
Uncalled bet ($0.03) returned to Hero
*** SHOWDOWN ***
Hero collected $0.04 from pot
*** SUMMARY ***
Total pot $0.04 | Rake $0 | Jackpot $0 | Bingo $0 | Fortune $0 | Tax $0
Seat 1: 709ac205 (button) folded before Flop (didn't bet)
Seat 2: f1f26d78 (small blind) folded before Flop
Seat 3: Hero (big blind) collected ($0.04)
Seat 4: 15e8a442 folded before Flop (didn't bet)
Seat 5: 37558bf9 folded before Flop (didn't bet)
Seat 6: 8d83fcbb folded before Flop (didn't bet)


Poker Hand #RC3334367421: Hold'em No Limit ($0.02/$0.05) - 2025/02/17 20:08:48
Table 'RushAndCash592681' 6-max Seat #1 is the button
Seat 1: cda72279 ($2.07 in chips)
Seat 2: e94f5acb ($13.16 in chips)
Seat 3: 918d412c ($4.67 in chips)
Seat 4: 42fca4f9 ($5.07 in chips)
Seat 5: Hero ($5 in chips)
Seat 6: 93735ac4 ($5.15 in chips)
e94f5acb: posts small blind $0.02
918d412c: posts big blind $0.05
*** HOLE CARDS ***
Dealt to cda72279 
Dealt to e94f5acb 
Dealt to 918d412c 
Dealt to 42fca4f9 
Dealt to Hero [2c 3h]
Dealt to 93735ac4 
42fca4f9: folds
Hero: folds
93735ac4: folds
cda72279: folds
e94f5acb: folds
Uncalled bet ($0.03) returned to 918d412c
*** SHOWDOWN ***
918d412c collected $0.04 from pot
*** SUMMARY ***
Total pot $0.04 | Rake $0 | Jackpot $0 | Bingo $0 | Fortune $0 | Tax $0
Seat 1: cda72279 (button) folded before Flop (didn't bet)
Seat 2: e94f5acb (small blind) folded before Flop
Seat 3: 918d412c (big blind) collected ($0.04)
Seat 4: 42fca4f9 folded before Flop (didn't bet)
Seat 5: Hero folded before Flop (didn't bet)
Seat 6: 93735ac4 folded before Flop (didn't bet)


Poker Hand #RC3334367397: Hold'em No Limit ($0.02/$0.05) - 2025/02/17 20:08:45
Table 'RushAndCash592657' 6-max Seat #1 is the button
Seat 1: f423ee1f ($6.27 in chips)
Seat 2: fe0566a4 ($6.46 in chips)
Seat 3: 54fe77bd ($5.06 in chips)
Seat 4: Hero ($5 in chips)
Seat 5: dbf5f543 ($9.06 in chips)
Seat 6: 80d92728 ($5 in chips)
fe0566a4: posts small blind $0.02
54fe77bd: posts big blind $0.05
*** HOLE CARDS ***
Dealt to f423ee1f 
Dealt to fe0566a4 
Dealt to 54fe77bd 
Dealt to Hero [3d Ah]
Dealt to dbf5f543 
Dealt to 80d92728 
Hero: folds
dbf5f543: folds
80d92728: folds
f423ee1f: raises $0.07 to $0.12
fe0566a4: folds
54fe77bd: calls $0.07
*** FLOP *** [5s 9h 9s]
54fe77bd: checks
f423ee1f: checks
*** TURN *** [5s 9h 9s] [Tc]
54fe77bd: bets $0.2
f423ee1f: calls $0.2
*** RIVER *** [5s 9h 9s Tc] [Js]
54fe77bd: checks
f423ee1f: bets $0.5
54fe77bd: calls $0.5
f423ee1f: shows [Kh Qh] (Kings-High Straight)
54fe77bd: shows [9d Ks] (Three Nines)
*** SHOWDOWN ***
f423ee1f collected $1.51 from pot
*** SUMMARY ***
Total pot $1.66 | Rake $0.08 | Jackpot $0.07 | Bingo $0 | Fortune $0 | Tax $0
Board [5s 9h 9s Tc Js]
Seat 1: f423ee1f (button) showed [Kh Qh] and won ($1.51) with Kings-High Straight
Seat 2: fe0566a4 (small blind) folded before Flop
Seat 3: 54fe77bd (big blind) showed [9d Ks] and lost with Three Nines
Seat 4: Hero folded before Flop (didn't bet)
Seat 5: dbf5f543 folded before Flop (didn't bet)
Seat 6: 80d92728 folded before Flop (didn't bet)


Poker Hand #RC3334367377: Hold'em No Limit ($0.02/$0.05) - 2025/02/17 20:08:41
Table 'RushAndCash592637' 6-max Seat #1 is the button
Seat 1: 87d9de00 ($4.9 in chips)
Seat 2: ab35fc95 ($5.83 in chips)
Seat 3: a22f05f1 ($5.84 in chips)
Seat 4: 97fe2676 ($9.85 in chips)
Seat 5: 130fc8d7 ($10.29 in chips)
Seat 6: Hero ($5 in chips)
ab35fc95: posts small blind $0.02
a22f05f1: posts big blind $0.05
*** HOLE CARDS ***
Dealt to 87d9de00 
Dealt to ab35fc95 
Dealt to a22f05f1 
Dealt to 97fe2676 
Dealt to 130fc8d7 
Dealt to Hero [Th 7c]
97fe2676: folds
130fc8d7: folds
Hero: folds
87d9de00: folds
ab35fc95: folds
Uncalled bet ($0.03) returned to a22f05f1
*** SHOWDOWN ***
a22f05f1 collected $0.04 from pot
*** SUMMARY ***
Total pot $0.04 | Rake $0 | Jackpot $0 | Bingo $0 | Fortune $0 | Tax $0
Seat 1: 87d9de00 (button) folded before Flop (didn't bet)
Seat 2: ab35fc95 (small blind) folded before Flop
Seat 3: a22f05f1 (big blind) collected ($0.04)
Seat 4: 97fe2676 folded before Flop (didn't bet)
Seat 5: 130fc8d7 folded before Flop (didn't bet)
Seat 6: Hero folded before Flop (didn't bet)


Poker Hand #RC3334367357: Hold'em No Limit ($0.02/$0.05) - 2025/02/17 20:08:39
Table 'RushAndCash592617' 6-max Seat #1 is the button
Seat 1: Hero ($5 in chips)
Seat 2: 94501470 ($6.19 in chips)
Seat 3: 886c894a ($11.58 in chips)
Seat 4: 27baaa05 ($5.33 in chips)
Seat 5: ba18b75e ($8.06 in chips)
Seat 6: 29471264 ($6.73 in chips)
94501470: posts small blind $0.02
886c894a: posts big blind $0.05
*** HOLE CARDS ***
Dealt to Hero [Th 4c]
Dealt to 94501470 
Dealt to 886c894a 
Dealt to 27baaa05 
Dealt to ba18b75e 
Dealt to 29471264 
27baaa05: folds
ba18b75e: raises $0.05 to $0.1
29471264: folds
Hero: folds
94501470: calls $0.08
886c894a: folds
*** FLOP *** [4h Tc 7h]
94501470: checks
ba18b75e: bets $0.13
94501470: folds
Uncalled bet ($0.13) returned to ba18b75e
*** SHOWDOWN ***
ba18b75e collected $0.24 from pot
*** SUMMARY ***
Total pot $0.25 | Rake $0.01 | Jackpot $0 | Bingo $0 | Fortune $0 | Tax $0
Board [4h Tc 7h]
Seat 1: Hero (button) folded before Flop (didn't bet)
Seat 2: 94501470 (small blind) folded on the Flop
Seat 3: 886c894a (big blind) folded before Flop
Seat 4: 27baaa05 folded before Flop (didn't bet)
Seat 5: ba18b75e won ($0.24)
Seat 6: 29471264 folded before Flop (didn't bet)


Poker Hand #RC3334367180: Hold'em No Limit ($0.02/$0.05) - 2025/02/17 20:08:11
Table 'RushAndCash592440' 6-max Seat #1 is the button
Seat 1: d16d905f ($5 in chips)
Seat 2: Hero ($5 in chips)
Seat 3: 83399f83 ($5.32 in chips)
Seat 4: 63499226 ($3.71 in chips)
Seat 5: c4eb9775 ($11.7 in chips)
Seat 6: 5f1cdd27 ($5 in chips)
Cash Drop to Pot : total $0.5 
Hero: posts small blind $0.02
83399f83: posts big blind $0.05
*** HOLE CARDS ***
Dealt to d16d905f 
Dealt to Hero [4h 6h]
Dealt to 83399f83 
Dealt to 63499226 
Dealt to c4eb9775 
Dealt to 5f1cdd27 
63499226: folds
c4eb9775: raises $0.05 to $0.1
5f1cdd27: folds
d16d905f: folds
Hero: calls $0.08
83399f83: calls $0.05
*** FLOP *** [9d Ks Ah]
Hero: checks
83399f83: checks
c4eb9775: bets $0.27
Hero: folds
83399f83: calls $0.27
*** TURN *** [9d Ks Ah] [5c]
83399f83: checks
c4eb9775: checks
*** RIVER *** [9d Ks Ah 5c] [8c]
83399f83: bets $1.01
c4eb9775: folds
Uncalled bet ($1.01) returned to 83399f83
*** SHOWDOWN ***
83399f83 collected $1.28 from pot
*** SUMMARY ***
Total pot $1.34 | Rake $0.06 | Jackpot $0 | Bingo $0 | Fortune $0 | Tax $0
Board [9d Ks Ah 5c 8c]
Seat 1: d16d905f (button) folded before Flop (didn't bet)
Seat 2: Hero (small blind) folded on the Flop
Seat 3: 83399f83 (big blind) won ($1.28)
Seat 4: 63499226 folded before Flop (didn't bet)
Seat 5: c4eb9775 folded on the River
Seat 6: 5f1cdd27 folded before Flop (didn't bet)


Poker Hand #RC3334366824: Hold'em No Limit ($0.02/$0.05) - 2025/02/17 20:07:14
Table 'RushAndCash592084' 6-max Seat #1 is the button
Seat 1: 24d6dfa4 ($9.62 in chips)
Seat 2: 89025632 ($3.34 in chips)
Seat 3: Hero ($5.18 in chips)
Seat 4: 2b6388ee ($5.85 in chips)
Seat 5: d16d905f ($5 in chips)
Seat 6: 4db54282 ($5 in chips)
89025632: posts small blind $0.02
Hero: posts big blind $0.05
*** HOLE CARDS ***
Dealt to 24d6dfa4 
Dealt to 89025632 
Dealt to Hero [Jc Kc]
Dealt to 2b6388ee 
Dealt to d16d905f 
Dealt to 4db54282 
2b6388ee: raises $0.05 to $0.1
d16d905f: calls $0.1
4db54282: folds
24d6dfa4: folds
89025632: folds
Hero: calls $0.05
*** FLOP *** [Qh Th 8c]
Hero: checks
2b6388ee: checks
d16d905f: checks
*** TURN *** [Qh Th 8c] [7s]
Hero: checks
2b6388ee: bets $0.16
d16d905f: folds
Hero: calls $0.16
*** RIVER *** [Qh Th 8c 7s] [Ks]
Hero: checks
2b6388ee: bets $0.22
Hero: calls $0.22
2b6388ee: shows [Jh Ad] (Aces-High Straight)
Hero: shows [Jc Kc] (Pair of Kings)
*** SHOWDOWN ***
2b6388ee collected $1.03 from pot
*** SUMMARY ***
Total pot $1.08 | Rake $0.05 | Jackpot $0 | Bingo $0 | Fortune $0 | Tax $0
Board [Qh Th 8c 7s Ks]
Seat 1: 24d6dfa4 (button) folded before Flop (didn't bet)
Seat 2: 89025632 (small blind) folded before Flop
Seat 3: Hero (big blind) showed [Jc Kc] and lost with Pair of Kings
Seat 4: 2b6388ee showed [Jh Ad] and won ($1.03) with Aces-High Straight
Seat 5: d16d905f folded on the Turn
Seat 6: 4db54282 folded before Flop (didn't bet)


Poker Hand #RC3334366806: Hold'em No Limit ($0.02/$0.05) - 2025/02/17 20:07:11
Table 'RushAndCash592066' 6-max Seat #1 is the button
Seat 1: 33bc9b8e ($9.29 in chips)
Seat 2: 693956f5 ($6.54 in chips)
Seat 3: c6158c9d ($5 in chips)
Seat 4: Hero ($5.18 in chips)
Seat 5: 9467aa1 ($5.42 in chips)
Seat 6: a58a1862 ($5.68 in chips)
693956f5: posts small blind $0.02
c6158c9d: posts big blind $0.05
*** HOLE CARDS ***
Dealt to 33bc9b8e 
Dealt to 693956f5 
Dealt to c6158c9d 
Dealt to Hero [2d Tc]
Dealt to 9467aa1 
Dealt to a58a1862 
Hero: folds
9467aa1: folds
a58a1862: folds
33bc9b8e: raises $0.05 to $0.1
693956f5: folds
c6158c9d: folds
Uncalled bet ($0.05) returned to 33bc9b8e
*** SHOWDOWN ***
33bc9b8e collected $0.12 from pot
*** SUMMARY ***
Total pot $0.12 | Rake $0 | Jackpot $0 | Bingo $0 | Fortune $0 | Tax $0
Seat 1: 33bc9b8e (button) collected ($0.12)
Seat 2: 693956f5 (small blind) folded before Flop
Seat 3: c6158c9d (big blind) folded before Flop
Seat 4: Hero folded before Flop (didn't bet)
Seat 5: 9467aa1 folded before Flop (didn't bet)
Seat 6: a58a1862 folded before Flop (didn't bet)


Poker Hand #RC3334366779: Hold'em No Limit ($0.02/$0.05) - 2025/02/17 20:07:07
Table 'RushAndCash592039' 6-max Seat #1 is the button
Seat 1: c6158c9d ($5 in chips)
Seat 2: d916afa1 ($9.87 in chips)
Seat 3: a22f05f1 ($5.46 in chips)
Seat 4: Hero ($5.18 in chips)
Seat 5: 15e8a442 ($5.18 in chips)
Seat 6: 90f78eaa ($9.78 in chips)
d916afa1: posts small blind $0.02
a22f05f1: posts big blind $0.05
*** HOLE CARDS ***
Dealt to c6158c9d 
Dealt to d916afa1 
Dealt to a22f05f1 
Dealt to Hero [8d Ks]
Dealt to 15e8a442 
Dealt to 90f78eaa 
Hero: folds
15e8a442: folds
90f78eaa: raises $0.05 to $0.1
c6158c9d: folds
d916afa1: calls $0.08
a22f05f1: folds
*** FLOP *** [5c 7s 4d]
d916afa1: checks
90f78eaa: bets $0.1
d916afa1: calls $0.1
*** TURN *** [5c 7s 4d] [Qd]
d916afa1: checks
90f78eaa: bets $0.18
d916afa1: folds
Uncalled bet ($0.18) returned to 90f78eaa
*** SHOWDOWN ***
90f78eaa collected $0.43 from pot
*** SUMMARY ***
Total pot $0.45 | Rake $0.02 | Jackpot $0 | Bingo $0 | Fortune $0 | Tax $0
Board [5c 7s 4d Qd]
Seat 1: c6158c9d (button) folded before Flop (didn't bet)
Seat 2: d916afa1 (small blind) folded on the Turn
Seat 3: a22f05f1 (big blind) folded before Flop
Seat 4: Hero folded before Flop (didn't bet)
Seat 5: 15e8a442 folded before Flop (didn't bet)
Seat 6: 90f78eaa won ($0.43)


Poker Hand #RC3334366682: Hold'em No Limit ($0.02/$0.05) - 2025/02/17 20:06:52
Table 'RushAndCash591942' 6-max Seat #1 is the button
Seat 1: 9135e49d ($5 in chips)
Seat 2: 8a752a8f ($5.21 in chips)
Seat 3: 6b985081 ($1.99 in chips)
Seat 4: 3d2a56c8 ($5.94 in chips)
Seat 5: 1a99fcb9 ($9.09 in chips)
Seat 6: Hero ($5.18 in chips)
8a752a8f: posts small blind $0.02
6b985081: posts big blind $0.05
*** HOLE CARDS ***
Dealt to 9135e49d 
Dealt to 8a752a8f 
Dealt to 6b985081 
Dealt to 3d2a56c8 
Dealt to 1a99fcb9 
Dealt to Hero [5s 2c]
3d2a56c8: folds
1a99fcb9: folds
Hero: folds
9135e49d: folds
8a752a8f: folds
Uncalled bet ($0.03) returned to 6b985081
*** SHOWDOWN ***
6b985081 collected $0.04 from pot
*** SUMMARY ***
Total pot $0.04 | Rake $0 | Jackpot $0 | Bingo $0 | Fortune $0 | Tax $0
Seat 1: 9135e49d (button) folded before Flop (didn't bet)
Seat 2: 8a752a8f (small blind) folded before Flop
Seat 3: 6b985081 (big blind) collected ($0.04)
Seat 4: 3d2a56c8 folded before Flop (didn't bet)
Seat 5: 1a99fcb9 folded before Flop (didn't bet)
Seat 6: Hero folded before Flop (didn't bet)


Poker Hand #RC3334366521: Hold'em No Limit ($0.02/$0.05) - 2025/02/17 20:06:27
Table 'RushAndCash591781' 6-max Seat #1 is the button
Seat 1: Hero ($5 in chips)
Seat 2: 275443dc ($4.73 in chips)
Seat 3: 94706c35 ($17.31 in chips)
Seat 4: 573eb753 ($4.58 in chips)
Seat 5: ec64208b ($5.74 in chips)
Seat 6: 3d2a56c8 ($6.06 in chips)
275443dc: posts small blind $0.02
94706c35: posts big blind $0.05
*** HOLE CARDS ***
Dealt to Hero [Qs Ah]
Dealt to 275443dc 
Dealt to 94706c35 
Dealt to 573eb753 
Dealt to ec64208b 
Dealt to 3d2a56c8 
573eb753: folds
ec64208b: folds
3d2a56c8: raises $0.07 to $0.12
Hero: raises $0.24 to $0.36
275443dc: folds
94706c35: folds
3d2a56c8: folds
Uncalled bet ($0.24) returned to Hero
*** SHOWDOWN ***
Hero collected $0.3 from pot
*** SUMMARY ***
Total pot $0.31 | Rake $0.01 | Jackpot $0 | Bingo $0 | Fortune $0 | Tax $0
Seat 1: Hero (button) collected ($0.3)
Seat 2: 275443dc (small blind) folded before Flop
Seat 3: 94706c35 (big blind) folded before Flop
Seat 4: 573eb753 folded before Flop (didn't bet)
Seat 5: ec64208b folded before Flop (didn't bet)
Seat 6: 3d2a56c8 folded before Flop


Poker Hand #RC3334366501: Hold'em No Limit ($0.02/$0.05) - 2025/02/17 20:06:24
Table 'RushAndCash591761' 6-max Seat #1 is the button
Seat 1: 8be10cd0 ($5 in chips)
Seat 2: Hero ($5 in chips)
Seat 3: 52b3e671 ($6.02 in chips)
Seat 4: 55d86a7e ($11.6 in chips)
Seat 5: 39c346bf ($9.1 in chips)
Seat 6: 4052bb6f ($5.77 in chips)
Hero: posts small blind $0.02
52b3e671: posts big blind $0.05
*** HOLE CARDS ***
Dealt to 8be10cd0 
Dealt to Hero [5h 9c]
Dealt to 52b3e671 
Dealt to 55d86a7e 
Dealt to 39c346bf 
Dealt to 4052bb6f 
55d86a7e: folds
39c346bf: folds
4052bb6f: folds
8be10cd0: folds
Hero: folds
Uncalled bet ($0.03) returned to 52b3e671
*** SHOWDOWN ***
52b3e671 collected $0.04 from pot
*** SUMMARY ***
Total pot $0.04 | Rake $0 | Jackpot $0 | Bingo $0 | Fortune $0 | Tax $0
Seat 1: 8be10cd0 (button) folded before Flop (didn't bet)
Seat 2: Hero (small blind) folded before Flop
Seat 3: 52b3e671 (big blind) collected ($0.04)
Seat 4: 55d86a7e folded before Flop (didn't bet)
Seat 5: 39c346bf folded before Flop (didn't bet)
Seat 6: 4052bb6f folded before Flop (didn't bet)


Poker Hand #RC3334366481: Hold'em No Limit ($0.02/$0.05) - 2025/02/17 20:06:20
Table 'RushAndCash591741' 6-max Seat #1 is the button
Seat 1: be95cbec ($8.02 in chips)
Seat 2: 9ad857e5 ($5.43 in chips)
Seat 3: Hero ($5 in chips)
Seat 4: 97fe2676 ($10.11 in chips)
Seat 5: 10a7b2c7 ($7.06 in chips)
Seat 6: d16d905f ($5.07 in chips)
9ad857e5: posts small blind $0.02
Hero: posts big blind $0.05
*** HOLE CARDS ***
Dealt to be95cbec 
Dealt to 9ad857e5 
Dealt to Hero [3d Kc]
Dealt to 97fe2676 
Dealt to 10a7b2c7 
Dealt to d16d905f 
97fe2676: folds
10a7b2c7: folds
d16d905f: raises $0.05 to $0.1
be95cbec: calls $0.1
9ad857e5: raises $0.5 to $0.6
Hero: folds
d16d905f: calls $0.5
be95cbec: folds
*** FLOP *** [Ah 5c 4c]
9ad857e5: bets $0.4
d16d905f: folds
Uncalled bet ($0.4) returned to 9ad857e5
*** SHOWDOWN ***
9ad857e5 collected $1.29 from pot
*** SUMMARY ***
Total pot $1.35 | Rake $0.06 | Jackpot $0 | Bingo $0 | Fortune $0 | Tax $0
Board [Ah 5c 4c]
Seat 1: be95cbec (button) folded before Flop
Seat 2: 9ad857e5 (small blind) won ($1.29)
Seat 3: Hero (big blind) folded before Flop
Seat 4: 97fe2676 folded before Flop (didn't bet)
Seat 5: 10a7b2c7 folded before Flop (didn't bet)
Seat 6: d16d905f folded on the Flop


Poker Hand #RC3334366457: Hold'em No Limit ($0.02/$0.05) - 2025/02/17 20:06:17
Table 'RushAndCash591717' 6-max Seat #1 is the button
Seat 1: f8067dc5 ($5.54 in chips)
Seat 2: f5fcc522 ($10.29 in chips)
Seat 3: 105d4be0 ($6.03 in chips)
Seat 4: 7dd18ea7 ($5.52 in chips)
Seat 5: Hero ($5 in chips)
Seat 6: fa40c39c ($4.92 in chips)
f5fcc522: posts small blind $0.02
105d4be0: posts big blind $0.05
*** HOLE CARDS ***
Dealt to f8067dc5 
Dealt to f5fcc522 
Dealt to 105d4be0 
Dealt to 7dd18ea7 
Dealt to Hero [6d 2c]
Dealt to fa40c39c 
7dd18ea7: raises $0.05 to $0.1
Hero: folds
fa40c39c: folds
f8067dc5: folds
f5fcc522: folds
105d4be0: folds
Uncalled bet ($0.05) returned to 7dd18ea7
*** SHOWDOWN ***
7dd18ea7 collected $0.12 from pot
*** SUMMARY ***
Total pot $0.12 | Rake $0 | Jackpot $0 | Bingo $0 | Fortune $0 | Tax $0
Seat 1: f8067dc5 (button) folded before Flop (didn't bet)
Seat 2: f5fcc522 (small blind) folded before Flop
Seat 3: 105d4be0 (big blind) folded before Flop
Seat 4: 7dd18ea7 collected ($0.12)
Seat 5: Hero folded before Flop (didn't bet)
Seat 6: fa40c39c folded before Flop (didn't bet)


Poker Hand #RC3334366435: Hold'em No Limit ($0.02/$0.05) - 2025/02/17 20:06:14
Table 'RushAndCash591695' 6-max Seat #1 is the button
Seat 1: 187f2194 ($6.03 in chips)
Seat 2: b76b457c ($10.22 in chips)
Seat 3: bcbd875d ($5.73 in chips)
Seat 4: Hero ($5 in chips)
Seat 5: 39c346bf ($9.1 in chips)
Seat 6: fa40c39c ($4.92 in chips)
b76b457c: posts small blind $0.02
bcbd875d: posts big blind $0.05
*** HOLE CARDS ***
Dealt to 187f2194 
Dealt to b76b457c 
Dealt to bcbd875d 
Dealt to Hero [7h As]
Dealt to 39c346bf 
Dealt to fa40c39c 
Hero: folds
39c346bf: folds
fa40c39c: folds
187f2194: raises $0.06 to $0.11
b76b457c: folds
bcbd875d: folds
Uncalled bet ($0.06) returned to 187f2194
*** SHOWDOWN ***
187f2194 collected $0.12 from pot
*** SUMMARY ***
Total pot $0.12 | Rake $0 | Jackpot $0 | Bingo $0 | Fortune $0 | Tax $0
Seat 1: 187f2194 (button) collected ($0.12)
Seat 2: b76b457c (small blind) folded before Flop
Seat 3: bcbd875d (big blind) folded before Flop
Seat 4: Hero folded before Flop (didn't bet)
Seat 5: 39c346bf folded before Flop (didn't bet)
Seat 6: fa40c39c folded before Flop (didn't bet)


Poker Hand #RC3334366409: Hold'em No Limit ($0.02/$0.05) - 2025/02/17 20:06:10
Table 'RushAndCash591669' 6-max Seat #1 is the button
Seat 1: bbd60b52 ($15.84 in chips)
Seat 2: 4c8dd192 ($10.16 in chips)
Seat 3: a3bb23ae ($5 in chips)
Seat 4: Hero ($5 in chips)
Seat 5: 8c6b70e4 ($5.42 in chips)
Seat 6: 27baaa05 ($5 in chips)
4c8dd192: posts small blind $0.02
a3bb23ae: posts big blind $0.05
*** HOLE CARDS ***
Dealt to bbd60b52 
Dealt to 4c8dd192 
Dealt to a3bb23ae 
Dealt to Hero [2d 7h]
Dealt to 8c6b70e4 
Dealt to 27baaa05 
Hero: folds
8c6b70e4: folds
27baaa05: folds
bbd60b52: folds
4c8dd192: raises $0.1 to $0.15
a3bb23ae: folds
Uncalled bet ($0.1) returned to 4c8dd192
*** SHOWDOWN ***
4c8dd192 collected $0.1 from pot
*** SUMMARY ***
Total pot $0.1 | Rake $0 | Jackpot $0 | Bingo $0 | Fortune $0 | Tax $0
Seat 1: bbd60b52 (button) folded before Flop (didn't bet)
Seat 2: 4c8dd192 (small blind) collected ($0.1)
Seat 3: a3bb23ae (big blind) folded before Flop
Seat 4: Hero folded before Flop (didn't bet)
Seat 5: 8c6b70e4 folded before Flop (didn't bet)
Seat 6: 27baaa05 folded before Flop (didn't bet)


Poker Hand #RC3334366387: Hold'em No Limit ($0.02/$0.05) - 2025/02/17 20:06:07
Table 'RushAndCash591647' 6-max Seat #1 is the button
Seat 1: 9885e0a0 ($5.85 in chips)
Seat 2: bbdadd69 ($6.56 in chips)
Seat 3: 27baaa05 ($5.05 in chips)
Seat 4: Hero ($5 in chips)
Seat 5: b282789b ($5.69 in chips)
Seat 6: 93735ac4 ($5.09 in chips)
bbdadd69: posts small blind $0.02
27baaa05: posts big blind $0.05
*** HOLE CARDS ***
Dealt to 9885e0a0 
Dealt to bbdadd69 
Dealt to 27baaa05 
Dealt to Hero [9s 5d]
Dealt to b282789b 
Dealt to 93735ac4 
Hero: folds
b282789b: folds
93735ac4: folds
9885e0a0: folds
bbdadd69: raises $0.1 to $0.15
27baaa05: folds
Uncalled bet ($0.1) returned to bbdadd69
*** SHOWDOWN ***
bbdadd69 collected $0.1 from pot
*** SUMMARY ***
Total pot $0.1 | Rake $0 | Jackpot $0 | Bingo $0 | Fortune $0 | Tax $0
Seat 1: 9885e0a0 (button) folded before Flop (didn't bet)
Seat 2: bbdadd69 (small blind) collected ($0.1)
Seat 3: 27baaa05 (big blind) folded before Flop
Seat 4: Hero folded before Flop (didn't bet)
Seat 5: b282789b folded before Flop (didn't bet)
Seat 6: 93735ac4 folded before Flop (didn't bet)


Poker Hand #RC3334366368: Hold'em No Limit ($0.02/$0.05) - 2025/02/17 20:06:04
Table 'RushAndCash591628' 6-max Seat #1 is the button
Seat 1: Hero ($5 in chips)
Seat 2: 100d4f9e ($5.95 in chips)
Seat 3: bbdadd69 ($6.61 in chips)
Seat 4: fa40c39c ($4.92 in chips)
Seat 5: 9b077cd8 ($6.69 in chips)
Seat 6: 7b9998a4 ($5 in chips)
100d4f9e: posts small blind $0.02
bbdadd69: posts big blind $0.05
*** HOLE CARDS ***
Dealt to Hero [2c Jc]
Dealt to 100d4f9e 
Dealt to bbdadd69 
Dealt to fa40c39c 
Dealt to 9b077cd8 
Dealt to 7b9998a4 
fa40c39c: folds
9b077cd8: raises $0.07 to $0.12
7b9998a4: folds
Hero: folds
100d4f9e: folds
bbdadd69: folds
Uncalled bet ($0.07) returned to 9b077cd8
*** SHOWDOWN ***
9b077cd8 collected $0.12 from pot
*** SUMMARY ***
Total pot $0.12 | Rake $0 | Jackpot $0 | Bingo $0 | Fortune $0 | Tax $0
Seat 1: Hero (button) folded before Flop (didn't bet)
Seat 2: 100d4f9e (small blind) folded before Flop
Seat 3: bbdadd69 (big blind) folded before Flop
Seat 4: fa40c39c folded before Flop (didn't bet)
Seat 5: 9b077cd8 collected ($0.12)
Seat 6: 7b9998a4 folded before Flop (didn't bet)


Poker Hand #RC3334366346: Hold'em No Limit ($0.02/$0.05) - 2025/02/17 20:06:00
Table 'RushAndCash591606' 6-max Seat #1 is the button
Seat 1: b5e0a560 ($4.4 in chips)
Seat 2: Hero ($5 in chips)
Seat 3: e74a324 ($5 in chips)
Seat 4: 709ac205 ($10.34 in chips)
Seat 5: 97bc7ae0 ($7.22 in chips)
Seat 6: 99af2b58 ($5.54 in chips)
Hero: posts small blind $0.02
e74a324: posts big blind $0.05
*** HOLE CARDS ***
Dealt to b5e0a560 
Dealt to Hero [As 2h]
Dealt to e74a324 
Dealt to 709ac205 
Dealt to 97bc7ae0 
Dealt to 99af2b58 
709ac205: folds
97bc7ae0: folds
99af2b58: raises $0.05 to $0.1
b5e0a560: folds
Hero: folds
e74a324: folds
Uncalled bet ($0.05) returned to 99af2b58
*** SHOWDOWN ***
99af2b58 collected $0.12 from pot
*** SUMMARY ***
Total pot $0.12 | Rake $0 | Jackpot $0 | Bingo $0 | Fortune $0 | Tax $0
Seat 1: b5e0a560 (button) folded before Flop (didn't bet)
Seat 2: Hero (small blind) folded before Flop
Seat 3: e74a324 (big blind) folded before Flop
Seat 4: 709ac205 folded before Flop (didn't bet)
Seat 5: 97bc7ae0 folded before Flop (didn't bet)
Seat 6: 99af2b58 collected ($0.12)


Poker Hand #RC3334366238: Hold'em No Limit ($0.02/$0.05) - 2025/02/17 20:05:44
Table 'RushAndCash591498' 6-max Seat #1 is the button
Seat 1: bf36c2b ($5.3 in chips)
Seat 2: 93dfef8b ($5.48 in chips)
Seat 3: Hero ($5 in chips)
Seat 4: 7c13e490 ($5.83 in chips)
Seat 5: bbdadd69 ($6.54 in chips)
Seat 6: 6abd829b ($6.55 in chips)
93dfef8b: posts small blind $0.02
Hero: posts big blind $0.05
*** HOLE CARDS ***
Dealt to bf36c2b 
Dealt to 93dfef8b 
Dealt to Hero [Qs 2h]
Dealt to 7c13e490 
Dealt to bbdadd69 
Dealt to 6abd829b 
7c13e490: folds
bbdadd69: raises $0.05 to $0.1
6abd829b: folds
bf36c2b: folds
93dfef8b: folds
Hero: folds
Uncalled bet ($0.05) returned to bbdadd69
*** SHOWDOWN ***
bbdadd69 collected $0.12 from pot
*** SUMMARY ***
Total pot $0.12 | Rake $0 | Jackpot $0 | Bingo $0 | Fortune $0 | Tax $0
Seat 1: bf36c2b (button) folded before Flop (didn't bet)
Seat 2: 93dfef8b (small blind) folded before Flop
Seat 3: Hero (big blind) folded before Flop
Seat 4: 7c13e490 folded before Flop (didn't bet)
Seat 5: bbdadd69 collected ($0.12)
Seat 6: 6abd829b folded before Flop (didn't bet)


